,نماد,نام,تعداد,حجم,ارزش,دیروز,اولین,آخرین معامله - مقدار,آخرین معامله - تغییر,آخرین معامله - درصد,قیمت پایانی - مقدار,قیمت پایانی - تغییر,قیمت پایانی - درصد,کمترین,بیشترین,تاریخ,gregorian_date
0,پالايش,صندوق پالايشي يكم-سهام,70109,102870527,7695506144490,70970,76500,73300,2330,3.28,74810,3840,5.41,72000,77490,1400-3-9,2021-05-30
1,سپيدار,سپيدار سيستم آسيا,41694,3113350,153988486386,50428,49230,47908,-2520,-5,49461,-967,-1.92,47907,51980,1400-3-9,2021-05-30
2,دارا يكم,صندوق واسطه گري مالي يكم-سهام,38904,32128255,4159346315520,123620,129250,126100,2480,2.01,129460,5840,4.72,125000,135900,1400-3-9,2021-05-30
3,فگستر,گسترش صنايع روي ايرانيان,33304,4350844,43991383684,9630,10111,10111,481,4.99,10111,481,4.99,10111,10111,1400-3-9,2021-05-30
4,چخزر,صنايع چوب خزر كاسپين,32535,5366662,184610328632,32996,34645,34645,1649,5,34399,1403,4.25,33400,34645,1400-3-9,2021-05-30
5,غزر,صنعتي زر ماكارون,27175,16055760,370758064470,24240,23030,23030,-1210,-4.99,23090,-1150,-4.74,23030,23940,1400-3-9,2021-05-30
6,فتوسا,توليد و توسعه سرب روي ايرانيان,23641,1585681,17456762129,10485,11009,11009,524,5,11009,524,5,11009,11009,1400-3-9,2021-05-30
7,خودرو,ايران‌ خودرو,19333,621306060,1127232839544,1767,1845,1765,-2,-0.11,1814,47,2.66,1731,1855,1400-3-9,2021-05-30
8,فملي,ملي‌ صنايع‌ مس‌ ايران‌,19206,124471852,1584726156120,12400,13010,12480,80,0.65,12730,330,2.66,12350,13020,1400-3-9,2021-05-30
9,فولاد,فولاد مباركه اصفهان,17198,189740020,1853228501870,9390,9850,9610,220,2.34,9770,380,4.05,9450,9850,1400-3-9,2021-05-30
10,خساپا,سايپا,16836,528877466,868573820153,1606,1671,1602,-4,-0.25,1642,36,2.24,1590,1686,1400-3-9,2021-05-30
11,ثبهساز,بهساز كاشانه تهران,16761,117764812,213402699143,1814,1820,1747,-67,-3.69,1812,-2,-0.11,1724,1900,1400-3-9,2021-05-30
12,بركت,گروه دارويي بركت,15584,55249924,1396091699280,24230,25440,25440,1210,4.99,25270,1040,4.29,24450,25440,1400-3-9,2021-05-30
13,شپنا,پالايش نفت اصفهان,15177,327049780,3423675738770,9980,10470,10470,490,4.91,10470,490,4.91,10310,10470,1400-3-9,2021-05-30
14,غگيلا,شيرپاستوريزه پگاه گيلان,14693,13408207,238487979937,17199,17700,17880,681,3.96,17787,588,3.42,16860,18058,1400-3-9,2021-05-30
15,شستا,سرمايه گذاري تامين اجتماعي,14346,79426221,838135101090,10170,10630,10290,120,1.18,10550,380,3.74,10200,10670,1400-3-9,2021-05-30
16,كزغال,زغال سنگ پروده طبس,14035,9762910,304502860290,30069,31572,31134,1065,3.54,31190,1121,3.73,30350,31572,1400-3-9,2021-05-30
17,كرمان,س. توسعه و عمران استان كرمان,13917,561364092,559830102034,957,1004,1004,47,4.91,997,40,4.18,970,1004,1400-3-9,2021-05-30
18,وبملت,بانك ملت,12686,288221418,1150045802804,3988,4070,3910,-78,-1.96,3990,2,0.05,3850,4148,1400-3-9,2021-05-30
19,خگستر,گسترش‌سرمايه‌گذاري‌ايران‌خودرو,10514,348625740,693400337405,1937,2030,1929,-8,-0.41,1989,52,2.68,1903,2033,1400-3-9,2021-05-30
20,امينح,ح . تامين سرمايه امين,9829,6114575,31282607260,5140,5170,5060,-80,-1.56,5120,-20,-0.39,4990,5200,1400-3-9,2021-05-30
21,شتران,پالايش نفت تهران,9765,149565894,1213125572230,7760,8140,8140,380,4.9,8110,350,4.51,7910,8140,1400-3-9,2021-05-30
22,وتجارت,بانك تجارت,8986,276334416,563255952665,1970,2058,1985,15,0.76,2038,68,3.45,1960,2068,1400-3-9,2021-05-30
23,غكورش,صنعت غذايي كورش,8768,1607824,53074270240,31440,33010,33010,1570,4.99,33010,1570,4.99,33010,33010,1400-3-9,2021-05-30
24,شبندر,پالايش نفت بندرعباس,8265,63483785,1397685509820,21060,22110,21640,580,2.75,22020,960,4.56,21320,22110,1400-3-9,2021-05-30
25,ثاميد,توسعه و عمران اميد,8246,93176212,141061830613,1528,1554,1458,-70,-4.58,1514,-14,-0.92,1453,1587,1400-3-9,2021-05-30
26,ذوب,سهامي ذوب آهن  اصفهان,8081,298996195,978612246429,3120,3276,3275,155,4.97,3273,153,4.9,3222,3276,1400-3-9,2021-05-30
27,وبصادر,بانك صادرات ايران,7576,272238144,527527282996,1852,1944,1918,66,3.56,1938,86,4.64,1890,1944,1400-3-9,2021-05-30
28,پتاير,ايران‌ تاير,7244,135884299,384074456299,2907,2970,2762,-145,-4.99,2826,-81,-2.79,2762,2980,1400-3-9,2021-05-30
29,كاما,باما,7080,47999491,415622356520,8790,9000,8360,-430,-4.89,8660,-130,-1.48,8360,9180,1400-3-9,2021-05-30
30,آريا,پليمر آريا ساسول,6969,4066189,340977637944,80363,84381,82996,2633,3.28,83857,3494,4.35,82600,84381,1400-3-9,2021-05-30
31,كوير,توليدي فولاد سپيد فراب كوير,6755,38725412,525292781860,13140,13450,13280,140,1.07,13560,420,3.2,12860,13790,1400-3-9,2021-05-30
32,خبهمن,گروه‌بهمن‌,6617,230447004,269459520923,1167,1206,1132,-35,-3,1169,2,0.17,1112,1219,1400-3-9,2021-05-30
33,پترول,گ.س.وت.ص.پتروشيمي خليج فارس,6614,35668274,317074630160,8800,9010,8700,-100,-1.14,8890,90,1.02,8550,9200,1400-3-9,2021-05-30
34,ولپارس,ليزينگ پارسيان,6489,12599857,50979421800,4138,4159,3932,-206,-4.98,4046,-92,-2.22,3932,4165,1400-3-9,2021-05-30
35,وخارزم,سرمايه گذاري خوارزمي,6385,127381911,506604120753,3812,4002,3992,180,4.72,3977,165,4.33,3850,4002,1400-3-9,2021-05-30
36,خزاميا,زامياد,6216,67990949,411394220330,6170,6200,5870,-300,-4.86,6050,-120,-1.94,5870,6390,1400-3-9,2021-05-30
37,كاذر,فرآورده‌هاي‌نسوزآذر,5970,29549587,445258343530,15750,14970,14970,-780,-4.95,15070,-680,-4.32,14970,15700,1400-3-9,2021-05-30
38,آبادا,توليد نيروي برق آبادان,5639,4838246,49501777290,9810,10300,10170,360,3.67,10230,420,4.28,9910,10300,1400-3-9,2021-05-30
39,شگويا,پتروشيمي تندگويان,5600,28698081,257597483430,8897,9100,8739,-158,-1.78,8976,79,0.89,8580,9200,1400-3-9,2021-05-30
40,وسپهر,سرمايه گذاري مالي سپهرصادرات,5452,12175964,111039100699,9149,9096,9094,-55,-0.6,9120,-29,-0.32,9094,9300,1400-3-9,2021-05-30
41,وكبهمن,مديريت سرمايه گذاري كوثربهمن,5425,4127319,45671006917,10885,11001,11002,117,1.07,11066,181,1.66,10670,11320,1400-3-9,2021-05-30
42,امين يكم,صندوق درآمد ثابت امين يكم فردا,5332,192416347,1931394687511,10035,10039,10041,6,0.06,10038,3,0.03,10030,10041,1400-3-9,2021-05-30
43,بوعلي,پتروشيمي بوعلي سينا,5328,2004777,91341529290,44290,45310,44700,410,0.93,45560,1270,2.87,44440,46320,1400-3-9,2021-05-30
44,اپال,فرآوري معدني اپال كاني پارس,5264,13055680,244526513660,18690,18890,18770,80,0.43,18730,40,0.21,18690,18900,1400-3-9,2021-05-30
45,فاراك,ماشين‌ سازي‌ اراك‌,5233,124423024,266906957891,2084,2116,2070,-14,-0.67,2145,61,2.93,2020,2188,1400-3-9,2021-05-30
46,حكشتي,كشتيراني جمهوري اسلامي ايران,4949,18942866,258116828710,13710,14090,13350,-360,-2.63,13630,-80,-0.58,13100,14340,1400-3-9,2021-05-30
47,دانا,بيمه دانا,4945,49715137,259772064150,5380,5420,5130,-250,-4.65,5230,-150,-2.79,5120,5550,1400-3-9,2021-05-30
48,كمند,صندوق س. با درآمد ثابت كمند,4841,252007080,2554747930518,10133,10137,10138,5,0.05,10138,5,0.05,10137,10140,1400-3-9,2021-05-30
49,ودي,بيمه  دي,4528,34507858,631219370875,19107,18152,18265,-842,-4.41,18292,-815,-4.27,18152,18700,1400-3-9,2021-05-30
50,فارس,صنايع پتروشيمي خليج فارس,4466,37542568,357595734850,9390,9500,9380,-10,-0.11,9530,140,1.49,9240,9810,1400-3-9,2021-05-30
51,وپاسار,بانك  پاسارگاد,4376,65364979,1033499706200,15780,15800,15830,50,0.32,15810,30,0.19,15490,15840,1400-3-9,2021-05-30
52,وملي,گروه‌ صنعتي‌ ملي‌ (هلدينگ‌,4304,2579107,360838914180,146420,139100,140400,-6020,-4.11,139910,-6510,-4.45,139100,143800,1400-3-9,2021-05-30
53,وبيمه,سرمايه‌ گذاري‌ صنعت‌ بيمه‌,4179,97705574,189656106864,1931,1924,1860,-71,-3.68,1941,10,0.52,1854,2020,1400-3-9,2021-05-30
54,امين,تامين سرمايه امين,4097,5093907,36218259740,7110,7110,7110,0,0,7110,0,0,7010,7150,1400-3-9,2021-05-30
55,سدور,سيمان‌ دورود,4066,34649645,301847175450,8790,9220,8440,-350,-3.98,8710,-80,-0.91,8360,9220,1400-3-9,2021-05-30
56,بپيوند,برق و انرژي پيوندگستر پارس,4006,3367805,35282369148,10485,10980,10207,-278,-2.65,10476,-9,-0.09,10150,10980,1400-3-9,2021-05-30
57,فخوز,فولاد  خوزستان,3915,25455068,399640015180,15500,15680,15510,10,0.06,15700,200,1.29,15210,16140,1400-3-9,2021-05-30
58,سيتا,سرمايه گذاري سيمان تامين,3892,8311867,124812921620,15080,15050,15000,-80,-0.53,15020,-60,-0.4,15000,15250,1400-3-9,2021-05-30
59,ثاخت,بين‌المللي‌توسعه‌ساختمان,3780,63442920,132950324207,2075,2140,2069,-6,-0.29,2096,21,1.01,2020,2160,1400-3-9,2021-05-30
60,كلوند,كاشي‌ الوند,3754,11597553,235390621760,19760,19560,20000,240,1.21,20300,540,2.73,19100,20740,1400-3-9,2021-05-30
61,نوري,پتروشيمي نوري,3570,4101659,261146001540,62920,66000,62660,-260,-0.41,63670,750,1.19,62110,66000,1400-3-9,2021-05-30
62,بگيلان,توسعه مسير برق گيلان,3474,1067504,19240877081,18020,18110,18100,80,0.44,18023,3,0.02,17502,18520,1400-3-9,2021-05-30
63,شتوكا,توكا رنگ فولاد سپاهان,3469,11178718,344153584823,29943,31440,31400,1457,4.87,30786,843,2.82,28446,31440,1400-3-9,2021-05-30
64,وغدير,سرمايه‌گذاري‌غدير(هلدينگ‌,3421,49545730,514410936650,9920,10410,10230,310,3.13,10380,460,4.64,10040,10410,1400-3-9,2021-05-30
65,وپارس,بانك‌پارسيان‌,3414,123743935,347664870290,2796,2860,2805,9,0.32,2810,14,0.5,2800,2895,1400-3-9,2021-05-30
66,سرو,صندوق س سروسودمند مدبران-سهام,3336,3518221,214172044490,59980,61430,59700,-280,-0.47,60880,900,1.5,59000,62800,1400-3-9,2021-05-30
67,فرآور,فرآوري‌موادمعدني‌ايران‌,3252,15916867,434072480570,28480,27120,27060,-1420,-4.99,27270,-1210,-4.25,27060,28380,1400-3-9,2021-05-30
68,خمحركه,نيرو محركه‌,3241,36960765,132753023095,3649,3750,3469,-180,-4.93,3592,-57,-1.56,3467,3830,1400-3-9,2021-05-30
69,گشان,توسعه بين المللي پديده شانديز,3236,7372615,159381616691,22013,21640,21573,-440,-2,21618,-395,-1.79,21573,22167,1400-3-9,2021-05-30
70,بترانس,ايران‌ ترانسفو,3032,56235355,130073521617,2242,2354,2260,18,0.8,2313,71,3.17,2203,2354,1400-3-9,2021-05-30
71,پكوير,كوير تاير,2907,20083154,232971147930,12540,11290,11390,-1150,-9.17,11600,-940,-7.5,11290,12480,1400-3-9,2021-05-30
72,شبريز,پالايش نفت تبريز,2839,10756180,272385291500,24330,25540,24830,500,2.06,25320,990,4.07,24300,25540,1400-3-9,2021-05-30
73,پيزد,مجتمع صنايع لاستيك يزد,2807,446888,24457317070,54334,56900,53850,-484,-0.89,54728,394,0.73,53000,56900,1400-3-9,2021-05-30
74,نوين,بيمه نوين,2800,24398570,132403264769,5478,5331,5225,-253,-4.62,5427,-51,-0.93,5212,5680,1400-3-9,2021-05-30
75,ساوه,سيمان ساوه,2780,1999902,82959546430,43192,44900,41034,-2158,-5,41482,-1710,-3.96,41033,44900,1400-3-9,2021-05-30
76,سبزوا,سيمان لار سبزوار,2757,29216871,86652998221,3027,3018,2876,-151,-4.99,2966,-61,-2.02,2876,3100,1400-3-9,2021-05-30
77,كفپارس,فرآورده‌هاي‌ نسوز پارس‌,2756,39560728,116736167592,2825,2849,2890,65,2.3,2951,126,4.46,2840,2966,1400-3-9,2021-05-30
78,خصدرا,صنعتي‌ دريايي‌ ايران‌,2743,62915600,134398972611,2144,2208,2081,-63,-2.94,2136,-8,-0.37,2080,2208,1400-3-9,2021-05-30
79,تاپيكو,س. نفت و گاز و پتروشيمي تأمين,2737,38747130,413694294610,10220,10550,10500,280,2.74,10680,460,4.5,10280,10730,1400-3-9,2021-05-30
80,غپينو,پارس‌ مينو,2731,22850677,139331042490,5910,5980,6090,180,3.05,6100,190,3.21,5800,6200,1400-3-9,2021-05-30
81,تسه0002,امتيازتسهيلاتمسكن ارديبهشت1400,2730,55688,30228386572,545800,550122,536000,-9800,-1.8,542817,-2983,-0.55,520000,563800,1400-3-9,2021-05-30
82,خاذين,سايپاآذين‌,2700,40400094,121952114635,3030,3040,2880,-150,-4.95,3019,-11,-0.36,2879,3181,1400-3-9,2021-05-30
83,بكهنوج,توليد برق ماهتاب كهنوج,2643,54548669,78980609888,1477,1471,1404,-73,-4.94,1448,-29,-1.96,1404,1520,1400-3-9,2021-05-30
84,ومعادن,توسعه‌معادن‌وفلزات‌,2579,25884318,213534997060,7960,8350,8180,220,2.76,8250,290,3.64,8020,8350,1400-3-9,2021-05-30
85,ستران,سيمان‌ تهران‌,2575,6995186,137957113680,20240,20500,19300,-940,-4.64,19720,-520,-2.57,19230,20750,1400-3-9,2021-05-30
86,آگاس,صندوق س.هستي بخش آگاه-س,2537,2725824,178260393905,64106,65999,64400,294,0.46,65397,1291,2.01,63700,67899,1400-3-9,2021-05-30
87,ختوقا,قطعات‌ اتومبيل‌ ايران‌,2535,36708458,69802605011,1935,1990,1839,-96,-4.96,1902,-33,-1.71,1839,2029,1400-3-9,2021-05-30
88,رتاپ,تجارت الكترونيك  پارسيان,2431,14950669,81631720760,5560,5410,5500,-60,-1.08,5460,-100,-1.8,5290,5690,1400-3-9,2021-05-30
89,حفاري,حفاري شمال,2426,37354911,218852772660,5600,5880,5880,280,5,5860,260,4.64,5650,5880,1400-3-9,2021-05-30
90,بجهرم,توسعه مولد نيروگاهي جهرم,2423,30454920,64843792131,2120,2190,2080,-40,-1.89,2129,9,0.42,2055,2210,1400-3-9,2021-05-30
91,ونيرو,سرمايه‌گذاري‌نيرو,2422,44285959,105172243863,2346,2381,2340,-6,-0.26,2375,29,1.24,2260,2459,1400-3-9,2021-05-30
92,قاسم,قاسم ايران,2343,11516979,123461479080,10348,10320,10400,52,0.5,10720,372,3.59,10320,10865,1400-3-9,2021-05-30
93,اعتماد,صندوق س.اعتماد آفرين پارسيان-د,2340,46578410,1709082452650,36675,36693,36695,20,0.05,36693,18,0.05,36600,36698,1400-3-9,2021-05-30
94,وساپا,سرمايه‌گذاري‌ سايپا,2312,34976980,149878706339,4396,4450,4180,-216,-4.91,4285,-111,-2.53,4177,4580,1400-3-9,2021-05-30
95,وخارزمح,ح.سرمايه گذاري خوارزمي,2281,20181604,57082231593,2719,2894,2760,41,1.51,2828,109,4.01,2620,2970,1400-3-9,2021-05-30
96,ساراب,سيمان‌ داراب‌,2272,9028769,169511684190,19600,18730,18620,-980,-5,18770,-830,-4.23,18620,19300,1400-3-9,2021-05-30
97,غمينو,شركت صنايع غذايي مينو شرق,2236,10698257,98695374520,9209,9050,9209,0,0,9225,16,0.17,8811,9437,1400-3-9,2021-05-30
98,وبانك,سرمايه گذاري گروه توسعه ملي,2198,19608423,144243911730,7120,7200,7350,230,3.23,7360,240,3.37,7130,7470,1400-3-9,2021-05-30
99,كچاد,معدني‌وصنعتي‌چادرملو,2179,10070419,233287178300,23130,23610,22820,-310,-1.34,23170,40,0.17,22550,24100,1400-3-9,2021-05-30
100,ولبهمن,شركت بهمن ليزينگ,2175,14343867,93062797750,6618,6340,6330,-288,-4.35,6488,-130,-1.96,6288,6890,1400-3-9,2021-05-30
101,سغرب,سيمان‌غرب‌,2174,4629748,126818536150,27790,26490,26420,-1370,-4.93,27390,-400,-1.44,26410,29000,1400-3-9,2021-05-30
102,ونوين,بانك‌اقتصادنوين‌,2129,40107257,170079642783,4113,4318,4179,66,1.6,4241,128,3.11,4101,4318,1400-3-9,2021-05-30
103,وتوصا,گروه س توسعه صنعتي ايران,2082,13291712,107946771890,8240,8490,8030,-210,-2.55,8120,-120,-1.46,7830,8490,1400-3-9,2021-05-30
104,كيان,صندوق س. با درآمد ثابت كيان,2062,28227192,808439478933,28625,28640,28641,16,0.06,28640,15,0.05,28640,28643,1400-3-9,2021-05-30
105,ومعادنح,ح . توسعه‌معادن‌وفلزات‌,2053,19032810,116044348660,6020,6210,6000,-20,-0.33,6100,80,1.33,5900,6320,1400-3-9,2021-05-30
106,فباهنرح,ح . مس‌ شهيدباهنر,2037,8295457,117508877410,13770,14480,13870,100,0.73,14170,400,2.9,13500,14880,1400-3-9,2021-05-30
107,چكارن,كارتن‌ ايران‌,2031,35447473,106003451125,3120,2964,2964,-156,-5,2990,-130,-4.17,2964,3080,1400-3-9,2021-05-30
108,غسالم,سالمين‌,2030,23906768,78343982215,3305,3299,3320,15,0.45,3277,-28,-0.85,3150,3380,1400-3-9,2021-05-30
109,تنوين,تامين سرمايه نوين,2027,84359793,670155458090,7680,7990,7990,310,4.04,7940,260,3.39,7730,8050,1400-3-9,2021-05-30
110,دكوثر,داروسازي‌ كوثر,1999,28159048,124629378568,4370,4588,4200,-170,-3.89,4426,56,1.28,4152,4588,1400-3-9,2021-05-30
111,صبا,سرمايه گذاري صبا تامين,1998,8389705,61030739780,7171,7340,7238,67,0.93,7221,50,0.7,7010,7480,1400-3-9,2021-05-30
112,اخابر,مخابرات ايران,1963,16949389,130602583180,7620,7900,7400,-220,-2.89,7710,90,1.18,7330,8000,1400-3-9,2021-05-30
113,آوا,صندوق س.سهام آواي معيار-س,1786,15364815,100652425192,6419,6580,6441,22,0.34,6551,132,2.06,6410,6729,1400-3-9,2021-05-30
114,فسرب,ملي‌ سرب‌وروي‌ ايران‌,1771,1534155,97208618630,66530,63210,63210,-3320,-4.99,63360,-3170,-4.76,63210,65000,1400-3-9,2021-05-30
115,وهور,مديريت انرژي اميد  تابان هور,1732,33411904,64188521350,1924,2000,1860,-64,-3.33,1921,-3,-0.16,1834,2010,1400-3-9,2021-05-30
116,توريل,توكاريل,1709,6138824,92539335834,15302,15002,14537,-765,-5,15074,-228,-1.49,14537,15698,1400-3-9,2021-05-30
117,غشوكو,شوكو پارس,1700,6069559,154621395898,26769,25431,25431,-1338,-5,25475,-1294,-4.83,25431,26060,1400-3-9,2021-05-30
118,ونيكي,سرمايه‌گذاري‌ ملي‌ايران‌,1699,9055613,74545232200,8440,8660,8020,-420,-4.98,8230,-210,-2.49,8020,8800,1400-3-9,2021-05-30
119,كاوه,فولاد كاوه جنوب كيش,1677,10695689,202534805000,18320,19000,18430,110,0.6,18940,620,3.38,18230,19230,1400-3-9,2021-05-30
120,تملت,تامين سرمايه بانك ملت,1675,8864335,39096454592,4402,4500,4300,-102,-2.32,4411,9,0.2,4186,4550,1400-3-9,2021-05-30
121,سصوفي,سيمان‌ صوفيان‌,1668,6179334,74763455170,12300,12890,11790,-510,-4.15,12100,-200,-1.63,11690,12890,1400-3-9,2021-05-30
122,البرز,بيمه البرز,1602,40084379,152963716752,3697,3881,3760,63,1.7,3816,119,3.22,3650,3881,1400-3-9,2021-05-30
123,رمپنا,گروه مپنا (سهامي عام),1591,13429235,169637159430,13050,13580,12570,-480,-3.68,12630,-420,-3.22,12400,13580,1400-3-9,2021-05-30
124,خفنر,فنرسازي‌خاور,1590,20806433,90815322240,4406,4626,4186,-220,-4.99,4365,-41,-0.93,4186,4626,1400-3-9,2021-05-30
125,سفارس,سيمان فارس و خوزستان,1566,9618149,155603431900,15900,16690,15860,-40,-0.25,16180,280,1.76,15310,16690,1400-3-9,2021-05-30
126,ميدكو,هلدينگ صنايع  معدني خاورميانه,1566,8430671,346874348179,40213,40213,41200,987,2.45,41144,931,2.32,40212,42223,1400-3-9,2021-05-30
127,غگرجي,بيسكويت‌  گرجي‌,1555,5025190,61052334120,12260,12160,12110,-150,-1.22,12150,-110,-0.9,12070,12450,1400-3-9,2021-05-30
128,كمنگنز,معادن‌منگنزايران‌,1544,1016554,70747258800,71230,68020,67670,-3560,-5,69600,-1630,-2.29,67670,73000,1400-3-9,2021-05-30
129,كگل,معدني و صنعتي گل گهر,1527,11323250,164792303850,14040,14210,14510,470,3.35,14550,510,3.63,14110,14740,1400-3-9,2021-05-30
130,آسيا,بيمه آسيا,1499,32128179,58203180943,1752,1839,1779,27,1.54,1812,60,3.42,1736,1839,1400-3-9,2021-05-30
131,هرمز,فولاد هرمزگان جنوب,1487,11675313,190346361520,15968,16210,15770,-198,-1.24,16303,335,2.1,15450,16766,1400-3-9,2021-05-30
132,شغدير,پتروشيمي غدير,1441,3028470,215136266520,69170,72490,69990,820,1.19,71040,1870,2.7,69000,72620,1400-3-9,2021-05-30
133,دزهراوي,داروسازي‌زهراوي‌,1411,7051957,44178466640,6430,6690,6110,-320,-4.98,6260,-170,-2.64,6110,6690,1400-3-9,2021-05-30
134,شيران,س. صنايع‌شيميايي‌ايران,1400,3388469,69367418360,20130,21090,20010,-120,-0.6,20430,300,1.49,19700,21100,1400-3-9,2021-05-30
135,طلا,صندوق س.پشتوانه طلاي لوتوس,1399,1430277,111181865555,77420,78340,76800,-620,-0.8,77734,314,0.41,76500,79000,1400-3-9,2021-05-30
136,شپترو,پتروشيمي آبادان,1381,21336468,90875836386,4186,4311,4215,29,0.69,4259,73,1.74,4152,4311,1400-3-9,2021-05-30
137,لسرما,سرما آفرين‌,1381,3848579,79320835360,19980,19150,20970,990,4.95,20610,630,3.15,19150,20970,1400-3-9,2021-05-30
138,فاسمين,كالسيمين‌,1378,8510940,124256852040,14140,14840,14600,460,3.25,14600,460,3.25,14190,14840,1400-3-9,2021-05-30
139,فباهنر,مس‌ شهيدباهنر,1369,4086103,91276493560,21500,22000,22080,580,2.7,22340,840,3.91,21710,22570,1400-3-9,2021-05-30
140,كگلح,ح . معدني و صنعتي گل گهر,1366,6634024,76838093100,11470,11600,11390,-80,-0.7,11580,110,0.96,11390,11950,1400-3-9,2021-05-30
141,شاراك,پتروشيمي شازند,1355,3801448,102937292090,26340,27260,26800,460,1.75,27080,740,2.81,26430,27640,1400-3-9,2021-05-30
142,وبوعلي,سرمايه‌گذاري‌بوعلي‌,1326,15798382,61208161147,3777,3965,3770,-7,-0.19,3874,97,2.57,3732,3965,1400-3-9,2021-05-30
143,زاگرس,پتروشيمي زاگرس,1319,418443,89139429119,212382,215880,212400,18,0.01,212936,554,0.26,207120,217600,1400-3-9,2021-05-30
144,شكلر,نيروكلر,1314,2519956,98045003300,39050,38030,37540,-1510,-3.87,38910,-140,-0.36,37110,40880,1400-3-9,2021-05-30
145,وسينا,بانك سينا,1308,84241206,206252877211,2341,2458,2376,35,1.5,2448,107,4.57,2365,2458,1400-3-9,2021-05-30
146,كماسه,تامين‌ ماسه‌ ريخته‌گري‌,1221,4698771,129743868340,26370,26900,27680,1310,4.97,27610,1240,4.7,26370,27680,1400-3-9,2021-05-30
147,خودكفا,اقتصادي و خودكفايي آزادگان,1218,12603585,216082586288,17371,17372,16850,-521,-3,17145,-226,-1.3,16850,17700,1400-3-9,2021-05-30
148,وسبحان,سرمايه گذاري سبحان,1210,33365948,79028197519,2396,2469,2350,-46,-1.92,2369,-27,-1.13,2310,2469,1400-3-9,2021-05-30
149,شرانل,نفت ايرانول,1186,2987865,129049789512,41575,42600,43650,2075,4.99,43191,1616,3.89,42100,43653,1400-3-9,2021-05-30
150,سشرق,سيمان‌ شرق‌,1156,10936681,59838005880,5540,5790,5360,-180,-3.25,5470,-70,-1.26,5270,5790,1400-3-9,2021-05-30
151,شپديس,پتروشيمي پرديس,1153,2047865,202637931460,97560,98500,97500,-60,-0.06,98950,1390,1.42,96010,100500,1400-3-9,2021-05-30
152,درهآور,دارويي ره آورد تامين,1145,3028712,76073075853,26274,26400,24961,-1313,-5,25117,-1157,-4.4,24961,26855,1400-3-9,2021-05-30
153,كهمدا,شيشه‌ همدان‌,1130,3611941,33494258450,9380,9370,9060,-320,-3.41,9270,-110,-1.17,8970,9640,1400-3-9,2021-05-30
154,مدير,ص.س.مديريت ثروت ص.بازنشستگي-س,1130,4718957,37763336817,7729,7999,7820,91,1.18,8002,273,3.53,7775,8280,1400-3-9,2021-05-30
155,ومهان,گروه توسعه مالي مهر آيندگان,1123,6680214,82696668423,12270,12695,12204,-66,-0.54,12379,109,0.89,12052,12770,1400-3-9,2021-05-30
156,افران,صندوق س افرا نماد پايدار-ثابت,1123,31475755,422231195009,13405,13413,13417,12,0.09,13414,9,0.07,13413,13418,1400-3-9,2021-05-30
157,وساخت,سرمايه‌ گذاري‌ ساختمان‌ايران‌,1120,4427805,196779870260,42410,44530,44530,2120,5,44440,2030,4.79,42860,44530,1400-3-9,2021-05-30
158,حخزر,كشتيراني درياي خزر,1117,3577704,78692554209,22590,23670,21500,-1090,-4.83,21995,-595,-2.63,21461,23670,1400-3-9,2021-05-30
159,شلرد,كود شيميايي اوره لردگان,1104,9717382,55414803134,5741,5870,5689,-52,-0.91,5703,-38,-0.66,5580,5912,1400-3-9,2021-05-30
160,ورنا,سرمايه‌گذاري‌ رنا(هلدينگ‌,1084,14311075,63279427362,4320,4430,4304,-16,-0.37,4422,102,2.36,4240,4536,1400-3-9,2021-05-30
161,پارند,صندوق س. پارند پايدار سپهر,1075,38450946,434833807420,11300,11308,11306,6,0.05,11309,9,0.08,11306,11320,1400-3-9,2021-05-30
162,مرقام,ايران‌ارقام‌,1037,7169092,124720442090,19320,17390,17390,-1930,-9.99,17400,-1920,-9.94,17390,17890,1400-3-9,2021-05-30
163,ارفع,شركت آهن و فولاد ارفع,1034,2434654,32011105858,13110,13640,12752,-358,-2.73,13129,19,0.14,12650,13640,1400-3-9,2021-05-30
164,وسلرستا,شركت س استان لرستان,1033,53258044,30852167955,605,575,575,-30,-4.96,579,-26,-4.3,575,606,1400-3-9,2021-05-30
165,وپست,پست بانك ايران,1014,3971912,86757550480,21580,22280,21530,-50,-0.23,21840,260,1.2,21110,22430,1400-3-9,2021-05-30
166,شسپا,نفت سپاهان,1005,3905601,57856539910,14640,15100,14480,-160,-1.09,14810,170,1.16,14420,15300,1400-3-9,2021-05-30
167,دفارا,داروسازي‌ فارابي‌,1001,1859759,100790154490,56960,54120,54120,-2840,-4.99,54200,-2760,-4.85,54120,55200,1400-3-9,2021-05-30
168,كنور,توسعه معدني و صنعتي صبانور,1000,1191878,62890117750,51570,54140,52000,430,0.83,52770,1200,2.33,51570,54140,1400-3-9,2021-05-30
169,سهگمت,سيمان‌هگمتان‌,992,8418653,166047041110,19270,19280,19380,110,0.57,19720,450,2.34,19070,20050,1400-3-9,2021-05-30
170,ساروم,سيمان‌اروميه‌,986,2370541,61798003870,26460,27660,25560,-900,-3.4,26070,-390,-1.47,25320,27660,1400-3-9,2021-05-30
171,دسينا,داروسازي‌ سينا,979,2263018,43264204190,19530,19250,19190,-340,-1.74,19120,-410,-2.1,18560,19950,1400-3-9,2021-05-30
172,پارسان,گسترش نفت و گاز پارسيان,966,9039839,168337815930,17940,18830,18260,320,1.78,18620,680,3.79,18200,18830,1400-3-9,2021-05-30
173,وصنعت,سرمايه گذاري توسعه صنعت وتجارت,940,6838008,38438558090,5610,5790,5530,-80,-1.43,5620,10,0.18,5460,5840,1400-3-9,2021-05-30
174,سرچشمه,سرمايه گذاري مس سرچشمه,939,5995305,41615447859,6730,6995,6959,229,3.4,6941,211,3.14,6767,7066,1400-3-9,2021-05-30
175,ارزش,صندوق س ارزش آفرين بيدار-سهام,938,6199411,53913458540,8510,8850,8500,-10,-0.12,8700,190,2.23,8470,8990,1400-3-9,2021-05-30
176,تاصيكو,سرمايه گذاري صدرتامين,936,7515397,74436811170,9700,9740,9660,-40,-0.41,9820,120,1.24,9610,10170,1400-3-9,2021-05-30
177,فمراد,آلومراد,918,693835,54535415610,81160,81100,77110,-4050,-4.99,78600,-2560,-3.15,77110,82400,1400-3-9,2021-05-30
178,واميد,گروه مديريت سرمايه گذاري اميد,912,6803576,69020582540,10290,10360,9860,-430,-4.18,10200,-90,-0.87,9780,10570,1400-3-9,2021-05-30
179,غمارگ,مارگارين‌,907,2383671,43606652770,18470,18860,17910,-560,-3.03,18290,-180,-0.97,17550,18900,1400-3-9,2021-05-30
180,دتماد,توليدمواداوليه‌داروپخش‌,897,2043364,82790783910,39380,41040,38870,-510,-1.3,40520,1140,2.89,38810,41340,1400-3-9,2021-05-30
181,شبصير,توليدات پتروشيمي قائد بصير,893,1572850,127890104379,78543,82470,80000,1457,1.86,81311,2768,3.52,79000,82470,1400-3-9,2021-05-30
182,وتوكا,سرمايه‌گذاري‌توكافولاد(هلدينگ,879,5296870,46063891670,8710,8950,8360,-350,-4.02,8700,-10,-0.11,8310,9030,1400-3-9,2021-05-30
183,كفرا,فراورده‌ هاي‌ نسوزايران‌,872,1945123,40090208890,21440,21140,20370,-1070,-4.99,20610,-830,-3.87,20370,21430,1400-3-9,2021-05-30
184,تسه0001,امتيازتسهيلات مسكن فروردين1400,871,10976,6030708627,550612,552300,540000,-10612,-1.93,549445,-1167,-0.21,526000,570000,1400-3-9,2021-05-30
185,خلنت,لنت‌ ترمزايران‌,864,842203,48884267700,60110,57110,57110,-3000,-4.99,58040,-2070,-3.44,57110,61950,1400-3-9,2021-05-30
186,فوكا,فولاد كاويان,854,6827301,79641171934,11360,11700,11700,340,2.99,11665,305,2.68,11055,11700,1400-3-9,2021-05-30
187,شبهرن,نفت‌ بهران‌,843,3408086,37153566900,10530,11050,10840,310,2.94,10790,260,2.47,10680,11050,1400-3-9,2021-05-30
188,هشستا103,اختيارف ت شستا-10338-01/03/08,814,3510138,3510138,1,1,1,0,0,1,0,0,1,1,1400-3-9,2021-05-30
189,واميدح,ح.گروه مديريت سرمايه گذار اميد,811,5492589,43678990270,8100,8100,7680,-420,-5.19,7950,-150,-1.85,7480,8440,1400-3-9,2021-05-30
190,ثمسكن,سرمايه‌گذاري‌ مسكن‌,809,14228129,59707162897,4077,4220,4280,203,4.98,4196,119,2.92,3988,4280,1400-3-9,2021-05-30
191,گكوثر,هتل پارسيان كوثر اصفهان,807,14375329,27821075209,1932,1979,1946,14,0.72,1935,3,0.16,1892,1979,1400-3-9,2021-05-30
192,سپ,پرداخت الكترونيك سامان كيش,795,3360451,77240049820,23160,22450,23180,20,0.09,22990,-170,-0.73,22110,23500,1400-3-9,2021-05-30
193,فسپا,گروه‌صنعتي‌سپاهان‌,792,1657134,58180283110,35630,36300,35500,-130,-0.36,35110,-520,-1.46,34060,36700,1400-3-9,2021-05-30
194,فنوال,نورد آلومينيوم‌,776,1018630,26109286220,25750,26730,24800,-950,-3.69,25630,-120,-0.47,24800,26730,1400-3-9,2021-05-30
195,كروي,توسعه‌ معادن‌ روي‌ ايران‌,775,2091712,44685093120,21020,21990,21000,-20,-0.1,21360,340,1.62,20120,22070,1400-3-9,2021-05-30
196,افق,فروشگاههاي زنجيره اي افق كوروش,770,796304,53455963720,66780,67500,66000,-780,-1.17,67010,230,0.34,66000,69440,1400-3-9,2021-05-30
197,فنورد,نوردوقطعات‌ فولادي‌,764,337131,53532733960,153400,155000,157290,3890,2.54,158790,5390,3.51,151120,161070,1400-3-9,2021-05-30
198,وسكاب,س.ص.بازنشستگي كاركنان بانكها,762,5925126,28755183688,4781,4960,4828,47,0.98,4853,72,1.51,4700,4980,1400-3-9,2021-05-30
199,والبر,سرمايه‌ گذاري‌ البرز(هلدينگ‌,753,2450483,31195231340,12830,13450,12500,-330,-2.57,12730,-100,-0.78,12310,13450,1400-3-9,2021-05-30
200,كاردان,صندوق س تجارت شاخصي كاردان,750,271717,39864640200,142920,148000,144100,1180,0.83,146710,3790,2.65,143380,151050,1400-3-9,2021-05-30
201,شكربن,كربن‌ ايران‌,747,589590,41133628550,68060,66200,67910,-150,-0.22,69770,1710,2.51,66200,71400,1400-3-9,2021-05-30
202,وملل,اعتباري ملل,746,24597338,313394330496,12703,12740,12749,46,0.36,12741,38,0.3,12739,12830,1400-3-9,2021-05-30
203,سمازن,سيمان‌مازندران‌,741,2995239,32923095700,11250,11490,10760,-490,-4.36,10990,-260,-2.31,10740,11490,1400-3-9,2021-05-30
204,تسه9908,امتياز تسهيلات مسكن آبان99,741,26585,14378432346,546178,573486,530003,-16175,-2.96,540848,-5330,-0.98,525555,573486,1400-3-9,2021-05-30
205,سقاين,سيمان‌ قائن‌,738,573649,30065670420,54240,56490,51530,-2710,-5,52410,-1830,-3.37,51530,56490,1400-3-9,2021-05-30
206,بپاس,بيمه پاسارگاد,735,661771,64811232078,96977,97103,98100,1123,1.16,97582,605,0.62,97103,99000,1400-3-9,2021-05-30
207,حتايد,تايدواترخاورميانه,734,4042573,99550446480,23680,24860,24700,1020,4.31,24630,950,4.01,23950,24860,1400-3-9,2021-05-30
208,وبرق,س.کارکنان صنعت برق زنجان وقزوي,730,1998907,82292281415,39291,38100,41255,1964,5,41169,1878,4.78,38100,41255,1400-3-9,2021-05-30
209,كگهر,سنگ آهن گهرزمين,728,1657685,65682952014,40663,41390,39200,-1463,-3.6,40077,-586,-1.44,38630,41461,1400-3-9,2021-05-30
210,ونفت,سرمايه‌گذاري‌ صنعت‌ نفت‌,720,2454317,33506405630,13800,13950,13280,-520,-3.77,13650,-150,-1.09,13240,14250,1400-3-9,2021-05-30
211,پلوله,گازلوله‌,710,3685847,97520935980,27715,26330,26330,-1385,-5,26458,-1257,-4.54,26330,27711,1400-3-9,2021-05-30
212,رانفور,خدمات‌انفورماتيك‌,702,13727903,82358639170,5980,6130,5990,10,0.17,6000,20,0.33,5810,6140,1400-3-9,2021-05-30
213,بموتو,موتوژن‌,692,1099539,54182923790,48690,48500,48330,-360,-0.74,49280,590,1.21,48000,50500,1400-3-9,2021-05-30
214,درازك,دارويي‌ رازك‌,685,2284573,58390687630,25530,26700,25600,70,0.27,25560,30,0.12,24950,26700,1400-3-9,2021-05-30
215,خكرمان,گروه اقتصادي كرمان خودرو,683,22098552,66489006289,2922,3009,3009,87,2.98,3009,87,2.98,2951,3009,1400-3-9,2021-05-30
216,كارين,صندوق س نگين سامان-ثابت,675,29171675,293195181460,10046,10050,10050,4,0.04,10051,5,0.05,10049,10052,1400-3-9,2021-05-30
217,سخزر,سيمان‌ خزر,670,2343999,43100975030,19010,19010,18060,-950,-5,18390,-620,-3.26,18060,19340,1400-3-9,2021-05-30
218,تسه9912,امتياز تسهيلات مسكن اسفند99,665,7575,4172750168,549707,550000,549800,93,0.02,550858,1151,0.21,523990,577192,1400-3-9,2021-05-30
219,فاما,صنعتي‌ آما,659,2539352,37320176290,14150,14850,14370,220,1.55,14700,550,3.89,14160,14850,1400-3-9,2021-05-30
220,زگلدشتح,ح.كشت و دام گلدشت نمونه اصفهان,651,2813563,16135392342,5756,5750,5585,-171,-2.97,5735,-21,-0.36,5510,5997,1400-3-9,2021-05-30
221,سپاها,سيمان‌سپاهان‌,627,5456243,38397387000,7200,7100,6990,-210,-2.92,7040,-160,-2.22,6840,7370,1400-3-9,2021-05-30
222,وثوق,سرمايه گذاري وثوق امين,625,1282592,18714704639,14375,14375,14170,-205,-1.43,14591,216,1.5,13990,14806,1400-3-9,2021-05-30
223,فولاژ,فولاد آلياژي ايران,619,1838035,26577870420,13980,14100,14280,300,2.15,14160,180,1.29,14000,14670,1400-3-9,2021-05-30
224,دروز,داروسازي‌ روزدارو,616,1463649,44940979360,29520,30990,30540,1020,3.46,30700,1180,4,29200,30990,1400-3-9,2021-05-30
225,دكيمي,كيميدارو,606,3966823,80649268710,28460,20000,21000,-7460,-26.21,20330,-8130,-28.57,19000,21000,1400-3-9,2021-05-30
226,وارس,سرمايه گذاري ارس صبا,605,2658901,35216613454,13292,13690,12894,-398,-2.99,13245,-47,-0.35,12894,13690,1400-3-9,2021-05-30
227,شفن,پتروشيمي فناوران,600,128659,37503310520,283520,292000,289750,6230,2.2,286380,2860,1.01,285330,295240,1400-3-9,2021-05-30
228,فايرا,آلومينيوم‌ايران‌,589,4746835,86324249600,17480,17710,17830,350,2,18190,710,4.06,17710,18350,1400-3-9,2021-05-30
229,همراه,شركت ارتباطات سيار ايران,587,2179150,42641459960,19290,19920,19500,210,1.09,19410,120,0.62,19200,20000,1400-3-9,2021-05-30
230,وصنا,گروه‌صنايع‌بهشهرايران‌,581,15402072,73412933525,4542,4769,4769,227,5,4766,224,4.93,4643,4769,1400-3-9,2021-05-30
231,وتوسم,سرمايه‌گذاري‌توسعه‌ملي‌,579,3205738,23351667760,7290,7400,7040,-250,-3.43,7280,-10,-0.14,7010,7620,1400-3-9,2021-05-30
232,سپيدما,صندوق س. سپيد دماوند-د,579,27853417,290065920489,10406,10413,10414,8,0.08,10414,8,0.08,10413,10418,1400-3-9,2021-05-30
233,بميلا,توسعه بازرگاني آهن وفولادميلاد,575,3642918,42563062648,11990,11631,11631,-359,-2.99,11684,-306,-2.55,11631,12240,1400-3-9,2021-05-30
234,خريخت,صنايع‌ريخته‌گري‌ايران‌,561,8915812,21099418373,2308,2380,2308,0,0,2367,59,2.56,2250,2423,1400-3-9,2021-05-30
235,پرداخت,به پرداخت ملت,559,1030142,21298658980,20500,20720,21000,500,2.44,20650,150,0.73,20260,21390,1400-3-9,2021-05-30
236,عيار,صندوق سكه طلاي مفيد,558,658638,18222890117,27887,28000,27190,-697,-2.5,27668,-219,-0.79,27000,28346,1400-3-9,2021-05-30
237,ضسپا3003,اختيارخ خساپا-2000-1400/03/26,555,30078,377336000,15,13,8,-7,-46.67,13,-2,-13.33,7,22,1400-3-9,2021-05-30
238,پاكشو,گروه صنعتي پاكشو,549,3250584,19112211070,5940,5900,5810,-130,-2.19,5930,-10,-0.17,5780,5980,1400-3-9,2021-05-30
239,تيپيكو,سرمايه گذاري دارويي تامين,545,2312032,84171355510,35140,36750,36180,1040,2.96,36410,1270,3.61,35310,36890,1400-3-9,2021-05-30
240,غبشهر,صنعتي‌ بهشهر,540,1476654,29422965320,20110,20990,19270,-840,-4.18,19930,-180,-0.9,19110,21000,1400-3-9,2021-05-30
241,وصندوق,سرمايه‌گذاري‌صندوق‌بازنشستگي‌,526,3385393,44287962830,13020,13520,13050,30,0.23,13040,20,0.15,12710,13520,1400-3-9,2021-05-30
242,واعتبار,سرمايه گذاري اعتبار ايران,513,4513441,34171238770,7930,7900,7590,-340,-4.29,7570,-360,-4.54,7540,7900,1400-3-9,2021-05-30
243,فسازان,غلتك سازان سپاهان,509,1024312,29802944280,28880,29300,28680,-200,-0.69,29100,220,0.76,27440,30300,1400-3-9,2021-05-30
244,سامان,بانك سامان,508,4882639,46108498000,9188,9463,9239,51,0.56,9443,255,2.78,9200,9463,1400-3-9,2021-05-30
245,سبجنو,سيمان‌ بجنورد,502,1537755,49310564150,33570,32010,31900,-1670,-4.97,32070,-1500,-4.47,31900,33570,1400-3-9,2021-05-30
246,واتي,سرمايه‌ گذاري‌ آتيه‌ دماوند,494,4323529,40356287350,9010,9160,9110,100,1.11,9330,320,3.55,9070,9460,1400-3-9,2021-05-30
247,دابور,داروسازي‌ ابوريحان‌,493,846620,22383359040,26810,27160,26030,-780,-2.91,26440,-370,-1.38,25960,27250,1400-3-9,2021-05-30
248,وشهر,بانك شهر,492,4555129,23659002914,5170,5370,5064,-106,-2.05,5187,17,0.33,5020,5370,1400-3-9,2021-05-30
249,سشمال,سيمان‌ شمال‌,489,2343784,19130187410,8450,8570,8030,-420,-4.97,8160,-290,-3.43,8030,8570,1400-3-9,2021-05-30
250,سرود,سيمان‌شاهرود,488,1504833,26999782260,17450,18320,17660,210,1.2,17940,490,2.81,17320,18320,1400-3-9,2021-05-30
251,ياقوت,صندوق س ياقوت آگاه-ثابت,488,7079589,87698323009,12382,12387,12391,9,0.07,12387,5,0.04,12387,12400,1400-3-9,2021-05-30
252,پارس,پتروشيمي پارس,487,534522,79848659480,146810,149560,150000,3190,2.17,148800,1990,1.36,148250,150520,1400-3-9,2021-05-30
253,سكه0012پ01,تمام سكه طرح جديد0012رفاه,485,204000,220009095200,1076167,1089999,1076500,333,0.03,1078476,2309,0.21,1073000,1089999,1400-3-9,2021-05-30
254,وپترو,سرمايه‌گذاري صنايع پتروشيمي‌,478,6728271,76502416020,10840,11380,11380,540,4.98,11370,530,4.89,10870,11380,1400-3-9,2021-05-30
255,اطلس,صندوق س.توسعه اندوخته آينده-س,467,142842,28688988667,198679,201071,197161,-1518,-0.76,200844,2165,1.09,196500,203990,1400-3-9,2021-05-30
256,جوين,كشت و صنعت جوين,467,5619666,25110574038,4577,4440,4440,-137,-2.99,4468,-109,-2.38,4440,4649,1400-3-9,2021-05-30
257,تسه9911,امتياز تسهيلات مسكن بهمن99,467,5721,3131140715,548466,540000,535000,-13466,-2.46,547307,-1159,-0.21,521222,570006,1400-3-9,2021-05-30
258,غگلپا,شير پاستوريزه پگاه گلپايگان,463,450274,21985108204,51311,48746,48746,-2565,-5,48826,-2485,-4.84,48746,50000,1400-3-9,2021-05-30
259,بخاور,بيمه زندگي خاورميانه,463,4934072,29290687435,6232,5921,5921,-311,-4.99,5936,-296,-4.75,5921,6171,1400-3-9,2021-05-30
260,ضخود7074,اختيارخ خودرو-1800-1400/07/07,453,16193,4415989000,248,295,234,-14,-5.65,273,25,10.08,226,343,1400-3-9,2021-05-30
261,امين يكم2,صندوق درآمد ثابت امين يكم فردا,450,45000000,45000000,10035,1,1,-10034,-99.99,1,-10034,-99.99,1,1,1400-3-9,2021-05-30
262,پكرمان,گروه‌ صنعتي‌ بارز,450,1334489,31039565720,23370,23810,22800,-570,-2.44,23260,-110,-0.47,22300,24100,1400-3-9,2021-05-30
263,ولملت,واسپاري ملت,449,4212643,19461438135,4775,4700,4537,-238,-4.98,4620,-155,-3.25,4537,4850,1400-3-9,2021-05-30
264,شاوان,پالايش نفت لاوان,447,282412,20574142940,72661,76283,70490,-2171,-2.99,72779,118,0.16,69510,76290,1400-3-9,2021-05-30
265,واحيا,م .صنايع و معادن احياء سپاهان,442,916272,138448427279,146932,149990,151339,4407,3,151100,4168,2.84,148100,151339,1400-3-9,2021-05-30
266,چكاپا,گروه صنايع كاغذ پارس,442,4946898,22236306510,4731,4495,4495,-236,-4.99,4495,-236,-4.99,4495,4495,1400-3-9,2021-05-30
267,وگردش,بانك گردشگري,436,5016816,72620042947,14891,14970,14539,-352,-2.36,14543,-348,-2.34,14445,14970,1400-3-9,2021-05-30
268,غگل,گلوكوزان‌,428,9347245,25125394560,2560,2688,2688,128,5,2688,128,5,2688,2688,1400-3-9,2021-05-30
269,شپاس,نفت پاسارگاد,425,821666,15500465746,19490,18721,18516,-974,-5,18955,-535,-2.74,18516,19780,1400-3-9,2021-05-30
270,جم,پتروشيمي جم,422,1464093,52348842300,34760,36400,35000,240,0.69,35250,490,1.41,34970,36490,1400-3-9,2021-05-30
271,پرديس,سرمايه گذاري پرديس,421,2217192,9993487025,4462,4660,4386,-76,-1.7,4490,28,0.63,4351,4660,1400-3-9,2021-05-30
272,ضخود7075,اختيارخ خودرو-2000-1400/07/07,421,13672,2423801000,168,180,160,-8,-4.76,177,9,5.36,151,224,1400-3-9,2021-05-30
273,مداران,داده‌پردازي‌ايران‌,420,1542801,27315087750,18500,18000,17580,-920,-4.97,17700,-800,-4.32,17580,18800,1400-3-9,2021-05-30
274,كي بي سي,شركت كي بي سي,412,660312,15804145617,24604,23500,23374,-1230,-5,23934,-670,-2.72,23374,24740,1400-3-9,2021-05-30
275,آكورد,صندوق س. آرمان آتي كوثر-د,410,3891420,125811112764,32315,32330,32331,16,0.05,32330,15,0.05,32330,32346,1400-3-9,2021-05-30
276,دسبحا,گروه دارويي سبحان,409,1583332,25980857030,16820,16830,16000,-820,-4.88,16410,-410,-2.44,16000,17100,1400-3-9,2021-05-30
277,ماديرا,صنايع ماديران,398,9197643,63656887203,6592,6921,6921,329,4.99,6921,329,4.99,6921,6921,1400-3-9,2021-05-30
278,شفارا,پتروشيمي فارابي,396,5027912,16151525864,3139,3232,3205,66,2.1,3212,73,2.33,3101,3233,1400-3-9,2021-05-30
279,فيروزه,صندوق شاخص30 شركت فيروزه- سهام,396,205704,26966009600,126280,129900,127800,1520,1.2,131090,4810,3.81,126280,133880,1400-3-9,2021-05-30
280,گوهران,سرمايه گذاري توسعه گوهران اميد,392,968234,6896507237,7003,7000,7149,146,2.08,7057,54,0.77,7000,7276,1400-3-9,2021-05-30
281,دعبيد,لابراتوارداروسازي‌  دكترعبيدي‌,391,930138,22387920450,24200,24000,24210,10,0.04,24130,-70,-0.29,23800,24500,1400-3-9,2021-05-30
282,جم پيلن,پلي پروپيلن جم - جم پيلن,385,374291,25876965420,67750,71000,68280,530,0.78,68400,650,0.96,68110,71100,1400-3-9,2021-05-30
283,شخارك,پتروشيمي‌ خارك‌,384,434152,18179952470,41770,42000,41600,-170,-0.41,41790,20,0.05,41500,42670,1400-3-9,2021-05-30
284,ضسپا3004,اختيارخ خساپا-2500-1400/03/26,382,22523,56081000,2,2,3,1,50,2,0,0,1,4,1400-3-9,2021-05-30
285,سخوز,سيمان خوزستان,379,1768525,33612197650,17760,18250,19160,1400,7.88,19010,1250,7.04,18250,19160,1400-3-9,2021-05-30
286,فخاس,فولاد خراسان,371,805918,18349172570,23530,22830,22360,-1170,-4.97,23390,-140,-0.59,22360,23980,1400-3-9,2021-05-30
287,ولتجار,واسپاري تجارت وسرمايه ايرانيان,370,2986185,21162756352,7301,7082,7082,-219,-3,7087,-214,-2.93,7082,7300,1400-3-9,2021-05-30
288,سفانو,سيمان فارس نو,368,712413,18726962620,27330,26900,25970,-1360,-4.98,26290,-1040,-3.81,25970,27570,1400-3-9,2021-05-30
289,زر,صندوق س.پشتوانه سكه طلاي زر,367,249239,11882737474,47952,48450,46999,-953,-1.99,47676,-276,-0.58,46890,48999,1400-3-9,2021-05-30
290,زكوثر,سرمايه گذاري كشاورزي كوثر,367,816562,15433021800,21000,18900,18900,-2100,-10,19440,-1560,-7.43,18900,18900,1400-3-9,2021-05-30
291,تسه9910,امتياز تسهيلات مسكن دي99,363,5245,2899566051,554713,554713,548000,-6713,-1.21,552825,-1888,-0.34,530090,578999,1400-3-9,2021-05-30
292,وسخوز,شركت س استان خوزستان,358,20487775,17598998725,904,859,859,-45,-4.98,895,-9,-1,859,859,1400-3-9,2021-05-30
293,معيار ,سرمايه گذاري معيار صنعت پارس,353,865773,43704228592,52027,50468,50467,-1560,-3,50480,-1547,-2.97,50467,51800,1400-3-9,2021-05-30
294,وثنو,سرمايه گذاري ساختماني نوين,352,2692582,11079207616,4092,4199,4130,38,0.93,4115,23,0.56,4000,4199,1400-3-9,2021-05-30
295,سكرما,سيمان‌ كرمان‌,351,1142516,15444313290,13080,13880,13190,110,0.84,13500,420,3.21,13190,14570,1400-3-9,2021-05-30
296,گوهر,صندوق سكه طلاي كيان,348,865652,46373838713,54318,54980,53238,-1080,-1.99,53571,-747,-1.38,53120,54980,1400-3-9,2021-05-30
297,ضسپا3002,اختيارخ خساپا-1800-1400/03/26,347,22259,1088561000,49,50,41,-8,-16.33,49,0,0,10,67,1400-3-9,2021-05-30
298,شپلي,پلي اكريل ايران,346,3429499,34312137495,9809,10005,10005,196,2,10005,196,2,10005,10005,1400-3-9,2021-05-30
299,سيدكو,سرمايه گذاري توسعه صنايع سيمان,345,2778229,14859397070,5400,5530,5400,0,0,5350,-50,-0.93,5260,5530,1400-3-9,2021-05-30
300,پسهند,صنايع‌ لاستيكي‌  سهند,341,442668,15658774300,36800,35070,34960,-1840,-5,35370,-1430,-3.89,34960,36790,1400-3-9,2021-05-30
301,مبين,مبين انرژي خليج فارس,340,1939681,29693261960,15140,15600,15130,-10,-0.07,15180,40,0.26,14910,15850,1400-3-9,2021-05-30
302,وحكمت,بيمه حكمت صبا,338,3549189,10186600694,2843,2928,2837,-6,-0.21,2870,27,0.95,2769,2928,1400-3-9,2021-05-30
303,خديزل,بهمن  ديزل,335,476114,19075203932,39512,39990,39920,408,1.03,40064,552,1.4,37600,41400,1400-3-9,2021-05-30
304,اميد,تامين سرمايه اميد,333,5534717,39867046780,7570,7200,7200,-370,-4.89,7200,-370,-4.89,7200,7260,1400-3-9,2021-05-30
305,صايند,صندوق س. گنجينه آينده روشن-د,330,6314930,63087715650,9778,9820,9999,221,2.26,9990,212,2.17,9820,10005,1400-3-9,2021-05-30
306,وكار,بانك‌ كارآفرين‌,329,3769209,10530655393,2752,2874,2800,48,1.74,2762,10,0.36,2710,2874,1400-3-9,2021-05-30
307,وبهمن,سرمايه‌گذاري‌بهمن‌,324,1166634,14222374310,12000,12430,12380,380,3.17,12180,180,1.5,12100,12550,1400-3-9,2021-05-30
308,وسپه,سرمايه‌گذاري‌ سپه‌,323,1708113,11121496350,6370,6670,6410,40,0.63,6420,50,0.78,6370,6670,1400-3-9,2021-05-30
309,تصميم,صندوق س با درآمد ثابت تصميم,322,2826087,46453599810,16421,16443,16436,15,0.09,16437,16,0.1,16426,16448,1400-3-9,2021-05-30
310,دكپسول,توليد ژلاتين كپسول ايران,317,581659,15265478977,26440,26450,26200,-240,-0.91,26245,-195,-0.74,25383,27500,1400-3-9,2021-05-30
311,ثباغ,شهر سازي و خانه سازي باغميشه,317,2215998,26553541425,12578,11950,11950,-628,-4.99,11983,-595,-4.73,11950,12350,1400-3-9,2021-05-30
312,تسه9909,امتياز تسهيلات مسكن آذر99,316,3667,2002785213,550434,547500,541152,-9282,-1.69,546164,-4270,-0.78,531100,577955,1400-3-9,2021-05-30
313,وخاور,بانك خاورميانه,316,4518297,38311361090,8390,8350,8490,100,1.19,8460,70,0.83,8350,8520,1400-3-9,2021-05-30
314,حسينا,توسعه خدمات دريايي وبندري سينا,299,260851,14554864727,57411,59999,55499,-1912,-3.33,55869,-1542,-2.69,54560,59999,1400-3-9,2021-05-30
315,آساس,صندوق س.آسمان آرماني سهام-س,291,86639,13356194804,150752,153611,152988,2236,1.48,154159,3407,2.26,150902,156060,1400-3-9,2021-05-30
316,پارسيان,بيمه پارسيان,288,2001406,16127844950,7800,8140,7850,50,0.64,8060,260,3.33,7700,8190,1400-3-9,2021-05-30
317,زپارس,ملي كشت و صنعت و دامپروري پارس,286,127123,13520394220,107440,112800,106990,-450,-0.42,106490,-950,-0.88,102500,112800,1400-3-9,2021-05-30
318,كدما,معدني‌ دماوند,282,212666,18382849040,82330,86440,86440,4110,4.99,86440,4110,4.99,86440,86440,1400-3-9,2021-05-30
319,ضخود7077,اختيارخ خودرو-3000-1400/07/07,279,14760,605658000,45,64,36,-9,-20,41,-4,-8.89,36,64,1400-3-9,2021-05-30
320,شرنگي,شيميايي رنگين,275,145417,37703896662,265977,266000,257998,-7979,-3,259281,-6696,-2.52,257998,269100,1400-3-9,2021-05-30
321,دالبر,البرزدارو,274,1020179,12577385860,12260,12280,11940,-320,-2.61,12320,60,0.49,11740,12870,1400-3-9,2021-05-30
322,شپاكسا,پاكسان‌,272,383366,7759188440,20120,20700,20480,360,1.79,20180,60,0.3,19930,21000,1400-3-9,2021-05-30
323,تايرا,تراكتورسازي‌ايران‌,268,790314,18339753830,23150,23370,22900,-250,-1.08,23180,30,0.13,22840,23650,1400-3-9,2021-05-30
324,وتوس,توسعه‌شهري‌توس‌گستر,267,969317,13568173530,13880,13860,13910,30,0.22,13990,110,0.79,13860,14180,1400-3-9,2021-05-30
325,كاريس,صندوق س.سپهر كاريزما-س,258,1228447,13033193669,10458,10730,10551,93,0.89,10609,151,1.44,10446,10909,1400-3-9,2021-05-30
326,ثشاهد,سرمايه‌ گذاري‌ شاهد,252,542629,8182845320,15870,15080,15080,-790,-4.98,15600,-270,-1.7,15080,15080,1400-3-9,2021-05-30
327,شوينده,مديريت صنعت شوينده ت.ص.بهشهر,251,685562,14191487970,20100,20860,20220,120,0.6,20630,530,2.64,20000,21100,1400-3-9,2021-05-30
328,بمپنا,توليد برق عسلويه  مپنا,248,139771,8639324196,63037,63249,60251,-2786,-4.42,62448,-589,-0.93,59886,63900,1400-3-9,2021-05-30
329,وسگيلا,شركت س استان گيلان,240,13276439,8059263683,638,607,607,-31,-4.86,631,-7,-1.1,607,613,1400-3-9,2021-05-30
330,وبازار,صندوق س شاخصي بازارآشنا,239,1467873,13601685670,8770,9100,9260,490,5.59,9270,500,5.7,9100,9460,1400-3-9,2021-05-30
331,دپارس,پارس‌ دارو,237,220145,8259160350,37760,36020,37480,-280,-0.74,37630,-130,-0.34,36020,38680,1400-3-9,2021-05-30
332,فروس,فروسيليس‌ ايران‌,233,2402993,12521996523,4963,5211,5211,248,5,5151,188,3.79,5211,5211,1400-3-9,2021-05-30
333,سمگا,گروه سرمايه گذاري ميراث فرهنگي,228,11124874,301250463046,28504,27079,27079,-1425,-5,27079,-1425,-5,27079,27079,1400-3-9,2021-05-30
334,تسه9803,امتياز تسهيلات مسكن خرداد98,227,3182,1688249069,528339,507122,519010,-9329,-1.77,530562,2223,0.42,507122,540000,1400-3-9,2021-05-30
335,دجابر,داروسازي‌ جابرابن‌حيان‌,226,2007716,31916864000,19130,16000,15200,-3930,-20.54,15900,-3230,-16.88,15200,16000,1400-3-9,2021-05-30
336,كخاك,صنايع‌خاك‌چيني‌ايران‌,223,296114,9333119200,32070,31420,30760,-1310,-4.08,31800,-270,-0.84,30600,32480,1400-3-9,2021-05-30
337,وبشهر,توسعه‌ صنايع‌ بهشهر(هلدينگ,221,1296704,12525415520,9480,9520,9370,-110,-1.16,9550,70,0.74,9350,9880,1400-3-9,2021-05-30
338,بساما,بيمه سامان,220,455398,8154088777,17577,18000,17280,-297,-1.69,17746,169,0.96,16810,18455,1400-3-9,2021-05-30
339,تسه9907,امتياز تسهيلات مسكن مهر99,215,3310,1806428879,535625,538522,540000,4375,0.82,545749,10124,1.89,528509,559990,1400-3-9,2021-05-30
340,شراز,پالايش نفت شيراز,210,47479,4700774723,99212,101500,97300,-1912,-1.93,99188,-24,-0.02,95557,102660,1400-3-9,2021-05-30
341,ساينا,صنايع بهداشتي ساينا,210,55773,8183427531,142876,150019,147790,4914,3.44,144966,2090,1.46,144495,150019,1400-3-9,2021-05-30
342,ضصاد3001,اختيارخ وبصادر-2000-1400/03/12,203,11049,245941000,14,27,13,-1,-7.14,22,8,57.14,13,30,1400-3-9,2021-05-30
343,تسه9904,امتياز تسهيلات مسكن تير99,200,2860,1560321522,543399,542500,516230,-27169,-5,545567,2168,0.4,516230,569999,1400-3-9,2021-05-30
344,شساخت,مهندسي و ساختمان صنايع نفت,196,692384,28461392859,40849,42020,42050,1201,2.94,41026,177,0.43,39640,42050,1400-3-9,2021-05-30
345,ضترا3002,اختيارخ شتران-8000-1400/03/09,193,4102,248707000,47,88,49,2,4.26,61,14,29.79,13,168,1400-3-9,2021-05-30
346,تسه9810,امتياز تسهيلات مسكن دي98,193,3161,1720316391,555024,531411,527273,-27751,-5,544232,-10792,-1.94,527273,582775,1400-3-9,2021-05-30
347,سحرخيز,صندوق س. گروه زعفران سحرخيز,193,361943,3095375235,8482,8749,8580,98,1.16,8552,70,0.83,8335,8849,1400-3-9,2021-05-30
348,حريل,ريل پردازسير,188,4372283,22281154168,5364,5096,5096,-268,-5,5096,-268,-5,5096,5096,1400-3-9,2021-05-30
349,وپخش,داروپخش‌ (هلدينگ‌,185,48697,4533109310,94030,97250,90170,-3860,-4.11,93890,-140,-0.15,90000,97970,1400-3-9,2021-05-30
350,اتكام,شركت بيمه اتكايي امين,185,1034993,4449208708,4281,4240,4250,-31,-0.72,4286,5,0.12,4240,4423,1400-3-9,2021-05-30
351,فردا,صندوق س آواي فرداي زاگرس-ثابت,184,7207681,77661997157,10770,10774,10775,5,0.05,10775,5,0.05,10774,10776,1400-3-9,2021-05-30
352,لبوتان,گروه‌صنعتي‌بوتان‌,183,116347,6019096080,50540,51800,50600,60,0.12,51010,470,0.93,49000,53030,1400-3-9,2021-05-30
353,قشرين,قند شيرين خراسان,181,6151407,75576186402,11701,12286,12286,585,5,12286,585,5,12286,12286,1400-3-9,2021-05-30
354,وسرمد,بيمه  سرمد,180,4634877,27840940412,6191,6006,6006,-185,-2.99,6007,-184,-2.97,6006,6100,1400-3-9,2021-05-30
355,شاملا,معدني‌ املاح‌  ايران‌,180,234959,8278430940,35470,36500,33800,-1670,-4.71,35330,-140,-0.39,33710,36520,1400-3-9,2021-05-30
356,تسه9902,امتياز تسهيلات مسكن ارديبهشت99,179,2033,1098184103,547871,532000,537000,-10871,-1.98,540179,-7692,-1.4,521115,569000,1400-3-9,2021-05-30
357,شنفت,نفت‌ پارس‌,173,161445,7672152040,45790,48000,46460,670,1.46,46070,280,0.61,46220,48070,1400-3-9,2021-05-30
358,سيستم,همكاران سيستم,170,545945,11705060800,20420,21440,21440,1020,5,21150,730,3.57,21440,21440,1400-3-9,2021-05-30
359,آتيمس,صندوق س.آرمان آتيه درخشان مس-س,167,48100,8151923878,169549,172990,167769,-1780,-1.05,169479,-70,-0.04,163693,174380,1400-3-9,2021-05-30
360,شكبير,پتروشيمي اميركبير,167,1482218,123033860078,82844,85329,82844,0,0,83007,163,0.2,81740,85329,1400-3-9,2021-05-30
361,مارون,پتروشيمي مارون,165,67870,9751612624,143963,145880,142000,-1963,-1.36,143935,-28,-0.02,141100,146799,1400-3-9,2021-05-30
362,كرازي,كارخانجات‌توليدي‌شيشه‌رازي‌,158,444567,9078058140,21490,20420,20420,-1070,-4.98,20800,-690,-3.21,20420,20420,1400-3-9,2021-05-30
363,شيراز,پتروشيمي‌شيراز,158,379799,19466880260,50830,53360,50420,-410,-0.81,50910,80,0.16,50000,53360,1400-3-9,2021-05-30
364,خاور,ايران خودرو ديزل,157,1832136,7663824888,4062,4183,4183,121,2.98,4151,89,2.19,4183,4183,1400-3-9,2021-05-30
365,تسه9906,امتياز تسهيلات مسكن شهريور99,156,1682,936337778,561868,539000,535110,-26758,-4.76,556681,-5187,-0.92,533775,579994,1400-3-9,2021-05-30
366,آساميد,صندوق س.مشترك آسمان اميد -د,154,10740908,129910771469,12088,12093,12096,8,0.07,12095,7,0.06,12093,12096,1400-3-9,2021-05-30
367,وساشرقي,شركت س استان آذربايجان شرقي,154,7138543,6431827243,948,901,901,-47,-4.96,944,-4,-0.42,901,901,1400-3-9,2021-05-30
368,سپاس,صندوق س. پاداش سهامداري-ثابت,150,4329306,43883278904,10132,10137,10136,4,0.04,10136,4,0.04,10136,10139,1400-3-9,2021-05-30
369,ضپال2007,اختيارخ اپال-32000-1401/02/12,149,9130,684955000,73,65,73,0,0,75,2,2.74,65,80,1400-3-9,2021-05-30
370,بفجر,فجر انرژي خليج فارس,149,608755,13422412550,21290,21890,21600,310,1.46,21470,180,0.85,21600,22350,1400-3-9,2021-05-30
371,تسه9903,امتياز تسهيلات مسكن خرداد99,148,1767,985843558,554298,540000,537989,-16309,-2.94,557919,3621,0.65,535582,582000,1400-3-9,2021-05-30
372,ارمغان,ص سرمايه گذاري ارمغان ايرانيان,145,1132545,11479412483,10134,10132,10148,14,0.14,10136,2,0.02,10131,10148,1400-3-9,2021-05-30
373,تمحركه,ماشين سازي نيرو محركه,144,765694,13420043555,18029,17610,17489,-540,-3,17527,-502,-2.78,17489,17910,1400-3-9,2021-05-30
374,وسهمدا,شركت س استان همدان,143,6946907,5335909472,808,768,768,-40,-4.95,802,-6,-0.74,768,774,1400-3-9,2021-05-30
375,نهال,صندوق س. طلاي سرخ نوويرا,141,198569,1702203220,8510,8621,8440,-70,-0.82,8572,62,0.73,8304,8898,1400-3-9,2021-05-30
376,بورس,بورس اوراق بهادار تهران,140,362086,9855980920,28650,27220,27220,-1430,-4.99,28330,-320,-1.12,27220,27220,1400-3-9,2021-05-30
377,سكه0011پ02,تمام سكه طرح جديد0011ملت,140,50000,53909909700,1075004,1085000,1073002,-2002,-0.19,1078198,3194,0.3,1070001,1090000,1400-3-9,2021-05-30
378,تسه9905,امتياز تسهيلات مسكن مرداد99,136,1513,855654368,569925,542005,541429,-28496,-5,565535,-4390,-0.77,541429,598421,1400-3-9,2021-05-30
379,دتوزيعح,ح . توزيع دارو پخش,136,751202,20206705470,28225,29400,26814,-1411,-5,26899,-1326,-4.7,26814,29400,1400-3-9,2021-05-30
380,سكه0012پ04,تمام سكه طرح جديد0012صادرات,136,56000,60372322300,1074626,1081535,1074900,274,0.03,1078077,3451,0.32,1070125,1087980,1400-3-9,2021-05-30
381,كالا,بورس كالاي ايران,136,186756,5428996920,30590,29070,29070,-1520,-4.97,30310,-280,-0.92,29070,29070,1400-3-9,2021-05-30
382,دارو,كارخانجات‌داروپخش‌,135,152244,4428711530,30480,29250,29290,-1190,-3.9,30130,-350,-1.15,28960,30100,1400-3-9,2021-05-30
383,سباقر,سيمان باقران,133,853812,12213780660,13889,14305,14305,416,3,14305,416,3,14305,14305,1400-3-9,2021-05-30
384,كباده,توليد خاك نسوزاستقلال آباده,130,216000,1955016000,8788,9051,9051,263,2.99,8838,50,0.57,9051,9051,1400-3-9,2021-05-30
385,تماوند,تامين سرمايه دماوند,129,1313387,6419070408,4892,4900,4920,28,0.57,4890,-2,-0.04,4860,4940,1400-3-9,2021-05-30
386,اتكاي,بيمه اتكايي ايرانيان,128,347658,4872461178,14061,14200,13702,-359,-2.55,14051,-10,-0.07,13700,14456,1400-3-9,2021-05-30
387,اخزا910,اسنادخزانه-م10بودجه99-020807,127,236858,144209093689,607666,607100,609000,1334,0.22,608842,1176,0.19,607011,609798,1400-3-9,2021-05-30
388,كيان2,صندوق س. با درآمد ثابت كيان,126,12600000,12600000,28625,1,1,-28624,-100,1,-28624,-100,1,1,1400-3-9,2021-05-30
389,دفرا,فرآورده‌هاي‌ تزريقي‌ ايران‌,121,70233,1599645670,23570,22600,22400,-1170,-4.96,23480,-90,-0.38,22400,23930,1400-3-9,2021-05-30
390,شاروم,پتروشيمي اروميه,119,143951,2553690740,18673,17740,17740,-933,-5,18502,-171,-0.92,17740,17740,1400-3-9,2021-05-30
391,غشهداب,كشت و صنعت شهداب ناب خراسان,119,1247178,4543469454,3834,3643,3643,-191,-4.98,3772,-62,-1.62,3643,3643,1400-3-9,2021-05-30
392,اخزا902,اسنادخزانه-م2بودجه99-011019,116,304261,220585529235,725896,725896,725000,-896,-0.12,724988,-908,-0.13,720000,726000,1400-3-9,2021-05-30
393,دلر,داروسازي‌ اكسير,115,107365,3167179560,29100,28820,29180,80,0.27,29180,80,0.27,28820,30190,1400-3-9,2021-05-30
394,تسه9812,امتياز تسهيلات مسكن اسفند98,114,929,504301017,551097,530611,523543,-27554,-5,542843,-8254,-1.5,523543,562000,1400-3-9,2021-05-30
395,وكادو,تكادو,110,1021786,13306719078,12644,13023,13023,379,3,13023,379,3,13023,13023,1400-3-9,2021-05-30
396,لوتوس,تامين سرمايه لوتوس پارسيان,109,1140996,7986972000,6670,7000,7000,330,4.95,6770,100,1.5,7000,7000,1400-3-9,2021-05-30
397,اخزا903,اسنادخزانه-م3بودجه99-011110,107,345434,247564163660,716974,716990,716520,-454,-0.06,716676,-298,-0.04,716500,717000,1400-3-9,2021-05-30
398,خاتم,صندوق س خاتم ايساتيس پويا-ثابت,106,1465868,16368268881,11162,11167,11167,5,0.04,11166,4,0.04,11166,11170,1400-3-9,2021-05-30
399,چفيبر,فيبر ايران‌,104,457169,5810617990,13370,12710,12710,-660,-4.94,13100,-270,-2.02,12710,12710,1400-3-9,2021-05-30
400,تسه9901,امتياز تسهيلات مسكن فروردين99,102,928,503105667,552155,550000,532110,-20045,-3.63,542140,-10015,-1.81,524666,578999,1400-3-9,2021-05-30
401,تماوندح,ح . تامين سرمايه دماوند,102,1411688,4352320465,3078,3060,3079,1,0.03,3083,5,0.16,3060,3150,1400-3-9,2021-05-30
402,تسه9811,امتياز تسهيلات مسكن بهمن98,98,723,390036224,545151,545000,546000,849,0.16,539469,-5682,-1.04,520000,550000,1400-3-9,2021-05-30
403,آريان,سرمايه گذاري پارس آريان,98,1851179,19739121677,10353,10663,10663,310,2.99,10425,72,0.7,10663,10663,1400-3-9,2021-05-30
404,فرابورس,فرابورس ايران,98,152630,4451453950,30700,29165,29165,-1535,-5,30491,-209,-0.68,29165,29165,1400-3-9,2021-05-30
405,فزرين,زرين معدن آسيا,97,676363,12659486271,19702,18717,18717,-985,-5,18781,-921,-4.67,18717,18717,1400-3-9,2021-05-30
406,آرمان,بيمه آرمان,96,7727536,60970259040,8133,7890,7890,-243,-2.99,7890,-243,-2.99,7890,7890,1400-3-9,2021-05-30
407,انرژي3,سايراشخاص بورس انرژي,94,10687,2384055960,234820,223080,223080,-11740,-5,234300,-520,-0.22,223080,223080,1400-3-9,2021-05-30
408,لخزر,پارس‌ خزر,94,41737,7216327300,181990,172900,172900,-9090,-4.99,177380,-4610,-2.53,172900,172900,1400-3-9,2021-05-30
409,ضترا3000,اختيارخ شتران-6000-1400/03/09,92,861,1805504000,1971,2220,2150,179,9.08,2097,126,6.39,1802,2300,1400-3-9,2021-05-30
410,بكام,كارخانجات توليدي شهيد قندي,91,869769,3156391701,3819,3629,3629,-190,-4.98,3776,-43,-1.13,3629,3629,1400-3-9,2021-05-30
411,تسه9809,امتياز تسهيلات مسكن آذر98,91,834,449269740,547655,523000,527750,-19905,-3.63,538693,-8962,-1.64,520283,560000,1400-3-9,2021-05-30
412,دمعيار,صندوق س. توازن معيار-د,89,6228356,62563069315,10040,10048,10044,4,0.04,10045,5,0.05,10042,10048,1400-3-9,2021-05-30
413,اخزا909,اسنادخزانه-م9بودجه99-020316,86,479728,316834788814,660367,660367,660029,-338,-0.05,660447,80,0.01,658017,662499,1400-3-9,2021-05-30
414,كبافق,معادن‌ بافق‌,85,335599,14283093440,44790,42560,42560,-2230,-4.98,43250,-1540,-3.44,42560,42560,1400-3-9,2021-05-30
415,كسرا,سراميك‌هاي‌صنعتي‌اردكان‌,81,915392,16348901120,18790,17860,17860,-930,-4.95,17860,-930,-4.95,17860,17860,1400-3-9,2021-05-30
416,فپنتا,سپنتا,81,46700,16446806000,335410,352180,352180,16770,5,352180,16770,5,352180,352180,1400-3-9,2021-05-30
417,ضپاس7029,اختيارخ وپارس-2500-1400/07/28,80,806,392554000,457,450,450,-7,-1.53,487,30,6.56,412,528,1400-3-9,2021-05-30
418,غشان,شيرپاستوريزه‌پگاه‌خراسان‌,78,682425,3732864750,5750,5470,5470,-280,-4.87,5660,-90,-1.57,5470,5470,1400-3-9,2021-05-30
419,تسه9808,امتياز تسهيلات مسكن آبان98,78,672,362374527,552389,525002,529000,-23389,-4.23,539248,-13141,-2.38,524770,549990,1400-3-9,2021-05-30
420,ضفلا3004,اختيارخ فولاد-8560-1400/03/19,75,2266,3666483762,955,1250,1139,184,19.27,1154,199,20.84,850,1380,1400-3-9,2021-05-30
421,ضملي7002,اختيارخ فملي-9720-1400/07/11,74,567,1994393000,3414,4000,3200,-214,-6.27,3517,103,3.02,3002,4000,1400-3-9,2021-05-30
422,ضخود7078,اختيارخ خودرو-3500-1400/07/07,73,4225,59370000,15,27,14,-1,-6.67,14,-1,-6.67,13,27,1400-3-9,2021-05-30
423,دماوند,توليد نيروي برق دماوند,73,110360,3204854400,30568,29040,29040,-1528,-5,30492,-76,-0.25,29040,29040,1400-3-9,2021-05-30
424,هاي وب,داده گسترعصرنوين-هاي وب,72,130225,1270996000,10270,9760,9760,-510,-4.97,10250,-20,-0.19,9760,9760,1400-3-9,2021-05-30
425,ضخود7076,اختيارخ خودرو-2500-1400/07/07,71,3883,391796000,91,130,94,3,3.3,101,10,10.99,78,135,1400-3-9,2021-05-30
426,غصينو,صنعتي مينو,71,1038442,62770703574,63628,60447,60447,-3181,-5,61416,-2212,-3.48,60447,60447,1400-3-9,2021-05-30
427,تليسه,دامداري تليسه نمونه,70,490807,1986295929,4260,4047,4047,-213,-5,4230,-30,-0.7,4047,4047,1400-3-9,2021-05-30
428,افق ملت,صندوق س در سهام افق ملت,69,27550,3402494330,121410,123500,120650,-760,-0.63,123500,2090,1.72,120520,124600,1400-3-9,2021-05-30
429,ضشنا8003,اختيارخ شپنا-8800-1400/08/16,68,437,949685000,1862,2150,2500,638,34.26,2173,311,16.7,1900,2500,1400-3-9,2021-05-30
430,ثعتما,س. ساختماني اعتماد گستر,68,394339,9579677327,23586,24293,24293,707,3,24234,648,2.75,24293,24293,1400-3-9,2021-05-30
431,فيروزا,صندوق بادرآمد ثابت فيروزه آسيا,67,1542858,35524311331,22994,23001,23045,51,0.22,23025,31,0.13,22928,23050,1400-3-9,2021-05-30
432,اخزا901,اسنادخزانه-م1بودجه99-010621,67,83096,64363530146,775169,773400,773600,-1569,-0.2,774568,-601,-0.08,773400,777000,1400-3-9,2021-05-30
433,ضترا3001,اختيارخ شتران-7000-1400/03/09,65,814,898028000,1022,1215,1090,68,6.65,1103,81,7.93,808,1400,1400-3-9,2021-05-30
434,زرين,صندوق س. سهام زرين كوروش-س,64,109188,1062158431,9495,9940,9584,89,0.94,9728,233,2.45,9340,9940,1400-3-9,2021-05-30
435,ضخود4002,اختيارخ خودرو-1800-1400/04/02,63,1895,315067000,150,179,142,-8,-5.33,166,16,10.67,135,185,1400-3-9,2021-05-30
436,سكه0112پ03,تمام سكه طرح جديد0112سامان,61,45500,49005353100,1078600,1084000,1075680,-2920,-0.27,1077041,-1559,-0.14,1073000,1093000,1400-3-9,2021-05-30
437,ساروج,بين المللي ساروج بوشهر,61,287833,4795620118,16922,16860,16500,-422,-2.49,16795,-127,-0.75,16454,17410,1400-3-9,2021-05-30
438,وسهرمز,شركت س استان هرمزگان,60,3033449,2617866487,908,863,863,-45,-4.96,904,-4,-0.44,863,863,1400-3-9,2021-05-30
439,ضشنا8001,اختيارخ شپنا-6800-1400/08/16,60,376,1153392000,2826,3750,3025,199,7.04,3068,242,8.56,2551,3750,1400-3-9,2021-05-30
440,تسه9807,امتياز تسهيلات مسكن مهر98,59,283,154368590,548733,522100,522014,-26719,-4.87,545472,-3261,-0.59,521599,551000,1400-3-9,2021-05-30
441,وآرين,شركت توسعه اقتصادي آرين,57,313405,1027654995,3380,3279,3279,-101,-2.99,3369,-11,-0.33,3279,3279,1400-3-9,2021-05-30
442,بنيرو,نيروترانس‌,55,118938,1691298360,14960,14220,14220,-740,-4.95,14870,-90,-0.6,14220,14220,1400-3-9,2021-05-30
443,سبهان,سيمان‌ بهبهان‌,55,24633,1896002010,81020,76970,76970,-4050,-5,80480,-540,-0.67,76970,76970,1400-3-9,2021-05-30
444,گوهر2,صندوق سكه طلاي كيان,55,550000,550000,54318,1,1,-54317,-100,1,-54317,-100,1,1,1400-3-9,2021-05-30
445,هنوري102,اختيارف ت نوري59561-01/02/15,54,300000,300000,865,1,1,-864,-99.88,1,-864,-99.88,1,1,1400-3-9,2021-05-30
446,لپارس,پارس‌ الكتريك‌,53,33649,2754170650,86150,81850,81850,-4300,-4.99,85300,-850,-0.99,81850,81850,1400-3-9,2021-05-30
447,وآوا,سرمايه گذاري آوا نوين,52,221950,1865711700,8848,8406,8406,-442,-5,8790,-58,-0.66,8406,8406,1400-3-9,2021-05-30
448,سمايه,بانك سرمايه,52,1353216,5849952768,4456,4323,4323,-133,-2.98,4374,-82,-1.84,4323,4323,1400-3-9,2021-05-30
449,تسه9806,امتياز تسهيلات مسكن شهريور98,51,383,210694327,560944,541060,541101,-19843,-3.54,550116,-10828,-1.93,540010,560200,1400-3-9,2021-05-30
450,گدنا,تهيه توزيع غذاي دنا آفرين فدك,51,436660,12746978720,30728,29192,29192,-1536,-5,29289,-1439,-4.68,29192,29192,1400-3-9,2021-05-30
451,ضشنا8002,اختيارخ شپنا-7800-1400/08/16,51,390,977075000,2175,2305,2400,225,10.34,2505,330,15.17,2023,3300,1400-3-9,2021-05-30
452,تسه9804,امتياز تسهيلات مسكن تير98,51,766,418433159,552203,531050,540000,-12203,-2.21,546257,-5946,-1.08,531050,559998,1400-3-9,2021-05-30
453,دارا,صندوق س. دارا الگوريتم-د,49,936583,9374716411,10004,10011,10010,6,0.06,10009,5,0.05,10005,10014,1400-3-9,2021-05-30
454,فردا2,صندوق س آواي فرداي زاگرس-ثابت,48,4800000,4800000,10770,1,1,-10769,-99.99,1,-10769,-99.99,1,1,1400-3-9,2021-05-30
455,غاذر,كشت‌وصنعت‌پياذر,48,70655,3541228600,55680,50120,50120,-5560,-9.99,54220,-1460,-2.62,50120,50120,1400-3-9,2021-05-30
456,سمتاز,سيمان ممتازان كرمان,47,70834,1542077495,22240,22400,21621,-619,-2.78,22166,-74,-0.33,21573,22400,1400-3-9,2021-05-30
457,ضملت3001,اختيارخ وبملت-3500-1400/03/19,47,1356,828419000,594,700,530,-64,-10.77,611,17,2.86,452,850,1400-3-9,2021-05-30
458,ختور,رادياتور ايران‌,46,158417,2773881670,18430,17510,17510,-920,-4.99,18250,-180,-0.98,17510,17510,1400-3-9,2021-05-30
459,كپرور,فرآوري زغال سنگ پروده طبس,46,183868,5769777840,33031,31380,31380,-1651,-5,32356,-675,-2.04,31380,31380,1400-3-9,2021-05-30
460,اخزا908,اسنادخزانه-م8بودجه99-020606,46,129571,81724109493,629486,629487,630120,634,0.1,630728,1242,0.2,629123,631550,1400-3-9,2021-05-30
461,خمهر,مهركام‌پارس‌,44,667161,1411045515,2226,2115,2115,-111,-4.99,2215,-11,-0.49,2115,2115,1400-3-9,2021-05-30
462,تسه9805,امتياز تسهيلات مسكن مرداد98,44,325,180519826,562967,536150,540000,-22967,-4.08,555446,-7521,-1.34,536150,565000,1400-3-9,2021-05-30
463,سخاش,سيمان‌خاش‌,44,8693,1105401880,133850,127160,127160,-6690,-5,133330,-520,-0.39,127160,127160,1400-3-9,2021-05-30
464,اوصتا,صندوق انديشه ورزان صباتامين -د,44,1236326,23186900933,18745,18760,18755,10,0.05,18755,10,0.05,18750,18760,1400-3-9,2021-05-30
465,خكاوه,سايپا ديزل,43,358453,1218023294,3576,3398,3398,-178,-4.98,3553,-23,-0.64,3398,3398,1400-3-9,2021-05-30
466,شصدف,صنعتي دوده فام,41,22784,678940416,31367,29799,29799,-1568,-5,31292,-75,-0.24,29799,29799,1400-3-9,2021-05-30
467,ضصاد3000,اختيارخ وبصادر-1800-1400/03/12,40,1904,327246000,151,150,230,79,52.32,172,21,13.91,150,230,1400-3-9,2021-05-30
468,ثجوان,تامين مسكن جوانان,40,655315,6830348245,10745,10423,10423,-322,-3,10538,-207,-1.93,10423,10423,1400-3-9,2021-05-30
469,دارا2,صندوق س. دارا الگوريتم-د,40,4000000,4000000,10004,1,1,-10003,-99.99,1,-10003,-99.99,1,1,1400-3-9,2021-05-30
470,سيمرغ,سيمرغ,38,17019,289663380,17910,17020,17020,-890,-4.97,17890,-20,-0.11,17020,17020,1400-3-9,2021-05-30
471,قيستو,شركت قند بيستون,38,112582,1793373038,16246,15950,15922,-324,-1.99,16131,-115,-0.71,15922,16559,1400-3-9,2021-05-30
472,غگلستا,شير پاستوريزه پگاه گلستان,38,57606,1080861378,19750,18763,18763,-987,-5,19643,-107,-0.54,18763,18763,1400-3-9,2021-05-30
473,پارتا,مجتمع‌صنعتي‌آرتاويل‌تاير,38,86192,2782105376,33276,32278,32278,-998,-3,33178,-98,-0.29,32278,32278,1400-3-9,2021-05-30
474,زملارد,كشاورزي و دامپروري ملارد شير,36,10225,354142875,36457,34635,34635,-1822,-5,36412,-45,-0.12,34635,34635,1400-3-9,2021-05-30
475,الماس,صندوق س.امين تدبيرگران فردا-س,36,17214,1754577155,100184,101900,100350,166,0.17,101927,1743,1.74,100000,104920,1400-3-9,2021-05-30
476,غپونه,نوش پونه مشهد,35,139054,2368228674,17557,17031,17031,-526,-3,17422,-135,-0.77,17031,17031,1400-3-9,2021-05-30
477,فراز,صندوق س.سهام فراز داريك-س,35,72129,745606166,10337,10337,10337,0,0,10337,0,0,10337,10340,1400-3-9,2021-05-30
478,ثروتم,صندوق س. ثروت آفرين پارسيان-س,35,84010,6240578100,71987,72883,72758,771,1.07,74284,2297,3.19,72758,75284,1400-3-9,2021-05-30
479,ثنور,سرمايه گذاري كوه نور,35,292949,2652946144,9532,9056,9056,-476,-4.99,9399,-133,-1.4,9056,9056,1400-3-9,2021-05-30
480,آپ,آسان پرداخت پرشين,35,147924,2295780480,16330,15520,15520,-810,-4.96,16220,-110,-0.67,15520,15520,1400-3-9,2021-05-30
481,اخزا914,اسنادخزانه-م14بودجه99-021025,32,76067,44319933803,582275,581202,582625,350,0.06,582643,368,0.06,581201,584000,1400-3-9,2021-05-30
482,ضسپا8039,اختيارخ خساپا-1200-1400/08/26,32,854,350157000,604,369,500,-104,-17.22,410,-194,-32.12,356,590,1400-3-9,2021-05-30
483,حفارس,حمل و نقل بين المللي خليج فارس,30,549801,2453212062,4696,4462,4462,-234,-4.98,4656,-40,-0.85,4462,4462,1400-3-9,2021-05-30
484,غنيلي,مجتمع توليدي نيلي صنعت كرمان,30,1496716,7483580000,5000,5000,5000,0,0,5000,0,0,5000,5000,1400-3-9,2021-05-30
485,فلوله,لوله‌وماشين‌سازي‌ايران‌,29,228019,4592302660,21190,20140,20140,-1050,-4.96,20840,-350,-1.65,20140,20140,1400-3-9,2021-05-30
486,شلعاب,لعابيران‌,29,93954,1168787760,13090,12440,12440,-650,-4.97,13040,-50,-0.38,12440,12440,1400-3-9,2021-05-30
487,صنوين,صندوق سرمايه‌گذاري صنوين-مختلط,29,3198,337694080,104260,106000,106980,2720,2.61,105600,1340,1.29,105000,106980,1400-3-9,2021-05-30
488,اخزا911,اسنادخزانه-م11بودجه99-020906,29,200794,120339441914,598232,600000,599101,869,0.15,599318,1086,0.18,598716,600000,1400-3-9,2021-05-30
489,زنگان,صنعت روي زنگان,28,3977,382169815,101152,96095,96095,-5057,-5,101016,-136,-0.13,96095,96095,1400-3-9,2021-05-30
490,ضپال2006,اختيارخ اپال-28000-1401/02/12,28,1505,827600000,523,550,550,27,5.16,550,27,5.16,520,550,1400-3-9,2021-05-30
491,وآيند,بانك  آينده,28,225142,3587637770,16260,15935,15935,-325,-2,16248,-12,-0.07,15935,15935,1400-3-9,2021-05-30
492,كوثر,بيمه كوثر,28,76473,1059456942,14583,13854,13854,-729,-5,14562,-21,-0.14,13854,13854,1400-3-9,2021-05-30
493,زعف0008پ16,زعفران0008نگين بيرجند(پ),27,31202,3717297980,119477,115252,118500,-977,-0.82,119137,-340,-0.28,115252,119500,1400-3-9,2021-05-30
494,اخزا812,اسنادخزانه-م12بودجه98-001111,27,32276,28259802953,876736,876900,876860,124,0.01,875567,-1169,-0.13,871918,879400,1400-3-9,2021-05-30
495,اعتلا,شركت سرمايه گذاري اعتلاء البرز,27,156695,1065055915,7154,6797,6797,-357,-4.99,7127,-27,-0.38,6797,6797,1400-3-9,2021-05-30
496,دلقما,دارويي‌ لقمان‌,27,57752,1323098320,24110,22910,22910,-1200,-4.98,24000,-110,-0.46,22910,22910,1400-3-9,2021-05-30
497,تكمبا,كمباين‌ سازي‌ ايران‌,26,120970,877032500,7630,7250,7250,-380,-4.98,7610,-20,-0.26,7250,7250,1400-3-9,2021-05-30
498,سجام,مجتمع سيمان غرب آسيا,26,373141,1426518043,3941,3823,3823,-118,-2.99,3924,-17,-0.43,3823,3823,1400-3-9,2021-05-30
499,اخزا905,اسنادخزانه-م5بودجه99-020218,26,161127,108449293307,670873,674890,673500,2627,0.39,673067,2194,0.33,671020,674890,1400-3-9,2021-05-30
500,زبينا,كشاورزي و دامپروري بينالود,26,128614,475100116,3888,3694,3694,-194,-4.99,3882,-6,-0.15,3694,3694,1400-3-9,2021-05-30
501,زعف0008پ20,زعفران0008نگين وحدت جام(پ),25,36820,4369658100,119243,119500,118500,-743,-0.62,118676,-567,-0.48,118000,119500,1400-3-9,2021-05-30
502,آكورد2,صندوق س. آرمان آتي كوثر-د,25,2500000,2500000,32315,1,1,-32314,-100,1,-32314,-100,1,1,1400-3-9,2021-05-30
503,ضخود7073,اختيارخ خودرو-1600-1400/07/07,25,592,224687000,416,420,360,-56,-13.46,380,-36,-8.65,301,455,1400-3-9,2021-05-30
504,غنوش,نوش‌ مازندران‌,25,10361,536907020,54540,51820,51820,-2720,-4.99,54440,-100,-0.18,51820,51820,1400-3-9,2021-05-30
505,بذر,صندوق س بذر اميد آفرين-سهام,24,11312,987781960,85980,88800,86780,800,0.93,87320,1340,1.56,86780,90400,1400-3-9,2021-05-30
506,بزاگرس,نيروگاه زاگرس كوثر,24,44621,301370234,7109,6754,6754,-355,-4.99,7102,-7,-0.1,6754,6754,1400-3-9,2021-05-30
507,نمرينو,ايران‌ مرينوس‌,24,10841,906416010,88010,83610,83610,-4400,-5,87730,-280,-0.32,83610,83610,1400-3-9,2021-05-30
508,كگاز,شيشه‌ و گاز,24,15620,273037600,18390,17480,17480,-910,-4.95,18370,-20,-0.11,17480,17480,1400-3-9,2021-05-30
509,زدشت,كشت و صنعت دشت خرم دره,23,9440,246922080,27533,26157,26157,-1376,-5,27509,-24,-0.09,26157,26157,1400-3-9,2021-05-30
510,رنيك,جنرال مكانيك,23,89376,1872159072,22049,20947,20947,-1102,-5,21904,-145,-0.66,20947,20947,1400-3-9,2021-05-30
511,ضسپا8041,اختيارخ خساپا-1600-1400/08/26,23,684,185438000,248,257,231,-17,-6.85,271,23,9.27,185,318,1400-3-9,2021-05-30
512,قصفها,قنداصفهان‌,23,2792,402438880,151720,144140,144140,-7580,-5,151510,-210,-0.14,144140,144140,1400-3-9,2021-05-30
513,وگستر,گسترش سرمايه گذاري ايرانيان,23,31156,556757720,18810,17870,17870,-940,-5,18773,-37,-0.2,17870,17870,1400-3-9,2021-05-30
514,وسنا,سرمايه گذاري نيروگاهي ايران,22,279705,4163968335,15670,14887,14887,-783,-5,15512,-158,-1.01,14887,14887,1400-3-9,2021-05-30
515,ضسپا3001,اختيارخ خساپا-1600-1400/03/26,22,1216,330410000,209,355,150,-59,-28.23,272,63,30.14,150,355,1400-3-9,2021-05-30
516,ريشمك,توليد و صادرات ريشمك,22,60216,3060959928,53508,50833,50833,-2675,-5,52924,-584,-1.09,50833,50833,1400-3-9,2021-05-30
517,ضجار7038,اختيارخ وتجارت-1797-1400/07/21,22,686,291226000,410,469,400,-10,-2.44,425,15,3.66,362,515,1400-3-9,2021-05-30
518,كمينا,شيشه سازي مينا,22,46428,1070583252,23772,23059,23059,-713,-3,23689,-83,-0.35,23059,23059,1400-3-9,2021-05-30
519,اخزا813,اسنادخزانه-م13بودجه98-010219,21,129691,107512529234,828457,828502,828630,173,0.02,828990,533,0.06,828501,829001,1400-3-9,2021-05-30
520,داريك,صندوق س.اعتماد داريك-د,21,37281,395096357,10596,10598,10598,2,0.02,10598,2,0.02,10597,10598,1400-3-9,2021-05-30
521,زعف0008پ11,زعفران0008نگين سحرخيز(پ),21,4987,598517850,122948,121100,120000,-2948,-2.4,120016,-2932,-2.38,120000,121100,1400-3-9,2021-05-30
522,ثرود,سرمايه‌گذاري مسكن زاينده رود,21,95565,1855394475,20436,19415,19415,-1021,-5,20300,-136,-0.67,19415,19415,1400-3-9,2021-05-30
523,زشريف,كشت وصنعت شريف آباد,21,330888,1633594056,5196,4937,4937,-259,-4.98,5166,-30,-0.58,4937,4937,1400-3-9,2021-05-30
524,شسينا,صنايع‌شيميايي‌سينا,20,5243,644312270,129350,122890,122890,-6460,-4.99,129060,-290,-0.22,122890,122890,1400-3-9,2021-05-30
525,سپر,صندوق س سپر سرمايه بيدار- ثابت,20,608795,7228044343,11866,11874,11871,5,0.04,11873,7,0.06,11871,11874,1400-3-9,2021-05-30
526,كلر,كلر پارس,20,3807,463178655,128068,121665,121665,-6403,-5,127882,-186,-0.15,121665,121665,1400-3-9,2021-05-30
527,كيا,كيا الكترود شرق,20,1000000,9350000000,9050,9350,9350,300,3.31,9350,300,3.31,9350,9350,1400-3-9,2021-05-30
528,اخزا820,اسنادخزانه-م20بودجه98-020806,20,25773,15720086244,609514,609490,610100,586,0.1,609944,430,0.07,609001,610101,1400-3-9,2021-05-30
529,زگلدشت,كشت و دام گلدشت نمونه اصفهان,20,14694,192050580,13757,13070,13070,-687,-4.99,13748,-9,-0.07,13070,13070,1400-3-9,2021-05-30
530,ضملي7004,اختيارخ فملي-13720-1400/07/11,20,104,98081000,998,900,940,-58,-5.81,943,-55,-5.51,851,1100,1400-3-9,2021-05-30
531,جهرم,پتروشيمي جهرم,20,109277,183913191,1771,1683,1683,-88,-4.97,1769,-2,-0.11,1683,1683,1400-3-9,2021-05-30
532,كيسون,شركت كيسون,20,503653,5650986660,11448,11220,11220,-228,-1.99,11391,-57,-0.5,11220,11220,1400-3-9,2021-05-30
533,اخزا806,اسنادخزانه-م6بودجه98-000519,20,13190,12662023652,959716,960960,958060,-1656,-0.17,959971,255,0.03,952301,961995,1400-3-9,2021-05-30
534,گنجين,صندوق س. گنجينه يكم آويد-د,19,34038,439914133,12915,12920,12924,9,0.07,12924,9,0.07,12920,12935,1400-3-9,2021-05-30
535,اخزا817,اسنادخزانه-م17بودجه98-010512,19,16657,13169376816,790570,792000,790500,-70,-0.01,790621,51,0.01,790500,792000,1400-3-9,2021-05-30
536,حبندر,دريايي و کشتيراني خط دريابندر,19,137314,4147981312,31142,30208,30208,-934,-3,30739,-403,-1.29,30208,30208,1400-3-9,2021-05-30
537,كپارس,كاشي‌ پارس‌,19,20878,2730633620,137670,130790,130790,-6880,-5,136260,-1410,-1.02,130790,130790,1400-3-9,2021-05-30
538,خمحور,توليدمحورخودرو,19,13658,718410800,55360,52600,52600,-2760,-4.99,55220,-140,-0.25,52600,52600,1400-3-9,2021-05-30
539,زمگسا,كشاورزي‌ ودامپروي‌ مگسال‌,19,41273,1272446590,32450,30830,30830,-1620,-4.99,32310,-140,-0.43,30830,30830,1400-3-9,2021-05-30
540,اخزا821,اسنادخزانه-م21بودجه98-020906,19,33066,19827979935,599923,599999,600000,77,0.01,599649,-274,-0.05,598716,601000,1400-3-9,2021-05-30
541,بهپاك,صنعتي بهپاك,19,24967,159414295,6721,6385,6385,-336,-5,6717,-4,-0.06,6385,6385,1400-3-9,2021-05-30
542,كحافظ,كاشي‌ وسراميك‌ حافظ‌,19,34056,380746080,11760,11180,11180,-580,-4.93,11740,-20,-0.17,11180,11180,1400-3-9,2021-05-30
543,اخزا815,اسنادخزانه-م15بودجه98-010406,19,12613,10175062903,806199,806600,806710,511,0.06,806712,513,0.06,806600,807990,1400-3-9,2021-05-30
544,غويتا,ويتانا,19,19787,336715379,17912,17017,17017,-895,-5,17899,-13,-0.07,17017,17017,1400-3-9,2021-05-30
545,اخزا723,اسنادخزانه-م23بودجه97-000824,18,26752,24333767298,910000,909600,916450,6450,0.71,909606,-394,-0.04,908501,916450,1400-3-9,2021-05-30
546,ضملي7003,اختيارخ فملي-11720-1400/07/11,18,154,295960000,1750,2200,1900,150,8.57,1922,172,9.83,1900,2200,1400-3-9,2021-05-30
547,غالبر,لبنيات‌ كالبر,18,21343,392284340,19340,18380,18380,-960,-4.96,19310,-30,-0.16,18380,18380,1400-3-9,2021-05-30
548,چكاوه,صنايع‌كاغذسازي‌كاوه‌,17,53089,925341270,18340,17430,17430,-910,-4.96,18280,-60,-0.33,17430,17430,1400-3-9,2021-05-30
549,غبهنوش,بهنوش‌ ايران‌,17,2772,180706680,68620,65190,65190,-3430,-5,68580,-40,-0.06,65190,65190,1400-3-9,2021-05-30
550,ومعلم,بيمه معلم,17,244864,1153309440,4957,4710,4710,-247,-4.98,4937,-20,-0.4,4710,4710,1400-3-9,2021-05-30
551,ثفارس,عمران‌وتوسعه‌فارس‌,17,30561,280549980,9660,9180,9180,-480,-4.97,9650,-10,-0.1,9180,9180,1400-3-9,2021-05-30
552,دسانكو,داروسازي سبحان انكولوژي,17,24192,335615616,14603,13873,13873,-730,-5,14586,-17,-0.12,13873,13873,1400-3-9,2021-05-30
553,خشرق,الكتريك‌ خودرو شرق‌,17,25729,352230010,14410,13690,13690,-720,-5,14390,-20,-0.14,13690,13690,1400-3-9,2021-05-30
554,ضملت3002,اختيارخ وبملت-4000-1400/03/19,16,707,125835000,303,390,160,-143,-47.19,178,-125,-41.25,150,390,1400-3-9,2021-05-30
555,تملي709,تسهيلات مسكن ب. ملي-آذر97,16,401,364564099,881704,837619,925789,44085,5,909137,27433,3.11,837619,925789,1400-3-9,2021-05-30
556,ضترا8057,اختيارخ شتران-3000-1400/08/09,16,175,480970000,1476,2980,1700,224,15.18,2748,1272,86.18,1700,2980,1400-3-9,2021-05-30
557,ضملت3003,اختيارخ وبملت-4500-1400/03/19,16,863,13373000,52,31,10,-42,-80.77,15,-37,-71.15,10,31,1400-3-9,2021-05-30
558,كيميا,معدني كيمياي زنجان گستران,16,12729,206286174,17058,16206,16206,-852,-4.99,17045,-13,-0.08,16206,16206,1400-3-9,2021-05-30
559,لكما,كارخانجات‌مخابراتي‌ايران‌,15,37125,219111750,6084,5902,5902,-182,-2.99,6080,-4,-0.07,5902,5902,1400-3-9,2021-05-30
560,ضجار7039,اختيارخ وتجارت-1997-1400/07/21,15,432,124494000,267,387,300,33,12.36,288,21,7.87,280,387,1400-3-9,2021-05-30
561,خبازرس,بازرسي مهندسي و صنعتي ايران,15,31208,755920176,24971,24222,24222,-749,-3,24912,-59,-0.24,24222,24222,1400-3-9,2021-05-30
562,سخند,صندوق س.سپهرخبرگان نفت-د,15,41340,412977220,9874,10049,10016,142,1.44,9990,116,1.17,9970,10049,1400-3-9,2021-05-30
563,تملي707,تسهيلات مسكن ب. ملي-مهر97,15,235,191439683,781000,750000,819999,38999,4.99,814637,33637,4.31,750000,819999,1400-3-9,2021-05-30
564,دتوزيع,توزيع دارو پخش,15,2870,129812970,47611,45231,45231,-2380,-5,47597,-14,-0.03,45231,45231,1400-3-9,2021-05-30
565,ضسپا8040,اختيارخ خساپا-1400-1400/08/26,15,684,273379000,414,103,332,-82,-19.81,400,-14,-3.38,103,600,1400-3-9,2021-05-30
566,رافزا,رايان هم افزا,14,2288,229868496,105754,100467,100467,-5287,-5,105669,-85,-0.08,100467,100467,1400-3-9,2021-05-30
567,سكرد,سيمان كردستان,14,124579,1158584700,9780,9300,9300,-480,-4.91,9740,-40,-0.41,9300,9300,1400-3-9,2021-05-30
568,تكشا,گسترش‌صنايع‌وخدمات‌كشاورزي‌,14,11221,418206670,39230,37270,37270,-1960,-5,39170,-60,-0.15,37270,37270,1400-3-9,2021-05-30
569,بنو,بيمه تجارت نو,14,9589,269259120,29557,28080,28080,-1477,-5,29545,-12,-0.04,28080,28080,1400-3-9,2021-05-30
570,اخزا904,اسنادخزانه-م4بودجه99-011215,14,34916,24671553450,707098,703000,707000,-98,-0.01,706597,-501,-0.07,703000,707095,1400-3-9,2021-05-30
571,كسرام,پارس‌ سرام‌,14,24299,187102300,8100,7700,7700,-400,-4.94,8090,-10,-0.12,7700,7700,1400-3-9,2021-05-30
572,مفاخر,توسعه فناوري اطلاعات خوارزمي,14,279569,13093614115,49299,46835,46835,-2464,-5,46928,-2371,-4.81,46835,46835,1400-3-9,2021-05-30
573,زشگزا,شير و گوشت زاگرس شهركرد,14,46347,360162537,8179,7771,7771,-408,-4.99,8169,-10,-0.12,7771,7771,1400-3-9,2021-05-30
574,ولشرق,ليزينگ ايران و شرق,13,325756,2536336216,8195,7786,7786,-409,-4.99,8122,-73,-0.89,7786,7786,1400-3-9,2021-05-30
575,اخزا808,اسنادخزانه-م8بودجه98-000817,13,2618,2384059080,913641,911015,909801,-3840,-0.42,910641,-3000,-0.33,909801,914000,1400-3-9,2021-05-30
576,تپمپي,پمپ‌ سازي‌ ايران‌,13,18663,321936750,18150,17250,17250,-900,-4.96,18130,-20,-0.11,17250,17250,1400-3-9,2021-05-30
577,هجرت,پخش هجرت,13,15566,413759846,27979,26581,26581,-1398,-5,27938,-41,-0.15,26581,26581,1400-3-9,2021-05-30
578,بالاس,مهندسي ساختمان تاسيسات راه آهن,13,140974,7119891870,53163,50505,50505,-2658,-5,51800,-1363,-2.56,50505,50505,1400-3-9,2021-05-30
579,غفارس,شير پاستوريزه پگاه فارس,13,109041,1880412045,18152,17245,17245,-907,-5,18032,-120,-0.66,17245,17245,1400-3-9,2021-05-30
580,زعف0008پ08,زعفران0008نگين روستا(پ),13,4066,491094340,119692,123000,119102,-590,-0.49,120781,1089,0.91,119102,123000,1400-3-9,2021-05-30
581,ديران,ايران‌دارو,13,15532,249133280,16880,16040,16040,-840,-4.98,16870,-10,-0.06,16040,16040,1400-3-9,2021-05-30
582,دبالك,مواد اوليه دارويي البرز بالك,12,24751,483981054,20583,19554,19554,-1029,-5,20548,-35,-0.17,19554,19554,1400-3-9,2021-05-30
583,تملي805,تسهيلات مسكن ب. ملي-مرداد98,12,142,109005856,744576,781804,781804,37228,5,767647,23071,3.1,707348,781804,1400-3-9,2021-05-30
584,اخزا814,اسنادخزانه-م14بودجه98-010318,12,35602,29049531904,816021,816000,817999,1978,0.24,815952,-69,-0.01,815010,817999,1400-3-9,2021-05-30
585,اخزا809,اسنادخزانه-م9بودجه98-000923,12,4670,4179723231,895248,895400,895500,252,0.03,895016,-232,-0.03,895000,895500,1400-3-9,2021-05-30
586,كپشيرح,ح . پشم‌شيشه‌ايران‌,12,188120,4332552000,24230,24600,23000,-1230,-5.08,23030,-1200,-4.95,23000,24600,1400-3-9,2021-05-30
587,زكشت,كشاورزي مكانيزه اصفهان كشت,12,103038,3950682996,40360,38342,38342,-2018,-5,39800,-560,-1.39,38342,38342,1400-3-9,2021-05-30
588,ضصاد8030,اختيارخ وبصادر-1589-1400/08/12,12,498,225999000,450,450,421,-29,-6.44,454,4,0.89,421,488,1400-3-9,2021-05-30
589,خرينگ,رينگ‌سازي‌مشهد,12,7136,336462400,49630,47150,47150,-2480,-5,49570,-60,-0.12,47150,47150,1400-3-9,2021-05-30
590,اخزا816,اسنادخزانه-م16بودجه98-010503,11,6582,5229711635,794010,794501,794550,540,0.07,794547,537,0.07,794500,794600,1400-3-9,2021-05-30
591,شگل,گلتاش‌,11,9597,91651350,10050,9550,9550,-500,-4.98,10050,0,0,9550,9550,1400-3-9,2021-05-30
592,اخزا907,اسنادخزانه-م7بودجه99-020704,11,35429,21994910500,619846,620021,620030,184,0.03,620817,971,0.16,620020,620990,1400-3-9,2021-05-30
593,دشيمي,شيمي‌ داروئي‌ داروپخش‌,11,4875,140790000,30400,28880,28880,-1520,-5,30380,-20,-0.07,28880,28880,1400-3-9,2021-05-30
594,باران,بيمه زندگي باران50%تاديه,11,107005,431337155,3914,4031,4031,117,2.99,3919,5,0.13,4031,4031,1400-3-9,2021-05-30
595,غديس,پاكديس,11,23408,298405184,13418,12748,12748,-670,-4.99,13404,-14,-0.1,12748,12748,1400-3-9,2021-05-30
596,وملت,سرمايه گذاري ملت,11,75863,317562518,4360,4186,4186,-174,-3.99,4348,-12,-0.28,4186,4186,1400-3-9,2021-05-30
597,كرونا2,تامين مالي جمعي صرفا اهداي سود,11,3939,39390000,10000,10000,10000,0,0,10000,0,0,10000,10000,1400-3-9,2021-05-30
598,دامين,داروسازي‌ امين‌,11,34661,164986360,5010,4760,4760,-250,-4.99,5010,0,0,4760,4760,1400-3-9,2021-05-30
599,تبرك,گروه كارخانجات صنعتي تبرك,11,9069,168946401,19609,18629,18629,-980,-5,19599,-10,-0.05,18629,18629,1400-3-9,2021-05-30
600,اخزا811,اسنادخزانه-م11بودجه98-001013,11,8731,7733148774,885367,885700,885700,333,0.04,885712,345,0.04,885638,888980,1400-3-9,2021-05-30
601,ضجار7037,اختيارخ وتجارت-1597-1400/07/21,11,191,90230000,660,500,620,-40,-6.06,472,-188,-28.48,461,620,1400-3-9,2021-05-30
602,شصدفح,ح . صنعتي دوده فام,10,113550,3104328000,28589,28800,27160,-1429,-5,27339,-1250,-4.37,27160,28800,1400-3-9,2021-05-30
603,قنيشا,قند  نيشابور,10,3083,187538890,64030,60830,60830,-3200,-5,63990,-40,-0.06,60830,60830,1400-3-9,2021-05-30
604,تپكو,توليدتجهيزات‌سنگين‌هپكو,10,59523,315352854,5406,5298,5298,-108,-2,5405,-1,-0.02,5298,5298,1400-3-9,2021-05-30
605,ثپرديس,سرمايه گذاري مسكن پرديس,10,30067,288643200,10105,9600,9600,-505,-5,10095,-10,-0.1,9600,9600,1400-3-9,2021-05-30
606,تاپكيش,تجارت الكترونيك پارسيان كيش,10,7277,125622851,18171,17263,17263,-908,-5,18163,-8,-0.04,17263,17263,1400-3-9,2021-05-30
607,تكنار,مجتمع معادن مس تكنار,10,1419,161462334,117305,113786,113786,-3519,-3,117246,-59,-0.05,113786,113786,1400-3-9,2021-05-30
608,ضبدر3002,اختيارخ شبندر-3843-1400/03/30,10,16,50084000,4500,3000,3990,-510,-11.33,3130,-1370,-30.44,3000,3990,1400-3-9,2021-05-30
609,غشهد,شهد ايران ‌,10,29782,196263380,6930,6590,6590,-340,-4.91,6930,0,0,6590,6590,1400-3-9,2021-05-30
610,خكمك,كمك‌فنرايندامين‌,10,5232,131061600,26360,25050,25050,-1310,-4.97,26350,-10,-0.04,25050,25050,1400-3-9,2021-05-30
611,كشرق,صنعتي و معدني شمال شرق شاهرود,10,80067,6318487305,83068,78915,78915,-4153,-5,81177,-1891,-2.28,78915,78915,1400-3-9,2021-05-30
612,اراد50,مرابحه عام دولت5-ش.خ0302,10,105300,105300030000,1000000,1000000,1000000,0,0,1000000,0,0,1000000,1000001,1400-3-9,2021-05-30
613,خچرخش,چرخشگر,9,9049,116551120,13550,12880,12880,-670,-4.94,13540,-10,-0.07,12880,12880,1400-3-9,2021-05-30
614,خزر,فنرسازي‌زر,9,15647,653731660,43970,41780,41780,-2190,-4.98,43870,-100,-0.23,41780,41780,1400-3-9,2021-05-30
615,غپاك,لبنيات‌ پاك‌,9,4191,119359680,29970,28480,28480,-1490,-4.97,29960,-10,-0.03,28480,28480,1400-3-9,2021-05-30
616,ثغرب,شركت سرمايه گذاري مسكن شمالغرب,9,36688,277324592,7956,7559,7559,-397,-4.99,7948,-8,-0.1,7559,7559,1400-3-9,2021-05-30
617,داسوه,داروسازي‌ اسوه‌,9,8893,243134620,28770,27340,27340,-1430,-4.97,28750,-20,-0.07,27340,27340,1400-3-9,2021-05-30
618,وايران,ليزينگ ايرانيان,9,14388,169346760,12380,11770,11770,-610,-4.93,12370,-10,-0.08,11770,11770,1400-3-9,2021-05-30
619,لابسا,آبسال‌,9,17147,796478150,48890,46450,46450,-2440,-4.99,48750,-140,-0.29,46450,46450,1400-3-9,2021-05-30
620,ولانا,شركت ليزينگ آريا دانا,9,7086,239294220,34814,33770,33770,-1044,-3,34788,-26,-0.07,33770,33770,1400-3-9,2021-05-30
621,اخزا818,اسنادخزانه-م18بودجه98-010614,8,11984,9311821811,778957,777010,777077,-1880,-0.24,777021,-1936,-0.25,777010,777100,1400-3-9,2021-05-30
622,سپيدما2,صندوق س. سپيد دماوند-د,8,70000000,70000000,10406,1,1,-10405,-99.99,1,-10405,-99.99,1,1,1400-3-9,2021-05-30
623,افران2,صندوق س افرا نماد پايدار-ثابت,8,55076000,55076000,13405,1,1,-13404,-99.99,1,-13404,-99.99,1,1,1400-3-9,2021-05-30
624,ضجار7040,اختيارخ وتجارت-2497-1400/07/21,8,126,20374000,184,150,150,-34,-18.48,162,-22,-11.96,150,250,1400-3-9,2021-05-30
625,كتوكا,توليدي و خدمات صنايع نسوز توكا,8,10358,337277196,34275,32562,32562,-1713,-5,34234,-41,-0.12,32562,32562,1400-3-9,2021-05-30
626,ضفلا3003,اختيارخ فولاد-7133-1400/03/19,8,206,758906806,2489,2600,2200,-289,-11.61,2628,139,5.58,2200,2690,1400-3-9,2021-05-30
627,لازما,كارخانه هاي صنعتي آزمايش,8,2404,78120384,34206,32496,32496,-1710,-5,34192,-14,-0.04,32496,32496,1400-3-9,2021-05-30
628,تملي809,تسهيلات مسكن ب. ملي-آذر98,8,162,103554549,609683,640167,630000,20317,3.33,639226,29543,4.85,630000,640167,1400-3-9,2021-05-30
629,نگين,ص.س. زمين و ساختمان نگين شهرري,8,1600,76620500,47820,48000,47590,-230,-0.48,47890,70,0.15,47590,48000,1400-3-9,2021-05-30
630,بايكا,كارخانجات كابلسازي ‌ايران‌,8,2979,106016652,36688,35588,35588,-1100,-3,36676,-12,-0.03,35588,35588,1400-3-9,2021-05-30
631,شدوص,دوده‌ صنعتي‌ پارس‌,8,3980,81072600,21440,20370,20370,-1070,-4.99,21430,-10,-0.05,20370,20370,1400-3-9,2021-05-30
632,شفا,سرمايه گذاري شفادارو,8,2721,109765140,42460,40340,40340,-2120,-4.99,42450,-10,-0.02,40340,40340,1400-3-9,2021-05-30
633,قشكر,شكرشاهرود,8,34450,121332900,3707,3522,3522,-185,-4.99,3705,-2,-0.05,3522,3522,1400-3-9,2021-05-30
634,بسويچ,پارس‌سويچ‌,8,22175,578767500,27470,26100,26100,-1370,-4.99,27430,-40,-0.15,26100,26100,1400-3-9,2021-05-30
635,اخزا721,اسنادخزانه-م21بودجه97-000728,8,819,757218950,922454,920000,926000,3546,0.38,924565,2111,0.23,920000,926000,1400-3-9,2021-05-30
636,ومشان,س. فني و مهندسي مشانير,7,817,56867285,71757,69605,69605,-2152,-3,71744,-13,-0.02,69605,69605,1400-3-9,2021-05-30
637,ضسپا3000,اختيارخ خساپا-1400-1400/03/26,7,159,41800000,290,250,290,0,0,263,-27,-9.31,250,290,1400-3-9,2021-05-30
638,ثنوسا,نوسازي‌وساختمان‌تهران‌,7,15126,182722080,12710,12080,12080,-630,-4.96,12700,-10,-0.08,12080,12080,1400-3-9,2021-05-30
639,فجام,جام‌دارو,7,55860,516146400,9720,9240,9240,-480,-4.94,9700,-20,-0.21,9240,9240,1400-3-9,2021-05-30
640,خفولا,خدمات فني فولاد يزد,7,4474,184686720,42556,41280,41280,-1276,-3,42531,-25,-0.06,41280,41280,1400-3-9,2021-05-30
641,برن0003پ01,برنج طارم0003تجارت مازندران(پ),7,698,193913500,277300,277000,277500,200,0.07,277813,513,0.18,276500,280000,1400-3-9,2021-05-30
642,كطبس,ذغال‌سنگ‌ نگين‌ ط‌بس‌,7,2483,162040580,68690,65260,65260,-3430,-4.99,68650,-40,-0.06,65260,65260,1400-3-9,2021-05-30
643,خعمرا,توسعه و عمران شهرستان نائين,7,98603,2383826128,23472,24176,24176,704,3,23635,163,0.69,24176,24176,1400-3-9,2021-05-30
644,ثاباد,توريستي ورفاهي آبادگران ايران,7,2725,139765250,53980,51290,51290,-2690,-4.98,53950,-30,-0.06,51290,51290,1400-3-9,2021-05-30
645,شپارس,بين‌ المللي‌ محصولات‌  پارس‌,7,24940,522742400,22060,20960,20960,-1100,-4.99,22020,-40,-0.18,20960,20960,1400-3-9,2021-05-30
646,وهنر,گروه توسعه هنر ايران,7,96858,738639108,8027,7626,7626,-401,-5,7996,-31,-0.39,7626,7626,1400-3-9,2021-05-30
647,اخزا810,اسنادخزانه-م10بودجه98-001006,7,591,526479423,890000,887302,893599,3599,0.4,890828,828,0.09,887302,893599,1400-3-9,2021-05-30
648,كقزوي,شيشه‌ قزوين‌,7,8428,82982088,10150,9846,9846,-304,-3,10147,-3,-0.03,9846,9846,1400-3-9,2021-05-30
649,اپرداز,آتيه داده پرداز,7,6019,121421287,21234,20173,20173,-1061,-5,21225,-9,-0.04,20173,20173,1400-3-9,2021-05-30
650,طلا2,صندوق س.پشتوانه طلاي لوتوس,7,700000,700000,77420,1,1,-77419,-100,1,-77419,-100,1,1,1400-3-9,2021-05-30
651,تملي701,تسهيلات مسكن ب. ملي-فروردين97,7,75,45161748,584285,555200,613498,29213,5,602157,17872,3.06,555200,613499,1400-3-9,2021-05-30
652,زقيام,كشت و دام قيام اصفهان,7,5047,137449998,28667,27234,27234,-1433,-5,28653,-14,-0.05,27234,27234,1400-3-9,2021-05-30
653,قشير,قند شيروان قوچان و بجنورد,6,1938,47093400,25578,24300,24300,-1278,-5,25574,-4,-0.02,24300,24300,1400-3-9,2021-05-30
654,فنرژي,گسترش صنايع انرژي آذرآب,6,7666,136554458,18555,17813,17813,-742,-4,18534,-21,-0.11,17813,17813,1400-3-9,2021-05-30
655,نطرين,عطرين نخ قم,6,7215,82106700,11978,11380,11380,-598,-4.99,11975,-3,-0.03,11380,11380,1400-3-9,2021-05-30
656,پلاسك,پلاسكوكار,6,12317,83755600,7150,6800,6800,-350,-4.9,7150,0,0,6800,6800,1400-3-9,2021-05-30
657,تملي807,تسهيلات مسكن ب. ملي-مهر98,6,95,57780615,579255,608217,608217,28962,5,608217,28962,5,608217,608217,1400-3-9,2021-05-30
658,غمهرا,توليدي‌مهرام‌,6,1904,220254720,121760,115680,115680,-6080,-4.99,121670,-90,-0.07,115680,115680,1400-3-9,2021-05-30
659,اشاد1,مشاركت دولتي1-شرايط خاص001026,6,50100,49195000000,999945,988000,981000,-18945,-1.89,981936,-18009,-1.8,981000,988000,1400-3-9,2021-05-30
660,زفكا,كشت و دامداري فكا,6,6984,83130552,12529,11903,11903,-626,-5,12525,-4,-0.03,11903,11903,1400-3-9,2021-05-30
661,اخزا722,اسنادخزانه-م22بودجه97-000428,6,144,140034986,972426,975327,975000,2574,0.26,972465,39,0,971602,975327,1400-3-9,2021-05-30
662,ضخود4001,اختيارخ خودرو-1600-1400/04/02,6,500,123300000,254,300,285,31,12.2,247,-7,-2.76,220,300,1400-3-9,2021-05-30
663,وآذر,سرمايه‌گذاري‌توسعه‌آذربايجان‌,6,1124,87615800,82050,77950,77950,-4100,-5,82020,-30,-0.04,77950,77950,1400-3-9,2021-05-30
664,فسا,پتروشيمي فسا,6,26700,45710400,1764,1712,1712,-52,-2.95,1764,0,0,1712,1712,1400-3-9,2021-05-30
665,خنصير,مهندسي‌نصيرماشين‌,6,2328,239039040,108080,102680,102680,-5400,-5,107990,-90,-0.08,102680,102680,1400-3-9,2021-05-30
666,اخزا716,اسنادخزانه-م16بودجه97-000407,6,1830,1802534050,983750,999000,983750,0,0,984991,1241,0.13,983750,999000,1400-3-9,2021-05-30
667,ضشنا8004,اختيارخ شپنا-10800-1400/08/16,6,202,202200000,241,1000,1000,759,314.94,1001,760,315.35,1000,1100,1400-3-9,2021-05-30
668,كاسپين,داروسازي كاسپين تامين,6,1848,45203928,25748,24461,24461,-1287,-5,25744,-4,-0.02,24461,24461,1400-3-9,2021-05-30
669,ساربيل,سيمان آرتا اردبيل,6,10708,540646920,53140,50490,50490,-2650,-4.99,53040,-100,-0.19,50490,50490,1400-3-9,2021-05-30
670,غپآذر,شير پگاه آذربايجان شرقي,6,5894,306505682,54740,52003,52003,-2737,-5,54681,-59,-0.11,52003,52003,1400-3-9,2021-05-30
671,سرو2,صندوق س سروسودمند مدبران-سهام,6,800000,800000,59980,1,1,-59979,-100,1,-59979,-100,1,1,1400-3-9,2021-05-30
672,زعف0008پ05,زعفران0008نگين زرين(پ),6,518,62400000,121515,121200,120000,-1515,-1.25,120463,-1052,-0.87,120000,121200,1400-3-9,2021-05-30
673,اخزا720,اسنادخزانه-م20بودجه97-000324,6,1239,1232247000,991141,994000,993000,1859,0.19,994550,3409,0.34,992500,994898,1400-3-9,2021-05-30
674,هفجر102,اختيارف ت بفجر8626-01/02/11,5,35644,23703260,724,665,665,-59,-8.15,665,-59,-8.15,665,665,1400-3-9,2021-05-30
675,سفار,سيمان‌فارس‌,5,35440,4757465600,141300,134240,134240,-7060,-5,138890,-2410,-1.71,134240,134240,1400-3-9,2021-05-30
676,ضمخا7071,اختيارخ اخابر-23700-1400/07/28,5,395,13555000,31,31,40,9,29.03,34,3,9.68,31,40,1400-3-9,2021-05-30
677,خوساز,محورسازان‌ايران‌خودرو,5,4166,28620420,7230,6870,6870,-360,-4.98,7230,0,0,6870,6870,1400-3-9,2021-05-30
678,سدشت,صنايع سيمان دشتستان,5,1959,123710850,66470,63150,63150,-3320,-4.99,66460,-10,-0.02,63150,63150,1400-3-9,2021-05-30
679,فلامي,لاميران‌,5,3486,133444080,40290,38280,38280,-2010,-4.99,40270,-20,-0.05,38280,38280,1400-3-9,2021-05-30
680,ثالوند,سرمايه گذاري مسكن الوند,5,21432,654726168,32156,30549,30549,-1607,-5,32082,-74,-0.23,30549,30549,1400-3-9,2021-05-30
681,ضخود7072,اختيارخ خودرو-1400-1400/07/07,5,146,77797000,513,588,510,-3,-0.58,533,20,3.9,510,588,1400-3-9,2021-05-30
682,تملي612,تسهيلات مسكن بانك ملي-اسفند96,5,67,45880368,656372,656372,689190,32818,5,684782,28410,4.33,656372,689190,1400-3-9,2021-05-30
683,رتكو,كنترل‌خوردگي‌تكين‌كو,5,4526,74045360,17220,16360,16360,-860,-4.99,17220,0,0,16360,16360,1400-3-9,2021-05-30
684,ثشرق,سرمايه گذاري مسكن شمال شرق,5,82886,542903300,6890,6550,6550,-340,-4.93,6880,-10,-0.15,6550,6550,1400-3-9,2021-05-30
685,كپشير,پشم‌شيشه‌ايران‌,5,714,27082020,39920,37930,37930,-1990,-4.98,39920,0,0,37930,37930,1400-3-9,2021-05-30
686,بالبر,كابل‌ البرز,5,14444,808719560,58930,55990,55990,-2940,-4.99,58760,-170,-0.29,55990,55990,1400-3-9,2021-05-30
687,شتولي,تولي‌پرس‌,5,6181,212113377,35746,34317,34317,-1429,-4,35683,-63,-0.18,34317,34317,1400-3-9,2021-05-30
688,ولصنم,ليزينگ‌صنعت‌ومعدن‌,5,10745,112285250,10990,10450,10450,-540,-4.91,10990,0,0,10450,10450,1400-3-9,2021-05-30
689,بشهاب,لامپ‌  پارس‌ شهاب‌,5,5488,777539840,149130,141680,141680,-7450,-5,148720,-410,-0.27,141680,141680,1400-3-9,2021-05-30
690,بكاب,صنايع‌جوشكاب‌يزد,4,115,39297800,359700,341720,341720,-17980,-5,359650,-50,-0.01,341720,341720,1400-3-9,2021-05-30
691,افاد84,منفعت دولت8-ش.خاص ساير0205,4,100000,96000000000,960000,960000,960000,0,0,960000,0,0,960000,960000,1400-3-9,2021-05-30
692,اخزا718,اسنادخزانه-م18بودجه97-000525,4,189,181397799,955418,958437,960000,4582,0.48,959777,4359,0.46,958437,960000,1400-3-9,2021-05-30
693,ددام,داروسازي زاگرس فارمد پارس,4,3060,49174200,16910,16070,16070,-840,-4.97,16910,0,0,16070,16070,1400-3-9,2021-05-30
694,ضملت3004,اختيارخ وبملت-5000-1400/03/19,4,40,393000,10,9,80,70,700,10,0,0,7,80,1400-3-9,2021-05-30
695,ساذري,آذريت‌,4,22471,142511082,6158,6342,6342,184,2.99,6161,3,0.05,6342,6342,1400-3-9,2021-05-30
696,دقاضي,داروسازي شهيد قاضي,4,603,25291026,43239,41942,41942,-1297,-3,43237,-2,0,41942,41942,1400-3-9,2021-05-30
697,غشاذر,پگاه‌آذربايجان‌غربي‌,4,9164,85866680,9860,9370,9370,-490,-4.97,9860,0,0,9370,9370,1400-3-9,2021-05-30
698,هپارس102,اختيارف ت پارس-157010-01/02/05,4,4205,3502765,3029,833,833,-2196,-72.5,833,-2196,-72.5,833,833,1400-3-9,2021-05-30
699,شسم,توليد سموم‌ علف‌ كش,4,5172,490424556,92964,94823,94823,1859,2,93143,179,0.19,94823,94823,1400-3-9,2021-05-30
700,افرا,افرانت,4,7455,242496240,34240,32528,32528,-1712,-5,34211,-29,-0.08,32528,32528,1400-3-9,2021-05-30
701,سصفها,سيمان‌اصفهان‌,4,423,50573880,125850,119560,119560,-6290,-5,125840,-10,-0.01,119560,119560,1400-3-9,2021-05-30
702,تكنو,تكنوتار,4,1117,22462870,21160,20110,20110,-1050,-4.96,21160,0,0,20110,20110,1400-3-9,2021-05-30
703,حپارسا,توسعه حمل و نقل ريلي پارسيان,4,7027,235116393,35219,33459,33459,-1760,-5,35190,-29,-0.08,33459,33459,1400-3-9,2021-05-30
704,قنقش,قند نقش جهان,4,398,27980594,71737,70303,70303,-1434,-2,71729,-8,-0.01,70303,70303,1400-3-9,2021-05-30
705,سيلام,سيمان‌ ايلام‌,4,14943,156752070,11040,10490,10490,-550,-4.98,11030,-10,-0.09,10490,10490,1400-3-9,2021-05-30
706,قهكمت,قندهكمتان‌,4,1577,68977980,46040,43740,43740,-2300,-5,46030,-10,-0.02,43740,43740,1400-3-9,2021-05-30
707,ضفلا3005,اختيارخ فولاد-9986-1400/03/19,4,231,104028400,175,450,400,225,128.57,321,146,83.43,170,450,1400-3-9,2021-05-30
708,حتوكا,حمل‌ونقل‌توكا,4,4161,84593130,21390,20330,20330,-1060,-4.96,21380,-10,-0.05,20330,20330,1400-3-9,2021-05-30
709,كساوه,صنايع‌ كاشي‌ و سراميك‌ سينا,4,373,24819420,70040,66540,66540,-3500,-5,70030,-10,-0.01,66540,66540,1400-3-9,2021-05-30
710,تملي804,تسهيلات مسكن ب. ملي-تير98,4,49,25905467,503508,528683,528683,25175,5,528683,25175,5,528683,528683,1400-3-9,2021-05-30
711,هكوير109,اختيارف ت كوير-8194-01/09/20,4,10200,9220800,1,904,904,903,90300,904,903,90300,904,904,1400-3-9,2021-05-30
712,زعف0008پ10,زعفران0008نگين طلاي سرخ(پ),4,494,59461219,121370,121211,120000,-1370,-1.13,120367,-1003,-0.83,120000,121211,1400-3-9,2021-05-30
713,اعتماد2,صندوق س.اعتماد آفرين پارسيان-د,4,38500000,38500000,36675,1,1,-36674,-100,1,-36674,-100,1,1,1400-3-9,2021-05-30
714,تملي704,تسهيلات مسكن ب. ملي-تير97,4,114,75700666,632420,664040,664041,31621,5,664041,31621,5,664040,664041,1400-3-9,2021-05-30
715,حآسا,آسيا سير ارس,4,962,36253932,39669,37686,37686,-1983,-5,39664,-5,-0.01,37686,37686,1400-3-9,2021-05-30
716,تملي802,تسهيلات مسكن ب. ملي-ارديبهشت98,4,36,29174788,786384,747065,825700,39316,5,810411,24027,3.06,747065,825703,1400-3-9,2021-05-30
717,وسديد,گروه ‌صنعتي‌سديد,4,15736,44517144,2886,2829,2829,-57,-1.98,2886,0,0,2829,2829,1400-3-9,2021-05-30
718,كصدف,كاشي صدف سرام استقلال آباده,3,2400,57588000,25257,23995,23995,-1262,-5,25249,-8,-0.03,23995,23995,1400-3-9,2021-05-30
719,وسزنجان,شركت س استان زنجان,3,14659,19774991,1420,1349,1349,-71,-5,1420,0,0,1349,1349,1400-3-9,2021-05-30
720,آسام,صندوق س.آرمان سپهر آشنا-م,3,160,16583100,101830,102000,104131,2301,2.26,103644,1814,1.78,102000,104131,1400-3-9,2021-05-30
721,گكيش,توريستي ورفاهي آبادگران كيش,3,1112,52120552,48320,46871,46871,-1449,-3,48312,-8,-0.02,46871,46871,1400-3-9,2021-05-30
722,عيار2,صندوق سكه طلاي مفيد,3,30000,30000,27887,1,1,-27886,-100,1,-27886,-100,1,1,1400-3-9,2021-05-30
723,ثنظام,س. ساختماني نظام مهندسي ايران,3,3252,149393628,47359,45939,45939,-1420,-3,47337,-22,-0.05,45939,45939,1400-3-9,2021-05-30
724,كايتا,ايتالران‌,3,8400,82101600,9309,9774,9774,465,5,9313,4,0.04,9774,9774,1400-3-9,2021-05-30
725,زعف0008پ19,زعفران0008نگين تروند قاينات(پ),3,1180,139450000,119405,118500,118100,-1305,-1.09,118178,-1227,-1.03,118100,118500,1400-3-9,2021-05-30
726,ضمخا7075,اختيارخ اخابر-8700-1400/07/28,3,7,4200000,600,600,600,0,0,600,0,0,600,600,1400-3-9,2021-05-30
727,اخزا804,اسنادخزانه-م4بودجه98-000421,3,106,103373640,976000,975000,978940,2940,0.3,975223,-777,-0.08,975000,978940,1400-3-9,2021-05-30
728,وتعاون,بيمه  تعاون,3,9765,57711150,6092,5910,5910,-182,-2.99,6091,-1,-0.02,5910,5910,1400-3-9,2021-05-30
729,ضسپا3005,اختيارخ خساپا-3000-1400/03/26,3,117,234000,2,2,2,0,0,2,0,0,2,2,1400-3-9,2021-05-30
730,وليز,ليزينگ‌ايران‌,3,50529,456782160,9510,9040,9040,-470,-4.94,9490,-20,-0.21,9040,9040,1400-3-9,2021-05-30
731,تپولا,مهندسي مرآت پولاد,3,703,23409900,35052,33300,33300,-1752,-5,35048,-4,-0.01,33300,33300,1400-3-9,2021-05-30
732,چافست,افست‌,3,1530,24128100,16590,15770,15770,-820,-4.94,16590,0,0,15770,15770,1400-3-9,2021-05-30
733,اراد33,مرابحه عام دولت3-ش.خ 0303,3,1200,1061000000,908870,880000,880000,-28870,-3.18,884167,-24703,-2.72,880000,885000,1400-3-9,2021-05-30
734,ضملي7005,اختيارخ فملي-15720-1400/07/11,3,11,6400000,530,550,600,70,13.21,582,52,9.81,550,600,1400-3-9,2021-05-30
735,آ س پ,آ.س.پ,3,3664,56139808,16128,15322,15322,-806,-5,16125,-3,-0.02,15322,15322,1400-3-9,2021-05-30
736,زماهان,مجتمع توليد گوشت مرغ ماهان,3,2955,57808665,20592,19563,19563,-1029,-5,20588,-4,-0.02,19563,19563,1400-3-9,2021-05-30
737,اخزا807,اسنادخزانه-م7بودجه98-000719,3,123,114141700,926438,927900,928000,1562,0.17,927981,1543,0.17,927900,928000,1400-3-9,2021-05-30
738,ضبدر3003,اختيارخ شبندر-4270-1400/03/30,3,21,42000000,1638,2000,2000,362,22.1,2000,362,22.1,2000,2000,1400-3-9,2021-05-30
739,شرق1400,مشاركت ليزينگ ايران وشرق140010,3,76,76608000,1008000,1008000,1008000,0,0,1008000,0,0,1008000,1008000,1400-3-9,2021-05-30
740,كفرآور,فرآورده هاي سيمان شرق,3,2085,47713140,23591,22884,22884,-707,-3,23588,-3,-0.01,22884,22884,1400-3-9,2021-05-30
741,اخزا713,اسنادخزانه-م13بودجه97-000518,3,130,124920000,959951,960000,961000,1049,0.11,960923,972,0.1,960000,961000,1400-3-9,2021-05-30
742,تملي703,تسهيلات مسكن ب. ملي-خرداد97,3,47,32622114,661037,694088,694087,33050,5,694088,33051,5,694087,694088,1400-3-9,2021-05-30
743,وجامي,سرمايه گذاري جامي,3,33880,495257840,15070,14618,14618,-452,-3,15047,-23,-0.15,14618,14618,1400-3-9,2021-05-30
744,خفناور,مهندسي صنعتي روان فن آور,3,6513,305186154,48307,46858,46858,-1449,-3,48261,-46,-0.1,46858,46858,1400-3-9,2021-05-30
745,دشيري,شيرين دارو,3,555,120494940,228534,217108,217108,-11426,-5,228389,-145,-0.06,217108,217108,1400-3-9,2021-05-30
746,سدبير,س. تدبيرگران فارس وخوزستان,3,404,33226980,86573,82245,82245,-4328,-5,86563,-10,-0.01,82245,82245,1400-3-9,2021-05-30
747,پاسا,ايران‌ياساتايرورابر,3,1563,39606420,26670,25340,25340,-1330,-4.99,26670,0,0,25340,25340,1400-3-9,2021-05-30
748,ضفلا7004,اختيارخ فولاد-9586-1400/07/25,3,27,59732210,1627,1801,1500,-127,-7.81,1578,-49,-3.01,1500,1801,1400-3-9,2021-05-30
749,ضفلا3000,اختيارخ فولاد-4993-1400/03/19,2,15,105171030,5600,5001,5001,-599,-10.7,5001,-599,-10.7,5001,5001,1400-3-9,2021-05-30
750,اوان,مبين وان كيش,2,197,10205782,54532,51806,51806,-2726,-5,54530,-2,0,51806,51806,1400-3-9,2021-05-30
751,غشصفا,شيرپاستوريزه‌پگاه‌اصفهان‌,2,2130,54975300,27160,25810,25810,-1350,-4.97,27150,-10,-0.04,25810,25810,1400-3-9,2021-05-30
752,تملي801,تسهيلات مسكن ب. ملي-فروردين98,2,30,23649405,750776,788314,788313,37537,5,788313,37537,5,788313,788314,1400-3-9,2021-05-30
753,گپارس,امور رفاهي كارگزاران پارس,2,76,15378144,208602,202344,202344,-6258,-3,208592,-10,0,202344,202344,1400-3-9,2021-05-30
754,ضفلا3001,اختيارخ فولاد-5706-1400/03/19,2,3,16824000,5000,4000,4000,-1000,-20,4000,-1000,-20,4000,4000,1400-3-9,2021-05-30
755,شكف,كف,2,112,10979808,100034,98034,98034,-2000,-2,100032,-2,0,98034,98034,1400-3-9,2021-05-30
756,خكار,ايركا پارت صنعت,2,1707,35130060,21660,20580,20580,-1080,-4.99,21660,0,0,20580,20580,1400-3-9,2021-05-30
757,قلرست,قند لرستان‌,2,661,22487220,35810,34020,34020,-1790,-5,35810,0,0,34020,34020,1400-3-9,2021-05-30
758,وسرضوي,س.سهام عدالت استان خراسان رضوي,2,24692,24173468,1030,979,979,-51,-4.95,1030,0,0,979,979,1400-3-9,2021-05-30
759,طمخا7072,اختيارف اخابر-27700-1400/07/28,2,18,317718000,18540,17651,17651,-889,-4.8,17651,-889,-4.8,17651,17651,1400-3-9,2021-05-30
760,تصميم2,صندوق س با درآمد ثابت تصميم,2,1600000,1600000,16421,1,1,-16420,-99.99,1,-16420,-99.99,1,1,1400-3-9,2021-05-30
761,آينده,بازرگاني آينده سازان بهشت پارس,2,700,13471500,19840,19245,19245,-595,-3,19839,-1,-0.01,19245,19245,1400-3-9,2021-05-30
762,سكه0111پ05,تمام سكه طرح جديد0111آينده,2,200,220867600,1000000,1079000,1129676,129676,12.97,1104338,104338,10.43,1079000,1129676,1400-3-9,2021-05-30
763,زعف0008پ12,زعفران0008پوشالمعمول سحرخيز(پ),2,100,8565560,86397,85800,85078,-1319,-1.53,85656,-741,-0.86,85078,85800,1400-3-9,2021-05-30
764,ضترا8056,اختيارخ شتران-2558-1400/08/09,2,13,38345000,2783,2949,2950,167,6,2950,167,6,2949,2950,1400-3-9,2021-05-30
765,ضخود4004,اختيارخ خودرو-2500-1400/04/02,2,104,3620000,20,30,35,15,75,35,15,75,30,35,1400-3-9,2021-05-30
766,فسديد,لوله‌وتجهيزات‌ سديد - ورشكسته,2,316,34626016,110682,109576,109576,-1106,-1,110673,-9,-0.01,109576,109576,1400-3-9,2021-05-30
767,وآفري,بيمه كارآفرين,2,4000,12612000,3318,3153,3153,-165,-4.97,3318,0,0,3153,3153,1400-3-9,2021-05-30
768,اراد61,مرابحه عام دولت61-ش.خ0309,2,40000,40000000000,1000000,1000000,1000000,0,0,1000000,0,0,1000000,1000000,1400-3-9,2021-05-30
769,ضفلا3008,اختيارخ فولاد-14266-1400/03/19,1,39,54678,10,1,1,-9,-90,1,-9,-90,1,1,1400-3-9,2021-05-30
770,صخابر102,صكوك اجاره مخابرات-3 ماهه 16%,1,5000,4800500000,971000,960100,960100,-10900,-1.12,960100,-10900,-1.12,960100,960100,1400-3-9,2021-05-30
771,قشهد,شهد,1,263,5102200,20420,19400,19400,-1020,-5,20420,0,0,19400,19400,1400-3-9,2021-05-30
772,سپيدما4,صندوق س. سپيد دماوند-د,1,50000000,520650000000,10406,10413,10413,7,0.07,10413,7,0.07,10413,10413,1400-3-9,2021-05-30
773,وثخوز,سرمايه گذاري و توسعه خوزستان,1,77,5157768,70509,66984,66984,-3525,-5,70507,-2,0,66984,66984,1400-3-9,2021-05-30
774,غچين,كشت‌ و صنعت‌ چين‌ چين,1,300,5601000,19650,18670,18670,-980,-4.99,19650,0,0,18670,18670,1400-3-9,2021-05-30
775,پشاهن,توليدي پلاستيك‌ شاهين,1,669,5085069,7380,7601,7601,221,2.99,7380,0,0,7601,7601,1400-3-9,2021-05-30
776,ضترا3004,اختيارخ شتران-10000-1400/03/09,1,19,19000,1,1,1,0,0,1,0,0,1,1,1400-3-9,2021-05-30
777,اخزا7182,اسنادخزانه-م18بودجه97-000525,1,260000,249600000000,955418,960000,960000,4582,0.48,960000,4582,0.48,960000,960000,1400-3-9,2021-05-30
778,ضمخا7070,اختيارخ اخابر-19700-1400/07/28,1,4,2000000,200,500,500,300,150,500,300,150,500,500,1400-3-9,2021-05-30
779,ثتوسا,س.توسعه و عمران استان اردبيل,1,140,5166840,38848,36906,36906,-1942,-5,38847,-1,0,36906,36906,1400-3-9,2021-05-30
780,اراد354,مرابحه عام دولت3-ش.خ 0103,1,13532700,12930359523000,986916,955490,955490,-31426,-3.18,955490,-31426,-3.18,955490,955490,1400-3-9,2021-05-30
781,آگاس2,صندوق س.هستي بخش آگاه-س,1,100000,100000,64106,1,1,-64105,-100,1,-64105,-100,1,1,1400-3-9,2021-05-30
782,داراب,پتروشيمي داراب,1,2150,5007350,2451,2329,2329,-122,-4.98,2451,0,0,2329,2329,1400-3-9,2021-05-30
783,ركيش,كارت اعتباري ايران كيش,1,232,4981040,22600,21470,21470,-1130,-5,22600,0,0,21470,21470,1400-3-9,2021-05-30
784,كساپا,سايپاشيشه‌,1,268,9924040,38970,37030,37030,-1940,-4.98,38970,0,0,37030,37030,1400-3-9,2021-05-30
785,ثزاگرس,سرمايه گذاري توسعه عمران زاگرس,1,95,5143300,56989,54140,54140,-2849,-5,56987,-2,0,54140,54140,1400-3-9,2021-05-30
786,حرهشا,رهشاد سپاهان (سهامي عام,1,100,6046400,61697,60464,60464,-1233,-2,61695,-2,0,60464,60464,1400-3-9,2021-05-30
787,تسه99102,امتياز تسهيلات مسكن دي99,1,15,150,554713,10,10,-554703,-100,10,-554703,-100,10,10,1400-3-9,2021-05-30
788,ضغدر8056,اختيارخ وغدير-8000-1400/08/26,1,30,75000000,2700,2500,2500,-200,-7.41,2500,-200,-7.41,2500,2500,1400-3-9,2021-05-30
789,سفاسي,شركت فارسيت اهواز,1,2000,27972000,14418,13986,13986,-432,-3,14417,-1,-0.01,13986,13986,1400-3-9,2021-05-30
790,ضغدر3004,اختيارخ وغدير-11200-1400/03/26,1,5,500000,81,100,100,19,23.46,100,19,23.46,100,100,1400-3-9,2021-05-30
791,اخزا805,اسنادخزانه-م5بودجه98-000422,1,6,5886000,975000,981000,981000,6000,0.62,981000,6000,0.62,981000,981000,1400-3-9,2021-05-30
792,ضسپا8043,اختيارخ خساپا-2000-1400/08/26,1,1,200000,200,200,200,0,0,200,0,0,200,200,1400-3-9,2021-05-30
793,ضپنا8001,اختيارخ رمپنا-11850-1400/08/05,1,1,1200000,1873,1200,1200,-673,-35.93,1200,-673,-35.93,1200,1200,1400-3-9,2021-05-30
794,ضشنا8000,اختيارخ شپنا-5800-1400/08/16,1,1,3700000,3305,3700,3700,395,11.95,3700,395,11.95,3700,3700,1400-3-9,2021-05-30
795,تسه99122,امتياز تسهيلات مسكن اسفند99,1,13,130,549707,10,10,-549697,-100,10,-549697,-100,10,10,1400-3-9,2021-05-30
796,نتوس,پشم‌ بافي‌ توس,1,1354,27692008,21084,20452,20452,-632,-3,21082,-2,-0.01,20452,20452,1400-3-9,2021-05-30
797,قزوين,كارخانجات‌ قند قزوين‌,1,136,5112240,39560,37590,37590,-1970,-4.98,39560,0,0,37590,37590,1400-3-9,2021-05-30
798,سنير,سيمان‌ سفيد ني‌ريز,1,500,116615000,245500,233230,233230,-12270,-5,245400,-100,-0.04,233230,233230,1400-3-9,2021-05-30
799,همبين102,اختيارف ت مبين17952-01/02/10,1,30000,38820000,1271,1294,1294,23,1.81,1294,23,1.81,1294,1294,1400-3-9,2021-05-30
800,تسه99082,امتياز تسهيلات مسكن آبان99,1,15,150,546178,10,10,-546168,-100,10,-546168,-100,10,10,1400-3-9,2021-05-30
801,حريل2,ريل پردازسير,1,15000000,76440000000,5364,5096,5096,-268,-5,5096,-268,-5,5096,5096,1400-3-9,2021-05-30
802,زنجان,صنايع كشاورزي وكود زنجان,1,650,5883800,9331,9052,9052,-279,-2.99,9331,0,0,9052,9052,1400-3-9,2021-05-30
803,فخوز2,فولاد  خوزستان,1,10000000,157900000000,15500,15790,15790,290,1.87,15790,290,1.87,15790,15790,1400-3-9,2021-05-30
804,ضملي7000,اختيارخ فملي-7720-1400/07/11,1,3,16800000,4700,5600,5600,900,19.15,5600,900,19.15,5600,5600,1400-3-9,2021-05-30
805,آبين,كشت و صنعت آبشيرين,1,1300,5249400,4206,4038,4038,-168,-3.99,4206,0,0,4038,4038,1400-3-9,2021-05-30
806,ثاصفا,شركت‌ ساختمان‌ اصفهان‌,1,1206,32317182,27625,26797,26797,-828,-3,27622,-3,-0.01,26797,26797,1400-3-9,2021-05-30
807,اگ0004192,گام بانك صادرات0004,1,1500000,1459245000000,968000,972830,972830,4830,0.5,972830,4830,0.5,972830,972830,1400-3-9,2021-05-30
808,تسه99022,امتياز تسهيلات مسكن ارديبهشت99,1,6,60,547871,10,10,-547861,-100,10,-547861,-100,10,10,1400-3-9,2021-05-30
809,داوه,داروسازي آوه سينا,1,300,5744700,20156,19149,19149,-1007,-5,20156,0,0,19149,19149,1400-3-9,2021-05-30
810,ضترا8060,اختيارخ شتران-4323-1400/08/09,1,100,50000000,500,500,500,0,0,500,0,0,500,500,1400-3-9,2021-05-30
811,وحافظ,بيمه حافظ,1,100,6440000,65714,64400,64400,-1314,-2,65712,-2,0,64400,64400,1400-3-9,2021-05-30
812,ضپيك7041,اختيارخ تاپيكو-7070-00/07/18,1,22,41800000,2190,1900,1900,-290,-13.24,1900,-290,-13.24,1900,1900,1400-3-9,2021-05-30
813,پست0008پ08,پسته فندقي32-30مه ولات0008(پ),1,4,6640000,1583476,1660000,1660000,76524,4.83,1660000,76524,4.83,1660000,1660000,1400-3-9,2021-05-30
814,ضفلا3002,اختيارخ فولاد-6420-1400/03/19,1,1,3953640,4060,2820,2820,-1240,-30.54,2820,-1240,-30.54,2820,2820,1400-3-9,2021-05-30
815,وسگلستا,شركت س استان گلستان,1,5111,6010536,1237,1176,1176,-61,-4.93,1237,0,0,1176,1176,1400-3-9,2021-05-30
816,لپيام,گسترش صنايع پيام,1,100,5205300,54792,52053,52053,-2739,-5,54790,-2,0,52053,52053,1400-3-9,2021-05-30
817,غنيليح2,ح.مجتمع توليدي نيلي صنعت كرمان,1,3990148,15960592000,4000,4000,4000,0,0,4000,0,0,4000,4000,1400-3-9,2021-05-30
818,ضشنا8005,اختيارخ شپنا-12800-1400/08/16,1,20,10000000,1500,500,500,-1000,-66.67,500,-1000,-66.67,500,500,1400-3-9,2021-05-30
819,پلاست,كارخانجات توليدي پلاستيران,1,156,10858068,71755,69603,69603,-2152,-3,71753,-2,0,69603,69603,1400-3-9,2021-05-30
820,كمرجان,بازرگاني و توليدي مرجان كار,1,70,9766960,146871,139528,139528,-7343,-5,146866,-5,0,139528,139528,1400-3-9,2021-05-30
821,تسه99092,امتياز تسهيلات مسكن آذر99,1,17,170,550434,10,10,-550424,-100,10,-550424,-100,10,10,1400-3-9,2021-05-30
822,ضمخا7080,اختيارخ اخابر-5700-1400/07/28,1,10,25000000,1970,2500,2500,530,26.9,2500,530,26.9,2500,2500,1400-3-9,2021-05-30
823,ضملت3005,اختيارخ وبملت-6000-1400/03/19,1,8,8000,5,1,1,-4,-80,1,-4,-80,1,1,1400-3-9,2021-05-30
824,تسه99112,امتياز تسهيلات مسكن بهمن99,1,14,140,548466,10,10,-548456,-100,10,-548456,-100,10,10,1400-3-9,2021-05-30
825,دارا4,صندوق س. دارا الگوريتم-د,1,15000000,150330000000,10004,10022,10022,18,0.18,10022,18,0.18,10022,10022,1400-3-9,2021-05-30
826,ضملت3006,اختيارخ وبملت-7000-1400/03/19,1,1,1000,3,1,1,-2,-66.67,1,-2,-66.67,1,1,1400-3-9,2021-05-30
827,افاد82,منفعت دولت8-ش.خاص لوتوس0205,1,5000,4801000000,970000,960200,960200,-9800,-1.01,960200,-9800,-1.01,960200,960200,1400-3-9,2021-05-30
828,ضمخا7066,اختيارخ اخابر-11700-1400/07/28,1,30,12000000,540,400,400,-140,-25.93,400,-140,-25.93,400,400,1400-3-9,2021-05-30
829,فولاد2,فولاد مباركه اصفهان,1,9000000,88200000000,9390,9800,9800,410,4.37,9800,410,4.37,9800,9800,1400-3-9,2021-05-30
830,سميعا002,سلف موازي استاندارد سميعا002,1,100000,131143800000,1310872,1311438,1311438,566,0.04,1311438,566,0.04,1311438,1311438,1400-3-9,2021-05-30
831,آوا2,صندوق س.سهام آواي معيار-س,1,700000,700000,6419,1,1,-6418,-99.98,1,-6418,-99.98,1,1,1400-3-9,2021-05-30
832,غبهار,كشت وصنعت بهاران گلبهار خراسان,1,1700,56338000,34164,33140,33140,-1024,-3,34158,-6,-0.02,33140,33140,1400-3-9,2021-05-30
833,وسيزد,شركت س استان يزد,1,4283,5208128,1280,1216,1216,-64,-5,1280,0,0,1216,1216,1400-3-9,2021-05-30
834,ضترا3003,اختيارخ شتران-9000-1400/03/09,1,2,2000,1,1,1,0,0,1,0,0,1,1,1400-3-9,2021-05-30
835,ضملت3000,اختيارخ وبملت-3000-1400/03/19,1,4,3720000,998,930,930,-68,-6.81,930,-68,-6.81,930,930,1400-3-9,2021-05-30
836,وخاور2,بانك خاورميانه,1,4000000,34000000000,8390,8500,8500,110,1.31,8500,110,1.31,8500,8500,1400-3-9,2021-05-30
837,ثامان,سامان‌ گستراصفهان‌,1,306,6600420,22700,21570,21570,-1130,-4.98,22700,0,0,21570,21570,1400-3-9,2021-05-30
838,اگ000419,گام بانك صادرات0004,1,5000,4864150000,968000,972830,972830,4830,0.5,972830,4830,0.5,972830,972830,1400-3-9,2021-05-30
