,نماد,نام,تعداد,حجم,ارزش,دیروز,اولین,آخرین معامله - مقدار,آخرین معامله - تغییر,آخرین معامله - درصد,قیمت پایانی - مقدار,قیمت پایانی - تغییر,قیمت پایانی - درصد,کمترین,بیشترین,تاریخ,gregorian_date
0,پالايش,صندوق پالايشي يكم-سهام,21512,21073909,1471323741040,70980,70060,69300,-1680,-2.37,69820,-1160,-1.63,69000,70820,1400-9-15,2021-12-06
1,دارا يكم,صندوق واسطه گري مالي يكم-سهام,13681,8990607,997948895900,110870,110600,109860,-1010,-0.91,111000,130,0.12,109450,112580,1400-9-15,2021-12-06
2,توسن,توسعه سامانه ي نرم افزاري نگين,9230,15986081,369474485222,23050,23380,23114,64,0.28,23112,62,0.27,21898,23970,1400-9-15,2021-12-06
3,بركت,گروه دارويي بركت,9119,21947553,414372148490,19560,19600,18600,-960,-4.91,18880,-680,-3.48,18590,19800,1400-9-15,2021-12-06
4,شستا,سرمايه گذاري تامين اجتماعي,8698,44818930,487129207110,10910,10740,10760,-150,-1.37,10870,-40,-0.37,10740,11110,1400-9-15,2021-12-06
5,انرژي3,سايراشخاص بورس انرژي,8648,6238483,648882516550,100110,103950,102150,2040,2.04,104010,3900,3.9,102010,105110,1400-9-15,2021-12-06
6,بورس,بورس اوراق بهادار تهران,7569,57007494,672943507860,11400,11710,11470,70,0.61,11800,400,3.51,11420,11970,1400-9-15,2021-12-06
7,غزر,صنعتي زر ماكارون,7286,5258819,54372462440,10120,10010,10250,130,1.28,10340,220,2.17,10000,10490,1400-9-15,2021-12-06
8,شاروم,پتروشيمي اروميه,7217,2258988,31345564488,13521,13900,13640,119,0.88,13876,355,2.63,13531,14140,1400-9-15,2021-12-06
9,كالا,بورس كالاي ايران,6745,31312427,821662647990,25080,26330,26000,920,3.67,26240,1160,4.63,25720,26330,1400-9-15,2021-12-06
10,فسبزوار,پارس فولاد سبزوار,6354,4881788,169435024950,34150,34150,34990,840,2.46,34710,560,1.64,34120,35170,1400-9-15,2021-12-06
11,شبندر,پالايش نفت بندرعباس,6283,58043083,362840015860,6290,6290,6160,-130,-2.07,6250,-40,-0.64,6150,6380,1400-9-15,2021-12-06
12,پترول,گ.س.وت.ص.پتروشيمي خليج فارس,5911,87516296,223016054556,2636,2586,2516,-120,-4.55,2548,-88,-3.34,2505,2620,1400-9-15,2021-12-06
13,فرابورس,فرابورس ايران,5839,25659314,487997383188,18283,19197,18666,383,2.09,19018,735,4.02,18487,19197,1400-9-15,2021-12-06
14,فولاد,فولاد مباركه اصفهان,5740,38216266,392663069250,10320,10350,10190,-130,-1.26,10270,-50,-0.48,10160,10380,1400-9-15,2021-12-06
15,فجهان,مجتمع جهان فولاد سيرجان,5296,19512624,107411971546,5421,5420,5502,81,1.49,5505,84,1.55,5420,5557,1400-9-15,2021-12-06
16,وسديد,گروه ‌صنعتي‌سديد,5255,103705124,115245560138,1165,1107,1107,-58,-4.98,1111,-54,-4.64,1107,1143,1400-9-15,2021-12-06
17,كمند,صندوق س. با درآمد ثابت كمند,5058,200226531,2035954250008,10159,10168,10169,10,0.1,10168,9,0.09,10168,10169,1400-9-15,2021-12-06
18,خگستر,گسترش‌سرمايه‌گذاري‌ايران‌خودرو,5002,112850604,283061446948,2465,2470,2470,5,0.2,2508,43,1.74,2432,2563,1400-9-15,2021-12-06
19,مديريت,س. و خدمات مديريت صند. ب كشوري,4890,12213178,106402397194,8360,8470,8778,418,5,8712,352,4.21,8302,8778,1400-9-15,2021-12-06
20,شپنا,پالايش نفت اصفهان,3996,26228160,153979704810,5910,5870,5780,-130,-2.2,5870,-40,-0.68,5780,5960,1400-9-15,2021-12-06
21,سپيدار,سپيدار سيستم آسيا,3991,5109646,106660776391,20063,20450,21055,992,4.94,20874,811,4.04,20100,21066,1400-9-15,2021-12-06
22,البرز,بيمه البرز,3979,205591877,380065735152,1930,1834,1867,-63,-3.26,1849,-81,-4.2,1834,1930,1400-9-15,2021-12-06
23,كيمياتك,آريان كيميا تك,3737,828328,20389671330,24760,24530,24550,-210,-0.85,24620,-140,-0.57,24520,24800,1400-9-15,2021-12-06
24,كدما,معدني‌ دماوند,3696,2389001,171147809420,70360,70000,70880,520,0.74,71640,1280,1.82,70000,73200,1400-9-15,2021-12-06
25,شتران,پالايش نفت تهران,3607,28739160,119283487105,4204,4200,4079,-125,-2.97,4152,-52,-1.24,4068,4249,1400-9-15,2021-12-06
26,خبهمن,گروه‌بهمن‌,3520,86655791,169766028507,1917,1922,1941,24,1.25,1959,42,2.19,1921,1990,1400-9-15,2021-12-06
27,كرمان,س. توسعه و عمران استان كرمان,3479,101785044,94111828951,925,937,913,-12,-1.3,925,0,0,909,942,1400-9-15,2021-12-06
28,وتجارت,بانك تجارت,3371,80633506,146624350769,1805,1785,1797,-8,-0.44,1818,13,0.72,1785,1850,1400-9-15,2021-12-06
29,وبملت,بانك ملت,3340,51972958,150251184226,2843,2845,2880,37,1.3,2891,48,1.69,2845,2935,1400-9-15,2021-12-06
30,گدنا,تهيه توزيع غذاي دنا آفرين فدك,3281,2210304,30938662904,13769,14289,13670,-99,-0.72,13997,228,1.66,13600,14289,1400-9-15,2021-12-06
31,لپارس,پارس‌ الكتريك‌,3078,2990731,285516208510,91500,90700,96070,4570,4.99,95470,3970,4.34,88220,96070,1400-9-15,2021-12-06
32,فاراك,ماشين‌ سازي‌ اراك‌,3004,130685229,197910523121,1455,1480,1500,45,3.09,1514,59,4.05,1475,1527,1400-9-15,2021-12-06
33,غدام,خوراك‌  دام‌ پارس‌,2903,1986333,208743640300,109470,104000,104000,-5470,-5,105090,-4380,-4,104000,108490,1400-9-15,2021-12-06
34,خصدرا,صنعتي‌ دريايي‌ ايران‌,2836,68467327,153632922718,2356,2239,2239,-117,-4.97,2244,-112,-4.75,2239,2283,1400-9-15,2021-12-06
35,طلا,صندوق س.پشتوانه طلاي لوتوس,2781,9011508,858653625012,93652,94689,96150,2498,2.67,95284,1632,1.74,93850,96350,1400-9-15,2021-12-06
36,نوري,پتروشيمي نوري,2766,2805694,308847012870,110440,110510,109980,-460,-0.42,110080,-360,-0.33,108270,110900,1400-9-15,2021-12-06
37,وبصادر,بانك صادرات ايران,2734,64431474,110972061812,1722,1710,1701,-21,-1.22,1722,0,0,1700,1760,1400-9-15,2021-12-06
38,امين,تامين سرمايه امين,2726,1473676,17959662100,12160,12170,12200,40,0.33,12170,10,0.08,12150,12240,1400-9-15,2021-12-06
39,كيان,صندوق س. با درآمد ثابت كيان,2711,25981740,829371872239,31903,31921,31922,19,0.06,31921,18,0.06,31920,31924,1400-9-15,2021-12-06
40,آريا,پليمر آريا ساسول,2633,594597,65437924526,110783,110900,109134,-1649,-1.49,110307,-476,-0.43,109134,111100,1400-9-15,2021-12-06
41,فملي,ملي‌ صنايع‌ مس‌ ايران‌,2632,54161441,349821097230,6650,6410,6500,-150,-2.26,6460,-190,-2.86,6410,6540,1400-9-15,2021-12-06
42,ختوقا,قطعات‌ اتومبيل‌ ايران‌,2590,55158838,155425974069,2722,2703,2751,29,1.07,2818,96,3.53,2703,2858,1400-9-15,2021-12-06
43,شفن,پتروشيمي فناوران,2545,7282585,118774009650,16800,16950,16090,-710,-4.23,16310,-490,-2.92,16090,16950,1400-9-15,2021-12-06
44,گشان,توسعه بين المللي پديده شانديز,2534,8344258,174835896653,21582,20935,20935,-647,-3,20953,-629,-2.91,20935,21500,1400-9-15,2021-12-06
45,فاراكح,ح . ماشين‌ سازي‌ اراك‌,2432,1175806269,446896906412,385,385,380,-5,-1.3,380,-5,-1.3,380,385,1400-9-15,2021-12-06
46,سپيد,سپيد ماكيان,2286,783719,45196164430,57040,57300,57300,260,0.46,57670,630,1.1,55600,58600,1400-9-15,2021-12-06
47,بركتح,ح . گروه دارويي بركت,2233,5183054,81534145340,16220,16020,15380,-840,-5.18,15730,-490,-3.02,15310,16690,1400-9-15,2021-12-06
48,وخارزم,سرمايه گذاري خوارزمي,2218,22463017,94371505448,4208,4240,4162,-46,-1.09,4201,-7,-0.17,4150,4298,1400-9-15,2021-12-06
49,امين يكم,صندوق درآمد ثابت امين يكم فردا,2187,63204436,636514218529,10067,10076,10070,3,0.03,10071,4,0.04,10068,10076,1400-9-15,2021-12-06
50,ذوب,سهامي ذوب آهن  اصفهان,2185,22288056,77441159172,3466,3510,3437,-29,-0.84,3474,8,0.23,3432,3530,1400-9-15,2021-12-06
51,انار,صندوق س.انارنماد ارزش-درسهام,2126,6243611,62436110000,10000,10000,10000,0,0,10000,0,0,10000,10000,1400-9-15,2021-12-06
52,خنصير,مهندسي‌نصيرماشين‌,2114,5512782,108729738310,19880,20000,19350,-530,-2.67,19720,-160,-0.8,19100,20490,1400-9-15,2021-12-06
53,وكبهمن,مديريت سرمايه گذاري كوثربهمن,2043,1030160,10365984638,10013,10150,9940,-73,-0.73,10046,33,0.33,9853,10370,1400-9-15,2021-12-06
54,شگويا,پتروشيمي تندگويان,2027,8846162,95256733140,10667,10667,10777,110,1.03,10760,93,0.87,10651,10920,1400-9-15,2021-12-06
55,افران,صندوق س افرا نماد پايدار-ثابت,2013,72952244,1088535198661,14914,14923,14922,8,0.05,14921,7,0.05,14921,14924,1400-9-15,2021-12-06
56,تسه0008,امتيازتسهيلات مسكن آبان1400,2004,92210,79094761668,827622,838000,869000,41378,5,857768,30146,3.64,838000,869000,1400-9-15,2021-12-06
57,وهامون,سرمايه گذاري هامون صبا,1969,4286183,11834931682,2739,2783,2753,14,0.51,2756,17,0.62,2740,2783,1400-9-15,2021-12-06
58,ومدير,گ.مديريت ارزش سرمايه ص ب كشوري,1962,4477186,18882077395,4204,4171,4233,29,0.69,4217,13,0.31,4171,4250,1400-9-15,2021-12-06
59,بوعلي,پتروشيمي بوعلي سينا,1959,633945,45891919070,71580,71580,72260,680,0.95,71950,370,0.52,71580,73480,1400-9-15,2021-12-06
60,آبادا,توليد نيروي برق آبادان,1948,1074383,11264979570,10630,10910,10280,-350,-3.29,10520,-110,-1.03,10100,10910,1400-9-15,2021-12-06
61,كاما,باما,1935,10439214,74731686600,7210,7250,7110,-100,-1.39,7160,-50,-0.69,7100,7290,1400-9-15,2021-12-06
62,كماسه,تامين‌ ماسه‌ ريخته‌گري‌,1927,23638095,98739357190,4016,4030,4216,200,4.98,4177,161,4.01,4020,4216,1400-9-15,2021-12-06
63,صبا,سرمايه گذاري صبا تامين,1915,12739458,77456092368,6053,6100,6048,-5,-0.08,6072,19,0.31,6040,6170,1400-9-15,2021-12-06
64,سحرخيز,صندوق س. گروه زعفران سحرخيز,1911,3243958,62548685614,20153,20150,19345,-808,-4.01,19282,-871,-4.32,19010,20150,1400-9-15,2021-12-06
65,ورازي,بيمه رازي,1911,71735846,118402409604,1697,1647,1647,-50,-2.95,1651,-46,-2.71,1647,1682,1400-9-15,2021-12-06
66,ختور,رادياتور ايران‌,1889,6404716,98104786730,15900,15840,15110,-790,-4.97,15320,-580,-3.65,15110,15840,1400-9-15,2021-12-06
67,ولپارس,ليزينگ پارسيان,1882,3186775,10267350016,3220,3206,3218,-2,-0.06,3221,1,0.03,3089,3298,1400-9-15,2021-12-06
68,خمحور,توليدمحورخودرو,1873,52401284,202682640983,3704,3750,3889,185,4.99,3868,164,4.43,3713,3889,1400-9-15,2021-12-06
69,اپال,فرآوري معدني اپال كاني پارس,1868,4839570,110429774800,22100,22220,22920,820,3.71,22730,630,2.85,22220,23010,1400-9-15,2021-12-06
70,چخزر,صنايع چوب خزر كاسپين,1852,393993,10940083986,28104,27810,27561,-543,-1.93,27854,-250,-0.89,27201,28300,1400-9-15,2021-12-06
71,رافزا,رايان هم افزا,1847,296756,17270622489,56388,57800,57700,1312,2.33,58198,1810,3.21,57000,59099,1400-9-15,2021-12-06
72,غگل,گلوكوزان‌,1828,28173901,88208023455,3015,3080,3160,145,4.81,3131,116,3.85,3056,3165,1400-9-15,2021-12-06
73,قشكر,شكرشاهرود,1816,26833828,63502139516,2370,2252,2410,40,1.69,2366,-4,-0.17,2252,2470,1400-9-15,2021-12-06
74,اعتماد,صندوق س.اعتماد آفرين پارسيان-د,1760,28003780,1132872097610,40431,40453,40452,21,0.05,40454,23,0.06,40452,40457,1400-9-15,2021-12-06
75,نهال,صندوق س. طلاي سرخ نوويرا,1725,2612664,50986485907,20289,20010,19629,-660,-3.25,19515,-774,-3.81,19200,20020,1400-9-15,2021-12-06
76,غكورش,صنعت غذايي كورش,1724,951095,43775559230,45880,45670,46310,430,0.94,46000,120,0.26,45060,46600,1400-9-15,2021-12-06
77,وسپهر,سرمايه گذاري مالي سپهرصادرات,1717,5005790,35341558016,7060,7060,7060,0,0,7060,0,0,7060,7062,1400-9-15,2021-12-06
78,ولكار,ليزينگ كارآفرين,1715,827368,3385868886,4204,4052,4062,-142,-3.38,4178,-26,-0.62,4010,4150,1400-9-15,2021-12-06
79,وايران,ليزينگ ايرانيان,1707,23417122,75075569761,3101,3229,3110,9,0.29,3206,105,3.39,3080,3256,1400-9-15,2021-12-06
80,بپيوند,برق و انرژي پيوندگستر پارس,1699,864537,8443175268,9867,9681,9690,-177,-1.79,9808,-59,-0.6,9660,9990,1400-9-15,2021-12-06
81,لطيف,محصولات كاغذي لطيف,1676,501543,19040549366,37953,38000,37320,-633,-1.67,37964,11,0.03,37002,38855,1400-9-15,2021-12-06
82,زملارد,كشاورزي و دامپروري ملارد شير,1649,1121229,22082837908,20449,20201,19524,-925,-4.52,19695,-754,-3.69,19427,21000,1400-9-15,2021-12-06
83,فاذر,صنايع‌ آذرآب‌,1636,63913389,54008259644,828,836,849,21,2.54,845,17,2.05,827,865,1400-9-15,2021-12-06
84,زكشت,كشاورزي مكانيزه اصفهان كشت,1627,3578731,74010080828,20985,20400,19936,-1049,-5,20681,-304,-1.45,19936,21600,1400-9-15,2021-12-06
85,تپكو,توليدتجهيزات‌سنگين‌هپكو,1625,29315767,94252085670,3253,3230,3156,-97,-2.98,3215,-38,-1.17,3156,3320,1400-9-15,2021-12-06
86,شفنح,ح . پتروشيمي فناوران,1561,6833397,81844395760,12350,12320,11890,-460,-3.72,11980,-370,-3,11800,12450,1400-9-15,2021-12-06
87,وغدير,سرمايه‌گذاري‌غدير(هلدينگ‌,1552,10204402,148387156280,14460,14440,14520,60,0.41,14540,80,0.55,14300,14690,1400-9-15,2021-12-06
88,كزغال,زغال سنگ پروده طبس,1546,867455,26426646666,30585,30001,30540,-45,-0.15,30465,-120,-0.39,30001,31010,1400-9-15,2021-12-06
89,دماوند,توليد نيروي برق دماوند,1529,2164998,50881396373,23083,23979,22840,-243,-1.05,23494,411,1.78,22700,24170,1400-9-15,2021-12-06
90,خودكفا,اقتصادي و خودكفايي آزادگان,1523,10149618,82136791963,8332,8120,8083,-249,-2.99,8093,-239,-2.87,8083,8318,1400-9-15,2021-12-06
91,فگستر,گسترش صنايع روي ايرانيان,1513,963575,8755855475,9057,9195,9130,73,0.81,9074,17,0.19,8910,9199,1400-9-15,2021-12-06
92,خزر,فنرسازي‌زر,1511,6293849,67433263470,10360,10200,10550,190,1.83,10710,350,3.38,10200,10870,1400-9-15,2021-12-06
93,غگيلا,شيرپاستوريزه پگاه گيلان,1477,1173553,17400147997,14801,15150,14552,-249,-1.68,14827,26,0.18,14402,15150,1400-9-15,2021-12-06
94,سيتا,سرمايه گذاري سيمان تامين,1463,1900721,17309403050,9130,9010,9060,-70,-0.77,9120,-10,-0.11,9000,9300,1400-9-15,2021-12-06
95,ثشاهد,سرمايه‌ گذاري‌ شاهد,1452,6455041,66576082010,10290,10300,10140,-150,-1.46,10310,20,0.19,10130,10550,1400-9-15,2021-12-06
96,پارند,صندوق س. پارند پايدار سپهر,1440,57650912,586163985642,10162,10168,10168,6,0.06,10167,5,0.05,10167,10169,1400-9-15,2021-12-06
97,شصدف,صنعتي دوده فام,1409,2170512,71035747697,33049,32700,32500,-549,-1.66,32728,-321,-0.97,31890,33499,1400-9-15,2021-12-06
98,كرازي,كارخانجات‌توليدي‌شيشه‌رازي‌,1403,51643772,63611497943,1182,1215,1216,34,2.88,1232,50,4.23,1203,1241,1400-9-15,2021-12-06
99,خمهرح,ح . مهركام‌پارس‌,1401,22840681,20302550548,858,841,870,12,1.4,889,31,3.61,841,916,1400-9-15,2021-12-06
100,خزاميا,زامياد,1392,9694511,69567771160,7070,6870,7080,10,0.14,7180,110,1.56,6870,7380,1400-9-15,2021-12-06
101,خمهر,مهركام‌پارس‌,1363,39641865,79527175305,1920,1862,1999,79,4.11,2006,86,4.48,1862,2016,1400-9-15,2021-12-06
102,خموتور,موتورسازان‌تراكتورسازي‌ايران‌,1358,12762786,75591535990,6190,5960,5890,-300,-4.85,5920,-270,-4.36,5890,6120,1400-9-15,2021-12-06
103,وپارس,بانك‌پارسيان‌,1340,40037619,78795252175,1980,1950,1968,-12,-0.61,1972,-8,-0.4,1921,2010,1400-9-15,2021-12-06
104,فسپا,گروه‌صنعتي‌سپاهان‌,1312,11027164,190407288990,16510,17200,16990,480,2.91,17270,760,4.6,16720,17330,1400-9-15,2021-12-06
105,خكمك,كمك‌فنرايندامين‌,1305,4808079,122830029440,24580,25000,25200,620,2.52,25550,970,3.95,24850,25800,1400-9-15,2021-12-06
106,شلرد,كود شيميايي اوره لردگان,1296,7182978,84822332180,11742,11570,11618,-124,-1.06,11809,67,0.57,11570,12000,1400-9-15,2021-12-06
107,پلاست,كارخانجات توليدي پلاستيران,1279,7289523,61349629001,8439,8186,8451,12,0.14,8416,-23,-0.27,8186,8692,1400-9-15,2021-12-06
108,شغدير,پتروشيمي غدير,1278,959157,92990850140,95720,97000,96110,390,0.41,96950,1230,1.28,94510,98290,1400-9-15,2021-12-06
109,غبهنوش,بهنوش‌ ايران‌,1277,1560657,119691817310,73320,74120,76980,3660,4.99,76690,3370,4.6,73320,76980,1400-9-15,2021-12-06
110,وهور,مديريت انرژي اميد  تابان هور,1276,48991500,70753540323,1509,1445,1434,-75,-4.97,1444,-65,-4.31,1434,1499,1400-9-15,2021-12-06
111,حكشتي,كشتيراني جمهوري اسلامي ايران,1258,6559872,85222375270,13000,12960,12940,-60,-0.46,12990,-10,-0.08,12880,13200,1400-9-15,2021-12-06
112,بكاب,صنايع‌جوشكاب‌يزد,1244,483576,34073561220,71790,71500,68880,-2910,-4.05,70460,-1330,-1.85,68260,74000,1400-9-15,2021-12-06
113,قثابت,قند ثابت‌ خراسان‌,1242,39439117,70320242275,1705,1749,1790,85,4.99,1783,78,4.57,1710,1790,1400-9-15,2021-12-06
114,حآسا,آسيا سير ارس,1233,4913833,70266461151,13706,13810,13955,249,1.82,14300,594,4.33,13810,14391,1400-9-15,2021-12-06
115,لكما,كارخانجات‌مخابراتي‌ايران‌,1217,34260422,32106437172,963,935,935,-28,-2.91,937,-26,-2.7,935,957,1400-9-15,2021-12-06
116,تملت,تامين سرمايه بانك ملت,1207,9635636,26341834530,2849,2853,2707,-142,-4.98,2734,-115,-4.04,2707,2853,1400-9-15,2021-12-06
117,شلعاب,لعابيران‌,1205,11539704,71746703130,6490,6450,6170,-320,-4.93,6220,-270,-4.16,6170,6540,1400-9-15,2021-12-06
118,خكار,ايركا پارت صنعت,1198,12392020,46645918878,3878,3940,3685,-193,-4.98,3764,-114,-2.94,3685,3948,1400-9-15,2021-12-06
119,فباهنر,مس‌ شهيدباهنر,1198,2671359,70582000080,25310,26000,26570,1260,4.98,26420,1110,4.39,25400,26570,1400-9-15,2021-12-06
120,هاي وب,داده گسترعصرنوين-هاي وب,1171,8180835,67247386710,8210,8290,8070,-140,-1.71,8220,10,0.12,8050,8350,1400-9-15,2021-12-06
121,وملي,گروه‌ صنعتي‌ ملي‌ (هلدينگ‌,1169,345889,47336306720,135210,135210,133700,-1510,-1.12,136850,1640,1.21,131850,139800,1400-9-15,2021-12-06
122,وپويا,سرمايه گذاري پويا,1169,2616483,9082352797,3537,3434,3412,-125,-3.53,3495,-42,-1.19,3411,3549,1400-9-15,2021-12-06
123,نطرين,عطرين نخ قم,1154,7276460,50422293161,7008,6850,6810,-198,-2.83,6930,-78,-1.11,6658,7200,1400-9-15,2021-12-06
124,شپديس,پتروشيمي پرديس,1128,1410757,242764541640,170420,171700,172000,1580,0.93,172080,1660,0.97,169000,173500,1400-9-15,2021-12-06
125,زاگرس,پتروشيمي زاگرس,1109,235826,57442430791,247075,247100,242890,-4185,-1.69,245083,-1992,-0.81,235000,248930,1400-9-15,2021-12-06
126,سدبير,س. تدبيرگران فارس وخوزستان,1100,1054812,62285982421,56773,57999,59449,2676,4.71,59049,2276,4.01,57300,59611,1400-9-15,2021-12-06
127,بگيلان,توسعه مسير برق گيلان,1093,350378,5039263559,14350,13633,14350,0,0,14357,7,0.05,13633,14990,1400-9-15,2021-12-06
128,بترانس,ايران‌ ترانسفو,1080,22721409,47039876000,2080,2080,2036,-44,-2.12,2070,-10,-0.48,2036,2123,1400-9-15,2021-12-06
129,وسكرد,شركت س استان كردستان,1073,66175994,28371152482,426,427,431,5,1.17,429,3,0.7,422,438,1400-9-15,2021-12-06
130,سرو,صندوق س سروسودمند مدبران-سهام,1068,1005552,68625968970,68660,69150,67950,-710,-1.03,68250,-410,-0.6,67780,69150,1400-9-15,2021-12-06
131,زر,صندوق س.پشتوانه سكه طلاي زر,1054,1702867,99220700834,57755,58100,58500,745,1.29,58267,512,0.89,57843,58750,1400-9-15,2021-12-06
132,شاراك,پتروشيمي شازند,1042,1663213,74151293960,43580,44600,44300,720,1.65,44290,710,1.63,44010,44960,1400-9-15,2021-12-06
133,اطلس,صندوق س.توسعه اندوخته آينده-س,1030,656361,159339574656,242416,242400,241998,-418,-0.17,242762,346,0.14,241300,244501,1400-9-15,2021-12-06
134,سنير,سيمان‌ سفيد ني‌ريز,1028,858185,29344202560,33530,35090,33550,20,0.06,34190,660,1.97,33000,35090,1400-9-15,2021-12-06
135,فارس,صنايع پتروشيمي خليج فارس,1000,4894130,49504457800,10050,10200,10110,60,0.6,10080,30,0.3,10050,10200,1400-9-15,2021-12-06
136,ديران,ايران‌دارو,996,2557571,55670595020,21660,22200,21190,-470,-2.17,21770,110,0.51,21000,22490,1400-9-15,2021-12-06
137,اخابر,مخابرات ايران,991,6828404,47515722230,7000,7000,6880,-120,-1.71,6980,-20,-0.29,6840,7150,1400-9-15,2021-12-06
138,آپ,آسان پرداخت پرشين,990,4592600,52598152250,11800,11700,11210,-590,-5,11450,-350,-2.97,11210,11950,1400-9-15,2021-12-06
139,فنفت,صنايع تجهيزات نفت,971,3252470,50806819770,15303,14851,15762,459,3,15621,318,2.08,14844,15762,1400-9-15,2021-12-06
140,شيران,س. صنايع‌شيميايي‌ايران,956,2183608,46718515290,20930,21100,21180,250,1.19,21190,260,1.24,21010,21890,1400-9-15,2021-12-06
141,خمحركه,نيرو محركه‌,947,8254218,30744129727,3652,3652,3675,23,0.63,3725,73,2,3550,3794,1400-9-15,2021-12-06
142,كگل,معدني و صنعتي گل گهر,945,11064708,252501130640,22840,22530,22350,-490,-2.15,22820,-20,-0.09,22220,22860,1400-9-15,2021-12-06
143,سيمرغ,سيمرغ,940,2197285,52265653280,23400,23460,23220,-180,-0.77,23790,390,1.67,23080,24490,1400-9-15,2021-12-06
144,تسه0006,امتيازتسهيلات مسكن شهريور1400,939,35783,30573453634,827961,835555,862000,34039,4.11,854413,26452,3.19,835555,867890,1400-9-15,2021-12-06
145,زنگان,صنعت روي زنگان,931,679689,46767533290,71360,73100,67792,-3568,-5,68807,-2553,-3.58,67792,73100,1400-9-15,2021-12-06
146,كاوه,فولاد كاوه جنوب كيش,929,6552674,98422099390,14850,15000,15180,330,2.22,15020,170,1.14,14900,15190,1400-9-15,2021-12-06
147,چكاپا,گروه صنايع كاغذ پارس,925,12110826,35705686297,2918,2922,2919,1,0.03,2948,30,1.03,2910,2995,1400-9-15,2021-12-06
148,دلقما,دارويي‌ لقمان‌,923,2248980,47947393280,22280,22000,21170,-1110,-4.98,21320,-960,-4.31,21170,22380,1400-9-15,2021-12-06
149,وصندوق,سرمايه‌گذاري‌صندوق‌بازنشستگي‌,921,16468527,209980411890,12720,12970,12810,90,0.71,12750,30,0.24,12520,13050,1400-9-15,2021-12-06
150,خفنر,فنرسازي‌خاور,920,3995189,28283327510,6900,6700,7050,150,2.17,7080,180,2.61,6700,7240,1400-9-15,2021-12-06
151,فتوسا,توليد و توسعه سرب روي ايرانيان,920,368402,3773492334,10235,10490,10141,-94,-0.92,10237,2,0.02,10030,10490,1400-9-15,2021-12-06
152,آگاس,صندوق س.هستي بخش آگاه-س,919,697928,53759195937,77390,76720,76555,-835,-1.08,77027,-363,-0.47,76310,77845,1400-9-15,2021-12-06
153,كتوكا,توليدي و خدمات صنايع نسوز توكا,911,3657940,36340186498,10002,10000,9722,-280,-2.8,9935,-67,-0.67,9660,10289,1400-9-15,2021-12-06
154,غويتا,ويتانا,900,5058697,31402424127,6431,6151,6185,-246,-3.83,6208,-223,-3.47,6130,6330,1400-9-15,2021-12-06
155,آ س پ,آ.س.پ,867,5845915,36304834657,5947,6150,6230,283,4.76,6210,263,4.42,6030,6244,1400-9-15,2021-12-06
156,بجهرم,توسعه مولد نيروگاهي جهرم,857,10449160,20074551469,1928,1930,1898,-30,-1.56,1921,-7,-0.36,1890,1966,1400-9-15,2021-12-06
157,فروي,ذوب روي اصفهان,855,1334989,25162243469,18929,19488,18600,-329,-1.74,18848,-81,-0.43,18401,19488,1400-9-15,2021-12-06
158,فرآور,فرآوري‌موادمعدني‌ايران‌,855,1606763,52024210210,32020,32610,31810,-210,-0.66,32380,360,1.12,31600,33230,1400-9-15,2021-12-06
159,فلوله,لوله‌وماشين‌سازي‌ايران‌,855,30197659,30623856349,974,981,1000,26,2.67,1014,40,4.11,975,1022,1400-9-15,2021-12-06
160,شسپا,نفت سپاهان,854,14130538,48811983611,3383,3420,3429,46,1.36,3428,45,1.33,3420,3489,1400-9-15,2021-12-06
161,حريل,ريل پردازسير,845,14330661,36679534241,2560,2599,2520,-40,-1.56,2560,0,0,2500,2650,1400-9-15,2021-12-06
162,سكه0012پ01,تمام سكه طرح جديد0012رفاه,835,256100,343752292600,1316932,1328000,1347900,30968,2.35,1342258,25326,1.92,1321000,1357900,1400-9-15,2021-12-06
163,فكمند,گسترش قطعه سازي كمند,834,1244609,48719568785,39018,40188,37848,-1170,-3,39144,126,0.32,37848,40188,1400-9-15,2021-12-06
164,دسانكو,داروسازي سبحان انكولوژي,831,4784016,58321591660,12779,12141,12141,-638,-4.99,12191,-588,-4.6,12141,12555,1400-9-15,2021-12-06
165,وخاور,بانك خاورميانه,830,13581755,69070763480,5170,5210,5200,30,0.58,5090,-80,-1.55,4980,5280,1400-9-15,2021-12-06
166,وصنعت,سرمايه گذاري توسعه صنعت وتجارت,816,8187194,56373001390,6840,6800,6930,90,1.32,6890,50,0.73,6510,7100,1400-9-15,2021-12-06
167,حفاري,حفاري شمال,815,8664838,33975859997,3911,3900,3910,-1,-0.03,3921,10,0.26,3860,3988,1400-9-15,2021-12-06
168,سنيرح,ح . سيمان‌ سفيدني‌ريز,813,1026370,26184919250,24850,26170,24790,-60,-0.24,25510,660,2.66,24200,26730,1400-9-15,2021-12-06
169,زكوثر,سرمايه گذاري كشاورزي كوثر,811,1440942,21591025230,14900,15530,14630,-270,-1.81,14980,80,0.54,14530,15530,1400-9-15,2021-12-06
170,واحيا,م .صنايع و معادن احياء سپاهان,811,3405815,444752092402,130084,132500,133986,3902,3,130586,502,0.39,129210,133986,1400-9-15,2021-12-06
171,خاذين,سايپاآذين‌,808,10292691,29330754103,2815,2740,2775,-40,-1.42,2850,35,1.24,2740,2947,1400-9-15,2021-12-06
172,ولغدر,ليزينگ‌خودروغدير,806,5478439,51027901080,8880,9320,9320,440,4.95,9310,430,4.84,9210,9320,1400-9-15,2021-12-06
173,فوكا,فولاد كاويان,805,6381097,93393415877,15084,14745,14640,-444,-2.94,14636,-448,-2.97,14632,14990,1400-9-15,2021-12-06
174,كاذر,فرآورده‌هاي‌نسوزآذر,804,5189598,77207017890,14440,15140,15000,560,3.88,14880,440,3.05,14450,15140,1400-9-15,2021-12-06
175,پيزد,مجتمع صنايع لاستيك يزد,792,402513,21786530331,56748,54086,53911,-2837,-5,54126,-2622,-4.62,53911,55290,1400-9-15,2021-12-06
176,تسه0007,امتيازتسهيلات مسكن مهر1400,791,20855,17808471614,831026,835858,872577,41551,5,853919,22893,2.75,835858,872577,1400-9-15,2021-12-06
177,ماديرا,صنايع ماديران,790,4465426,24921415749,5643,5700,5500,-143,-2.53,5581,-62,-1.1,5472,5720,1400-9-15,2021-12-06
178,كنور,توسعه معدني و صنعتي صبانور,781,2368790,44685159310,18290,18070,18700,410,2.24,18560,270,1.48,18070,18990,1400-9-15,2021-12-06
179,ومعادن,توسعه‌معادن‌وفلزات‌,776,4382384,40849580980,9330,9260,9310,-20,-0.21,9330,0,0,9240,9480,1400-9-15,2021-12-06
180,سبزوا,سيمان لار سبزوار,775,9371699,19351514553,2101,2065,2035,-66,-3.14,2065,-36,-1.71,2029,2136,1400-9-15,2021-12-06
181,فخوز,فولاد  خوزستان,772,3612641,22886507290,6370,6400,6350,-20,-0.31,6360,-10,-0.16,6220,6470,1400-9-15,2021-12-06
182,شبريز,پالايش نفت تبريز,761,1100221,33820230860,30590,31490,30650,60,0.2,30640,50,0.16,30550,31490,1400-9-15,2021-12-06
183,سبهان,سيمان‌ بهبهان‌,757,766566,35039905060,47670,46550,45290,-2380,-4.99,45710,-1960,-4.11,45290,48350,1400-9-15,2021-12-06
184,وساپا,سرمايه‌گذاري‌ سايپا,754,6248065,26928693340,4272,4193,4226,-46,-1.08,4310,38,0.89,4193,4400,1400-9-15,2021-12-06
185,خموتورح,ح . موتورسازان‌تراكتورسازي‌,753,9987200,36195609608,3947,3875,3553,-394,-9.98,3624,-323,-8.18,3553,3875,1400-9-15,2021-12-06
186,وهنر,گروه توسعه هنر ايران,751,10297352,28301168722,2678,2645,2758,80,2.99,2748,70,2.61,2645,2758,1400-9-15,2021-12-06
187,گكوثر,هتل پارسيان كوثر اصفهان,739,16123158,30851673010,1930,1926,1900,-30,-1.55,1914,-16,-0.83,1850,1969,1400-9-15,2021-12-06
188,وصنا,گروه‌صنايع‌بهشهرايران‌,734,6018400,31567579780,5470,5280,5280,-190,-3.47,5250,-220,-4.02,5200,5400,1400-9-15,2021-12-06
189,شپترو,پتروشيمي آبادان,730,8654803,26581326735,3089,3042,3021,-68,-2.2,3071,-18,-0.58,3020,3129,1400-9-15,2021-12-06
190,كبافق,معادن‌ بافق‌,727,924902,26525233050,29540,28080,28530,-1010,-3.42,28680,-860,-2.91,28070,29750,1400-9-15,2021-12-06
191,سفارس,سيمان فارس و خوزستان,724,2523026,38916880950,15460,15840,15290,-170,-1.1,15420,-40,-0.26,15080,15840,1400-9-15,2021-12-06
192,ملت,بيمه ملت,721,27765589,32659726071,1184,1180,1179,-5,-0.42,1176,-8,-0.68,1160,1212,1400-9-15,2021-12-06
193,كچاد,معدني‌وصنعتي‌چادرملو,721,1118202,30341459360,26990,27390,26850,-140,-0.52,27030,40,0.15,26730,27400,1400-9-15,2021-12-06
194,شكلر,نيروكلر,721,1677637,60246923790,37540,36300,36150,-1390,-3.7,35910,-1630,-4.34,35670,38000,1400-9-15,2021-12-06
195,بشهاب,لامپ‌  پارس‌ شهاب‌,721,309292,41846615850,133760,134490,135360,1600,1.2,135300,1540,1.15,129550,139570,1400-9-15,2021-12-06
196,ثتران,سرمايه گذاري مسكن تهران,720,5680098,18786813104,3393,3450,3274,-119,-3.51,3307,-86,-2.53,3224,3450,1400-9-15,2021-12-06
197,وگستر,گسترش سرمايه گذاري ايرانيان,710,3788456,19980023747,5356,5260,5319,-37,-0.69,5274,-82,-1.53,5089,5471,1400-9-15,2021-12-06
198,وثنو,سرمايه گذاري ساختماني نوين,710,12618647,53775396683,4388,4310,4257,-131,-2.99,4262,-126,-2.87,4257,4450,1400-9-15,2021-12-06
199,ثفارس,عمران‌وتوسعه‌فارس‌,705,3628857,25490122660,6850,6900,7000,150,2.19,7020,170,2.48,6860,7160,1400-9-15,2021-12-06
200,ونوين,بانك‌اقتصادنوين‌,704,12524111,38927242086,3079,3016,3094,15,0.49,3108,29,0.94,3016,3150,1400-9-15,2021-12-06
201,هماي,صندوق س هماي آگاه-ثابت,697,6968515,70300399984,10082,10084,10089,7,0.07,10088,6,0.06,10084,10089,1400-9-15,2021-12-06
202,كلر,كلر پارس,691,269300,28950641266,105743,107700,107500,1757,1.66,107503,1760,1.66,106043,109145,1400-9-15,2021-12-06
203,رتكو,كنترل‌خوردگي‌تكين‌كو,688,3066932,23254913510,7760,7380,7500,-260,-3.35,7580,-180,-2.32,7380,7940,1400-9-15,2021-12-06
204,ثاخت,بين‌المللي‌توسعه‌ساختمان,680,11703197,20974533733,1779,1800,1779,0,0,1792,13,0.73,1760,1818,1400-9-15,2021-12-06
205,ثنوسا,نوسازي‌وساختمان‌تهران‌,680,5377007,24800881500,4680,4680,4500,-180,-3.85,4610,-70,-1.5,4500,4740,1400-9-15,2021-12-06
206,ضجار1023,اختيارخ وتجارت-2500-1400/10/15,677,33130,442323000,16,15,12,-4,-25,13,-3,-18.75,12,17,1400-9-15,2021-12-06
207,شاوان,پالايش نفت لاوان,676,346485,46106057084,131663,133500,130600,-1063,-0.81,132727,1064,0.81,130000,134649,1400-9-15,2021-12-06
208,ثمسكن,سرمايه‌گذاري‌ مسكن‌,674,15715493,57119153206,3470,3620,3640,170,4.9,3635,165,4.76,3540,3643,1400-9-15,2021-12-06
209,وسكرمان,س.سهام عدالت استان كرمان,673,41056387,17589357610,426,437,429,3,0.7,427,1,0.23,420,437,1400-9-15,2021-12-06
210,وساغربي,شركت س استان آذربايجان غربي,669,42686251,18194685627,424,423,429,5,1.18,426,2,0.47,421,432,1400-9-15,2021-12-06
211,سپاها,سيمان‌سپاهان‌,667,3555764,24803230080,6850,6940,6900,50,0.73,6980,130,1.9,6880,7120,1400-9-15,2021-12-06
212,سصفها,سيمان‌اصفهان‌,650,1208175,36171085400,28800,28810,29510,710,2.47,29940,1140,3.96,28810,30240,1400-9-15,2021-12-06
213,وبانك,سرمايه گذاري گروه توسعه ملي,643,5506069,44659780340,8020,8000,8100,80,1,8070,50,0.62,7990,8200,1400-9-15,2021-12-06
214,كوير,توليدي فولاد سپيد فراب كوير,633,3588804,21497970790,5980,5990,6050,70,1.17,5980,0,0,5950,6080,1400-9-15,2021-12-06
215,زقيام,كشت و دام قيام اصفهان,629,15631498,20595136431,1261,1240,1324,63,5,1318,57,4.52,1240,1324,1400-9-15,2021-12-06
216,عيار,صندوق سكه طلاي مفيد,629,2405997,81564331969,33426,34045,34201,775,2.32,33900,474,1.42,33550,34280,1400-9-15,2021-12-06
217,تاپيكو,س. نفت و گاز و پتروشيمي تأمين,629,3317033,45627244980,13820,13970,13610,-210,-1.52,13800,-20,-0.14,13600,14000,1400-9-15,2021-12-06
218,بكامح,ح.كارخانجات توليدي شهيد قندي,618,11544561,7300249583,653,630,628,-25,-3.83,632,-21,-3.22,612,654,1400-9-15,2021-12-06
219,تاپكيش,تجارت الكترونيك پارسيان كيش,613,2829537,47260113799,16188,16268,16669,481,2.97,16702,514,3.18,16268,16889,1400-9-15,2021-12-06
220,بنو,بيمه تجارت نو,607,5581436,35501014568,6551,6357,6401,-150,-2.29,6361,-190,-2.9,6224,6545,1400-9-15,2021-12-06
221,وفتخار,سرمايه گذاري افتخار سهام,607,2899821,5687144611,2064,1961,1961,-103,-4.99,1979,-85,-4.12,1961,2020,1400-9-15,2021-12-06
222,شفارس,صنايع‌ شيميايي‌ فارس‌,605,15174094,16427543431,1084,1110,1073,-11,-1.01,1083,-1,-0.09,1071,1110,1400-9-15,2021-12-06
223,سشرق,سيمان‌ شرق‌,603,3710105,23547698340,6400,6500,6180,-220,-3.44,6350,-50,-0.78,6110,6580,1400-9-15,2021-12-06
224,خريخت,صنايع‌ريخته‌گري‌ايران‌,601,9196146,28494102828,3142,3027,3149,7,0.22,3098,-44,-1.4,3010,3160,1400-9-15,2021-12-06
225,چكاوه,صنايع‌كاغذسازي‌كاوه‌,599,3144280,25359650740,7820,7750,7950,130,1.66,8070,250,3.2,7750,8210,1400-9-15,2021-12-06
226,شبصير,توليدات پتروشيمي قائد بصير,599,515866,58229341303,110885,114000,113700,2815,2.54,112877,1992,1.8,110010,114000,1400-9-15,2021-12-06
227,فجر,فولاد اميركبيركاشان,598,1574712,37231055650,23590,23500,23600,10,0.04,23640,50,0.21,23500,23990,1400-9-15,2021-12-06
228,غپاك,لبنيات‌ پاك‌,597,1813074,24776237360,14180,13730,13480,-700,-4.94,13670,-510,-3.6,13480,14180,1400-9-15,2021-12-06
229,پارس,پتروشيمي پارس,581,283798,53854173810,189640,191370,187000,-2640,-1.39,189710,70,0.04,186500,192450,1400-9-15,2021-12-06
230,ومهان,گروه توسعه مالي مهر آيندگان,574,5076527,21869892856,4363,4260,4337,-26,-0.6,4340,-23,-0.53,4250,4400,1400-9-15,2021-12-06
231,تسه9810,امتياز تسهيلات مسكن دي98,556,13147,11162140890,827831,830222,850001,22170,2.68,849026,21195,2.56,830010,863999,1400-9-15,2021-12-06
232,كفپارس,فرآورده‌هاي‌ نسوز پارس‌,556,5541114,16419347181,2906,2981,2929,23,0.79,2963,57,1.96,2883,3030,1400-9-15,2021-12-06
233,ولملتح,ح . واسپاري ملت,554,2400956,5243465039,2279,2409,2119,-160,-7.02,2184,-95,-4.17,2102,2409,1400-9-15,2021-12-06
234,بكام,كارخانجات توليدي شهيد قندي,553,7421825,12069678850,1632,1630,1632,0,0,1627,-5,-0.31,1610,1642,1400-9-15,2021-12-06
235,وسكرشا,س.سهام عدالت استان كرمانشاه,540,29749539,12754871506,425,424,431,6,1.41,428,3,0.71,423,443,1400-9-15,2021-12-06
236,لابسا,آبسال‌,538,701351,24152908880,35610,34200,34200,-1410,-3.96,34440,-1170,-3.29,33880,35500,1400-9-15,2021-12-06
237,فاسمين,كالسيمين‌,538,2400452,37847115430,15740,15940,15610,-130,-0.83,15770,30,0.19,15600,15980,1400-9-15,2021-12-06
238,رانفور,خدمات‌انفورماتيك‌,538,5246340,18402571166,3569,3550,3490,-79,-2.21,3547,-22,-0.62,3471,3582,1400-9-15,2021-12-06
239,بپاس,بيمه پاسارگاد,537,3780798,160604246650,42480,42480,42490,10,0.02,42479,-1,0,40530,42500,1400-9-15,2021-12-06
240,مارون,پتروشيمي مارون,534,54132,9198908457,176066,172598,169185,-6881,-3.91,175480,-586,-0.33,167263,172967,1400-9-15,2021-12-06
241,ثاژن,سخت آژند,532,5375473,25928220766,4856,4759,4920,64,1.32,4823,-33,-0.68,4759,4953,1400-9-15,2021-12-06
242,غسالم,سالمين‌,530,7087678,20341571967,2854,2888,2820,-34,-1.19,2870,16,0.56,2802,2960,1400-9-15,2021-12-06
243,ثالوند,سرمايه گذاري مسكن الوند,523,1932321,13504115408,7282,6918,6918,-364,-5,6989,-293,-4.02,6918,7260,1400-9-15,2021-12-06
244,كفرا,فراورده‌ هاي‌ نسوزايران‌,520,1153459,18282730130,16450,16060,15640,-810,-4.92,15850,-600,-3.65,15630,16430,1400-9-15,2021-12-06
245,كرماشا,صنايع پتروشيمي كرمانشاه,519,1861476,98465789130,52540,53410,52550,10,0.02,52900,360,0.69,52550,53930,1400-9-15,2021-12-06
246,حفارس,حمل و نقل بين المللي خليج فارس,518,6758109,24008760499,3483,3598,3580,97,2.78,3553,70,2.01,3364,3624,1400-9-15,2021-12-06
247,رتاپ,تجارت الكترونيك  پارسيان,517,2677884,16278648290,6380,6130,6070,-310,-4.86,6080,-300,-4.7,6070,6200,1400-9-15,2021-12-06
248,آسيا,بيمه آسيا,513,10796510,18220003067,1703,1701,1672,-31,-1.82,1688,-15,-0.88,1664,1742,1400-9-15,2021-12-06
249,هرمز,فولاد هرمزگان جنوب,511,1140410,18365594074,16201,16200,15935,-266,-1.64,16186,-15,-0.09,15930,16470,1400-9-15,2021-12-06
250,شجم,صنايع پتروشيمي تخت جمشيد,506,5289239,66898992797,12885,12530,12648,-237,-1.84,12648,-237,-1.84,12241,12885,1400-9-15,2021-12-06
251,تسه0004,امتيازتسهيلات مسكن تير1400,505,16368,14045369428,835658,835122,865000,29342,3.51,858099,22441,2.69,835122,865000,1400-9-15,2021-12-06
252,غشهداب,كشت و صنعت شهداب ناب خراسان,505,7603562,19226517179,2526,2480,2540,14,0.55,2529,3,0.12,2480,2554,1400-9-15,2021-12-06
253,شنفت,نفت‌ پارس‌,503,3228893,32439864330,9960,10000,10100,140,1.41,10000,40,0.4,9710,10110,1400-9-15,2021-12-06
254,ضجار1022,اختيارخ وتجارت-2000-1400/10/15,502,14290,1638076000,115,111,106,-9,-7.83,115,0,0,106,121,1400-9-15,2021-12-06
255,ولشرق,ليزينگ ايران و شرق,501,5314776,13029611818,2504,2411,2380,-124,-4.95,2455,-49,-1.96,2379,2530,1400-9-15,2021-12-06
256,شفا,سرمايه گذاري شفادارو,499,1767272,30799586300,18250,18100,17340,-910,-4.99,17430,-820,-4.49,17340,18100,1400-9-15,2021-12-06
257,لبوتان,گروه‌صنعتي‌بوتان‌,496,606582,25392012830,42430,42420,40500,-1930,-4.55,41860,-570,-1.34,40330,43600,1400-9-15,2021-12-06
258,ساوه,سيمان ساوه,491,114898,5072585249,43923,45004,44001,78,0.18,43998,75,0.17,43000,45004,1400-9-15,2021-12-06
259,ونيرو,سرمايه‌گذاري‌نيرو,485,5600506,11352739308,2002,2077,1983,-19,-0.95,2021,19,0.95,1982,2077,1400-9-15,2021-12-06
260,خرينگ,رينگ‌سازي‌مشهد,484,783115,20634405950,25980,25160,26000,20,0.08,26350,370,1.42,25160,26850,1400-9-15,2021-12-06
261,غالبر,لبنيات‌ كالبر,484,1630592,19208843700,12340,12400,11730,-610,-4.94,11780,-560,-4.54,11730,12400,1400-9-15,2021-12-06
262,غمينو,شركت صنايع غذايي مينو شرق,483,3754696,17387546984,4661,4655,4670,9,0.19,4631,-30,-0.64,4510,4770,1400-9-15,2021-12-06
263,آريان,سرمايه گذاري پارس آريان,479,5232709,78340618139,15251,14850,14794,-457,-3,15023,-228,-1.49,14794,15500,1400-9-15,2021-12-06
264,پاكشو,گروه صنعتي پاكشو,476,18394853,111085833520,6030,6060,6040,10,0.17,6040,10,0.17,6030,6090,1400-9-15,2021-12-06
265,تسه0005,امتيازتسهيلات مسكن مرداد 1400,474,9155,7807748065,816108,840000,856913,40805,5,852840,36732,4.5,840000,856913,1400-9-15,2021-12-06
266,كيميا,معدني كيمياي زنجان گستران,469,1333811,16253088667,11973,12003,12074,101,0.84,12185,212,1.77,12003,12409,1400-9-15,2021-12-06
267,چفيبر,فيبر ايران‌,468,3150477,19063030360,6000,6100,6110,110,1.83,6050,50,0.83,5900,6190,1400-9-15,2021-12-06
268,ثرود,سرمايه‌گذاري مسكن زاينده رود,467,2800199,16621656457,6014,5781,5800,-214,-3.56,5936,-78,-1.3,5781,6105,1400-9-15,2021-12-06
269,حتايد,تايدواترخاورميانه,464,2378199,11009769909,4684,4598,4584,-100,-2.13,4641,-43,-0.92,4490,4742,1400-9-15,2021-12-06
270,ختراك,ريخته‌گري‌ تراكتورسازي‌ ايران‌,464,3242601,18690164690,5590,5560,5800,210,3.76,5760,170,3.04,5370,5860,1400-9-15,2021-12-06
271,حگردش,ريل گردش ايرانيان,464,5488210,23662516139,4192,4290,4317,125,2.98,4312,120,2.86,4265,4317,1400-9-15,2021-12-06
272,چكارن,كارتن‌ ايران‌,458,9356821,23720470902,2535,2550,2533,-2,-0.08,2535,0,0,2523,2581,1400-9-15,2021-12-06
273,توريل,توكاريل,456,2824413,24355756076,8296,8520,8710,414,4.99,8623,327,3.94,8185,8710,1400-9-15,2021-12-06
274,شيراز,پتروشيمي‌شيراز,456,659679,52934465090,79230,76300,79230,0,0,79760,530,0.67,76300,80900,1400-9-15,2021-12-06
275,قرن,پديده شيمي قرن,455,512550,11969922110,23150,23740,23410,260,1.12,23280,130,0.56,23000,23740,1400-9-15,2021-12-06
276,پتاير,ايران‌ تاير,454,8013501,15390403743,1917,1950,1933,16,0.83,1921,4,0.21,1900,1967,1400-9-15,2021-12-06
277,افرا,افرانت,454,1446566,23620137123,15563,15500,16051,488,3.14,16328,765,4.92,15500,16341,1400-9-15,2021-12-06
278,ولملت,واسپاري ملت,452,9028165,37169189454,4298,4290,4084,-214,-4.98,4117,-181,-4.21,4084,4300,1400-9-15,2021-12-06
279,حتوكا,حمل‌ونقل‌توكا,448,1417444,16597552790,12040,11710,11520,-520,-4.32,11710,-330,-2.74,11440,12280,1400-9-15,2021-12-06
280,فزرين,زرين معدن آسيا,448,1466856,16824439008,11344,11699,11342,-2,-0.02,11470,126,1.11,11210,11699,1400-9-15,2021-12-06
281,والبر,سرمايه‌ گذاري‌ البرز(هلدينگ‌,447,2953375,23070045160,7830,7600,7920,90,1.15,7810,-20,-0.26,7560,7960,1400-9-15,2021-12-06
282,ثپرديس,سرمايه گذاري مسكن پرديس,447,3911103,15522874950,4097,3922,3893,-204,-4.98,3969,-128,-3.12,3893,4200,1400-9-15,2021-12-06
283,تاصيكو,سرمايه گذاري صدرتامين,445,3286820,29204535690,8910,9100,8800,-110,-1.23,8900,-10,-0.11,8760,9100,1400-9-15,2021-12-06
284,تليسه,دامداري تليسه نمونه,444,5297815,10942012871,2092,2045,2047,-45,-2.15,2071,-21,-1,2040,2120,1400-9-15,2021-12-06
285,گوهر,صندوق سكه طلاي كيان,444,498923,33247580084,65038,65131,67500,2462,3.79,66639,1601,2.46,65131,67700,1400-9-15,2021-12-06
286,شفارا,پتروشيمي فارابي,444,2935203,21062578089,7064,7040,7171,107,1.51,7176,112,1.59,6860,7275,1400-9-15,2021-12-06
287,فولاي,صنايع فولاد آلياژي يزد,442,1273164,21817772980,17486,17485,16951,-535,-3.06,17137,-349,-2,16901,17500,1400-9-15,2021-12-06
288,قنيشا,قند  نيشابور,441,743430,29847962940,40110,40000,39600,-510,-1.27,40150,40,0.1,39000,41000,1400-9-15,2021-12-06
289,دامين,داروسازي‌ امين‌,440,5382048,13012190347,2525,2580,2399,-126,-4.99,2422,-103,-4.08,2399,2580,1400-9-15,2021-12-06
290,مبين,مبين انرژي خليج فارس,439,2999629,74270521680,24130,24890,24300,170,0.7,24510,380,1.57,24130,25200,1400-9-15,2021-12-06
291,سصوفي,سيمان‌ صوفيان‌,438,1056396,15128674280,14150,14360,14300,150,1.06,14320,170,1.2,14010,14700,1400-9-15,2021-12-06
292,دتوزيع,توزيع دارو پخش,437,672449,18254302005,27497,27210,26861,-636,-2.31,27146,-351,-1.28,26700,27799,1400-9-15,2021-12-06
293,دزهراوي,داروسازي‌زهراوي‌,434,2476709,11489882550,4727,4662,4530,-197,-4.17,4656,-71,-1.5,4520,4724,1400-9-15,2021-12-06
294,غگلپا,شير پاستوريزه پگاه گلپايگان,432,447053,23631284903,55301,53999,52536,-2765,-5,52860,-2441,-4.41,52536,56000,1400-9-15,2021-12-06
295,دتوليد,داروسازي توليد دارو,431,1475688,12153627336,8362,8210,8130,-232,-2.77,8251,-111,-1.33,8106,8449,1400-9-15,2021-12-06
296,ونيكي,سرمايه‌گذاري‌ ملي‌ايران‌,425,1971499,18603894180,9680,9420,9400,-280,-2.89,9610,-70,-0.72,9400,9540,1400-9-15,2021-12-06
297,ورنا,سرمايه‌گذاري‌ رنا(هلدينگ‌,424,5142544,15522344630,3022,3032,3030,8,0.26,3018,-4,-0.13,2932,3100,1400-9-15,2021-12-06
298,كپشير,پشم‌شيشه‌ايران‌,424,1134045,13911498510,11950,11840,12190,240,2.01,12240,290,2.43,11810,12530,1400-9-15,2021-12-06
299,تسه0003,امتيازتسهيلات مسكن خرداد1400,421,11200,9624734618,834208,860000,870000,35792,4.29,859351,25143,3.01,834522,870000,1400-9-15,2021-12-06
300,شدوصح,ح . دوده‌ صنعتي‌ پارس‌,419,2036468,15029235820,7320,7500,7300,-20,-0.27,7380,60,0.82,7250,7600,1400-9-15,2021-12-06
301,لسرما,سرما آفرين‌,417,1038075,20780433260,19750,20700,20650,900,4.56,20020,270,1.37,19700,20700,1400-9-15,2021-12-06
302,ستران,سيمان‌ تهران‌,416,658261,13472250020,20530,20650,20020,-510,-2.48,20480,-50,-0.24,19820,20980,1400-9-15,2021-12-06
303,تيپيكو,سرمايه گذاري دارويي تامين,415,3010959,59047766610,20640,19610,19610,-1030,-4.99,19940,-700,-3.39,19610,19950,1400-9-15,2021-12-06
304,خراسان,پتروشيمي خراسان,414,170825,19319991870,113590,115500,113990,400,0.35,113470,-120,-0.11,111300,115500,1400-9-15,2021-12-06
305,بالبر,كابل‌ البرز,411,531672,10633025810,20170,20110,19710,-460,-2.28,20040,-130,-0.64,19460,20800,1400-9-15,2021-12-06
306,فايرا,آلومينيوم‌ايران‌,409,821983,12808227990,15390,15900,15400,10,0.06,15430,40,0.26,15330,15900,1400-9-15,2021-12-06
307,ولقمان,سرمايه گذاري لقمان,409,1806651,5759147509,3104,3190,3197,93,3,3152,48,1.55,3150,3197,1400-9-15,2021-12-06
308,كساوه,صنايع‌ كاشي‌ و سراميك‌ سينا,407,909676,36243228360,40220,39790,39790,-430,-1.07,39840,-380,-0.94,38500,41460,1400-9-15,2021-12-06
309,ودي,بيمه  دي,405,2965332,11315631243,3877,3950,3800,-77,-1.99,3827,-50,-1.29,3750,3950,1400-9-15,2021-12-06
310,فمراد,آلومراد,403,1177165,16970410490,14160,14450,14160,0,0,14420,260,1.84,14130,14790,1400-9-15,2021-12-06
311,چدن,توليدي چدن سازان,402,3476089,8670393841,2490,2545,2469,-21,-0.84,2493,3,0.12,2432,2546,1400-9-15,2021-12-06
312,فجام,جام‌دارو,401,2493410,9774329836,3818,3880,3960,142,3.72,3885,67,1.75,3820,4006,1400-9-15,2021-12-06
313,آساميد,صندوق س.مشترك آسمان اميد -د,400,13187186,178920945480,13563,13568,13568,5,0.04,13568,5,0.04,13566,13569,1400-9-15,2021-12-06
314,سمگا,گروه سرمايه گذاري ميراث فرهنگي,398,7703452,91732706416,12534,11908,11908,-626,-4.99,11908,-626,-4.99,11908,11908,1400-9-15,2021-12-06
315,همراه,شركت ارتباطات سيار ايران,397,1077330,8788660820,8330,8200,8170,-160,-1.92,8320,-10,-0.12,8120,8270,1400-9-15,2021-12-06
316,زشريف,كشت وصنعت شريف آباد,397,4545151,14959637575,3396,3314,3264,-132,-3.89,3291,-105,-3.09,3230,3388,1400-9-15,2021-12-06
317,خلنت,لنت‌ ترمزايران‌,396,238917,15551659120,66230,65000,65230,-1000,-1.51,65090,-1140,-1.72,63000,68000,1400-9-15,2021-12-06
318,وپست,پست بانك ايران,394,1225761,23259499700,19110,19480,19090,-20,-0.1,18980,-130,-0.68,18500,19480,1400-9-15,2021-12-06
319,شبهرن,نفت‌ بهران‌,392,1882168,20996203450,11140,11140,11170,30,0.27,11150,10,0.09,11030,11290,1400-9-15,2021-12-06
320,تپمپي,پمپ‌ سازي‌ ايران‌,390,1341724,24656563440,18020,18790,18280,260,1.44,18380,360,2,18000,18900,1400-9-15,2021-12-06
321,تسه9908,امتياز تسهيلات مسكن آبان99,388,8602,7330638380,830749,840010,860000,29251,3.52,852202,21453,2.58,832222,864900,1400-9-15,2021-12-06
322,وتوصا,گروه س توسعه صنعتي ايران,388,1864580,18300863580,9630,9780,9830,200,2.08,9820,190,1.97,9550,10000,1400-9-15,2021-12-06
323,غشوكو,شوكو پارس,387,1964607,16263894901,7933,8329,8282,349,4.4,8278,345,4.35,7990,8329,1400-9-15,2021-12-06
324,ياقوت,صندوق س ياقوت آگاه-ثابت,385,1957743,26878305747,13715,13721,13729,14,0.1,13729,14,0.1,13721,13738,1400-9-15,2021-12-06
325,وساخت,سرمايه‌ گذاري‌ ساختمان‌ايران‌,385,286638,10930665560,38150,38400,38010,-140,-0.37,38140,-10,-0.03,37500,38970,1400-9-15,2021-12-06
326,افق,فروشگاههاي زنجيره اي افق كوروش,383,485815,20457410440,42890,43190,41550,-1340,-3.12,42570,-320,-0.75,41500,43190,1400-9-15,2021-12-06
327,پكويرح,ح. كوير تاير,382,2584739,8990131100,3541,3470,3420,-121,-3.42,3478,-63,-1.78,3418,3550,1400-9-15,2021-12-06
328,ددام,داروسازي زاگرس فارمد پارس,378,1106813,10408116360,9330,9140,9330,0,0,9380,50,0.54,9110,9630,1400-9-15,2021-12-06
329,غشوكوح,ح . شوكو پارس,371,2189719,10848501512,4839,4984,4984,145,3,4954,115,2.38,4854,4984,1400-9-15,2021-12-06
330,كسرا,سراميك‌هاي‌صنعتي‌اردكان‌,371,1175373,17405625540,14800,14530,14580,-220,-1.49,14810,10,0.07,14530,15370,1400-9-15,2021-12-06
331,وبشهر,توسعه‌ صنايع‌ بهشهر(هلدينگ,370,2257360,16079779930,6930,6820,7250,320,4.62,7000,70,1.01,6790,7270,1400-9-15,2021-12-06
332,ماني,صندوق س. با درآمد ثابت ماني,368,15077573,159559933041,10578,10583,10583,5,0.05,10583,5,0.05,10582,10583,1400-9-15,2021-12-06
333,فلامي,لاميران‌,365,966886,18417013720,18760,18760,19100,340,1.81,19050,290,1.55,18010,19510,1400-9-15,2021-12-06
334,وسپه,سرمايه‌گذاري‌ سپه‌,364,1944281,15020708620,7730,7790,7650,-80,-1.03,7730,0,0,7630,7860,1400-9-15,2021-12-06
335,سفار,سيمان‌فارس‌,362,244383,14261586020,59780,60520,56800,-2980,-4.98,58410,-1370,-2.29,56800,61000,1400-9-15,2021-12-06
336,پلاسك,پلاسكوكار,362,2636271,10916436736,4281,4400,4093,-188,-4.39,4174,-107,-2.5,4067,4400,1400-9-15,2021-12-06
337,غفارس,شير پاستوريزه پگاه فارس,360,1174084,6690753559,5821,5601,5700,-121,-2.08,5764,-57,-0.98,5590,5843,1400-9-15,2021-12-06
338,زدشت,كشت و صنعت دشت خرم دره,358,1096289,13650365348,12553,12245,12349,-204,-1.63,12456,-97,-0.77,12245,12790,1400-9-15,2021-12-06
339,فنورد,نوردوقطعات‌ فولادي‌,358,70180,12250922700,177850,179500,173560,-4290,-2.41,175180,-2670,-1.5,172000,179500,1400-9-15,2021-12-06
340,دبالك,مواد اوليه دارويي البرز بالك,357,1392823,9707783492,6961,7020,6900,-61,-0.88,6967,6,0.09,6755,7190,1400-9-15,2021-12-06
341,ارفع,شركت آهن و فولاد ارفع,355,1467920,21513438598,14660,14998,14650,-10,-0.07,14659,-1,-0.01,14412,14998,1400-9-15,2021-12-06
342,وپاسار,بانك  پاسارگاد,355,7065517,90837526600,12850,12850,12890,40,0.31,12850,0,0,12850,12900,1400-9-15,2021-12-06
343,تيپيكوح,ح . سرمايه گذاري دارويي تامين,354,10451033,176335576600,17400,17400,16500,-900,-5.17,16870,-530,-3.05,16500,17400,1400-9-15,2021-12-06
344,وآذر,سرمايه‌گذاري‌توسعه‌آذربايجان‌,353,310847,11826806340,38290,37110,37510,-780,-2.04,38090,-200,-0.52,37110,39460,1400-9-15,2021-12-06
345,وشهر,بانك شهر,349,5516555,24776083411,4511,4520,4491,-20,-0.44,4493,-18,-0.4,4452,4620,1400-9-15,2021-12-06
346,ريشمك,توليد و صادرات ريشمك,346,1640950,55863947154,33520,33890,34000,480,1.43,34044,524,1.56,33520,34650,1400-9-15,2021-12-06
347,خپويش,سازه‌ پويش‌,344,130699,9607757400,73160,74410,73210,50,0.07,73380,220,0.3,71390,75390,1400-9-15,2021-12-06
348,شدوص,دوده‌ صنعتي‌ پارس‌,344,2229182,28524887210,12750,12410,12440,-310,-2.43,12800,50,0.39,12300,13250,1400-9-15,2021-12-06
349,حشكوه,دليجان طلايي شكوه پارس,344,12855822,48185816252,3641,3720,3750,109,2.99,3748,107,2.94,3642,3750,1400-9-15,2021-12-06
350,غچين,كشت‌ و صنعت‌ چين‌ چين,342,1366919,17037491470,12710,12600,12650,-60,-0.47,12460,-250,-1.97,12210,12900,1400-9-15,2021-12-06
351,تكنو,تكنوتار,342,2983296,22964956660,8090,7690,7690,-400,-4.94,7700,-390,-4.82,7690,8160,1400-9-15,2021-12-06
352,كساپا,سايپاشيشه‌,341,745454,13411186910,17720,17310,17930,210,1.19,17980,260,1.47,17310,18500,1400-9-15,2021-12-06
353,بفجر,فجر انرژي خليج فارس,341,1455894,16372723570,11190,11520,11000,-190,-1.7,11200,10,0.09,10830,11520,1400-9-15,2021-12-06
354,فنوال,نورد آلومينيوم‌,340,1615287,30188069070,17910,18400,18800,890,4.97,18690,780,4.36,18000,18800,1400-9-15,2021-12-06
355,دلر,داروسازي‌ اكسير,339,450304,19382791440,41950,41800,43160,1210,2.88,43040,1090,2.6,41800,43400,1400-9-15,2021-12-06
356,وتوسم,سرمايه‌گذاري‌توسعه‌ملي‌,339,2499215,20818456150,8270,8400,8310,40,0.48,8330,60,0.73,8300,8410,1400-9-15,2021-12-06
357,تسه0002,امتيازتسهيلاتمسكن ارديبهشت1400,336,5842,5017120417,836551,867000,865001,28450,3.4,858802,22251,2.66,830022,867000,1400-9-15,2021-12-06
358,قاسم,قاسم ايران,335,4849539,16243257903,3365,3409,3375,10,0.3,3349,-16,-0.48,3301,3410,1400-9-15,2021-12-06
359,كروي,توسعه‌ معادن‌ روي‌ ايران‌,334,806765,18472007370,22480,22400,22480,0,0,22830,350,1.56,22150,23100,1400-9-15,2021-12-06
360,ثاباد,توريستي ورفاهي آبادگران ايران,334,635125,30321338880,47260,47350,46460,-800,-1.69,47740,480,1.02,45920,48980,1400-9-15,2021-12-06
361,رمپنا,گروه مپنا (سهامي عام),334,2044176,31138123600,15110,15430,15100,-10,-0.07,15140,30,0.2,15000,15550,1400-9-15,2021-12-06
362,خشرق,الكتريك‌ خودرو شرق‌,333,1476025,18030047730,12060,12280,12250,190,1.58,12220,160,1.33,11820,12490,1400-9-15,2021-12-06
363,دكوثر,داروسازي‌ كوثر,333,7333497,19795666436,2795,2707,2656,-139,-4.97,2699,-96,-3.43,2656,2848,1400-9-15,2021-12-06
364,زماهان,مجتمع توليد گوشت مرغ ماهان,326,1814206,11512940310,6379,6210,6258,-121,-1.9,6352,-27,-0.42,6210,6500,1400-9-15,2021-12-06
365,تكشا,گسترش‌صنايع‌وخدمات‌كشاورزي‌,324,561595,18801964780,35010,35000,33890,-1120,-3.2,33480,-1530,-4.37,33260,35700,1400-9-15,2021-12-06
366,دانا,بيمه دانا,324,2617454,11824229891,4528,4528,4477,-51,-1.13,4520,-8,-0.18,4473,4559,1400-9-15,2021-12-06
367,بالاس,مهندسي ساختمان تاسيسات راه آهن,323,384858,10907845279,27306,26501,28671,1365,5,28099,793,2.9,26501,28671,1400-9-15,2021-12-06
368,فافق,صنايع مس افق كرمان,323,5183605,17931658996,3377,3350,3478,101,2.99,3459,82,2.43,3309,3478,1400-9-15,2021-12-06
369,بهپاك,صنعتي بهپاك,320,2513547,13409475421,5411,5260,5280,-131,-2.42,5345,-66,-1.22,5248,5546,1400-9-15,2021-12-06
370,تبرك,گروه كارخانجات صنعتي تبرك,320,1562930,12516079459,8021,8100,8001,-20,-0.25,8010,-11,-0.14,7862,8140,1400-9-15,2021-12-06
371,غشصفا,شيرپاستوريزه‌پگاه‌اصفهان‌,320,1007892,29649797980,30680,30090,29150,-1530,-4.99,29420,-1260,-4.11,29150,31500,1400-9-15,2021-12-06
372,غصينو,صنعتي مينو,316,1293165,28553760719,23218,22960,22058,-1160,-5,22850,-368,-1.58,22058,22960,1400-9-15,2021-12-06
373,خكاوه,سايپا ديزل,315,3567702,12063326475,3413,3440,3321,-92,-2.7,3381,-32,-0.94,3321,3489,1400-9-15,2021-12-06
374,شكربن,كربن‌ ايران‌,315,150973,13909993480,90420,89700,91200,780,0.86,92090,1670,1.85,89500,93910,1400-9-15,2021-12-06
375,كترام,توليدي‌ كاشي‌ تكسرام‌,314,586737,11512464270,19730,19200,19620,-110,-0.56,19650,-80,-0.41,19130,20180,1400-9-15,2021-12-06
376,سپيدما,صندوق س. سپيد دماوند-د,313,15257839,175145359818,11474,11480,11479,5,0.04,11479,5,0.04,11479,11480,1400-9-15,2021-12-06
377,سخاش,سيمان‌خاش‌,311,131173,11458713600,86630,88170,85610,-1020,-1.18,87170,540,0.62,85000,90170,1400-9-15,2021-12-06
378,خكرمان,گروه اقتصادي كرمان خودرو,310,3594498,10090517862,2773,2773,2778,5,0.18,2807,34,1.23,2772,2856,1400-9-15,2021-12-06
379,غناب,روغن‌ نباتي‌ ناب,310,253618,27767873966,106299,109487,109487,3188,3,109487,3188,3,109487,109487,1400-9-15,2021-12-06
380,فروس,فروسيليس‌ ايران‌,309,1756841,11083567560,6320,6200,6350,30,0.47,6310,-10,-0.16,6150,6550,1400-9-15,2021-12-06
381,كقزوي,شيشه‌ قزوين‌,307,4569243,37918357508,8077,8299,8319,242,3,8299,222,2.75,8085,8319,1400-9-15,2021-12-06
382,خاهن,آهنگري‌ تراكتورسازي‌ ايران‌,307,4867150,25098020620,5160,5170,5150,-10,-0.19,5160,0,0,5140,5200,1400-9-15,2021-12-06
383,پارسان,گسترش نفت و گاز پارسيان,306,608943,18946855960,31080,31250,31000,-80,-0.26,31090,10,0.03,30810,31500,1400-9-15,2021-12-06
384,زيتون,صندوق س زيتون نماد پايا- مختلط,305,831888,7870173666,9479,9540,9400,-79,-0.83,9461,-18,-0.19,9351,9540,1400-9-15,2021-12-06
385,وملل,اعتباري ملل,304,2065197,17525702184,8478,8205,8517,39,0.46,8482,4,0.05,8205,8599,1400-9-15,2021-12-06
386,كسرام,پارس‌ سرام‌,304,3869483,15237888151,3971,3830,3985,14,0.35,3938,-33,-0.83,3825,4110,1400-9-15,2021-12-06
387,وبيمه,سرمايه‌ گذاري‌ صنعت‌ بيمه‌,302,6225777,8714856530,1408,1370,1408,0,0,1403,-5,-0.36,1365,1450,1400-9-15,2021-12-06
388,داسوه,داروسازي‌ اسوه‌,300,641127,16265352130,24390,24400,25600,1210,4.96,25370,980,4.02,24400,25600,1400-9-15,2021-12-06
389,تسه9912,امتياز تسهيلات مسكن اسفند99,300,4683,4014231390,833544,834000,852300,18756,2.25,857192,23648,2.84,834000,875000,1400-9-15,2021-12-06
390,ساروم,سيمان‌اروميه‌,299,649133,26761387600,40900,40400,41660,760,1.86,41230,330,0.81,39550,41660,1400-9-15,2021-12-06
391,تسه0001,امتيازتسهيلات مسكن فروردين1400,299,4711,4032968614,839814,840000,862000,22186,2.64,856075,16261,1.94,834000,868900,1400-9-15,2021-12-06
392,كهمدا,شيشه‌ همدان‌,299,1579122,14226241540,9030,9030,8960,-70,-0.78,9010,-20,-0.22,8950,9150,1400-9-15,2021-12-06
393,وسين,بيمه سينا,298,5725318,20796881749,3703,3600,3718,15,0.41,3632,-71,-1.92,3592,3750,1400-9-15,2021-12-06
394,بكهنوج,توليد برق ماهتاب كهنوج,298,7927743,8754878241,1118,1099,1100,-18,-1.61,1110,-8,-0.72,1089,1135,1400-9-15,2021-12-06
395,غديس,پاكديس,298,995044,10289268469,10123,10300,10180,57,0.56,10271,148,1.46,10150,10530,1400-9-15,2021-12-06
396,غگلستا,شير پاستوريزه پگاه گلستان,295,1108115,11495826903,10397,10800,10330,-67,-0.64,10378,-19,-0.18,10130,10800,1400-9-15,2021-12-06
397,وآوا,سرمايه گذاري آوا نوين,293,1904726,5051887799,2642,2600,2613,-29,-1.1,2646,4,0.15,2600,2698,1400-9-15,2021-12-06
398,اتكاي,بيمه اتكايي ايرانيان,292,2304380,24736809378,10765,11075,10605,-160,-1.49,10735,-30,-0.28,10505,11076,1400-9-15,2021-12-06
399,شپارس,بين‌ المللي‌ محصولات‌  پارس‌,291,1858654,13578532770,7290,7450,7340,50,0.69,7300,10,0.14,7110,7550,1400-9-15,2021-12-06
400,ونفت,سرمايه‌گذاري‌ صنعت‌ نفت‌,289,1324245,18289829270,14080,14100,13550,-530,-3.76,13810,-270,-1.92,13490,14100,1400-9-15,2021-12-06
401,جم,پتروشيمي جم,285,892207,43667717720,48410,47500,48490,80,0.17,48640,230,0.48,47500,49500,1400-9-15,2021-12-06
402,شتوكاح,ح . توكا رنگ فولاد سپاهان,283,849377,10152026720,11429,12000,12000,571,5,11952,523,4.58,11800,12000,1400-9-15,2021-12-06
403,پخش,پخش البرز,283,426538,10710180977,24261,24801,24871,610,2.51,24871,610,2.51,24600,25474,1400-9-15,2021-12-06
404,سدور,سيمان‌ دورود,280,1760179,10021987520,5640,5640,5600,-40,-0.71,5680,40,0.71,5490,5760,1400-9-15,2021-12-06
405,تكمبا,كمباين‌ سازي‌ ايران‌,278,1397937,5256439795,3768,3616,3740,-28,-0.74,3765,-3,-0.08,3616,3840,1400-9-15,2021-12-06
406,پدرخش,درخشان‌ تهران‌,275,548060,10459137720,18780,18780,18770,-10,-0.05,19010,230,1.22,18200,19580,1400-9-15,2021-12-06
407,خچرخش,چرخشگر,272,2382676,20063319050,8160,8370,8450,290,3.55,8420,260,3.19,8090,8560,1400-9-15,2021-12-06
408,تسه9902,امتياز تسهيلات مسكن ارديبهشت99,272,4252,3625364602,831307,820000,860000,28693,3.45,852626,21319,2.56,820000,861000,1400-9-15,2021-12-06
409,ارزش,صندوق س ارزش آفرين بيدار-سهام,272,1356593,12721089290,9370,9400,9340,-30,-0.32,9380,10,0.11,9290,9440,1400-9-15,2021-12-06
410,شكام,صنايع شيميايي كيمياگران امروز,272,877655,26931542878,30606,30570,31160,554,1.81,30686,80,0.26,30120,31899,1400-9-15,2021-12-06
411,ثعمرا,عمران و توسعه شاهد,271,1420322,9600462004,6778,6990,6848,70,1.03,6766,-12,-0.18,6540,6990,1400-9-15,2021-12-06
412,پلوله,گازلوله‌,271,629398,16086407144,26294,26360,25510,-784,-2.98,25558,-736,-2.8,25506,26360,1400-9-15,2021-12-06
413,پسهند,صنايع‌ لاستيكي‌  سهند,270,723543,21046682660,27920,28200,28990,1070,3.83,29090,1170,4.19,27750,29310,1400-9-15,2021-12-06
414,ومعلم,بيمه معلم,269,2869643,6162577823,2135,2101,2110,-25,-1.17,2140,5,0.23,2047,2228,1400-9-15,2021-12-06
415,كامياب,صندوق س. كامياب آشنا-د,269,3758172,41375156929,11002,11010,11009,7,0.06,11009,7,0.06,11008,11010,1400-9-15,2021-12-06
416,حآفرين,ريل پرداز نو آفرين,269,1865595,10543058804,5762,5769,5679,-83,-1.44,5692,-70,-1.21,5555,5820,1400-9-15,2021-12-06
417,غگرجي,بيسكويت‌  گرجي‌,268,4382188,9057946945,2087,2062,2055,-32,-1.53,2075,-12,-0.57,2049,2100,1400-9-15,2021-12-06
418,سرچشمه,سرمايه گذاري مس سرچشمه,268,2056343,10410393588,5045,5090,5076,31,0.61,5058,13,0.26,5025,5170,1400-9-15,2021-12-06
419,سيستم,همكاران سيستم,268,1860670,9344019170,5030,4820,5030,0,0,5030,0,0,4820,5150,1400-9-15,2021-12-06
420,لازما,كارخانه هاي صنعتي آزمايش,265,624332,17577664087,28900,28073,28033,-867,-3,28154,-746,-2.58,28033,29597,1400-9-15,2021-12-06
421,قنقش,قند نقش جهان,265,628913,71050531351,113146,110884,115408,2262,2,112974,-172,-0.15,110884,115408,1400-9-15,2021-12-06
422,تايرا,تراكتورسازي‌ايران‌,264,653911,14484491440,21780,22000,22000,220,1.01,21970,190,0.87,21250,22860,1400-9-15,2021-12-06
423,پرديسح,ح .  سرمايه گذاري پرديس,264,4510266,6046573706,1326,1292,1331,5,0.38,1341,15,1.13,1290,1349,1400-9-15,2021-12-06
424,واتي,سرمايه‌ گذاري‌ آتيه‌ دماوند,264,1736475,16244730120,9630,9630,9340,-290,-3.01,9360,-270,-2.8,9200,9650,1400-9-15,2021-12-06
425,مرقام,ايران‌ارقام‌,264,1036801,10403741110,10040,10190,9990,-50,-0.5,10040,0,0,9760,10330,1400-9-15,2021-12-06
426,خوساز,محورسازان‌ايران‌خودرو,261,1562876,10265410940,6560,6670,6470,-90,-1.37,6570,10,0.15,6400,6830,1400-9-15,2021-12-06
427,نتوس,پشم‌ بافي‌ توس,259,2080558,23055314332,10865,10569,11000,135,1.24,11081,216,1.99,10569,11190,1400-9-15,2021-12-06
428,وسگيلا,شركت س استان گيلان,257,22067216,9476469290,428,422,430,2,0.47,429,1,0.23,421,431,1400-9-15,2021-12-06
429,زبينا,كشاورزي و دامپروري بينالود,257,3641761,7341147521,2029,2011,2029,0,0,2022,-7,-0.34,1988,2056,1400-9-15,2021-12-06
430,لخانه,لوازم‌ خانگي‌ پارس‌,256,1118778,19640862848,17546,17544,17020,-526,-3,17556,10,0.06,17020,18071,1400-9-15,2021-12-06
431,وپترو,سرمايه‌گذاري صنايع پتروشيمي‌,256,857640,9385358060,11060,10610,10930,-130,-1.18,10980,-80,-0.72,10610,11130,1400-9-15,2021-12-06
432,قتربت,قند تربت حيدريه,256,37416,1949653632,52633,51089,52827,194,0.37,52524,-109,-0.21,51089,52880,1400-9-15,2021-12-06
433,تسه9911,امتياز تسهيلات مسكن بهمن99,255,3205,2737675993,826166,830001,864000,37834,4.58,854189,28023,3.39,830001,864840,1400-9-15,2021-12-06
434,سكارون,سيمان كارون,255,200619,9320108316,47862,46428,46427,-1435,-3,46457,-1405,-2.94,46427,47427,1400-9-15,2021-12-06
435,ميدكو,توسعه معادن وص.معدني خاورميانه,254,4864190,222581512340,45750,45750,45760,10,0.02,45760,10,0.02,45750,45800,1400-9-15,2021-12-06
436,كسعدي,كاشي‌ سعدي‌,253,927081,7116253960,7580,7500,7590,10,0.13,7630,50,0.66,7500,7920,1400-9-15,2021-12-06
437,غشان,شيرپاستوريزه‌پگاه‌خراسان‌,251,1268474,5809046168,4620,4700,4650,30,0.65,4605,-15,-0.32,4413,4770,1400-9-15,2021-12-06
438,سپر,صندوق س سپر سرمايه بيدار- ثابت,251,10676506,141965667315,13293,13298,13297,4,0.03,13297,4,0.03,13296,13299,1400-9-15,2021-12-06
439,وملت,سرمايه گذاري ملت,251,3104493,7470324260,2500,2402,2400,-100,-4,2406,-94,-3.76,2400,2450,1400-9-15,2021-12-06
440,معيار ,سرمايه گذاري معيار صنعت پارس,250,581077,24230066034,42977,41688,41688,-1289,-3,41699,-1278,-2.97,41688,43399,1400-9-15,2021-12-06
441,تسه9909,امتياز تسهيلات مسكن آذر99,247,4547,3876152222,824381,820050,860001,35620,4.32,852464,28083,3.41,820050,865600,1400-9-15,2021-12-06
442,ولصنم,ليزينگ‌صنعت‌ومعدن‌,245,1293576,4808697787,3821,3750,3739,-82,-2.15,3786,-35,-0.92,3641,3861,1400-9-15,2021-12-06
443,تسه9910,امتياز تسهيلات مسكن دي99,244,3884,3319724534,833064,831109,865000,31936,3.83,854718,21654,2.6,831109,865000,1400-9-15,2021-12-06
444,كمنگنز,معادن‌منگنزايران‌,244,84700,5190162740,61570,60000,61040,-530,-0.86,61470,-100,-0.16,60000,62810,1400-9-15,2021-12-06
445,سرود,سيمان‌شاهرود,244,563529,10593599250,19200,19550,18750,-450,-2.34,18910,-290,-1.51,18460,19550,1400-9-15,2021-12-06
446,وحكمت,بيمه حكمت صبا,240,4175694,15605944119,3844,3750,3729,-115,-2.99,3737,-107,-2.78,3729,3844,1400-9-15,2021-12-06
447,شرنگي,شيميايي رنگين,240,92825,16533153575,172924,178111,178111,5187,3,178111,5187,3,178111,178111,1400-9-15,2021-12-06
448,كپرور,فرآوري زغال سنگ پروده طبس,238,393797,12138470261,31219,30800,30105,-1114,-3.57,30883,-336,-1.08,30101,31560,1400-9-15,2021-12-06
449,وپخش,داروپخش‌ (هلدينگ‌,237,305517,10593300010,34790,33060,35600,810,2.33,34760,-30,-0.09,33060,35640,1400-9-15,2021-12-06
450,حپارسا,توسعه حمل و نقل ريلي پارسيان,236,264822,7858414798,29105,29394,29150,45,0.15,29403,298,1.02,28013,30550,1400-9-15,2021-12-06
451,كلوند,كاشي‌ الوند,233,600033,12835609660,20890,20790,21450,560,2.68,21310,420,2.01,20790,21520,1400-9-15,2021-12-06
452,شخارك,پتروشيمي‌ خارك‌,233,610871,31173331520,51190,52780,51190,0,0,51140,-50,-0.1,50900,52780,1400-9-15,2021-12-06
453,ساربيل,سيمان آرتا اردبيل,232,198745,4555337650,23130,23670,22140,-990,-4.28,23060,-70,-0.3,22140,23670,1400-9-15,2021-12-06
454,سباقر,سيمان باقران,232,1038856,12818010537,12523,12650,12450,-73,-0.58,12339,-184,-1.47,12170,12650,1400-9-15,2021-12-06
455,وتوكا,سرمايه‌گذاري‌توكافولاد(هلدينگ,231,1527755,12212143320,8030,8110,7970,-60,-0.75,8000,-30,-0.37,7930,8120,1400-9-15,2021-12-06
456,سكرما,سيمان‌ كرمان‌,230,538624,7307700380,13620,13770,13800,180,1.32,13590,-30,-0.22,13280,14020,1400-9-15,2021-12-06
457,نمرينو,ايران‌ مرينوس‌,226,107101,8316364970,80010,78320,78740,-1270,-1.59,78640,-1370,-1.71,76220,80900,1400-9-15,2021-12-06
458,نوين,بيمه نوين,226,1874754,6679373259,3550,3571,3560,10,0.28,3556,6,0.17,3520,3622,1400-9-15,2021-12-06
459,دكپسول,توليد ژلاتين كپسول ايران,225,191778,5531726376,28095,28930,28610,515,1.83,28365,270,0.96,28300,29240,1400-9-15,2021-12-06
460,بفجرح,ح . فجر انرژي خليج فارس,225,1060205,8990271310,8190,8500,8720,530,6.47,8480,290,3.54,7960,8720,1400-9-15,2021-12-06
461,حپترو,حمل و نقل پتروشيمي( سهامي عام,224,407196,9838234720,24030,24350,23850,-180,-0.75,24120,90,0.37,23150,24880,1400-9-15,2021-12-06
462,وسينا,بانك سينا,223,4013532,9265397342,2335,2277,2295,-40,-1.71,2325,-10,-0.43,2277,2390,1400-9-15,2021-12-06
463,دروز,داروسازي‌ روزدارو,222,656970,15985054650,23860,24930,23600,-260,-1.09,24330,470,1.97,23510,24930,1400-9-15,2021-12-06
464,وسكاب,س.ص.بازنشستگي كاركنان بانكها,221,1593918,4696142946,2934,2920,2964,30,1.02,2938,4,0.14,2901,2977,1400-9-15,2021-12-06
465,پكوير,كوير تاير,220,1337647,7841063060,5880,5660,5810,-70,-1.19,5870,-10,-0.17,5660,6030,1400-9-15,2021-12-06
466,كوثر,بيمه كوثر,220,3543783,14161110560,3967,4000,3990,23,0.58,3982,15,0.38,3960,4089,1400-9-15,2021-12-06
467,قلرست,قند لرستان‌,220,534471,8742236210,17050,16480,16210,-840,-4.93,16620,-430,-2.52,16200,17110,1400-9-15,2021-12-06
468,فردا,صندوق س آواي فرداي زاگرس-ثابت,220,8035942,96000423440,11940,11947,11946,6,0.05,11946,6,0.05,11946,11947,1400-9-15,2021-12-06
469,مدير,ص.س.مديريت ثروت ص.بازنشستگي-س,219,869975,8192895029,9457,9499,9360,-97,-1.03,9417,-40,-0.42,9335,9510,1400-9-15,2021-12-06
470,غشهد,شهد ايران ‌,218,1281344,5237841740,4048,4030,4202,154,3.8,4062,14,0.35,3910,4230,1400-9-15,2021-12-06
471,سمازن,سيمان‌مازندران‌,216,707051,9679209630,13500,13660,13620,120,0.89,13620,120,0.89,13510,13890,1400-9-15,2021-12-06
472,جوين,كشت و صنعت جوين,214,3058515,7756804910,2597,2550,2558,-39,-1.5,2548,-49,-1.89,2520,2578,1400-9-15,2021-12-06
473,واميد,گروه مديريت سرمايه گذاري اميد,213,1154696,15566097460,13230,13230,13400,170,1.28,13260,30,0.23,13230,13630,1400-9-15,2021-12-06
474,ثشرق,سرمايه گذاري مسكن شمال شرق,212,3295523,12481964352,3978,3799,3780,-198,-4.98,3809,-169,-4.25,3780,3897,1400-9-15,2021-12-06
475,آوا,صندوق س.سهام آواي معيار-س,210,579652,4492631572,7868,7702,7682,-186,-2.36,7751,-117,-1.49,7652,7860,1400-9-15,2021-12-06
476,سجامح,ح.مجتمع سيمان غرب آسيا,208,1432092,1230660718,877,851,854,-23,-2.62,859,-18,-2.05,851,900,1400-9-15,2021-12-06
477,پرديس,سرمايه گذاري پرديس,206,1684789,5625316955,3284,3277,3311,27,0.82,3305,21,0.64,3277,3385,1400-9-15,2021-12-06
478,فولاژ,فولاد آلياژي ايران,206,1039495,17028411110,16090,16470,16230,140,0.87,16150,60,0.37,16030,16680,1400-9-15,2021-12-06
479,قصفها,قنداصفهان‌,205,71649,5379927400,75530,77920,73640,-1890,-2.5,75360,-170,-0.23,72010,77920,1400-9-15,2021-12-06
480,سغرب,سيمان‌غرب‌,205,647815,10388112820,16010,15340,16100,90,0.56,16030,20,0.12,15340,16330,1400-9-15,2021-12-06
481,غنوش,نوش‌ مازندران‌,205,1072927,15428690260,13700,14380,14380,680,4.96,14370,670,4.89,14380,14380,1400-9-15,2021-12-06
482,وبوعلي,سرمايه‌گذاري‌بوعلي‌,203,1025817,3835708570,3749,3860,3749,0,0,3746,-3,-0.08,3681,3860,1400-9-15,2021-12-06
483,اتكام,بيمه اتكايي امين,202,2381325,11501808444,4781,4770,4820,39,0.82,4818,37,0.77,4715,4880,1400-9-15,2021-12-06
484,تنوين,تامين سرمايه نوين,201,2614372,13777169210,5190,5340,5340,150,2.89,5220,30,0.58,5200,5350,1400-9-15,2021-12-06
485,ثغرب,شركت سرمايه گذاري مسكن شمالغرب,201,2766597,10983888303,3967,4098,3940,-27,-0.68,3969,2,0.05,3840,4098,1400-9-15,2021-12-06
486,كگهر,سنگ آهن گهرزمين,199,2433449,111467390765,45794,46090,45794,0,0,45806,12,0.03,45500,46100,1400-9-15,2021-12-06
487,ثامان,سامان‌ گستراصفهان‌,198,468849,4271317100,9410,9170,8950,-460,-4.89,9320,-90,-0.96,8940,9700,1400-9-15,2021-12-06
488,اميد,تامين سرمايه اميد,196,1477607,11293249490,7550,7630,7650,100,1.32,7590,40,0.53,7630,7680,1400-9-15,2021-12-06
489,فپنتا,سپنتا,194,23168,10344665730,441120,457000,445820,4700,1.07,444770,3650,0.83,441000,457000,1400-9-15,2021-12-06
490,فبيرا,بسته‌ بندي‌ ايران‌,193,3588980,6357250298,1831,1802,1760,-71,-3.88,1791,-40,-2.18,1741,1829,1400-9-15,2021-12-06
491,كگاز,شيشه‌ و گاز,193,394006,5953219510,14860,14710,15270,410,2.76,14960,100,0.67,14710,15270,1400-9-15,2021-12-06
492,ميهن,بيمه ميهن,191,1472580,3216761413,2163,2200,2140,-23,-1.06,2168,5,0.23,2129,2260,1400-9-15,2021-12-06
493,ولتجار,واسپاري تجارت وسرمايه ايرانيان,191,4779814,13766943490,3025,2874,2874,-151,-4.99,2880,-145,-4.79,2874,2990,1400-9-15,2021-12-06
494,كهربا,صندوق س.پشتوانه سكه طلا كهربا,190,2005026,23129170999,11275,11301,11628,353,3.13,11536,261,2.31,11301,11646,1400-9-15,2021-12-06
495,تسه9907,امتياز تسهيلات مسكن مهر99,187,3132,2688589150,829529,816009,865000,35471,4.28,858426,28897,3.48,816009,871004,1400-9-15,2021-12-06
496,تصميم,صندوق س با درآمد ثابت تصميم,185,1994637,36182373263,18129,18139,18140,11,0.06,18140,11,0.06,18135,18143,1400-9-15,2021-12-06
497,بساما,بيمه سامان,182,273218,5609903497,20203,19958,20895,692,3.43,20313,110,0.54,19958,21005,1400-9-15,2021-12-06
498,ولشرقح,ح . ليزينگ ايران و شرق,182,5616055,6836220860,1279,1216,1216,-63,-4.93,1217,-62,-4.85,1216,1270,1400-9-15,2021-12-06
499,پكرمان,گروه‌ صنعتي‌ بارز,181,274388,5498680700,20250,19820,20000,-250,-1.23,20190,-60,-0.3,19800,20450,1400-9-15,2021-12-06
500,شرانل,نفت ايرانول,181,232273,10732161201,45555,45000,46000,445,0.98,45744,189,0.41,45000,46828,1400-9-15,2021-12-06
501,دپارس,پارس‌ دارو,181,159992,4570735980,29130,30020,28270,-860,-2.95,28950,-180,-0.62,28260,30020,1400-9-15,2021-12-06
502,ويسا,سرمايه گذاري ايساتيس پويا,179,2939781,23437160732,8012,8212,8036,24,0.3,7972,-40,-0.5,7940,8249,1400-9-15,2021-12-06
503,آكورد,صندوق س. آرمان آتي كوثر-د,178,1605165,57115027663,35564,35588,35582,18,0.05,35582,18,0.05,35581,35588,1400-9-15,2021-12-06
504,تسه9812,امتياز تسهيلات مسكن اسفند98,177,2492,2131226572,830354,823000,855023,24669,2.97,855227,24873,3,823000,869800,1400-9-15,2021-12-06
505,تماوند,تامين سرمايه دماوند,177,1973448,10821078629,5328,5328,5487,159,2.98,5437,109,2.05,5282,5487,1400-9-15,2021-12-06
506,سقاين,سيمان‌ قائن‌,177,107717,4707539470,43900,42930,42750,-1150,-2.62,43840,-60,-0.14,42750,45210,1400-9-15,2021-12-06
507,كفرآور,فرآورده هاي سيمان شرق,176,379793,7602474671,19837,20350,20165,328,1.65,19975,138,0.7,19840,20360,1400-9-15,2021-12-06
508,دارو,كارخانجات‌داروپخش‌,176,374038,11623621780,30280,31400,30250,-30,-0.1,30780,500,1.65,30110,31700,1400-9-15,2021-12-06
509,زعف0008پ10,زعفران0008نگين طلاي سرخ(پ),176,153496,41587264591,272426,269151,273100,674,0.25,270934,-1492,-0.55,269151,276000,1400-9-15,2021-12-06
510,شوينده,مديريت صنعت شوينده ت.ص.بهشهر,176,383807,7294210450,19000,18990,18900,-100,-0.53,19000,0,0,18750,19780,1400-9-15,2021-12-06
511,زفكا,كشت و دامداري فكا,175,1232000,8594318532,6918,7140,6911,-7,-0.1,6951,33,0.48,6601,7140,1400-9-15,2021-12-06
512,كارين,صندوق س نگين سامان-ثابت,174,5644474,56928420366,10080,10084,10085,5,0.05,10086,6,0.06,10084,10088,1400-9-15,2021-12-06
513,بزاگرس,نيروگاه زاگرس كوثر,174,1120702,3820447753,3425,3450,3378,-47,-1.37,3421,-4,-0.12,3337,3493,1400-9-15,2021-12-06
514,ثزاگرس,سرمايه گذاري توسعه عمران زاگرس,173,103190,3336365928,32752,31601,32700,-52,-0.16,32601,-151,-0.46,31600,33170,1400-9-15,2021-12-06
515,وسبحان,سرمايه گذاري سبحان,173,2341327,7139188226,3039,2971,3032,-7,-0.23,3044,5,0.16,2971,3113,1400-9-15,2021-12-06
516,دابور,داروسازي‌ ابوريحان‌,172,160396,3661063970,23300,22420,22870,-430,-1.85,23180,-120,-0.52,22420,23420,1400-9-15,2021-12-06
517,ساينا,صنايع بهداشتي ساينا,172,81118,6643517012,84580,83900,81750,-2830,-3.35,83308,-1272,-1.5,81010,83900,1400-9-15,2021-12-06
518,ثاصفا,شركت‌ ساختمان‌ اصفهان‌,170,686455,6321058794,9486,9202,9202,-284,-2.99,9248,-238,-2.51,9202,9400,1400-9-15,2021-12-06
519,بميلا,توسعه بازرگاني آهن وفولادميلاد,169,1964417,13782053697,7168,7000,7098,-70,-0.98,7016,-152,-2.12,6955,7328,1400-9-15,2021-12-06
520,رنيك,جنرال مكانيك,169,457550,5005062379,10782,10803,10790,8,0.07,10835,53,0.49,10727,11180,1400-9-15,2021-12-06
521,وبرق,س.کارکنان صنعت برق زنجان وقزوي,166,290160,37907082720,134682,130642,130642,-4040,-3,130642,-4040,-3,130642,130642,1400-9-15,2021-12-06
522,غپآذر,شير پگاه آذربايجان شرقي,165,162295,4730784742,29655,28633,29011,-644,-2.17,29489,-166,-0.56,28630,29829,1400-9-15,2021-12-06
523,كخاك,صنايع‌خاك‌چيني‌ايران‌,164,508690,13596825880,26920,26700,27000,80,0.3,26760,-160,-0.59,26070,27100,1400-9-15,2021-12-06
524,دسبحان,سبحان دارو,164,289818,4088566270,14520,14450,14320,-200,-1.38,14400,-120,-0.83,13900,14450,1400-9-15,2021-12-06
525,كطبس,ذغال‌سنگ‌ نگين‌ ط‌بس‌,163,125458,6018434760,48750,47250,47300,-1450,-2.97,48430,-320,-0.66,47250,49900,1400-9-15,2021-12-06
526,ولبهمن,شركت بهمن ليزينگ,162,775183,5467144848,7018,7120,7020,2,0.03,7031,13,0.19,6910,7164,1400-9-15,2021-12-06
527,لخزر,پارس‌ خزر,162,34487,4479878190,127940,131000,128570,630,0.49,128540,600,0.47,128100,132000,1400-9-15,2021-12-06
528,وساشرقي,شركت س استان آذربايجان شرقي,161,9816998,4218383878,443,422,430,-13,-2.93,441,-2,-0.45,422,439,1400-9-15,2021-12-06
529,شستان,پتروشيمي گلستان,161,2447981,9356462069,3793,3732,3867,74,1.95,3822,29,0.76,3718,3868,1400-9-15,2021-12-06
530,داوه,داروسازي آوه سينا,160,416493,3999786472,9824,9421,9530,-294,-2.99,9760,-64,-0.65,9421,9898,1400-9-15,2021-12-06
531,تسه9901,امتياز تسهيلات مسكن فروردين99,160,1808,1544781730,822368,820510,863486,41118,5,854415,32047,3.9,820510,863486,1400-9-15,2021-12-06
532,عيار2,صندوق سكه طلاي مفيد,160,1600000,1600000,33426,1,1,-33425,-100,1,-33425,-100,1,1,1400-9-15,2021-12-06
533,تپولا,مهندسي مرآت پولاد,159,949938,15662490690,16656,16157,16157,-499,-3,16488,-168,-1.01,16157,17000,1400-9-15,2021-12-06
534,ساراب,سيمان‌ داراب‌,157,1076740,15760310790,14200,13640,14910,710,5,14640,440,3.1,13640,14910,1400-9-15,2021-12-06
535,تسه9811,امتياز تسهيلات مسكن بهمن98,157,1790,1528936835,831863,822100,859500,27637,3.32,854155,22292,2.68,822100,865000,1400-9-15,2021-12-06
536,شپاس,نفت پاسارگاد,157,253465,3897523301,15112,15122,15340,228,1.51,15182,70,0.46,15122,15620,1400-9-15,2021-12-06
537,فاهواز,نورد و لوله اهواز,156,1175872,7121499832,6152,6121,6036,-116,-1.89,6102,-50,-0.81,6029,6220,1400-9-15,2021-12-06
538,سكه0111پ05,تمام سكه طرح جديد0111آينده,153,196500,263345651700,1311970,1331000,1347000,35030,2.67,1340181,28211,2.15,1325101,1356999,1400-9-15,2021-12-06
539,فلات,گروه صنايع معادن فلات ايرانيان,152,775318,8175570028,10804,10481,10480,-324,-3,10577,-227,-2.1,10480,11098,1400-9-15,2021-12-06
540,كاردان,صندوق س تجارت شاخصي كاردان,152,26039,4770984670,183790,184100,181390,-2400,-1.31,183220,-570,-0.31,181200,185500,1400-9-15,2021-12-06
541,كاريس,صندوق س.سپهر كاريزما-س,152,825977,10538151969,12778,12940,12758,-20,-0.16,12758,-20,-0.16,12650,12940,1400-9-15,2021-12-06
542,سكرد,سيمان كردستان,151,828045,3640893726,4454,4302,4320,-134,-3.01,4440,-14,-0.31,4302,4500,1400-9-15,2021-12-06
543,دتماد,توليدمواداوليه‌داروپخش‌,151,128576,5538342380,43140,43030,43090,-50,-0.12,43120,-20,-0.05,43000,43400,1400-9-15,2021-12-06
544,سپاس,صندوق س. پاداش سهامداري-ثابت,151,5384418,54759508782,10168,10175,10169,1,0.01,10170,2,0.02,10169,10175,1400-9-15,2021-12-06
545,آساميد2,صندوق س.مشترك آسمان اميد -د,149,14900000,14900000,13563,1,1,-13562,-99.99,1,-13562,-99.99,1,1,1400-9-15,2021-12-06
546,پرداخت,به پرداخت ملت,148,838455,10510913140,12890,12600,12300,-590,-4.58,12640,-250,-1.94,12300,12720,1400-9-15,2021-12-06
547,اوصتا,صندوق انديشه ورزان صباتامين -د,148,7541211,156401981372,20728,20738,20739,11,0.05,20740,12,0.06,20738,20743,1400-9-15,2021-12-06
548,اعتلاح,ح سرمايه گذاري اعتلاء البرز,148,827339,1300654669,1600,1565,1565,-35,-2.19,1572,-28,-1.75,1551,1600,1400-9-15,2021-12-06
549,پارسيان,بيمه پارسيان,147,757885,6635869310,8750,8800,8800,50,0.57,8750,0,0,8600,9050,1400-9-15,2021-12-06
550,خديزل,بهمن  ديزل,146,165176,8657076303,53086,54069,52000,-1086,-2.05,52807,-279,-0.53,51700,54069,1400-9-15,2021-12-06
551,اخزا917,اسنادخزانه-م17بودجه99-010226,146,422397,383840922660,908620,908001,908501,-119,-0.01,908721,101,0.01,906500,909200,1400-9-15,2021-12-06
552,دعبيد,لابراتوارداروسازي‌  دكترعبيدي‌,146,389964,7405143260,18910,19200,18700,-210,-1.11,18930,20,0.11,18600,19200,1400-9-15,2021-12-06
553,وكادو,تكادو,144,377585,5429851765,14435,14435,14440,5,0.03,14404,-31,-0.21,14103,14868,1400-9-15,2021-12-06
554,درازك,دارويي‌ رازك‌,144,135784,4793960450,36040,35990,35240,-800,-2.22,35800,-240,-0.67,35160,35990,1400-9-15,2021-12-06
555,دشيمي,شيمي‌ داروئي‌ داروپخش‌,142,230006,5433312940,23720,23520,23520,-200,-0.84,23680,-40,-0.17,23400,23950,1400-9-15,2021-12-06
556,سكه0012پ04,تمام سكه طرح جديد0012صادرات,141,42500,56968381500,1310867,1320001,1348000,37133,2.83,1340432,29565,2.26,1320000,1356300,1400-9-15,2021-12-06
557,هجرت,پخش هجرت,141,224804,6190253044,27359,28390,27504,145,0.53,27433,74,0.27,26740,28390,1400-9-15,2021-12-06
558,پاسا,ايران‌ياساتايرورابر,139,293993,3886867550,13310,13040,13260,-50,-0.38,13290,-20,-0.15,13040,13400,1400-9-15,2021-12-06
559,غشاذر,پگاه‌آذربايجان‌غربي‌,139,590755,3080984240,5340,5450,5160,-180,-3.37,5310,-30,-0.56,5090,5450,1400-9-15,2021-12-06
560,وتوس,توسعه‌شهري‌توس‌گستر,138,424291,3960957490,9350,9100,9290,-60,-0.64,9350,0,0,9100,9550,1400-9-15,2021-12-06
561,تسه9906,امتياز تسهيلات مسكن شهريور99,138,1456,1247720500,832358,840000,855555,23197,2.79,856951,24593,2.95,840000,873975,1400-9-15,2021-12-06
562,قهكمت,قندهكمتان‌,138,1580774,7097886906,4463,4380,4509,46,1.03,4476,13,0.29,4260,4590,1400-9-15,2021-12-06
563,ثباغ,شهر سازي و خانه سازي باغميشه,136,719793,5972324671,8274,8330,8280,6,0.07,8283,9,0.11,8260,8400,1400-9-15,2021-12-06
564,رماس,صندوق س.راهبرد ممتازابن سينا-س,135,212841,2128410000,10000,10000,10000,0,0,10000,0,0,10000,10000,1400-9-15,2021-12-06
565,تسه9903,امتياز تسهيلات مسكن خرداد99,135,1345,1151622226,856174,898982,862005,5831,0.68,856225,51,0.01,813367,898982,1400-9-15,2021-12-06
566,وبهمن,سرمايه‌گذاري‌بهمن‌,134,445790,6671358750,15650,15640,14890,-760,-4.86,15370,-280,-1.79,14880,15640,1400-9-15,2021-12-06
567,تسه9809,امتياز تسهيلات مسكن آذر98,134,2421,2038686282,824128,820000,835000,10872,1.32,842084,17956,2.18,810000,865334,1400-9-15,2021-12-06
568,اخزا006,اسنادخزانه-م6بودجه00-030723,132,319366,166388863174,520582,523000,520555,-27,-0.01,520997,415,0.08,519555,528999,1400-9-15,2021-12-06
569,وزمين,بانك ايران زمين,132,808574,7624244098,9731,9342,9600,-131,-1.35,9579,-152,-1.56,9342,9680,1400-9-15,2021-12-06
570,تسه9904,امتياز تسهيلات مسكن تير99,132,1461,1254159256,838067,840000,860000,21933,2.62,858425,20358,2.43,835112,878887,1400-9-15,2021-12-06
571,خاهنح,ح . آهنگري تراكتورسازي‌ ايران‌,131,839802,3037818686,3672,3650,3619,-53,-1.44,3617,-55,-1.5,3601,3680,1400-9-15,2021-12-06
572,وكار,بانك‌ كارآفرين‌,130,1488186,4349895465,3010,2946,2903,-107,-3.55,3002,-8,-0.27,2901,2950,1400-9-15,2021-12-06
573,سكه0112پ03,تمام سكه طرح جديد0112سامان,129,23800,31954792000,1317234,1328000,1350490,33256,2.52,1342638,25404,1.93,1328000,1358000,1400-9-15,2021-12-06
574,لوتوس,تامين سرمايه لوتوس پارسيان,129,1316212,7524079740,5680,5700,5720,40,0.7,5690,10,0.18,5690,5770,1400-9-15,2021-12-06
575,دفارا,داروسازي‌ فارابي‌,128,266137,3554526960,13470,13100,13120,-350,-2.6,13440,-30,-0.22,12930,13850,1400-9-15,2021-12-06
576,بسويچ,پارس‌سويچ‌,128,206821,2982135990,15150,14400,14400,-750,-4.95,14990,-160,-1.06,14400,14800,1400-9-15,2021-12-06
577,تسه9905,امتياز تسهيلات مسكن مرداد99,128,1843,1591561886,844933,841111,869999,25066,2.97,863571,18638,2.21,841111,887178,1400-9-15,2021-12-06
578,زشگزا,شير و گوشت زاگرس شهركرد,124,785873,3780022964,4801,4620,4815,14,0.29,4803,2,0.04,4620,4941,1400-9-15,2021-12-06
579,حسينا,توسعه خدمات دريايي وبندري سينا,123,82594,3395958077,41127,42930,41899,772,1.88,41125,-2,0,40610,42930,1400-9-15,2021-12-06
580,بنيرو,نيروترانس‌,122,1716419,3141431568,1862,1800,1801,-61,-3.28,1855,-7,-0.38,1800,1878,1400-9-15,2021-12-06
581,ضپال2007,اختيارخ اپال-32000-1401/02/12,122,1639,632946000,325,396,399,74,22.77,386,61,18.77,348,442,1400-9-15,2021-12-06
582,اخزا002,اسنادخزانه-م2بودجه00-031024,121,443775,218353883806,491457,490671,491211,-246,-0.05,492037,580,0.12,490503,493000,1400-9-15,2021-12-06
583,ضجار1020,اختيارخ وتجارت-1600-1400/10/15,121,4414,1533983000,348,429,325,-23,-6.61,348,0,0,315,429,1400-9-15,2021-12-06
584,شصفها,پتروشيمي‌ اصفهان‌,119,103621,12194480212,116564,117706,114624,-1940,-1.66,117531,967,0.83,114233,118895,1400-9-15,2021-12-06
585,شراز,پالايش نفت شيراز,118,48576,5557591227,113742,113742,114210,468,0.41,113821,79,0.07,113742,117480,1400-9-15,2021-12-06
586,كي بي سي,شركت كي بي سي,117,86520,1452402933,16651,16600,16859,208,1.25,16665,14,0.08,16600,17187,1400-9-15,2021-12-06
587,سخوز,سيمان خوزستان,116,453639,10805202580,23760,24000,23500,-260,-1.09,23800,40,0.17,23460,24070,1400-9-15,2021-12-06
588,آبين,كشت و صنعت آبشيرين,116,1616409,2692476845,1716,1666,1665,-51,-2.97,1702,-14,-0.82,1665,1680,1400-9-15,2021-12-06
589,چافست,افست‌,115,404415,3367343190,8630,8250,8330,-300,-3.48,8560,-70,-0.81,8230,8570,1400-9-15,2021-12-06
590,تكنار,مجتمع معادن مس تكنار,115,55279,2933908485,54611,52980,54000,-611,-1.12,54120,-491,-0.9,52973,54615,1400-9-15,2021-12-06
591,فيروزه,صندوق شاخص30 شركت فيروزه- سهام,115,21960,3638977800,165790,171000,166990,1200,0.72,165710,-80,-0.05,164500,171000,1400-9-15,2021-12-06
592,فخاس,فولاد خراسان,114,128903,2902075980,23650,22490,22500,-1150,-4.86,23620,-30,-0.13,22470,22890,1400-9-15,2021-12-06
593,زمگسا,كشاورزي‌ ودامپروي‌ مگسال‌,113,397024,6751740150,17220,16550,16900,-320,-1.86,17120,-100,-0.58,16550,17560,1400-9-15,2021-12-06
594,شپاكسا,پاكسان‌,112,203560,3237739640,15880,15890,15670,-210,-1.32,15890,10,0.06,15640,16170,1400-9-15,2021-12-06
595,اعتلا,شركت سرمايه گذاري اعتلاء البرز,112,580806,2057664731,3581,3500,3583,2,0.06,3576,-5,-0.14,3500,3600,1400-9-15,2021-12-06
596,كحافظ,كاشي‌ وسراميك‌ حافظ‌,110,550655,1984689040,3621,3700,3625,4,0.11,3619,-2,-0.06,3511,3700,1400-9-15,2021-12-06
597,شگل,گلتاش‌,110,216359,1386985390,6630,6330,6460,-170,-2.56,6610,-20,-0.3,6330,6560,1400-9-15,2021-12-06
598,دشيري,شيرين دارو,108,86396,10803267221,128766,124904,124904,-3862,-3,125044,-3722,-2.89,124904,128000,1400-9-15,2021-12-06
599,مفاخر,توسعه فناوري اطلاعات خوارزمي,108,401793,11572040193,27430,28801,28801,1371,5,28436,1006,3.67,28801,28801,1400-9-15,2021-12-06
600,اخزا004,اسنادخزانه-م4بودجه00-030522,107,416019,225474302453,541454,541453,542000,546,0.1,541981,527,0.1,541215,542500,1400-9-15,2021-12-06
601,وثخوز,سرمايه گذاري و توسعه خوزستان,107,109133,3312741691,31139,31132,30789,-350,-1.12,30873,-266,-0.85,29820,31132,1400-9-15,2021-12-06
602,وتوشه,سرمايه‌ گذاري‌ پارس‌ توشه‌,107,934810,5251682770,5690,5770,5620,-70,-1.23,5660,-30,-0.53,5560,5770,1400-9-15,2021-12-06
603,فاما,صنعتي‌ آما,106,396450,7938762360,19970,19700,19990,20,0.1,20000,30,0.15,19700,20490,1400-9-15,2021-12-06
604,كرمان39,مرابحه كرمان موتور14030915,106,10000000,10000000000000,1000000,1000000,1000000,0,0,1000000,0,0,1000000,1000000,1400-9-15,2021-12-06
605,مداران,داده‌پردازي‌ايران‌,105,218604,2851706270,13530,13380,12960,-570,-4.21,13430,-100,-0.74,12870,13540,1400-9-15,2021-12-06
606,كاسپين,داروسازي كاسپين تامين,104,339823,7913950639,23261,23000,23238,-23,-0.1,23276,15,0.06,22503,24010,1400-9-15,2021-12-06
607,دحاوي,الحاوي,103,486478,2241611879,4701,4562,4564,-137,-2.91,4680,-21,-0.45,4560,4747,1400-9-15,2021-12-06
608,خاتم,صندوق س خاتم ايساتيس پويا-ثابت,102,2078036,25819223559,12418,12426,12426,8,0.06,12425,7,0.06,12424,12427,1400-9-15,2021-12-06
609,كشرق,صنعتي و معدني شمال شرق شاهرود,101,32869,2286613026,68875,69000,69995,1120,1.63,68980,105,0.15,67443,71987,1400-9-15,2021-12-06
610,سپ,پرداخت الكترونيك سامان كيش,101,184181,5516271060,30380,30690,29950,-430,-1.42,30340,-40,-0.13,29460,30690,1400-9-15,2021-12-06
611,سخزر,سيمان‌ خزر,100,273997,4925640780,17890,18000,17930,40,0.22,17920,30,0.17,17630,18590,1400-9-15,2021-12-06
612,ركيش,كارت اعتباري ايران كيش,100,381707,2052929910,5450,5280,5360,-90,-1.65,5440,-10,-0.18,5220,5470,1400-9-15,2021-12-06
613,نيرو,نيرو سرمايه,100,228522,7856079702,33387,34388,34388,1001,3,34151,764,2.29,34046,34388,1400-9-15,2021-12-06
614,سشمال,سيمان‌ شمال‌,99,387866,2979134630,7830,7920,7580,-250,-3.19,7800,-30,-0.38,7570,7920,1400-9-15,2021-12-06
615,قمرو,قند مرودشت‌,99,107662,2383530470,22480,22370,21830,-650,-2.89,22420,-60,-0.27,21800,22370,1400-9-15,2021-12-06
616,سجام,مجتمع سيمان غرب آسيا,98,712823,1586977113,2241,2241,2220,-21,-0.94,2239,-2,-0.09,2201,2270,1400-9-15,2021-12-06
617,حخزر,كشتيراني درياي خزر,98,147925,2091784409,14843,14145,14104,-739,-4.98,14739,-104,-0.7,14101,14380,1400-9-15,2021-12-06
618,سكه0011پ02,تمام سكه طرح جديد0011ملت,97,18100,24299980100,1315698,1324999,1350000,34302,2.61,1342540,26842,2.04,1324999,1353999,1400-9-15,2021-12-06
619,حبندرح,ح.دريايي وكشتيراني خط دريابندر,97,456256,4941708736,10516,10831,10831,315,3,10831,315,3,10831,10831,1400-9-15,2021-12-06
620,ثمين,صندوق س. ثروت افزون ثمين-س,97,1306789,13140899758,10014,10091,10050,36,0.36,10056,42,0.42,10000,10100,1400-9-15,2021-12-06
621,ثجوان,تامين مسكن جوانان,96,836688,4090725132,5040,4889,4889,-151,-3,4976,-64,-1.27,4889,4950,1400-9-15,2021-12-06
622,آساس,صندوق س.آسمان آرماني سهام-س,94,79949,13276407157,166038,166039,165102,-936,-0.56,166061,23,0.01,165005,166500,1400-9-15,2021-12-06
623,سهرمز,سيمان‌هرمزگان‌,93,119547,1711652450,14850,14660,14520,-330,-2.22,14790,-60,-0.4,14240,14670,1400-9-15,2021-12-06
624,ويستا,صندوق س. ويستا -س,92,1635745,16515667577,10082,10090,10150,68,0.67,10097,15,0.15,9551,10215,1400-9-15,2021-12-06
625,دالبر,البرزدارو,90,158094,1866443100,11670,11600,11820,150,1.29,11690,20,0.17,11550,12190,1400-9-15,2021-12-06
626,وارس,سرمايه گذاري ارس صبا,90,245860,2649417480,10907,10600,10978,71,0.65,10870,-37,-0.34,10580,11049,1400-9-15,2021-12-06
627,واعتبار,سرمايه گذاري اعتبار ايران,87,1378606,9237887690,6540,6550,6610,70,1.07,6640,100,1.53,6550,6760,1400-9-15,2021-12-06
628,ضملت1132,اختيارخ وبملت-2500-1400/11/13,87,4589,2753991000,575,575,600,25,4.35,600,25,4.35,573,619,1400-9-15,2021-12-06
629,بخاور,بيمه زندگي خاورميانه,87,685443,2770806251,4039,4098,4070,31,0.77,4040,1,0.02,4002,4099,1400-9-15,2021-12-06
630,اخزا005,اسنادخزانه-م5بودجه00-030626,85,320040,169106530378,528005,529000,527000,-1005,-0.19,528392,387,0.07,526542,529489,1400-9-15,2021-12-06
631,درهآور,دارويي ره آورد تامين,83,122826,2846997860,22851,22770,23031,180,0.79,22912,61,0.27,22770,23640,1400-9-15,2021-12-06
632,دفرا,فرآورده‌هاي‌ تزريقي‌ ايران‌,82,71052,1957311410,27430,26170,27060,-370,-1.35,27450,20,0.07,26160,28080,1400-9-15,2021-12-06
633,وايرا,سرمايه گذاري صنايع ايران,82,459234,2036906062,4565,4429,4430,-135,-2.96,4537,-28,-0.61,4429,4470,1400-9-15,2021-12-06
634,دسبحا,گروه دارويي سبحان,82,116012,2205772670,18710,19640,18760,50,0.27,18740,30,0.16,18120,19640,1400-9-15,2021-12-06
635,وبازار,صندوق س شاخصي بازارآشنا,80,457388,5341964290,11660,11700,11590,-70,-0.6,11680,20,0.17,11590,11750,1400-9-15,2021-12-06
636,سهگمت,سيمان‌هگمتان‌,78,77492,1616315300,21460,21000,20890,-570,-2.66,21390,-70,-0.33,20520,21210,1400-9-15,2021-12-06
637,سيدكو,سرمايه گذاري توسعه صنايع سيمان,78,2226058,12935978450,5850,5920,5840,-10,-0.17,5820,-30,-0.51,5770,5920,1400-9-15,2021-12-06
638,زعف0008پ11,زعفران0008نگين سحرخيز(پ),78,124753,36016603440,287744,285000,290000,2256,0.78,288703,959,0.33,280009,297481,1400-9-15,2021-12-06
639,زگلدشت,كشت و دام گلدشت نمونه اصفهان,77,250215,2180052887,8692,8840,8641,-51,-0.59,8695,3,0.03,8563,8841,1400-9-15,2021-12-06
640,حسير,ريل سير كوثر,77,534872,14778513360,29084,27630,27630,-1454,-5,27630,-1454,-5,27630,27630,1400-9-15,2021-12-06
641,دكيمي,كيميدارو,76,143613,2652081280,18630,18080,18230,-400,-2.15,18600,-30,-0.16,18080,19460,1400-9-15,2021-12-06
642,وآرين,شركت توسعه اقتصادي آرين,74,1565546,2985824222,1965,1907,1907,-58,-2.95,1947,-18,-0.92,1907,1923,1400-9-15,2021-12-06
643,ضصاد1114,اختيارخ وبصادر-2500-1400/11/06,74,5642,230321000,33,66,39,6,18.18,41,8,24.24,35,66,1400-9-15,2021-12-06
644,تشتاد,صنايع توليدي اشتاد ايران‌,72,465740,2174364710,4812,4669,4668,-144,-2.99,4780,-32,-0.67,4668,4797,1400-9-15,2021-12-06
645,كصدف,كاشي صدف سرام استقلال آباده,72,330896,6701074629,20308,19880,20299,-9,-0.04,20269,-39,-0.19,19880,20917,1400-9-15,2021-12-06
646,وتعاون,بيمه  تعاون,72,1593316,2683216448,1702,1651,1651,-51,-3,1697,-5,-0.29,1651,1752,1400-9-15,2021-12-06
647,وگردش,بانك گردشگري,70,1512863,17626366813,12011,11651,11651,-360,-3,11920,-91,-0.76,11651,11651,1400-9-15,2021-12-06
648,ثبات,صندوق س. ثبات ويستا -د,69,1980227,20824109231,10511,10517,10517,6,0.06,10516,5,0.05,10516,10517,1400-9-15,2021-12-06
649,زعف0110پ11,زعفران0110نگين سحرخيز(پ),68,27395,10258693210,374939,370000,371200,-3739,-1,374473,-466,-0.12,370000,380000,1400-9-15,2021-12-06
650,گوهران,سرمايه گذاري توسعه گوهران اميد,68,497805,2477416165,4983,4984,4983,0,0,4982,-1,-0.02,4960,4984,1400-9-15,2021-12-06
651,داريوش,صندوق س. ثروت داريوش -س,67,263456,2512276118,9544,9556,9510,-34,-0.36,9536,-8,-0.08,9510,9605,1400-9-15,2021-12-06
652,فافزا,فولاد افزا سپاهان,66,41930,1466590944,36055,34974,34974,-1081,-3,35894,-161,-0.45,34974,35717,1400-9-15,2021-12-06
653,سفانو,سيمان فارس نو,66,86649,2148271260,24620,25740,24560,-60,-0.24,24640,20,0.08,23620,25740,1400-9-15,2021-12-06
654,دسينا,داروسازي‌ سينا,62,178620,3632055350,20340,20420,20390,50,0.25,20340,0,0,20200,20870,1400-9-15,2021-12-06
655,ولانا,شركت ليزينگ آريا دانا,61,155018,1774646064,11802,11448,11448,-354,-3,11692,-110,-0.93,11448,11448,1400-9-15,2021-12-06
656,سمايه,بانك سرمايه,58,1599074,10840122646,6988,6779,6779,-209,-2.99,6779,-209,-2.99,6779,6779,1400-9-15,2021-12-06
657,شكبير,پتروشيمي اميركبير,55,21224,2009127430,96142,94106,95450,-692,-0.72,96111,-31,-0.03,94106,96600,1400-9-15,2021-12-06
658,اطلس2,صندوق س.توسعه اندوخته آينده-س,55,550000,550000,242416,1,1,-242415,-100,1,-242415,-100,1,1,1400-9-15,2021-12-06
659,وامين,س. امين توان آفرين ساز,55,104175,1298090369,12623,12600,12500,-123,-0.97,12619,-4,-0.03,12370,12670,1400-9-15,2021-12-06
660,شپلي,پلي اكريل ايران,55,392695,2473978500,6494,6300,6300,-194,-2.99,6443,-51,-0.79,6300,6300,1400-9-15,2021-12-06
661,ضبدر1163,اختيارخ شبندر-6000-1400/11/13,53,619,562514000,965,1045,888,-77,-7.98,909,-56,-5.8,820,1045,1400-9-15,2021-12-06
662,قشهد,شهد,53,166019,2308394180,14070,13450,14010,-60,-0.43,14040,-30,-0.21,13450,14010,1400-9-15,2021-12-06
663,اخزا908,اسنادخزانه-م8بودجه99-020606,51,238849,164147514031,697011,680010,690004,-7007,-1.01,687244,-9767,-1.4,680010,698500,1400-9-15,2021-12-06
664,اخزا001,اسنادخزانه-م1بودجه00-030821,49,251360,128613955183,510571,511000,511600,1029,0.2,511672,1101,0.22,511000,512499,1400-9-15,2021-12-06
665,شتوكا,توكا رنگ فولاد سپاهان,49,187267,2647768113,13466,14139,14139,673,5,13576,110,0.82,14139,14139,1400-9-15,2021-12-06
666,اخزا901,اسنادخزانه-م1بودجه99-010621,49,44039,37431167528,849262,847702,850011,749,0.09,849955,693,0.08,847701,850999,1400-9-15,2021-12-06
667,ارمغان,ص سرمايه گذاري ارمغان ايرانيان,49,663258,6736200848,10152,10156,10156,4,0.04,10156,4,0.04,10155,10163,1400-9-15,2021-12-06
668,قچار,فراوردههاي غذايي وقند چهارمحال,48,124074,1070014176,9077,8624,8624,-453,-4.99,9042,-35,-0.39,8624,8624,1400-9-15,2021-12-06
669,زعف0110پ10,زعفران0110نگين طلاي سرخ(پ),48,14184,5310919010,361105,361632,370000,8895,2.46,374430,13325,3.69,361632,379869,1400-9-15,2021-12-06
670,ضملت1134,اختيارخ وبملت-3500-1400/11/13,46,1908,277946000,133,240,122,-11,-8.27,146,13,9.77,122,240,1400-9-15,2021-12-06
671,ماني2,صندوق س. با درآمد ثابت ماني,45,4500000,4500000,10578,1,1,-10577,-99.99,1,-10577,-99.99,1,1,1400-9-15,2021-12-06
672,قيستو,شركت قند بيستون,45,213897,5064653166,24410,23678,23678,-732,-3,24011,-399,-1.63,23678,23678,1400-9-15,2021-12-06
673,طلا2,صندوق س.پشتوانه طلاي لوتوس,44,4400000,4400000,93652,1,1,-93651,-100,1,-93651,-100,1,1,1400-9-15,2021-12-06
674,دقاضي,داروسازي شهيد قاضي,43,63322,1759505164,28453,28100,28000,-453,-1.59,28331,-122,-0.43,27600,28100,1400-9-15,2021-12-06
675,زرين,صندوق س. سهام زرين كوروش-س,42,145816,1841321056,12646,12689,12585,-61,-0.48,12628,-18,-0.14,12553,12690,1400-9-15,2021-12-06
676,ضملت1133,اختيارخ وبملت-3000-1400/11/13,42,1185,412873000,337,358,333,-4,-1.19,348,11,3.26,332,399,1400-9-15,2021-12-06
677,وليز,ليزينگ‌ايران‌,41,653676,1435472496,2311,2196,2196,-115,-4.98,2299,-12,-0.52,2196,2196,1400-9-15,2021-12-06
678,وسنا,سرمايه گذاري نيروگاهي ايران,40,264680,2849809560,11333,10767,10767,-566,-4.99,11225,-108,-0.95,10767,10767,1400-9-15,2021-12-06
679,گوهر2,صندوق سكه طلاي كيان,40,400000,400000,65038,1,1,-65037,-100,1,-65037,-100,1,1,1400-9-15,2021-12-06
680,زعف0110پ18,زعفران0110نگين بهرامن(پ),40,11756,4324771368,355695,369785,370000,14305,4.02,367878,12183,3.43,360013,379700,1400-9-15,2021-12-06
681,كارا,صندوق س. كارا -د,40,711029,7339095738,10316,10322,10321,5,0.05,10322,6,0.06,10321,10323,1400-9-15,2021-12-06
682,داريك,صندوق س.اعتماد داريك-د,39,2945104,35311814664,11984,11990,11989,5,0.04,11990,6,0.05,11989,11992,1400-9-15,2021-12-06
683,سمتاز,سيمان ممتازان كرمان,39,65713,907979978,14218,14158,14000,-218,-1.53,14180,-38,-0.27,13792,14160,1400-9-15,2021-12-06
684,اخزا910,اسنادخزانه-م10بودجه99-020807,39,103851,69744394564,673376,671500,670500,-2876,-0.43,671581,-1795,-0.27,670500,672000,1400-9-15,2021-12-06
685,ضفلا1164,اختيارخ فولاد-12000-1400/11/24,39,848,529708000,602,650,600,-2,-0.33,625,23,3.82,599,699,1400-9-15,2021-12-06
686,وسخوز,شركت س استان خوزستان,38,811456,464152832,635,572,572,-63,-9.92,635,0,0,572,572,1400-9-15,2021-12-06
687,اگ010155,گام بانك اقتصاد نوين0101,38,262010,239649286800,914575,914577,916000,1425,0.16,914657,82,0.01,913002,929000,1400-9-15,2021-12-06
688,صنوين,صندوق سرمايه‌گذاري صنوين-مختلط,38,4151,384215400,92400,95000,90690,-1710,-1.85,92560,160,0.17,90680,95000,1400-9-15,2021-12-06
689,گكيش,توريستي ورفاهي آبادگران كيش,37,206931,5892774087,29975,28477,28477,-1498,-5,29043,-932,-3.11,28477,28477,1400-9-15,2021-12-06
690,قشرين,قند شيرين خراسان,37,245992,1829442504,7667,7437,7437,-230,-3,7621,-46,-0.6,7437,7437,1400-9-15,2021-12-06
691,اخزا903,اسنادخزانه-م3بودجه99-011110,36,192748,151307639399,785753,780565,783110,-2643,-0.34,785002,-751,-0.1,780565,788000,1400-9-15,2021-12-06
692,سبجنو,سيمان‌ بجنورد,35,23384,814662820,35120,35120,34980,-140,-0.4,35100,-20,-0.06,34620,36170,1400-9-15,2021-12-06
693,وثوق,سرمايه گذاري وثوق امين,35,88846,766918672,8898,8632,8632,-266,-2.99,8877,-21,-0.24,8632,8632,1400-9-15,2021-12-06
694,ضصاد1113,اختيارخ وبصادر-2000-1400/11/06,33,1012,137404000,140,148,132,-8,-5.71,136,-4,-2.86,127,150,1400-9-15,2021-12-06
695,آتيمس,صندوق س.آرمان آتيه درخشان مس-س,32,7495,1332885805,178575,178000,177500,-1075,-0.6,177837,-738,-0.41,176200,180000,1400-9-15,2021-12-06
696,اخزا007,اسنادخزانه-م7بودجه00-030912,32,229005,115614035120,507049,503119,505500,-1549,-0.31,504854,-2195,-0.43,503119,506000,1400-9-15,2021-12-06
697,قپيرا,فرآورده‌هاي‌غدايي‌وقندپيرانشهر,32,110770,820017670,7610,7350,7410,-200,-2.63,7600,-10,-0.13,7250,7550,1400-9-15,2021-12-06
698,اخزا003,اسنادخزانه-م3بودجه00-030418,31,139213,77089568087,552408,553000,553611,1203,0.22,553753,1345,0.24,552611,555000,1400-9-15,2021-12-06
699,صايند,صندوق س. گنجينه آينده روشن-د,31,489230,4874629900,9991,9965,9968,-23,-0.23,9964,-27,-0.27,9962,9970,1400-9-15,2021-12-06
700,اراد50,مرابحه عام دولت5-ش.خ0302,30,657000,657000135900,1000001,1000000,1000000,-1,0,1000000,-1,0,1000000,1000001,1400-9-15,2021-12-06
701,هفارس104,اختيارف ت فارس-11832-01/04/12,30,309480,141741840,503,458,458,-45,-8.95,458,-45,-8.95,458,458,1400-9-15,2021-12-06
702,فيروزا,صندوق بادرآمد ثابت فيروزه آسيا,30,89335,2296916979,25709,25720,25653,-56,-0.22,25711,2,0.01,25653,25748,1400-9-15,2021-12-06
703,پلاستح,ح.كارخانجات توليدي پلاستيران,30,233590,1170753080,5167,5012,5012,-155,-3,5012,-155,-3,5012,5012,1400-9-15,2021-12-06
704,اخزا008,اسنادخزانه-م8بودجه00-030919,29,55866,28097784789,503054,502000,502998,-56,-0.01,502950,-104,-0.02,502000,504999,1400-9-15,2021-12-06
705,افق ملت,صندوق س در سهام افق ملت,29,9077,1254749820,139240,141490,137500,-1740,-1.25,138230,-1010,-0.73,137500,141490,1400-9-15,2021-12-06
706,آرمان,بيمه آرمان,28,434150,2470494210,5715,5544,5544,-171,-2.99,5709,-6,-0.1,5544,5880,1400-9-15,2021-12-06
707,زعف0008پ05,زعفران0008نگين زرين(پ),28,1633,455073310,286798,270111,282999,-3799,-1.32,278673,-8125,-2.83,270111,286797,1400-9-15,2021-12-06
708,الماس,صندوق س.امين تدبيرگران فردا-س,28,2640,264040872,101337,103000,100100,-1237,-1.22,100015,-1322,-1.3,99000,103000,1400-9-15,2021-12-06
709,ضشنا1050,اختيارخ شپنا-7629-1400/10/19,27,423,109536655,171,154,110,-61,-35.67,141,-30,-17.54,10,170,1400-9-15,2021-12-06
710,حبندر,دريايي و کشتيراني خط دريابندر,27,574339,9192295695,16500,16005,16005,-495,-3,16014,-486,-2.95,16005,16005,1400-9-15,2021-12-06
711,ضستا1004,اختيارخ شستا-12000-1400/10/29,26,287,248257000,871,865,840,-31,-3.56,865,-6,-0.69,840,899,1400-9-15,2021-12-06
712,فراز,صندوق س.سهام فراز داريك-س,26,82884,1177451817,14205,14207,14206,1,0.01,14206,1,0.01,14206,14207,1400-9-15,2021-12-06
713,سلار,شركت سيمان لارستان,25,18804,496463208,27791,26402,26402,-1389,-5,27718,-73,-0.26,26402,26402,1400-9-15,2021-12-06
714,اخزا902,اسنادخزانه-م2بودجه99-011019,24,51686,41135569015,795879,796000,797000,1121,0.14,795874,-5,0,793301,798000,1400-9-15,2021-12-06
715,سي تيپ2ن17,گواهي سيمان تيپ2ماهان كرمان(ن),24,780000,3739320000,4794,4794,4794,0,0,4794,0,0,4794,4794,1400-9-15,2021-12-06
716,وسرضوي,س.سهام عدالت استان خراسان رضوي,24,793983,519264882,726,654,654,-72,-9.92,726,0,0,654,654,1400-9-15,2021-12-06
717,گنجين,صندوق س. گنجينه يكم آويد-د,23,117373,1678939746,14298,14300,14308,10,0.07,14304,6,0.04,14300,14308,1400-9-15,2021-12-06
718,دارا,صندوق س. دارا الگوريتم-د,22,352148,3518375499,9984,9991,9992,8,0.08,9991,7,0.07,9991,9992,1400-9-15,2021-12-06
719,وپسا,س. پتروشيمي ساختمان  خليج فارس,22,263583,436493448,1707,1656,1656,-51,-2.99,1705,-2,-0.12,1656,1656,1400-9-15,2021-12-06
720,اخزا914,اسنادخزانه-م14بودجه99-021025,22,26033,16499716208,634368,631201,634700,332,0.05,633800,-568,-0.09,631201,634701,1400-9-15,2021-12-06
721,غپونه,نوش پونه مشهد,21,36011,432096489,12370,12000,11999,-371,-3,12353,-17,-0.14,11999,12000,1400-9-15,2021-12-06
722,نگين,ص.س. زمين و ساختمان نگين شهرري,21,1429,75109240,52450,53130,52500,50,0.1,52560,110,0.21,51910,53130,1400-9-15,2021-12-06
723,اخزا811,اسنادخزانه-م11بودجه98-001013,21,13407,13173815498,981469,982710,982800,1331,0.14,982607,1138,0.12,981541,982800,1400-9-15,2021-12-06
724,هنوري102,اختيارف ت نوري59561-01/02/15,20,66021,66021,1,1,1,0,0,1,0,0,1,1,1400-9-15,2021-12-06
725,وآفري,بيمه كارآفرين,20,1199130,4199094251,3530,3425,3500,-30,-0.85,3521,-9,-0.25,3425,3539,1400-9-15,2021-12-06
726,ضشنا1048,اختيارخ شپنا-5450-1400/10/19,20,98,134639455,786,800,630,-156,-19.85,749,-37,-4.71,630,801,1400-9-15,2021-12-06
727,برن0104پ01,برنج طارم0104تجارت مازندران(پ),19,1302,602633760,457297,460000,464000,6703,1.47,462852,5555,1.21,460000,464000,1400-9-15,2021-12-06
728,ضصاد1111,اختيارخ وبصادر-1600-1400/11/06,19,1234,350460000,293,300,280,-13,-4.44,284,-9,-3.07,280,313,1400-9-15,2021-12-06
729,اخزا812,اسنادخزانه-م12بودجه98-001111,19,30732,29688272525,965469,965316,965915,446,0.05,966038,569,0.06,965316,968000,1400-9-15,2021-12-06
730,ضفلا1163,اختيارخ فولاد-10000-1400/11/24,19,142,203142000,1589,1450,1411,-178,-11.2,1431,-158,-9.94,1411,1499,1400-9-15,2021-12-06
731,ثروتم,صندوق س. ثروت آفرين پارسيان-س,18,224150,18453233180,83860,83788,82100,-1760,-2.1,82325,-1535,-1.83,82100,84435,1400-9-15,2021-12-06
732,اپرداز,آتيه داده پرداز,18,20809,526238801,26620,25289,25289,-1331,-5,26567,-53,-0.2,25289,25289,1400-9-15,2021-12-06
733,زعف0110پ05,زعفران0110نگين زرين(پ),17,6353,2334721846,370271,380000,378000,7729,2.09,367499,-2772,-0.75,361000,380000,1400-9-15,2021-12-06
734,لپيام,گسترش صنايع پيام,17,52184,1663312816,32859,31874,31874,-985,-3,32690,-169,-0.51,31874,31874,1400-9-15,2021-12-06
735,زعف0110پ21,زعفران0110نگين ملل(پ),17,14320,5325043655,356435,364994,371999,15564,4.37,371861,15426,4.33,364994,378885,1400-9-15,2021-12-06
736,زعف0008پ16,زعفران0008نگين بيرجند(پ),17,1338,361084992,279489,270000,278900,-589,-0.21,269869,-9620,-3.44,269151,279439,1400-9-15,2021-12-06
737,فالوم,آلومتك‌,17,32017,800489034,25775,25002,25002,-773,-3,25711,-64,-0.25,25002,25002,1400-9-15,2021-12-06
738,ثهام,صندوق س ثروت هامرز-سهام,17,4321,46381120,10850,10700,10870,20,0.18,10734,-116,-1.07,10700,10890,1400-9-15,2021-12-06
739,بذر,صندوق س بذر اميد آفرين-سهام,16,3916,365325470,92980,93140,94000,1020,1.1,93290,310,0.33,92870,94000,1400-9-15,2021-12-06
740,ضفلا1165,اختيارخ فولاد-14000-1400/11/24,16,17,5477000,264,349,300,36,13.64,322,58,21.97,298,349,1400-9-15,2021-12-06
741,خبازرس,بازرسي مهندسي و صنعتي ايران,16,18101,412340780,23484,22780,22780,-704,-3,23454,-30,-0.13,22780,22780,1400-9-15,2021-12-06
742,فردا2,صندوق س آواي فرداي زاگرس-ثابت,16,1600000,1600000,11940,1,1,-11939,-99.99,1,-11939,-99.99,1,1,1400-9-15,2021-12-06
743,شساخت,مهندسي و ساختمان صنايع نفت,16,8482,365522772,43837,44000,42522,-1315,-3,43831,-6,-0.01,42522,44000,1400-9-15,2021-12-06
744,اخزا909,اسنادخزانه-م9بودجه99-020316,16,93186,67667481035,725123,723501,726000,877,0.12,726155,1032,0.14,723501,727000,1400-9-15,2021-12-06
745,اخزا809,اسنادخزانه-م9بودجه98-000923,15,6923,6891547781,994601,995555,995690,1089,0.11,995457,856,0.09,995200,995690,1400-9-15,2021-12-06
746,ضستا1003,اختيارخ شستا-10000-1400/10/29,15,76,132368000,1815,1801,1702,-113,-6.23,1742,-73,-4.02,1702,1801,1400-9-15,2021-12-06
747,ساروج,بين المللي ساروج بوشهر,15,54336,848264505,15610,15454,15455,-155,-0.99,15610,0,0,15454,15766,1400-9-15,2021-12-06
748,دمعيار,صندوق س. توازن معيار-د,15,74500,745949262,10004,10014,10013,9,0.09,10013,9,0.09,10006,10015,1400-9-15,2021-12-06
749,وجامي,سرمايه گذاري جامي,14,49618,336906220,6999,6790,6790,-209,-2.99,6992,-7,-0.1,6790,6790,1400-9-15,2021-12-06
750,سي تيپ2ن04,گواهي سيمان تيپ2فارس نو(ن),14,510000,2949840000,5616,5784,5784,168,2.99,5616,0,0,5784,5784,1400-9-15,2021-12-06
751,اخزا911,اسنادخزانه-م11بودجه99-020906,14,51658,33762734426,652833,653655,653626,793,0.12,653582,749,0.11,653500,653655,1400-9-15,2021-12-06
752,دتوليدح,ح. داروسازي توليد دارو,14,83362,539548634,6755,7000,6418,-337,-4.99,6472,-283,-4.19,6418,7000,1400-9-15,2021-12-06
753,ضفرابورس1200,اختيارخ فرابورس-19000-14001218,12,23,65842000,2029,4000,2500,471,23.21,2863,834,41.1,2500,4000,1400-9-15,2021-12-06
754,زعف0110پ20,زعفران0110نگين وحدت جام(پ),12,3664,1336838110,360326,360001,363000,2674,0.74,364858,4532,1.26,360001,370800,1400-9-15,2021-12-06
755,آسام,صندوق س.آرمان سپهر آشنا-م,11,6250,736644000,117598,119000,117800,202,0.17,117863,265,0.23,117800,119000,1400-9-15,2021-12-06
756,اخزا818,اسنادخزانه-م18بودجه98-010614,11,100170,85455129170,852670,853100,853201,531,0.06,853101,431,0.05,853100,853201,1400-9-15,2021-12-06
757,سي تيپ2ن02,گواهي سيمان تيپ2صوفيان(ن),11,282000,1398720000,4816,4960,4960,144,2.99,4816,0,0,4960,4960,1400-9-15,2021-12-06
758,تابا,تابان نيرو سپاهان,11,16878,383248746,23409,22707,22707,-702,-3,23371,-38,-0.16,22707,22707,1400-9-15,2021-12-06
759,زعف0008پ20,زعفران0008نگين وحدت جام(پ),11,11244,3079605713,273996,269151,273996,0,0,273889,-107,-0.04,269151,273996,1400-9-15,2021-12-06
760,اراد61,مرابحه عام دولت61-ش.خ0309,10,100000,100000100000,1000001,1000001,1000001,0,0,1000001,0,0,1000001,1000001,1400-9-15,2021-12-06
761,صعبيد312,صكوك اجاره دعبيد-3ماهه18%,10,100000,100000000000,996000,1000000,1000000,4000,0.4,1000000,4000,0.4,1000000,1000000,1400-9-15,2021-12-06
762,سخند,صندوق س.سپهرخبرگان نفت-د,10,32620,331311540,10143,10150,10195,52,0.51,10157,14,0.14,10150,10195,1400-9-15,2021-12-06
763,شليا,شركت مواد ويژه ليا,10,5872,215613968,38651,36719,36719,-1932,-5,38607,-44,-0.11,36719,36719,1400-9-15,2021-12-06
764,سي تيپ2ن01,گواهي سيمان تيپ 2 فارس(ن),10,479000,2711619000,5497,5661,5661,164,2.98,5497,0,0,5661,5661,1400-9-15,2021-12-06
765,تملي706,تسهيلات مسكن ب. ملي-شهريور97,10,74,50008516,657881,675000,670000,12119,1.84,675791,17910,2.72,649999,690775,1400-9-15,2021-12-06
766,پست0108پ04,پسته فندقي32-30سبزدانه0108(پ),9,82,193702021,2458150,2335243,2581000,122850,5,2362220,-95930,-3.9,2335243,2581057,1400-9-15,2021-12-06
767,سي تيپ2ن06,گواهي سيمان تيپ 2شاهرود(ن),9,447000,2308308000,5113,5164,5164,51,1,5113,0,0,5164,5164,1400-9-15,2021-12-06
768,زعف0008پ19,زعفران0008نگين تروند قاينات(پ),9,3320,895279320,276856,270000,270000,-6856,-2.48,269662,-7194,-2.6,269151,270000,1400-9-15,2021-12-06
769,ضستا1005,اختيارخ شستا-14000-1400/10/29,9,262,83814000,396,330,320,-76,-19.19,320,-76,-19.19,302,330,1400-9-15,2021-12-06
770,زعف0008پ08,زعفران0008نگين روستا(پ),9,1705,503413200,300637,290000,297481,-3156,-1.05,295257,-5380,-1.79,290000,297481,1400-9-15,2021-12-06
771,كمينا,شيشه سازي مينا,9,15885,155673000,10103,9800,9800,-303,-3,10098,-5,-0.05,9800,9800,1400-9-15,2021-12-06
772,اخزا918,اسنادخزانه-م18بودجه99-010323,8,11593,10365147657,891951,893493,895000,3049,0.34,894087,2136,0.24,893493,895700,1400-9-15,2021-12-06
773,ومشان,س. فني و مهندسي مشانير,8,7006,307899688,45307,43948,43948,-1359,-3,45212,-95,-0.21,43948,43948,1400-9-15,2021-12-06
774,زعف0008پ18,زعفران0008نگين بهرامن(پ),8,1390,402470579,286485,297481,297480,10995,3.84,289547,3062,1.07,269151,297481,1400-9-15,2021-12-06
775,زعف0008پ12,زعفران0008پوشالمعمول سحرخيز(پ),8,1021,270665880,261618,264000,265010,3392,1.3,265099,3481,1.33,264000,268000,1400-9-15,2021-12-06
776,ثنام,س ساختماني ب نام آوران مهندسي,8,28567,319293359,11522,11177,11177,-345,-2.99,11510,-12,-0.1,11177,11177,1400-9-15,2021-12-06
777,اخزا815,اسنادخزانه-م15بودجه98-010406,7,5316,4713829079,885344,886700,887201,1857,0.21,886725,1381,0.16,886506,890999,1400-9-15,2021-12-06
778,سي تيپ2ن07,گواهي سيمان تيپ 2تهران(ن),7,229000,1683608000,7138,7352,7352,214,3,7138,0,0,7352,7352,1400-9-15,2021-12-06
779,ثعتما,س. ساختماني اعتماد گستر,7,3599,95103575,27242,26425,26425,-817,-3,27234,-8,-0.03,26425,26425,1400-9-15,2021-12-06
780,ثتوسا,س.توسعه و عمران استان اردبيل,7,20923,301102893,14836,14391,14391,-445,-3,14817,-19,-0.13,14391,14391,1400-9-15,2021-12-06
781,ضملت1135,اختيارخ وبملت-4000-1400/11/13,7,230,17270000,82,47,70,-12,-14.63,75,-7,-8.54,67,88,1400-9-15,2021-12-06
782,ضبدر1164,اختيارخ شبندر-7000-1400/11/13,7,92,44060000,450,499,450,0,0,479,29,6.44,300,499,1400-9-15,2021-12-06
783,ضپال2006,اختيارخ اپال-28000-1401/02/12,6,143,114461000,897,801,801,-96,-10.7,800,-97,-10.81,800,810,1400-9-15,2021-12-06
784,ضذوب901,اختيارخ ذوب-3000-14000917,6,114,35048000,700,88,310,-390,-55.71,307,-393,-56.14,88,420,1400-9-15,2021-12-06
785,ضجار1019,اختيارخ وتجارت-1400-1400/10/15,6,65,32115000,489,510,489,0,0,494,5,1.02,488,510,1400-9-15,2021-12-06
786,شزنگ,تجهيزنيروي‌زنگان‌,6,5000,756195000,155916,151239,151239,-4677,-3,155542,-374,-0.24,151239,151239,1400-9-15,2021-12-06
787,اخزا813,اسنادخزانه-م13بودجه98-010219,6,4986,4557257000,912509,914000,914000,1491,0.16,914011,1502,0.16,914000,914500,1400-9-15,2021-12-06
788,اراد86,مرابحه عام دولت86-ش.خ020404,6,10000,9574489000,940227,950000,984489,44262,4.71,957449,17222,1.83,950000,984489,1400-9-15,2021-12-06
789,كباده,توليد خاك نسوزاستقلال آباده,6,5299,133863338,24527,25262,25262,735,3,24536,9,0.04,25262,25262,1400-9-15,2021-12-06
790,سي تيپ2ن12,گواهي سيمان تيپ2خزر(ن),6,317000,1645230000,5139,5190,5190,51,0.99,5139,0,0,5190,5190,1400-9-15,2021-12-06
791,هكشو208,اختيارف ت پاكشو10000-02/08/29,5,216000,115560000,531,535,535,4,0.75,535,4,0.75,535,535,1400-9-15,2021-12-06
792,سخواف,سيمان مجد خواف,5,3724,27937448,7734,7502,7502,-232,-3,7733,-1,-0.01,7502,7502,1400-9-15,2021-12-06
793,سي تيپ2ن11,گواهي سيمان تيپ2دورود(ن),5,246000,1244268000,5008,5058,5058,50,1,5008,0,0,5058,5058,1400-9-15,2021-12-06
794,كيان2,صندوق س. با درآمد ثابت كيان,5,500000,500000,31903,1,1,-31902,-100,1,-31902,-100,1,1,1400-9-15,2021-12-06
795,اخزا810,اسنادخزانه-م10بودجه98-001006,5,663,654304043,986535,987000,987000,465,0.05,986884,349,0.04,986601,989000,1400-9-15,2021-12-06
796,شمواد,توليد مواداوليه الياف مصنوعي,5,3224,145985944,46205,45281,45281,-924,-2,46177,-28,-0.06,45281,45281,1400-9-15,2021-12-06
797,بايكا,كارخانجات كابلسازي ‌ايران‌,5,6160,118247360,19789,19196,19196,-593,-3,19782,-7,-0.04,19196,19196,1400-9-15,2021-12-06
798,ضمخا1035,اختيارخ اخابر-7000-1400/10/26,5,100,72541000,836,751,700,-136,-16.27,725,-111,-13.28,700,751,1400-9-15,2021-12-06
799,صخابر102,صكوك اجاره مخابرات-3 ماهه 16%,5,50000,49575000000,991500,991500,991500,0,0,991500,0,0,991500,991500,1400-9-15,2021-12-06
800,زعف0008پ15,زعفران0008پوشالمعمول طلاسرخ(پ),5,193,48597800,237526,244077,263900,26374,11.1,251802,14276,6.01,244077,264900,1400-9-15,2021-12-06
801,وحافظ,بيمه حافظ,5,93608,856232376,9429,9147,9147,-282,-2.99,9404,-25,-0.27,9147,9147,1400-9-15,2021-12-06
802,ضشنا1049,اختيارخ شپنا-6540-1400/10/19,5,19,10147550,408,300,290,-118,-28.92,291,-117,-28.68,290,300,1400-9-15,2021-12-06
803,اخزا904,اسنادخزانه-م4بودجه99-011215,4,31000,23870000000,770000,770000,770000,0,0,770000,0,0,770000,770000,1400-9-15,2021-12-06
804,ضملت1131,اختيارخ وبملت-2000-1400/11/13,4,170,187000000,1018,1100,1100,82,8.06,1100,82,8.06,1100,1100,1400-9-15,2021-12-06
805,اراد33,مرابحه عام دولت3-ش.خ 0303,4,2300,2168639400,943590,942000,943569,-21,0,942887,-703,-0.07,942000,943569,1400-9-15,2021-12-06
806,اراد864,مرابحه عام دولت86-ش.خ020404,4,26412400,24380624902200,940227,923032,923140,-17087,-1.82,923075,-17152,-1.82,922941,923140,1400-9-15,2021-12-06
807,سپرمي,پرميت‌,4,3991,46511114,11539,11654,11654,115,1,11542,3,0.03,11654,11654,1400-9-15,2021-12-06
808,حرهشا,رهشاد سپاهان (سهامي عام,4,800,80094400,103214,100118,100118,-3096,-3,103181,-33,-0.03,100118,100118,1400-9-15,2021-12-06
809,پادا,صندوق س.پاداش سرمايه پارس-س,4,1050,110160000,103773,104200,105200,1427,1.38,104914,1141,1.1,104200,105200,1400-9-15,2021-12-06
810,سي تيپ2ن10,گواهي سيمان تيپ 2غرب(ن),4,100000,484100000,4794,4841,4841,47,0.98,4794,0,0,4841,4841,1400-9-15,2021-12-06
811,اخزا907,اسنادخزانه-م7بودجه99-020704,4,33524,23064512000,688259,688000,688000,-259,-0.04,688000,-259,-0.04,688000,688000,1400-9-15,2021-12-06
812,ضپنا1031,اختيارخ رمپنا-13850-1400/10/08,4,25,50600000,2431,2150,2000,-431,-17.73,2024,-407,-16.74,2000,2150,1400-9-15,2021-12-06
813,اخزا816,اسنادخزانه-م16بودجه98-010503,4,25257,22054572450,872192,872581,873190,998,0.11,873206,1014,0.12,872581,877900,1400-9-15,2021-12-06
814,صايپا012,صكوك مرابحه سايپا012-3ماهه 16%,4,35000,35000035000,1000000,1000001,1000001,1,0,1000001,1,0,1000001,1000001,1400-9-15,2021-12-06
815,ساذري,آذريت‌,4,3294,31263354,9784,9491,9491,-293,-2.99,9783,-1,-0.01,9491,9491,1400-9-15,2021-12-06
816,سايرا,ايرانيت‌,4,65170,1898793120,29730,29136,29136,-594,-2,29496,-234,-0.79,29136,29136,1400-9-15,2021-12-06
817,اخزا814,اسنادخزانه-م14بودجه98-010318,4,2513,2255261623,896191,896501,897506,1315,0.15,897438,1247,0.14,896501,897506,1400-9-15,2021-12-06
818,ضمخا1034,اختيارخ اخابر-6000-1400/10/26,4,12,17405000,1446,1510,1345,-101,-6.98,1450,4,0.28,1345,1510,1400-9-15,2021-12-06
819,اخزا817,اسنادخزانه-م17بودجه98-010512,4,50000,43450000000,867662,869000,869000,1338,0.15,869000,1338,0.15,869000,869000,1400-9-15,2021-12-06
820,كيش1402,اجاره س. و توسعه كيش14020820,3,800,800000000,1000000,1000000,1000000,0,0,1000000,0,0,1000000,1000000,1400-9-15,2021-12-06
821,ويستا2,صندوق س. ويستا -س,3,400000,400000,10082,1,1,-10081,-99.99,1,-10081,-99.99,1,1,1400-9-15,2021-12-06
822,افران2,صندوق س افرا نماد پايدار-ثابت,3,48400000,48400000,14914,1,1,-14913,-99.99,1,-14913,-99.99,1,1,1400-9-15,2021-12-06
823,اخزا009,اسناد خزانه-م9بودجه00-031101,3,121,59882900,489889,494900,494900,5011,1.02,494900,5011,1.02,494900,494900,1400-9-15,2021-12-06
824,كمند4,صندوق س. با درآمد ثابت كمند,3,230273625,2342012073500,10159,10168,10168,9,0.09,10171,12,0.12,10168,10172,1400-9-15,2021-12-06
825,سي تيپ2ن03,گواهي سيمان تيپ2اروميه(ن),3,75000,363075000,4794,4841,4841,47,0.98,4794,0,0,4841,4841,1400-9-15,2021-12-06
826,خفناور,مهندسي صنعتي روان فن آور,3,780,30019080,39676,38486,38486,-1190,-3,39672,-4,-0.01,38486,38486,1400-9-15,2021-12-06
827,كهربا2,صندوق س.پشتوانه سكه طلا كهربا,3,300000,300000,11275,1,1,-11274,-99.99,1,-11274,-99.99,1,1,1400-9-15,2021-12-06
828,واحصا,احياء صنايع خراسان,3,599,27640256,47571,46144,46144,-1427,-3,47567,-4,-0.01,46144,46144,1400-9-15,2021-12-06
829,پارتا,مجتمع‌صنعتي‌آرتاويل‌تاير,3,854,20236384,24428,23696,23696,-732,-3,24427,-1,0,23696,23696,1400-9-15,2021-12-06
830,سي تيپ2ن19,گواهي سيمان تيپ2غرب آسيا(ن),3,130000,623220000,4794,4794,4794,0,0,4794,0,0,4794,4794,1400-9-15,2021-12-06
831,ضفلا1162,اختيارخ فولاد-9000-1400/11/24,3,9,18802000,2475,2101,2050,-425,-17.17,2089,-386,-15.6,2050,2101,1400-9-15,2021-12-06
832,طپاس1011,اختيارف وپارس-2000-1400/10/22,3,4,325000,58,70,85,27,46.55,81,23,39.66,70,85,1400-9-15,2021-12-06
833,اخزا821,اسنادخزانه-م21بودجه98-020906,3,3860,2511208220,650327,650327,650800,473,0.07,650572,245,0.04,650327,650800,1400-9-15,2021-12-06
834,ضستا1006,اختيارخ شستا-16000-1400/10/29,3,20,2000000,100,100,100,0,0,100,0,0,100,100,1400-9-15,2021-12-06
835,اراد544,مرابحه عام دولت5-ش.خ 0109,3,10011400,9532895061200,990000,951806,952310,-37690,-3.81,952204,-37796,-3.82,951806,952310,1400-9-15,2021-12-06
836,ضمخا1036,اختيارخ اخابر-8000-1400/10/26,3,8,1806000,202,240,202,0,0,226,24,11.88,202,240,1400-9-15,2021-12-06
837,تمحركه,ماشين سازي نيرو محركه,3,5504,104922752,19652,19063,19063,-589,-3,19646,-6,-0.03,19063,19063,1400-9-15,2021-12-06
838,افاد624,منفعت دولت6-ش.خاص ملت0109,2,10000000,9771800000000,1000000,966360,988000,-12000,-1.2,977180,-22820,-2.28,966360,988000,1400-9-15,2021-12-06
839,دپارسح,ح . پارس‌ دارو,2,265,11925000,45000,45000,45000,0,0,45000,0,0,45000,45000,1400-9-15,2021-12-06
840,اراد244,مرابحه عام دولت2-ش.خ ساير0212,2,8000000,7386076000000,1000000,923119,923400,-76600,-7.66,923259,-76741,-7.67,923119,923400,1400-9-15,2021-12-06
841,تملي711,تسهيلات مسكن ب. ملي-بهمن97,2,36,24322032,643440,675612,675612,32172,5,675612,32172,5,675612,675612,1400-9-15,2021-12-06
842,اخزا905,اسنادخزانه-م5بودجه99-020218,2,1732,1283446930,743307,741000,745990,2683,0.36,741020,-2287,-0.31,741000,745990,1400-9-15,2021-12-06
843,اراد364,مرابحه عام دولت3-ش.خ 0104,2,40000000,38227880000000,966200,967894,943500,-22700,-2.35,955697,-10503,-1.09,943500,967894,1400-9-15,2021-12-06
844,طجار1020,اختيارف وتجارت-1600-1400/10/15,2,85,3825000,45,45,45,0,0,45,0,0,45,45,1400-9-15,2021-12-06
845,اخزا820,اسنادخزانه-م20بودجه98-020806,2,503,337999509,671070,666503,672000,930,0.14,671967,897,0.13,666503,672000,1400-9-15,2021-12-06
846,همبين102,اختيارف ت مبين17952-01/02/10,2,200000,200000,1,1,1,0,0,1,0,0,1,1,1400-9-15,2021-12-06
847,پر ه 12,پر باري هفته 12,2,20000,13000000,250000,650,650,-249350,-99.74,650,-249350,-99.74,650,650,1400-9-15,2021-12-06
848,ضپال2001,اختيارخ اپال-14000-1401/02/12,2,2,20000000,11770,10000,10000,-1770,-15.04,10000,-1770,-15.04,10000,10000,1400-9-15,2021-12-06
849,اتكاي2,بيمه اتكايي ايرانيان,2,40000000,428000000000,10765,10700,10700,-65,-0.6,10700,-65,-0.6,10700,10700,1400-9-15,2021-12-06
850,زيتون2,صندوق س زيتون نماد پايا- مختلط,2,380000,380000,9479,1,1,-9478,-99.99,1,-9478,-99.99,1,1,1400-9-15,2021-12-06
851,طملت1133,اختيارف وبملت-3000-1400/11/13,2,5,210000,180,42,42,-138,-76.67,42,-138,-76.67,42,42,1400-9-15,2021-12-06
852,اراد394,مرابحه عام دولت3-ش.خ 0204,2,60000000,57119820000000,1000000,933574,970420,-29580,-2.96,951997,-48003,-4.8,933574,970420,1400-9-15,2021-12-06
853,اراد454,مرابحه عام دولت4-ش.خ 0107,2,14123200,13669004949600,967044,958981,976700,9656,1,967840,796,0.08,958981,976700,1400-9-15,2021-12-06
854,اراد854,مرابحه عام دولت85-ش.خ010704,2,20000000,19103290000000,961000,953389,956940,-4060,-0.42,955164,-5836,-0.61,953389,956940,1400-9-15,2021-12-06
855,اخزا8124,اسنادخزانه-م12بودجه98-001111,2,6768720,6560429563800,965469,969235,969220,3751,0.39,969227,3758,0.39,969220,969235,1400-9-15,2021-12-06
856,اراد584,مرابحه عام دولت5-ش.خ 0110,2,14200000,13543730000000,960000,971771,946730,-13270,-1.38,953784,-6216,-0.65,946730,971771,1400-9-15,2021-12-06
857,اراد524,مرابحه عام دولت5-ش.خ 0108,2,14000000,13497750000000,1000000,954000,974250,-25750,-2.58,964125,-35875,-3.59,954000,974250,1400-9-15,2021-12-06
858,افاد44,منفعت دولتي4-شرايط خاص14010729,2,20000000,19609650000000,999999,970815,990150,-9849,-0.98,980482,-19517,-1.95,970815,990150,1400-9-15,2021-12-06
859,اراد124,مرابحه عام دولت1-ش.خ ملت0206,2,19998000,19227917016000,1000000,940484,982500,-17500,-1.75,961492,-38508,-3.85,940484,982500,1400-9-15,2021-12-06
860,سنوين,سرمايه گذاري اقتصاد نوين,2,2500,16560000,6972,6624,6624,-348,-4.99,6971,-1,-0.01,6624,6624,1400-9-15,2021-12-06
861,سرو2,صندوق س سروسودمند مدبران-سهام,2,770000,770000,68660,1,1,-68659,-100,1,-68659,-100,1,1,1400-9-15,2021-12-06
862,سيناد,صندوق س.سپهرسودمند سينا-د,2,1082,10836230,10015,10015,10015,0,0,10015,0,0,10015,10015,1400-9-15,2021-12-06
863,زير0103پ01,زيره سبز0103كيميابذر(پ),2,200,182000000,900000,920000,900000,0,0,910000,10000,1.11,900000,920000,1400-9-15,2021-12-06
864,اخزا8154,اسنادخزانه-م15بودجه98-010406,2,6348760,5663366916680,885344,892036,892050,6706,0.76,892043,6699,0.76,892036,892050,1400-9-15,2021-12-06
865,اراد404,مرابحه عام دولت4-ش.خ 0207,2,47000000,44429875500000,1000000,923733,966900,-33100,-3.31,945316,-54684,-5.47,923733,966900,1400-9-15,2021-12-06
866,اراد384,مرابحه عام دولت3-ش.خ 0105,2,50000000,48666200000000,1000000,965983,980665,-19335,-1.93,973324,-26676,-2.67,965983,980665,1400-9-15,2021-12-06
867,سي تيپ2ن13,گواهي سيمان تيپ2بجنورد(ن),2,45000,260550000,5733,5790,5790,57,0.99,5733,0,0,5790,5790,1400-9-15,2021-12-06
868,سي تيپ2ن21,گواهي سيمان تيپ2زاوه تربت(ن),2,50000,246850000,4794,4937,4937,143,2.98,4794,0,0,4937,4937,1400-9-15,2021-12-06
869,اراد324,مرابحه عام دولت3-ش.خ0211,2,1830000,1654974225000,1000000,880815,927900,-72100,-7.21,904357,-95643,-9.56,880815,927900,1400-9-15,2021-12-06
870,كرماشا2,صنايع پتروشيمي كرمانشاه,2,1500000,79500000000,52540,53000,53000,460,0.88,53000,460,0.88,53000,53000,1400-9-15,2021-12-06
871,ضپاس1011,اختيارخ وپارس-2000-1400/10/22,2,3,391000,300,151,120,-180,-60,130,-170,-56.67,120,151,1400-9-15,2021-12-06
872,اخزا8144,اسنادخزانه-م14بودجه98-010318,2,4887000,4407182122500,896191,901635,902000,5809,0.65,901817,5626,0.63,901635,902000,1400-9-15,2021-12-06
873,ضجار1024,اختيارخ وتجارت-3000-1400/10/15,2,200,2000000,24,10,10,-14,-58.33,10,-14,-58.33,10,10,1400-9-15,2021-12-06
874,كمند2,صندوق س. با درآمد ثابت كمند,2,196300000,196300000,10159,1,1,-10158,-99.99,1,-10158,-99.99,1,1,1400-9-15,2021-12-06
875,شگويات.ف0104,اختيارف.تبعي شگويا010408,2,20000,20000,1,1,1,0,0,1,0,0,1,1,1400-9-15,2021-12-06
876,اراد344,مرابحه عام دولت3-ش.خ 0305,2,16000000,14116296000000,1000000,850637,913900,-86100,-8.61,882268,-117732,-11.77,850637,913900,1400-9-15,2021-12-06
877,افاد614,منفعت دولت6-ش.خاص140109,2,6000000,5797911000000,1015000,966287,966350,-48650,-4.79,966318,-48682,-4.8,966287,966350,1400-9-15,2021-12-06
878,هفجر102,اختيارف ت بفجر8626-01/02/11,2,100000,100000,1,1,1,0,0,1,0,0,1,1,1400-9-15,2021-12-06
879,زير0103پ02,زيره سبز0103 دانش(پ),2,28,25440000,946420,900000,930000,-16420,-1.73,908571,-37849,-4,900000,930000,1400-9-15,2021-12-06
880,اراد814,مرابحه عام دولت81-ش.خ010812,2,40000000,38217440000000,1000000,955372,955500,-44500,-4.45,955436,-44564,-4.46,955372,955500,1400-9-15,2021-12-06
881,ضصاد1110,اختيارخ وبصادر-1400-1400/11/06,2,20,8640000,429,439,425,-4,-0.93,432,3,0.7,425,439,1400-9-15,2021-12-06
882,كمان,س.خ.كمان كاريزما 35% تاديه,2,18000,6793614000,377216,377423,377423,207,0.05,377423,207,0.05,377423,377423,1400-9-15,2021-12-06
883,ضبدر1162,اختيارخ شبندر-5000-1400/11/13,2,11,17610000,1630,1601,1600,-30,-1.84,1601,-29,-1.78,1600,1601,1400-9-15,2021-12-06
884,ضپاس1009,اختيارخ وپارس-1600-1400/10/22,2,10,4580000,455,458,458,3,0.66,458,3,0.66,458,458,1400-9-15,2021-12-06
885,زعف0110پ16,زعفران0110نگين بيرجند(پ),2,47,17440934,366076,368998,376000,9924,2.71,371084,5008,1.37,368998,376000,1400-9-15,2021-12-06
886,سي تيپ2ن14,گواهي سيمان تيپ2ساوه(ن),2,105000,666330000,6162,6346,6346,184,2.99,6162,0,0,6346,6346,1400-9-15,2021-12-06
887,گپارس,امور رفاهي كارگزاران پارس,2,5000,652370000,134509,130474,130474,-4035,-3,134237,-272,-0.2,130474,130474,1400-9-15,2021-12-06
888,اراد424,مرابحه عام دولت4-ش.خ 0106,2,10000000,9816550000000,998500,983610,979700,-18800,-1.88,981655,-16845,-1.69,979700,983610,1400-9-15,2021-12-06
889,فولاد2,فولاد مباركه اصفهان,1,24224806,249999997920,10320,10320,10320,0,0,10320,0,0,10320,10320,1400-9-15,2021-12-06
890,شخارك2,پتروشيمي‌ خارك‌,1,4883766,249999981540,51190,51190,51190,0,0,51190,0,0,51190,51190,1400-9-15,2021-12-06
891,ضشنا1051,اختيارخ شپنا-8719-1400/10/19,1,30,5174700,82,94,94,12,14.63,94,12,14.63,94,94,1400-9-15,2021-12-06
892,زعف0110پ09,زعفران0110نگين نوين(پ),1,200,75600000,362720,378000,378000,15280,4.21,378000,15280,4.21,378000,378000,1400-9-15,2021-12-06
893,داريوش2,صندوق س. ثروت داريوش -س,1,200000,200000,9544,1,1,-9543,-99.99,1,-9543,-99.99,1,1,1400-9-15,2021-12-06
894,تملي703,تسهيلات مسكن ب. ملي-خرداد97,1,9,5052033,590881,561337,561337,-29544,-5,561337,-29544,-5,561337,561337,1400-9-15,2021-12-06
895,وبانك2,سرمايه گذاري گروه توسعه ملي,1,62345000,500006900000,8020,8020,8020,0,0,8020,0,0,8020,8020,1400-9-15,2021-12-06
896,اخزا9172,اسنادخزانه-م17بودجه99-010226,1,1000000,908700000000,908620,908700,908700,80,0.01,908700,80,0.01,908700,908700,1400-9-15,2021-12-06
897,صگل039,صكوك اجاره گل گهر039-3ماهه20%,1,185,192400000,1035000,1040000,1040000,5000,0.48,1040000,5000,0.48,1040000,1040000,1400-9-15,2021-12-06
898,ثنظام,س. ساختماني نظام مهندسي ايران,1,700,14910700,21959,21301,21301,-658,-3,21958,-1,0,21301,21301,1400-9-15,2021-12-06
899,دماوند4,توليد نيروي برق دماوند,1,142681128,3923731020000,23083,27500,27500,4417,19.14,27500,4417,19.14,27500,27500,1400-9-15,2021-12-06
900,صملي404,صكوك اجاره صملي404-6ماهه18%,1,10,9900000,990000,990000,990000,0,0,990000,0,0,990000,990000,1400-9-15,2021-12-06
901,اوصتا4,صندوق انديشه ورزان صباتامين -د,1,33737017,699671995563,20728,20739,20739,11,0.05,20739,11,0.05,20739,20739,1400-9-15,2021-12-06
902,اراد624,مرابحه عام دولت62-ش.خ0309,1,6996000,6248533368000,1000000,893158,893158,-106842,-10.68,893158,-106842,-10.68,893158,893158,1400-9-15,2021-12-06
903,کم ه 12,کم باري هفته 12,1,10000,5000000,560,500,500,-60,-10.71,500,-60,-10.71,500,500,1400-9-15,2021-12-06
904,طملت1134,اختيارف وبملت-3500-1400/11/13,1,1,60000,1,60,60,59,5900,60,59,5900,60,60,1400-9-15,2021-12-06
905,صپا ه 12,بار پايه هفته 12صنعتي,1,1490,849300,570,570,570,0,0,570,0,0,570,570,1400-9-15,2021-12-06
906,تملي805,تسهيلات مسكن ب. ملي-مرداد98,1,1,731500,769999,731500,731500,-38499,-5,731500,-38499,-5,731500,731500,1400-9-15,2021-12-06
907,ضذوب903,اختيارخ ذوب-4000-14000917,1,1,1000,12,1,1,-11,-91.67,1,-11,-91.67,1,1,1400-9-15,2021-12-06
908,ضستا1007,اختيارخ شستا-18000-1400/10/29,1,2,204000,100,102,102,2,2,102,2,2,102,102,1400-9-15,2021-12-06
909,اخزا9182,اسنادخزانه-م18بودجه99-010323,1,1100000,984610000000,891951,895100,895100,3149,0.35,895100,3149,0.35,895100,895100,1400-9-15,2021-12-06
910,اراد87,مرابحه عام دولت87-ش.خ030304,1,1000,970000000,928016,970000,970000,41984,4.52,970000,41984,4.52,970000,970000,1400-9-15,2021-12-06
911,پارس2,پتروشيمي پارس,1,1575000,299076750000,189640,189890,189890,250,0.13,189890,250,0.13,189890,189890,1400-9-15,2021-12-06
912,اراد904,مرابحه عام دولت90-ش.خ050217,1,6000000,5172810000000,1000000,862135,862135,-137865,-13.79,862135,-137865,-13.79,862135,862135,1400-9-15,2021-12-06
913,آريا2,پليمر آريا ساسول,1,1450000,160558500000,110783,110730,110730,-53,-0.05,110730,-53,-0.05,110730,110730,1400-9-15,2021-12-06
914,كهرام,توليدي گرانيت بهسرام,1,58,5041882,88703,86929,86929,-1774,-2,88701,-2,0,86929,86929,1400-9-15,2021-12-06
915,وسالت,بانك قرض الحسنه رسالت,1,5046,5459772,1051,1082,1082,31,2.95,1051,0,0,1082,1082,1400-9-15,2021-12-06
916,شرنگي4,شيميايي رنگين,1,400000,71244400000,172924,178111,178111,5187,3,178111,5187,3,178111,178111,1400-9-15,2021-12-06
917,ضذوب900,اختيارخ ذوب-2500-14000917,1,3,2850000,1200,950,950,-250,-20.83,950,-250,-20.83,950,950,1400-9-15,2021-12-06
918,سبرق021,سلف موازي برق صادراتي گيلان021,1,261000,49981500000,191000,191500,191500,500,0.26,191500,500,0.26,191500,191500,1400-9-15,2021-12-06
919,اراد644,مرابحه عام دولتي64-ش.خ0111,1,10000000,9403490000000,944500,940349,940349,-4151,-0.44,940349,-4151,-0.44,940349,940349,1400-9-15,2021-12-06
920,شپاس2,نفت پاسارگاد,1,19851773,300198511306,15112,15122,15122,10,0.07,15122,10,0.07,15122,15122,1400-9-15,2021-12-06
921,ضفار1133,اختيارخ فارس-11400-1400/11/06,1,6,3600000,690,600,600,-90,-13.04,600,-90,-13.04,600,600,1400-9-15,2021-12-06
922,ثمين2,صندوق س. ثروت افزون ثمين-س,1,400000,400000,10014,1,1,-10013,-99.99,1,-10013,-99.99,1,1,1400-9-15,2021-12-06
923,ضذوب904,اختيارخ ذوب-4500-14000917,1,10,10000,100,1,1,-99,-99,1,-99,-99,1,1,1400-9-15,2021-12-06
924,قجام,فرآوردههاي غذايي وقندتربت‌جام‌,1,5000,31100000,6346,6220,6220,-126,-1.99,6345,-1,-0.02,6220,6220,1400-9-15,2021-12-06
925,شلرد022,كود شيميايي اوره لردگان,1,50000,50000000000,997000,1000000,1000000,3000,0.3,1000000,3000,0.3,1000000,1000000,1400-9-15,2021-12-06
926,بورس2,بورس اوراق بهادار تهران,1,933331,11069305660,11400,11860,11860,460,4.04,11860,460,4.04,11860,11860,1400-9-15,2021-12-06
927,ضترا1132,اختيارخ شتران-3970-1400/11/10,1,2,2267000,650,500,500,-150,-23.08,500,-150,-23.08,500,500,1400-9-15,2021-12-06
928,پست0108پ09,پسته بادامي32-30مه ولات0108(پ),1,3,6829407,2168066,2276469,2276469,108403,5,2276469,108403,5,2276469,2276469,1400-9-15,2021-12-06
929,اراد76,مرابحه عام دولت76-ش.خ030406,1,5000,4900000000,1008000,980000,980000,-28000,-2.78,980000,-28000,-2.78,980000,980000,1400-9-15,2021-12-06
930,ضملي1162,اختيارخ فملي-8000-1400/11/03,1,1,596000,550,298,298,-252,-45.82,298,-252,-45.82,298,298,1400-9-15,2021-12-06
931,ومدير2,گ.مديريت ارزش سرمايه ص ب كشوري,1,89900000,378838600000,4204,4214,4214,10,0.24,4214,10,0.24,4214,4214,1400-9-15,2021-12-06
932,كچاد2,معدني‌وصنعتي‌چادرملو,1,7410152,200000002480,26990,26990,26990,0,0,26990,0,0,26990,26990,1400-9-15,2021-12-06
933,صفارس412,صكوك اجاره خليج فارس- 3ماهه16%,1,5,5000000,1020000,1000000,1000000,-20000,-1.96,1000000,-20000,-1.96,1000000,1000000,1400-9-15,2021-12-06
934,فبستم,صنايع ‌بسته‌بندي‌ مشهد,1,9577,7833986,795,818,818,23,2.89,795,0,0,818,818,1400-9-15,2021-12-06
935,ضسان1049,اختيارخ پارسان-18000-00/10/12,1,4,56000000,14000,14000,14000,0,0,14000,0,0,14000,14000,1400-9-15,2021-12-06
936,خعمرا,توسعه و عمران شهرستان نائين,1,1000,4374000,4247,4374,4374,127,2.99,4247,0,0,4374,4374,1400-9-15,2021-12-06
937,اراد734,مرابحه عام دولت73-ش.خ0402,1,5000000,4415995000000,960050,883199,883199,-76851,-8,883199,-76851,-8,883199,883199,1400-9-15,2021-12-06
938,ضجار1021,اختيارخ وتجارت-1800-1400/10/15,1,1,250000,239,250,250,11,4.6,250,11,4.6,250,250,1400-9-15,2021-12-06
939,مشهد0012,مشاركت شهرداري مشهد-3ماهه20%,1,10,10000000,1000000,1000000,1000000,0,0,1000000,0,0,1000000,1000000,1400-9-15,2021-12-06
940,شرق1400,مشاركت ليزينگ ايران وشرق140010,1,5,5029955,999800,1005991,1005991,6191,0.62,1005991,6191,0.62,1005991,1005991,1400-9-15,2021-12-06
941,تصميم2,صندوق س با درآمد ثابت تصميم,1,600000,600000,18129,1,1,-18128,-99.99,1,-18128,-99.99,1,1,1400-9-15,2021-12-06
942,جم2,پتروشيمي جم,1,21000000,1016610000000,48410,48410,48410,0,0,48410,0,0,48410,48410,1400-9-15,2021-12-06
943,زير0103پ04,زيره سبز0103شركت مينوبذر(پ),1,6,5400000,908477,900000,900000,-8477,-0.93,900000,-8477,-0.93,900000,900000,1400-9-15,2021-12-06
944,صبا14044,اجاصبابدون ضامن بارتبه اعتباري,1,800000,800328000000,1000000,1000410,1000410,410,0.04,1000410,410,0.04,1000410,1000410,1400-9-15,2021-12-06
945,اروند10,منفعت صبا اروند لوتوس 14001222,1,10,9900000,1000000,990000,990000,-10000,-1,990000,-10000,-1,990000,990000,1400-9-15,2021-12-06
946,ضترا1133,اختيارخ شتران-4411-1400/11/10,1,2,1450880,329,320,320,-9,-2.74,320,-9,-2.74,320,320,1400-9-15,2021-12-06
947,اخزا906,اسنادخزانه-م6بودجه99-020321,1,3479,2514099350,722082,722650,722650,568,0.08,722650,568,0.08,722650,722650,1400-9-15,2021-12-06
948,افاد61,منفعت دولت6-ش.خاص140109,1,2000,1994000000,1015000,997000,997000,-18000,-1.77,997000,-18000,-1.77,997000,997000,1400-9-15,2021-12-06
949,دقاضي2,داروسازي شهيد قاضي,1,3000000,85359000000,28453,28453,28453,0,0,28453,0,0,28453,28453,1400-9-15,2021-12-06
950,ضملي1159,اختيارخ فملي-5000-1400/11/03,1,5,20000000,4000,2000,2000,-2000,-50,2000,-2000,-50,2000,2000,1400-9-15,2021-12-06
951,ضبدر1161,اختيارخ شبندر-4500-1400/11/13,1,5,10000000,1972,2000,2000,28,1.42,2000,28,1.42,2000,2000,1400-9-15,2021-12-06
952,کم ر 29,کم باري روز 29,1,15000,7500000,920,500,500,-420,-45.65,500,-420,-45.65,500,500,1400-9-15,2021-12-06
953,شپنا2,پالايش نفت اصفهان,1,6878686,40584247400,5910,5900,5900,-10,-0.17,5900,-10,-0.17,5900,5900,1400-9-15,2021-12-06
954,ضترا1130,اختيارخ شتران-3089-1400/11/10,1,2,5848860,1300,1290,1290,-10,-0.77,1290,-10,-0.77,1290,1290,1400-9-15,2021-12-06
955,ضپنا1032,اختيارخ رمپنا-15850-1400/10/08,1,2,1200000,1000,600,600,-400,-40,600,-400,-40,600,600,1400-9-15,2021-12-06
