,نماد,نام,تعداد,حجم,ارزش,دیروز,اولین,آخرین معامله - مقدار,آخرین معامله - تغییر,آخرین معامله - درصد,قیمت پایانی - مقدار,قیمت پایانی - تغییر,قیمت پایانی - درصد,کمترین,بیشترین,تاریخ,gregorian_date
0,پالايش,صندوق پالايشي يكم-سهام,23864,21943290,1524370204850,70840,71600,68330,-2510,-3.54,69470,-1370,-1.93,68130,71970,1400-2-18,2021-05-08
1,فملي,ملي‌ صنايع‌ مس‌ ايران‌,18880,113071053,1377278473820,11830,12480,12000,170,1.44,12180,350,2.96,11970,12480,1400-2-18,2021-05-08
2,دارا يكم,صندوق واسطه گري مالي يكم-سهام,18612,14610688,1989742313820,137990,139140,134170,-3820,-2.77,136180,-1810,-1.31,133990,139700,1400-2-18,2021-05-08
3,وسپهر,سرمايه گذاري مالي سپهرصادرات,10613,39023047,394134047182,10100,10100,10100,0,0,10100,0,0,10100,10101,1400-2-18,2021-05-08
4,شستا,سرمايه گذاري تامين اجتماعي,10321,52957987,560259687600,10860,10770,10540,-320,-2.95,10580,-280,-2.58,10540,10980,1400-2-18,2021-05-08
5,وپاسار,بانك  پاسارگاد,9035,65071404,1082103795070,16020,16580,16600,580,3.62,16630,610,3.81,16200,16850,1400-2-18,2021-05-08
6,وتجارت,بانك تجارت,8385,222878557,550816161735,2498,2520,2467,-31,-1.24,2471,-27,-1.08,2430,2550,1400-2-18,2021-05-08
7,اپال,فرآوري معدني اپال كاني پارس,8208,5765669,99127669280,17180,17180,17190,10,0.06,17190,10,0.06,17160,17280,1400-2-18,2021-05-08
8,فولاد,فولاد مباركه اصفهان,8182,45623577,544485078010,11970,12010,11820,-150,-1.25,11930,-40,-0.33,11680,12350,1400-2-18,2021-05-08
9,شپنا,پالايش نفت اصفهان,7598,57498938,574865590870,10210,10210,9910,-300,-2.94,10000,-210,-2.06,9910,10410,1400-2-18,2021-05-08
10,وبصادر,بانك صادرات ايران,6771,159136087,355004271667,2215,2260,2217,2,0.09,2231,16,0.72,2216,2279,1400-2-18,2021-05-08
11,بوعلي,پتروشيمي بوعلي سينا,6734,3375826,144532891240,42550,41800,42000,-550,-1.29,42810,260,0.61,41670,43450,1400-2-18,2021-05-08
12,امينح,ح . تامين سرمايه امين,6414,4827676,22718129301,4960,4880,4720,-240,-4.84,4706,-254,-5.12,4663,4950,1400-2-18,2021-05-08
13,پترول,گ.س.وت.ص.پتروشيمي خليج فارس,6069,37062219,294044283240,8090,8130,7900,-190,-2.35,7930,-160,-1.98,7850,8200,1400-2-18,2021-05-08
14,كمند,صندوق س. با درآمد ثابت كمند,5499,195758936,1960931851219,10170,10017,10017,-153,-1.5,10017,-153,-1.5,10016,10019,1400-2-18,2021-05-08
15,وكبهمن,مديريت سرمايه گذاري كوثربهمن,5231,3414042,34319971744,10270,10030,10004,-266,-2.59,10118,-152,-1.48,9963,10165,1400-2-18,2021-05-08
16,سيتا,سرمايه گذاري سيمان تامين,4902,8335645,125039246660,15000,15000,15000,0,0,15000,0,0,15000,15010,1400-2-18,2021-05-08
17,آريا,پليمر آريا ساسول,4683,1691581,145344373325,86575,85450,85001,-1574,-1.82,85922,-653,-0.75,84460,87700,1400-2-18,2021-05-08
18,شتران,پالايش نفت تهران,4670,42017824,332024321900,8110,8000,7870,-240,-2.96,7900,-210,-2.59,7870,8150,1400-2-18,2021-05-08
19,خودرو,ايران‌ خودرو,4658,149119762,291055244447,1999,2000,1940,-59,-2.95,1952,-47,-2.35,1940,2020,1400-2-18,2021-05-08
20,امين,تامين سرمايه امين,4613,4066150,28423206990,7000,6990,6990,-10,-0.14,6990,-10,-0.14,6990,7000,1400-2-18,2021-05-08
21,دماوند,توليد نيروي برق دماوند,4183,5974771,173373384044,27838,28400,29400,1562,5.61,29018,1180,4.24,28310,29488,1400-2-18,2021-05-08
22,كيان,صندوق س. با درآمد ثابت كيان,3581,27382629,775908284221,28293,28335,28340,47,0.17,28336,43,0.15,28335,28340,1400-2-18,2021-05-08
23,بگيلان,توسعه مسير برق گيلان,3456,1041001,20792248513,20129,19530,19541,-588,-2.92,20064,-65,-0.32,19526,20800,1400-2-18,2021-05-08
24,دعبيد,لابراتوارداروسازي‌  دكترعبيدي‌,3111,7656429,198402460320,24660,25000,25980,1320,5.35,25910,1250,5.07,24800,26130,1400-2-18,2021-05-08
25,ذوب,سهامي ذوب آهن  اصفهان,3057,65909181,203423146529,3178,3100,3083,-95,-2.99,3086,-92,-2.89,3083,3175,1400-2-18,2021-05-08
26,وپارس,بانك‌پارسيان‌,3013,105674658,252390052384,2426,2380,2365,-61,-2.51,2388,-38,-1.57,2354,2470,1400-2-18,2021-05-08
27,امين يكم,صندوق درآمد ثابت امين يكم فردا,2983,93501408,945029422795,10098,10102,10108,10,0.1,10107,9,0.09,10100,10111,1400-2-18,2021-05-08
28,وسكرد,شركت س استان كردستان,2939,136253758,91185279844,675,655,670,-5,-0.74,669,-6,-0.89,655,710,1400-2-18,2021-05-08
29,خبهمن,گروه‌بهمن‌,2762,139031314,191034456554,1407,1412,1365,-42,-2.99,1374,-33,-2.35,1365,1448,1400-2-18,2021-05-08
30,خساپا,سايپا,2722,96715125,180336320232,1913,1860,1856,-57,-2.98,1865,-48,-2.51,1856,1900,1400-2-18,2021-05-08
31,بركت,گروه دارويي بركت,2443,15492394,434078600570,28850,27990,27990,-860,-2.98,28020,-830,-2.88,27990,28600,1400-2-18,2021-05-08
32,شگويا,پتروشيمي تندگويان,2419,14075139,118106689757,8608,8600,8350,-258,-3,8391,-217,-2.52,8350,8626,1400-2-18,2021-05-08
33,كارين,صندوق س نگين سامان-ثابت,2374,115532519,1167567885881,10085,10103,10107,22,0.22,10106,21,0.21,10102,10107,1400-2-18,2021-05-08
34,شبندر,پالايش نفت بندرعباس,2329,9308002,184031080310,20300,19800,19700,-600,-2.96,19770,-530,-2.61,19700,20500,1400-2-18,2021-05-08
35,وغدير,سرمايه‌گذاري‌غدير(هلدينگ‌,2261,15323023,146556024870,9720,9650,9520,-200,-2.06,9560,-160,-1.65,9440,9990,1400-2-18,2021-05-08
36,فارس,صنايع پتروشيمي خليج فارس,2250,14116570,118807317020,8520,8610,8270,-250,-2.93,8420,-100,-1.17,8270,8740,1400-2-18,2021-05-08
37,نوري,پتروشيمي نوري,2195,2235396,125594171390,57290,57410,56310,-980,-1.71,56180,-1110,-1.94,55580,58000,1400-2-18,2021-05-08
38,جم پيلن,پلي پروپيلن جم - جم پيلن,2060,1855335,160299335870,84090,84720,86000,1910,2.27,86400,2310,2.75,84720,87800,1400-2-18,2021-05-08
39,ثاميد,توسعه و عمران اميد,1999,25715081,35050185191,1405,1363,1363,-42,-2.99,1375,-30,-2.14,1363,1370,1400-2-18,2021-05-08
40,ومعادنح,ح . توسعه‌معادن‌وفلزات‌,1909,10109543,49104159190,5050,5000,4820,-230,-4.55,4860,-190,-3.76,4760,5170,1400-2-18,2021-05-08
41,فاسمين,كالسيمين‌,1869,10212342,140870121400,13980,13590,13600,-380,-2.72,13790,-190,-1.36,13590,14400,1400-2-18,2021-05-08
42,اعتماد,صندوق س.اعتماد آفرين پارسيان-د,1849,32688150,1186728724770,36255,36318,36307,52,0.14,36305,50,0.14,36300,36319,1400-2-18,2021-05-08
43,وساپا,سرمايه‌گذاري‌ سايپا,1797,29603288,130780484391,4532,4553,4397,-135,-2.98,4418,-114,-2.52,4397,4640,1400-2-18,2021-05-08
44,تسه0001,امتيازتسهيلات مسكن فروردين1400,1777,46866,25312884162,529084,528888,555000,25916,4.9,540112,11028,2.08,525000,555000,1400-2-18,2021-05-08
45,بپيوند,برق و انرژي پيوندگستر پارس,1768,1492697,16196286713,11160,10900,10826,-334,-2.99,11057,-103,-0.92,10826,11080,1400-2-18,2021-05-08
46,وخارزمح,ح.سرمايه گذاري خوارزمي,1713,6666141,18911935119,2884,2904,2790,-94,-3.26,2837,-47,-1.63,2763,2988,1400-2-18,2021-05-08
47,كرمان,س. توسعه و عمران استان كرمان,1703,60837437,70950514893,1198,1198,1163,-35,-2.92,1166,-32,-2.67,1163,1199,1400-2-18,2021-05-08
48,پيزد,مجتمع صنايع لاستيك يزد,1560,154113,9332755671,61912,60055,60055,-1857,-3,61654,-258,-0.42,60055,63000,1400-2-18,2021-05-08
49,فخوز,فولاد  خوزستان,1554,9016515,130724284340,14520,14500,14330,-190,-1.31,14500,-20,-0.14,14180,14960,1400-2-18,2021-05-08
50,صبا,سرمايه گذاري صبا تامين,1554,6527539,47727069068,7506,7402,7281,-225,-3,7427,-79,-1.05,7281,7500,1400-2-18,2021-05-08
51,ياقوت,صندوق س ياقوت آگاه-ثابت,1390,52957176,653713553241,12361,12344,12347,-14,-0.11,12344,-17,-0.14,12344,12370,1400-2-18,2021-05-08
52,وتوس,توسعه‌شهري‌توس‌گستر,1383,4734574,65457680250,13870,13920,13460,-410,-2.96,13830,-40,-0.29,13460,14450,1400-2-18,2021-05-08
53,سرو,صندوق س سروسودمند مدبران-سهام,1366,1041436,63164928500,62170,62180,60100,-2070,-3.33,60650,-1520,-2.44,60020,62700,1400-2-18,2021-05-08
54,فايرا,آلومينيوم‌ايران‌,1322,7544000,137329784430,18150,18490,18170,20,0.11,18200,50,0.28,17760,19000,1400-2-18,2021-05-08
55,ومعادن,توسعه‌معادن‌وفلزات‌,1311,12651208,89956699880,7290,7220,7080,-210,-2.88,7150,-140,-1.92,7080,7290,1400-2-18,2021-05-08
56,بجهرم,توسعه مولد نيروگاهي جهرم,1300,20846334,45197692682,2228,2171,2162,-66,-2.96,2172,-56,-2.51,2162,2223,1400-2-18,2021-05-08
57,سفارس,سيمان فارس و خوزستان,1267,6910076,99619864490,14660,14500,14240,-420,-2.86,14420,-240,-1.64,14230,14710,1400-2-18,2021-05-08
58,فباهنرح,ح . مس‌ شهيدباهنر,1260,3648837,61159116450,16620,16950,16400,-220,-1.32,16760,140,0.84,16320,17800,1400-2-18,2021-05-08
59,آگاس,صندوق س.هستي بخش آگاه-س,1253,1388568,86478097345,63322,63350,61876,-1446,-2.28,62279,-1043,-1.65,61700,63800,1400-2-18,2021-05-08
60,سمازن,سيمان‌مازندران‌,1231,5677690,69697181260,12180,11990,12340,160,1.31,12280,100,0.82,11980,12450,1400-2-18,2021-05-08
61,شيران,س. صنايع‌شيميايي‌ايران,1205,4329617,86737291430,20530,20030,19920,-610,-2.97,20030,-500,-2.44,19920,20790,1400-2-18,2021-05-08
62,بپاس,بيمه پاسارگاد,1122,1297626,114424763241,88178,88185,88180,2,0,88180,2,0,88178,88190,1400-2-18,2021-05-08
63,وثوق,سرمايه گذاري وثوق امين,1118,3138208,53086506074,17444,16747,16747,-697,-4,16916,-528,-3.03,16747,17440,1400-2-18,2021-05-08
64,تاپيكو,س. نفت و گاز و پتروشيمي تأمين,1070,7440580,74558473390,10110,10150,9900,-210,-2.08,10050,-60,-0.59,9830,10250,1400-2-18,2021-05-08
65,پارند,صندوق س. پارند پايدار سپهر,1068,22801319,255096965391,11366,11181,11191,-175,-1.54,11188,-178,-1.57,11177,11191,1400-2-18,2021-05-08
66,البرز,بيمه البرز,1049,19563014,66955657973,3439,3400,3437,-2,-0.06,3423,-16,-0.47,3380,3479,1400-2-18,2021-05-08
67,فنوال,نورد آلومينيوم‌,1044,1359038,36323715130,26190,26000,26590,400,1.53,26570,380,1.45,25630,27390,1400-2-18,2021-05-08
68,تملت,تامين سرمايه بانك ملت,1011,4544756,22271220408,4994,5030,4845,-149,-2.98,4952,-42,-0.84,4845,5030,1400-2-18,2021-05-08
69,كچاد,معدني‌وصنعتي‌چادرملو,1009,4132900,85333797530,20590,20500,20350,-240,-1.17,20630,40,0.19,20110,21000,1400-2-18,2021-05-08
70,كاوه,فولاد كاوه جنوب كيش,950,4346779,85075231240,19970,19420,19390,-580,-2.9,19620,-350,-1.75,19380,20180,1400-2-18,2021-05-08
71,تسه9912,امتياز تسهيلات مسكن اسفند99,947,21255,11749892091,542997,560000,541000,-1997,-0.37,552806,9809,1.81,531000,560000,1400-2-18,2021-05-08
72,ونوين,بانك‌اقتصادنوين‌,925,22110216,96446259397,4492,4419,4358,-134,-2.98,4362,-130,-2.89,4358,4439,1400-2-18,2021-05-08
73,كگل,معدني و صنعتي گل گهر,900,7793026,104107262930,13400,13260,13230,-170,-1.27,13360,-40,-0.3,13110,13670,1400-2-18,2021-05-08
74,ارفع,شركت آهن و فولاد ارفع,891,8495507,115615529108,14024,13604,13604,-420,-2.99,13609,-415,-2.96,13604,13990,1400-2-18,2021-05-08
75,تاصيكو,سرمايه گذاري صدرتامين,876,8070681,79278686900,9890,9810,9600,-290,-2.93,9850,-40,-0.4,9600,10100,1400-2-18,2021-05-08
76,شسپا,نفت سپاهان,858,8942446,124782759520,14340,14010,13910,-430,-3,13950,-390,-2.72,13910,14600,1400-2-18,2021-05-08
77,فباهنر,مس‌ شهيدباهنر,855,1739130,40767000970,23990,23430,23280,-710,-2.96,23530,-460,-1.92,23280,24390,1400-2-18,2021-05-08
78,هفملي108,اختيارف ت فملي-7895-01/08/08,800,80000000,62480000000,1,781,781,780,78000,781,780,78000,781,781,1400-2-18,2021-05-08
79,ماديرا,صنايع ماديران,799,8801386,64092335127,7506,7281,7281,-225,-3,7282,-224,-2.98,7281,7360,1400-2-18,2021-05-08
80,طلا,صندوق س.پشتوانه طلاي لوتوس,798,680956,45813606708,65416,65869,67900,2484,3.8,67278,1862,2.85,65869,67948,1400-2-18,2021-05-08
81,هفولا108,اختيارف ت فولاد-11512-01/08/07,790,79000000,89033000000,1,1127,1127,1126,112600,1127,1126,112600,1127,1127,1400-2-18,2021-05-08
82,وبانك,سرمايه گذاري گروه توسعه ملي,768,11447618,85324563150,7660,7450,7500,-160,-2.09,7450,-210,-2.74,7440,7750,1400-2-18,2021-05-08
83,وسكاب,س.ص.بازنشستگي كاركنان بانكها,759,4786413,22658287689,4784,4840,4800,16,0.33,4761,-23,-0.48,4647,4900,1400-2-18,2021-05-08
84,هرمز,فولاد هرمزگان جنوب,735,4776914,71357602290,15023,15000,14600,-423,-2.82,14972,-51,-0.34,14580,15600,1400-2-18,2021-05-08
85,شصدف,صنعتي دوده فام,724,76451,2514014684,31023,32884,32884,1861,6,31111,88,0.28,32884,32884,1400-2-18,2021-05-08
86,كگلح,ح . معدني و صنعتي گل گهر,722,3714326,36938417510,10240,9900,10010,-230,-2.25,9940,-300,-2.93,9800,10130,1400-2-18,2021-05-08
87,آوا,صندوق س.سهام آواي معيار-س,710,7498943,47385531909,6430,6401,6300,-130,-2.02,6319,-111,-1.73,6300,6460,1400-2-18,2021-05-08
88,دالبرح,ح . البرزدارو,708,999559,8483360400,8740,8700,8370,-370,-4.23,8490,-250,-2.86,8270,8720,1400-2-18,2021-05-08
89,زاگرس,پتروشيمي زاگرس,701,244165,47902430384,197251,193750,200000,2749,1.39,196739,-512,-0.26,191334,200000,1400-2-18,2021-05-08
90,وصنعت,سرمايه گذاري توسعه صنعت وتجارت,701,5386435,30338970940,5700,5700,5610,-90,-1.58,5660,-40,-0.7,5560,5730,1400-2-18,2021-05-08
91,شپديس,پتروشيمي پرديس,675,1134756,103208546800,92010,91370,91000,-1010,-1.1,90950,-1060,-1.15,89630,93000,1400-2-18,2021-05-08
92,رانفور,خدمات‌انفورماتيك‌,665,17422459,109807163720,6460,6270,6270,-190,-2.94,6300,-160,-2.48,6270,6410,1400-2-18,2021-05-08
93,سرچشمه,سرمايه گذاري مس سرچشمه,657,2565001,15011538084,5987,5867,5820,-167,-2.79,5946,-41,-0.68,5808,6088,1400-2-18,2021-05-08
94,افق,فروشگاههاي زنجيره اي افق كوروش,648,685787,46719350380,68700,68650,66840,-1860,-2.71,68370,-330,-0.48,66650,69900,1400-2-18,2021-05-08
95,هتران108,اختيارف ت شتران-5206-01/08/11,635,63500000,80835500000,1,1273,1273,1272,127200,1273,1272,127200,1273,1273,1400-2-18,2021-05-08
96,تصميم,صندوق س با درآمد ثابت تصميم,631,11010757,179287999806,16280,16307,16282,2,0.01,16283,3,0.02,16100,16307,1400-2-18,2021-05-08
97,ميدكو,هلدينگ صنايع  معدني خاورميانه,612,8166920,270059923854,33067,33071,33079,12,0.04,33068,1,0,33066,33198,1400-2-18,2021-05-08
98,فجر,فولاد اميركبيركاشان,605,827067,47058250190,57730,56800,56000,-1730,-3,56940,-790,-1.37,56000,59590,1400-2-18,2021-05-08
99,واحيا,م .صنايع و معادن احياء سپاهان,602,643510,88435867433,135201,134211,139257,4056,3,137427,2226,1.65,134211,139257,1400-2-18,2021-05-08
100,خكرمان,گروه اقتصادي كرمان خودرو,601,7644358,26014387036,3460,3440,3391,-69,-1.99,3403,-57,-1.65,3391,3500,1400-2-18,2021-05-08
101,ما,بيمه  ما,601,6533119,47910423650,7360,7360,7410,50,0.68,7330,-30,-0.41,7140,7500,1400-2-18,2021-05-08
102,مدير,ص.س.مديريت ثروت ص.بازنشستگي-س,600,1847459,14164538897,7852,7810,7600,-252,-3.21,7667,-185,-2.36,7594,7910,1400-2-18,2021-05-08
103,پارسان,گسترش نفت و گاز پارسيان,593,3325572,58552262140,17620,17400,17410,-210,-1.19,17610,-10,-0.06,17210,18500,1400-2-18,2021-05-08
104,تسه9911,امتياز تسهيلات مسكن بهمن99,588,14654,7904024027,539021,513000,540034,1013,0.19,539377,356,0.07,513000,565972,1400-2-18,2021-05-08
105,وساخت,سرمايه‌ گذاري‌ ساختمان‌ايران‌,575,1373507,62130144500,46510,45300,45120,-1390,-2.99,45230,-1280,-2.75,45120,46500,1400-2-18,2021-05-08
106,شفن,پتروشيمي فناوران,567,111666,34297070340,311940,304250,303900,-8040,-2.58,310270,-1670,-0.54,303000,318200,1400-2-18,2021-05-08
107,سمتاز,سيمان ممتازان كرمان,561,1324554,30651594272,22980,22521,23650,670,2.92,23141,161,0.7,22521,23669,1400-2-18,2021-05-08
108,زر,صندوق س.پشتوانه سكه طلاي زر,560,1238594,48423951111,38147,39500,39590,1443,3.78,39096,949,2.49,38600,39600,1400-2-18,2021-05-08
109,ارمغان,ص سرمايه گذاري ارمغان ايرانيان,550,12611962,126346326156,10163,10018,10020,-143,-1.41,10018,-145,-1.43,10016,10020,1400-2-18,2021-05-08
110,ونيكي,سرمايه‌گذاري‌ ملي‌ايران‌,542,4881267,38644298290,8150,7920,7910,-240,-2.94,7990,-160,-1.96,7910,8080,1400-2-18,2021-05-08
111,ورازي,بيمه رازي,540,8942631,74589402094,8743,8774,8306,-437,-5,8341,-402,-4.6,8306,8774,1400-2-18,2021-05-08
112,رمپنا,گروه مپنا (سهامي عام),509,3118326,46685646050,15410,14970,14950,-460,-2.99,15230,-180,-1.17,14950,15330,1400-2-18,2021-05-08
113,هشپنا108,اختيارف ت شپنا-7247-01/08/14,505,50500000,56762000000,1,1124,1124,1123,112300,1124,1123,112300,1124,1124,1400-2-18,2021-05-08
114,شاراك,پتروشيمي شازند,503,1388102,35771665550,25990,25270,25390,-600,-2.31,25900,-90,-0.35,25270,26050,1400-2-18,2021-05-08
115,سيدكو,سرمايه گذاري توسعه صنايع سيمان,500,3641805,20664645150,5800,5700,5630,-170,-2.93,5750,-50,-0.86,5630,5940,1400-2-18,2021-05-08
116,ومهان,گروه توسعه مالي مهر آيندگان,496,1399743,16775591177,12293,12012,11998,-295,-2.4,12187,-106,-0.86,11925,12300,1400-2-18,2021-05-08
117,خصدرا,صنعتي‌ دريايي‌ ايران‌,491,14093559,35067065302,2591,2488,2488,-103,-3.98,2488,-103,-3.98,2488,2534,1400-2-18,2021-05-08
118,ضسپا3002,اختيارخ خساپا-1800-1400/03/26,491,24549,2471384000,146,160,96,-50,-34.25,101,-45,-30.82,90,160,1400-2-18,2021-05-08
119,فنورد,نوردوقطعات‌ فولادي‌,484,158975,24322316740,152240,152240,150140,-2100,-1.38,152610,370,0.24,148620,160000,1400-2-18,2021-05-08
120,فردا,صندوق س آواي فرداي زاگرس-ثابت,476,20523962,218519025652,10630,10646,10647,17,0.16,10647,17,0.16,10646,10648,1400-2-18,2021-05-08
121,شبريز,پالايش نفت تبريز,474,1829232,44951692130,25320,24570,24570,-750,-2.96,24970,-350,-1.38,24570,25000,1400-2-18,2021-05-08
122,ساراب,سيمان‌ داراب‌,470,3589291,80830833320,21250,22520,22520,1270,5.98,22520,1270,5.98,22520,22520,1400-2-18,2021-05-08
123,سپ,پرداخت الكترونيك سامان كيش,466,1363241,29226047200,21470,21500,21900,430,2,21450,-20,-0.09,20830,22100,1400-2-18,2021-05-08
124,تسه9908,امتياز تسهيلات مسكن آبان99,452,10237,5554021866,535089,523000,537000,1911,0.36,542544,7455,1.39,523000,555000,1400-2-18,2021-05-08
125,كرماشا,صنايع پتروشيمي كرمانشاه,429,892614,29722593690,33580,32800,33490,-90,-0.27,33410,-170,-0.51,32690,34990,1400-2-18,2021-05-08
126,سكه0012پ01,تمام سكه طرح جديد0012رفاه,422,103400,96716127800,906348,924500,938978,32630,3.6,935359,29011,3.2,924500,938978,1400-2-18,2021-05-08
127,خگستر,گسترش‌سرمايه‌گذاري‌ايران‌خودرو,420,7824156,17807779056,2346,2276,2276,-70,-2.98,2320,-26,-1.11,2276,2276,1400-2-18,2021-05-08
128,شغدير,پتروشيمي غدير,419,1465367,88000897760,61860,62000,60010,-1850,-2.99,60050,-1810,-2.93,60010,62000,1400-2-18,2021-05-08
129,شبهرن,نفت‌ بهران‌,414,2718024,29218758000,11080,10750,10750,-330,-2.98,10890,-190,-1.71,10750,10750,1400-2-18,2021-05-08
130,همراه,شركت ارتباطات سيار ايران,410,1833202,41852032670,23420,22720,22720,-700,-2.99,23170,-250,-1.07,22720,24800,1400-2-18,2021-05-08
131,كروي,توسعه‌ معادن‌ روي‌ ايران‌,394,1031418,26020630770,25980,25210,25210,-770,-2.96,25580,-400,-1.54,25210,25700,1400-2-18,2021-05-08
132,وسينا,بانك سينا,389,10898256,28890763116,2731,2652,2650,-81,-2.97,2683,-48,-1.76,2650,2690,1400-2-18,2021-05-08
133,حسينا,توسعه خدمات دريايي وبندري سينا,374,725169,40853088000,58070,56351,56328,-1742,-3,56610,-1460,-2.51,56328,56980,1400-2-18,2021-05-08
134,تيپيكو,سرمايه گذاري دارويي تامين,373,833060,28129148970,34720,33800,33680,-1040,-3,34260,-460,-1.32,33680,34480,1400-2-18,2021-05-08
135,شساخت,مهندسي و ساختمان صنايع نفت,358,703161,28440467519,39802,40237,40800,998,2.51,40252,450,1.13,39206,40900,1400-2-18,2021-05-08
136,سخوز,سيمان خوزستان,357,810663,16893619290,21390,20820,20750,-640,-2.99,21200,-190,-0.89,20750,21960,1400-2-18,2021-05-08
137,مبين,مبين انرژي خليج فارس,354,1677379,25887391110,15560,15560,15550,-10,-0.06,15530,-30,-0.19,15120,16100,1400-2-18,2021-05-08
138,تسه9909,امتياز تسهيلات مسكن آذر99,347,5026,2719534728,535423,531000,550000,14577,2.72,541093,5670,1.06,512700,557998,1400-2-18,2021-05-08
139,وخاور,بانك خاورميانه,340,2908654,25213609260,8580,8840,8550,-30,-0.35,8620,40,0.47,8550,8870,1400-2-18,2021-05-08
140,افران,صندوق س افرا نماد پايدار-ثابت,339,4474975,59402020674,13248,13264,13280,32,0.24,13274,26,0.2,13264,13280,1400-2-18,2021-05-08
141,تسه9803,امتياز تسهيلات مسكن خرداد98,334,5979,3127354431,519543,544526,529995,10452,2.01,523056,3513,0.68,500000,544526,1400-2-18,2021-05-08
142,وبشهر,توسعه‌ صنايع‌ بهشهر(هلدينگ,332,6106827,62181661810,10470,10160,10160,-310,-2.96,10180,-290,-2.77,10160,10640,1400-2-18,2021-05-08
143,آكورد,صندوق س. آرمان آتي كوثر-د,329,3390596,108384774562,31911,31965,31970,59,0.18,31966,55,0.17,31965,31970,1400-2-18,2021-05-08
144,چدن,توليدي چدن سازان,328,632719,14520901050,24410,22950,22950,-1460,-5.98,23960,-450,-1.84,22950,22950,1400-2-18,2021-05-08
145,گوهران,سرمايه گذاري توسعه گوهران اميد,312,1261602,8626149172,6949,6744,6848,-101,-1.45,6929,-20,-0.29,6744,6928,1400-2-18,2021-05-08
146,ضسپا3004,اختيارخ خساپا-2500-1400/03/26,312,25343,309006000,22,16,11,-11,-50,12,-10,-45.45,9,18,1400-2-18,2021-05-08
147,ضسپا3003,اختيارخ خساپا-2000-1400/03/26,310,14524,798800000,78,75,49,-29,-37.18,55,-23,-29.49,47,80,1400-2-18,2021-05-08
148,دسبحانح,ح. سبحان دارو,310,481821,5898306600,12960,12400,12200,-760,-5.86,12240,-720,-5.56,12190,12430,1400-2-18,2021-05-08
149,تنوين,تامين سرمايه نوين,307,3019065,21744756760,7200,7210,7210,10,0.14,7200,0,0,7180,7290,1400-2-18,2021-05-08
150,جم,پتروشيمي جم,302,640493,22968192550,35350,35500,34580,-770,-2.18,35470,120,0.34,34560,37470,1400-2-18,2021-05-08
151,سامان,بانك سامان,301,1869120,15695424289,8550,8494,8379,-171,-2,8488,-62,-0.73,8379,8600,1400-2-18,2021-05-08
152,تسه9910,امتياز تسهيلات مسكن دي99,301,3932,2136899645,537206,513333,539000,1794,0.33,543464,6258,1.16,513333,564065,1400-2-18,2021-05-08
153,تماوند,تامين سرمايه دماوند,296,8152083,45855561136,5464,5626,5626,162,2.96,5625,161,2.95,5355,5627,1400-2-18,2021-05-08
154,پارس,پتروشيمي پارس,292,574172,81389795460,142000,142030,142000,0,0,141800,-200,-0.14,140000,144800,1400-2-18,2021-05-08
155,غگل,گلوكوزان‌,286,2458131,6676283796,2799,2716,2716,-83,-2.97,2788,-11,-0.39,2716,2716,1400-2-18,2021-05-08
156,ضخود7075,اختيارخ خودرو-2000-1400/07/07,285,12798,2756988000,271,231,210,-61,-22.51,215,-56,-20.66,202,245,1400-2-18,2021-05-08
157,شخارك,پتروشيمي‌ خارك‌,281,444876,19171828150,43460,43470,42160,-1300,-2.99,43390,-70,-0.16,42160,44000,1400-2-18,2021-05-08
158,وكار,بانك‌ كارآفرين‌,281,5596503,16094253246,2948,2890,2860,-88,-2.99,2924,-24,-0.81,2860,3000,1400-2-18,2021-05-08
159,كنور,توسعه معدني و صنعتي صبانور,278,369541,17619680400,47950,46630,47500,-450,-0.94,47870,-80,-0.17,46630,48990,1400-2-18,2021-05-08
160,ثمسكن,سرمايه‌گذاري‌ مسكن‌,270,2415484,11675601167,4970,4823,4821,-149,-3,4937,-33,-0.66,4821,4996,1400-2-18,2021-05-08
161,شپلي,پلي اكريل ايران,270,5581835,45062153955,8063,8073,8073,10,0.12,8073,10,0.12,8073,8073,1400-2-18,2021-05-08
162,زگلدشتح,ح.كشت و دام گلدشت نمونه اصفهان,267,1897825,11825687405,6407,6240,6215,-192,-3,6231,-176,-2.75,6215,6580,1400-2-18,2021-05-08
163,آساميد,صندوق س.مشترك آسمان اميد -د,264,11565255,138569505761,11971,11979,11985,14,0.12,11982,11,0.09,11979,11985,1400-2-18,2021-05-08
164,كگهر,سنگ آهن گهرزمين,262,656777,27456994426,42899,41613,41613,-1286,-3,42642,-257,-0.6,41613,42883,1400-2-18,2021-05-08
165,ارزش,صندوق س ارزش آفرين بيدار-سهام,261,1167268,10516072190,9110,9050,9000,-110,-1.21,9010,-100,-1.1,8970,9110,1400-2-18,2021-05-08
166,سشرق,سيمان‌ شرق‌,259,3022110,17951333400,6120,5940,5940,-180,-2.94,6050,-70,-1.14,5940,5940,1400-2-18,2021-05-08
167,وگردش,بانك گردشگري,248,20034031,331443008864,16881,16544,16544,-337,-2,16544,-337,-2,16544,16544,1400-2-18,2021-05-08
168,وتوسم,سرمايه‌گذاري‌توسعه‌ملي‌,244,2092255,15984478980,7860,7630,7630,-230,-2.93,7790,-70,-0.89,7630,7760,1400-2-18,2021-05-08
169,شرانل,نفت ايرانول,235,326276,12658172558,39333,38700,38690,-643,-1.63,39195,-138,-0.35,38321,39000,1400-2-18,2021-05-08
170,درازك,دارويي‌ رازك‌,229,425364,12664015550,30680,29760,29760,-920,-3,30440,-240,-0.78,29760,29970,1400-2-18,2021-05-08
171,شنفت,نفت‌ پارس‌,224,187135,8608769180,47270,46000,45860,-1410,-2.98,47050,-220,-0.47,45860,48000,1400-2-18,2021-05-08
172,ونفت,سرمايه‌گذاري‌ صنعت‌ نفت‌,222,3404836,46305861200,14020,13600,13600,-420,-3,13620,-400,-2.85,13600,13650,1400-2-18,2021-05-08
173,تسه9810,امتياز تسهيلات مسكن دي98,221,3231,1736271583,528645,510000,502213,-26432,-5,537379,8734,1.65,502213,555077,1400-2-18,2021-05-08
174,عيار,صندوق سكه طلاي مفيد,217,259047,6149106992,23089,23500,23880,791,3.43,23737,648,2.81,23500,23899,1400-2-18,2021-05-08
175,آريان,سرمايه گذاري پارس آريان,215,2936990,28234916617,9363,9381,9643,280,2.99,9456,93,0.99,9381,9643,1400-2-18,2021-05-08
176,فردا2,صندوق س آواي فرداي زاگرس-ثابت,210,21000000,21000000,10630,1,1,-10629,-99.99,1,-10629,-99.99,1,1,1400-2-18,2021-05-08
177,بفجر,فجر انرژي خليج فارس,210,488097,10114467390,20970,20390,20400,-570,-2.72,20920,-50,-0.24,20350,22000,1400-2-18,2021-05-08
178,كاردان,صندوق س تجارت شاخصي كاردان,206,47224,6724570220,145440,146940,141500,-3940,-2.71,142400,-3040,-2.09,141500,146940,1400-2-18,2021-05-08
179,آسيا,بيمه آسيا,204,8593357,15588349598,1870,1814,1814,-56,-2.99,1852,-18,-0.96,1814,1814,1400-2-18,2021-05-08
180,خراسان,پتروشيمي خراسان,199,308406,21057623880,68940,66880,66880,-2060,-2.99,68660,-280,-0.41,66880,73070,1400-2-18,2021-05-08
181,اطلس,صندوق س.توسعه اندوخته آينده-س,193,30620,6047279410,197558,196250,197000,-558,-0.28,197494,-64,-0.03,196250,199983,1400-2-18,2021-05-08
182,ولانا,شركت ليزينگ آريا دانا,193,331355,13054061580,40199,39396,39396,-803,-2,39664,-535,-1.33,39396,39396,1400-2-18,2021-05-08
183,سپيدما,صندوق س. سپيد دماوند-د,189,7216730,74159668225,10263,10280,10276,13,0.13,10276,13,0.13,10275,10281,1400-2-18,2021-05-08
184,تسه9902,امتياز تسهيلات مسكن ارديبهشت99,189,2964,1621539520,540928,520000,560000,19072,3.53,547078,6150,1.14,520000,567974,1400-2-18,2021-05-08
185,تسه9907,امتياز تسهيلات مسكن مهر99,187,2391,1300171315,536890,514555,520000,-16890,-3.15,543777,6887,1.28,514555,552999,1400-2-18,2021-05-08
186,گوهر,صندوق سكه طلاي كيان,181,94608,4327724125,44446,44979,45850,1404,3.16,45744,1298,2.92,44500,46400,1400-2-18,2021-05-08
187,اخزا910,اسنادخزانه-م10بودجه99-020807,178,344708,209117755562,607322,605001,606092,-1230,-0.2,606652,-670,-0.11,605000,608000,1400-2-18,2021-05-08
188,كاريس,صندوق س.سپهر كاريزما-س,178,982473,10021098714,10346,10280,10140,-206,-1.99,10200,-146,-1.41,10132,10379,1400-2-18,2021-05-08
189,سحرخيز,صندوق س. گروه زعفران سحرخيز,176,709643,6328333762,8998,9002,8898,-100,-1.11,8918,-80,-0.89,8850,9002,1400-2-18,2021-05-08
190,سپاس,صندوق س. پاداش سهامداري-ثابت,175,4828517,48367587285,10172,10016,10020,-152,-1.49,10017,-155,-1.52,10016,10020,1400-2-18,2021-05-08
191,اخزا902,اسنادخزانه-م2بودجه99-011019,175,356214,254061521119,713461,711256,715300,1839,0.26,713227,-234,-0.03,708247,715300,1400-2-18,2021-05-08
192,سرود,سيمان‌شاهرود,174,1084111,18182143480,17280,16770,16770,-510,-2.95,17090,-190,-1.1,16770,17000,1400-2-18,2021-05-08
193,فسپا,گروه‌صنعتي‌سپاهان‌,166,753341,26140932700,35770,34700,34700,-1070,-2.99,35190,-580,-1.62,34700,34700,1400-2-18,2021-05-08
194,قپيرا,فرآورده‌هاي‌غدايي‌وقندپيرانشهر,163,46560,4661150980,102410,99340,99590,-2820,-2.75,102190,-220,-0.21,99340,102380,1400-2-18,2021-05-08
195,تسه9904,امتياز تسهيلات مسكن تير99,162,2007,1086586600,532500,513750,540000,7500,1.41,541398,8898,1.67,513750,555000,1400-2-18,2021-05-08
196,خديزل,بهمن  ديزل,158,322608,12415061158,39485,39035,38301,-1184,-3,39230,-255,-0.65,38301,39448,1400-2-18,2021-05-08
197,ضخود7076,اختيارخ خودرو-2500-1400/07/07,157,4237,576459000,152,145,126,-26,-17.11,136,-16,-10.53,126,149,1400-2-18,2021-05-08
198,تسه9804,امتياز تسهيلات مسكن تير98,156,2388,1289016761,539168,544000,540460,1292,0.24,539789,621,0.12,520340,549200,1400-2-18,2021-05-08
199,ساروم,سيمان‌اروميه‌,154,450905,14733497380,37040,32900,31920,-5120,-13.82,35450,-1590,-4.29,31920,32900,1400-2-18,2021-05-08
200,وصندوق,سرمايه‌گذاري‌صندوق‌بازنشستگي‌,154,2384234,33147197100,14250,13850,13830,-420,-2.95,14150,-100,-0.7,13830,14700,1400-2-18,2021-05-08
201,حكشتي,كشتيراني جمهوري اسلامي ايران,153,265002,4245332040,16510,16020,16020,-490,-2.97,16490,-20,-0.12,16020,16020,1400-2-18,2021-05-08
202,شلعابح,ح . لعابيران‌,151,1835170,17205257730,9730,10890,9350,-380,-3.91,9380,-350,-3.6,9350,10890,1400-2-18,2021-05-08
203,وخارزم,سرمايه گذاري خوارزمي,146,949229,4273428958,4641,4502,4502,-139,-3,4629,-12,-0.26,4502,4502,1400-2-18,2021-05-08
204,سكه0012پ04,تمام سكه طرح جديد0012صادرات,144,49800,46565381400,904445,930000,940000,35555,3.93,935048,30603,3.38,925202,941000,1400-2-18,2021-05-08
205,شيراز,پتروشيمي‌شيراز,143,254858,12958480830,52390,50820,50820,-1570,-3,52180,-210,-0.4,50820,51530,1400-2-18,2021-05-08
206,فيروزه,صندوق شاخص30 شركت فيروزه- سهام,140,34175,4324980650,127730,126760,125860,-1870,-1.46,126550,-1180,-0.92,125700,127100,1400-2-18,2021-05-08
207,لوتوس,تامين سرمايه لوتوس پارسيان,139,876468,7952010030,9290,9030,9040,-250,-2.69,9250,-40,-0.43,9020,9400,1400-2-18,2021-05-08
208,وبازار,صندوق س شاخصي بازارآشنا,136,1059034,9532273630,8930,9010,9000,70,0.78,9000,70,0.78,9000,9070,1400-2-18,2021-05-08
209,كاما,باما,135,395503,4532464380,11810,11460,11460,-350,-2.96,11780,-30,-0.25,11460,11460,1400-2-18,2021-05-08
210,تسه9903,امتياز تسهيلات مسكن خرداد99,133,1201,652378725,537262,512399,513980,-23282,-4.33,543196,5934,1.1,512399,564125,1400-2-18,2021-05-08
211,واعتبار,سرمايه گذاري اعتبار ايران,132,2825795,25912540150,8660,9170,9170,510,5.89,8910,250,2.89,9170,9170,1400-2-18,2021-05-08
212,آساس,صندوق س.آسمان آرماني سهام-س,129,54103,8689429347,162338,161000,159551,-2787,-1.72,160609,-1729,-1.07,159510,162200,1400-2-18,2021-05-08
213,وزمين,بانك ايران زمين,127,12500500,162193987500,13239,12975,12975,-264,-1.99,12975,-264,-1.99,12975,12975,1400-2-18,2021-05-08
214,تسه9806,امتياز تسهيلات مسكن شهريور98,122,1394,754523594,531727,520060,545033,13306,2.5,541265,9538,1.79,520060,558300,1400-2-18,2021-05-08
215,پكرمان,گروه‌ صنعتي‌ بارز,121,563591,13441801350,24580,23850,23850,-730,-2.97,24380,-200,-0.81,23850,24370,1400-2-18,2021-05-08
216,اخزا909,اسنادخزانه-م9بودجه99-020316,121,385749,253804637625,658632,656240,659799,1167,0.18,657953,-679,-0.1,650000,661000,1400-2-18,2021-05-08
217,اخزا903,اسنادخزانه-م3بودجه99-011110,121,133905,94335086019,704865,702547,705600,735,0.1,704493,-372,-0.05,702547,705600,1400-2-18,2021-05-08
218,فروي,ذوب روي اصفهان,120,47204,2613355052,57075,55363,55363,-1712,-3,56983,-92,-0.16,55363,55363,1400-2-18,2021-05-08
219,خاتم,صندوق س خاتم ايساتيس پويا-ثابت,119,1689189,18695243464,11061,11071,11068,7,0.06,11068,7,0.06,11062,11072,1400-2-18,2021-05-08
220,اخابر,مخابرات ايران,118,3160097,29072892400,9480,9200,9200,-280,-2.95,9410,-70,-0.74,9200,9200,1400-2-18,2021-05-08
221,بترانس,ايران‌ ترانسفو,117,1962235,5380448370,2826,2742,2742,-84,-2.97,2817,-9,-0.32,2742,2742,1400-2-18,2021-05-08
222,شصفها,پتروشيمي‌ اصفهان‌,116,520396,65593314570,128617,126045,126045,-2572,-2,126045,-2572,-2,126045,126050,1400-2-18,2021-05-08
223,تسه9906,امتياز تسهيلات مسكن شهريور99,116,1256,690242762,537046,514522,540000,2954,0.55,549556,12510,2.33,514522,563898,1400-2-18,2021-05-08
224,تسه9809,امتياز تسهيلات مسكن آذر98,115,1373,736882425,527518,503010,540111,12593,2.39,536695,9177,1.74,503010,553893,1400-2-18,2021-05-08
225,تسه9805,امتياز تسهيلات مسكن مرداد98,110,1757,954709430,537217,544972,541260,4043,0.75,543375,6158,1.15,520330,562810,1400-2-18,2021-05-08
226,تسه9808,امتياز تسهيلات مسكن آبان98,107,1218,657105286,535047,521000,561799,26752,5,539495,4448,0.83,521000,561799,1400-2-18,2021-05-08
227,نهال,صندوق س. طلاي سرخ نوويرا,106,117301,1056784989,9042,9101,9050,8,0.09,9009,-33,-0.36,8900,9101,1400-2-18,2021-05-08
228,سكه0112پ03,تمام سكه طرح جديد0112سامان,106,29900,27930714400,904989,920000,937060,32071,3.54,934138,29149,3.22,920000,938510,1400-2-18,2021-05-08
229,پارتا,مجتمع‌صنعتي‌آرتاويل‌تاير,106,442663,13450315255,29500,30385,30385,885,3,29945,445,1.51,30385,30385,1400-2-18,2021-05-08
230,تسه9905,امتياز تسهيلات مسكن مرداد99,105,955,515546771,534930,512000,532500,-2430,-0.45,539840,4910,0.92,512000,551965,1400-2-18,2021-05-08
231,سكه0011پ02,تمام سكه طرح جديد0011ملت,105,25200,23547524400,904659,923800,938000,33341,3.69,934426,29767,3.29,923800,939400,1400-2-18,2021-05-08
232,داروح,ح . كارخانجات‌داروپخش,101,459724,8500128810,19580,21500,18410,-1170,-5.98,18490,-1090,-5.57,18410,21500,1400-2-18,2021-05-08
233,اخزا901,اسنادخزانه-م1بودجه99-010621,97,82102,62526136194,761695,759518,762001,306,0.04,761567,-128,-0.02,759518,762500,1400-2-18,2021-05-08
234,تسه9812,امتياز تسهيلات مسكن اسفند98,96,582,313358690,529854,520512,540000,10146,1.91,538417,8563,1.62,520512,556346,1400-2-18,2021-05-08
235,تسه9811,امتياز تسهيلات مسكن بهمن98,96,631,340342408,532187,511000,558796,26609,5,539370,7183,1.35,511000,558796,1400-2-18,2021-05-08
236,سكرما,سيمان‌ كرمان‌,95,499050,7519475910,15510,15050,15050,-460,-2.97,15440,-70,-0.45,15050,15440,1400-2-18,2021-05-08
237,تسه9807,امتياز تسهيلات مسكن مهر98,95,1036,553865885,534884,520000,560000,25116,4.7,534620,-264,-0.05,520000,560000,1400-2-18,2021-05-08
238,ثباغ,شهر سازي و خانه سازي باغميشه,93,791783,11704139891,15239,14782,14782,-457,-3,15129,-110,-0.72,14782,14785,1400-2-18,2021-05-08
239,ضخود7077,اختيارخ خودرو-3000-1400/07/07,91,5913,315735000,77,62,51,-26,-33.77,53,-24,-31.17,51,63,1400-2-18,2021-05-08
240,تسه9901,امتياز تسهيلات مسكن فروردين99,85,950,518266985,539860,517444,517444,-22416,-4.15,545544,5684,1.05,517444,566853,1400-2-18,2021-05-08
241,اخزا908,اسنادخزانه-م8بودجه99-020606,84,359571,226341859589,628640,628223,628355,-285,-0.05,629477,837,0.13,626625,632000,1400-2-18,2021-05-08
242,صايند,صندوق س. گنجينه آينده روشن-د,80,417920,4078215430,9764,9765,9758,-6,-0.06,9758,-6,-0.06,9742,9789,1400-2-18,2021-05-08
243,فيروزا,صندوق بادرآمد ثابت فيروزه آسيا,79,1518149,34537929637,22700,22733,22750,50,0.22,22750,50,0.22,22733,22785,1400-2-18,2021-05-08
244,وحكمت,بيمه حكمت صبا,78,1686603,5714877920,3456,3387,3387,-69,-2,3436,-20,-0.58,3387,3404,1400-2-18,2021-05-08
245,اتكاي,بيمه اتكايي ايرانيان,78,873834,14039901797,16563,16068,16067,-496,-2.99,16419,-144,-0.87,16067,16068,1400-2-18,2021-05-08
246,شتولي,تولي‌پرس‌,78,176122,6264307296,34871,35568,35568,697,2,35299,428,1.23,35568,35568,1400-2-18,2021-05-08
247,گشان,توسعه بين المللي پديده شانديز,78,81117,1792442349,22547,22097,22097,-450,-2,22486,-61,-0.27,22097,22097,1400-2-18,2021-05-08
248,دارا,صندوق س. دارا الگوريتم-د,73,1053564,10593216158,10041,10070,10060,19,0.19,10055,14,0.14,10040,10070,1400-2-18,2021-05-08
249,سشمال,سيمان‌ شمال‌,70,1356074,13045431880,9910,9620,9620,-290,-2.93,9830,-80,-0.81,9620,9620,1400-2-18,2021-05-08
250,ضملي3004,اختيارخ فملي-14000-1400/03/02,68,3628,327712000,67,100,67,0,0,90,23,34.33,66,150,1400-2-18,2021-05-08
251,مارون,پتروشيمي مارون,68,33643,4881297887,149578,145093,145091,-4487,-3,149352,-226,-0.15,145091,145100,1400-2-18,2021-05-08
252,زعف0008پ16,زعفران0008نگين بيرجند(پ),67,25307,3038889167,121563,120000,119500,-2063,-1.7,120081,-1482,-1.22,119000,120800,1400-2-18,2021-05-08
253,كدما,معدني‌ دماوند,66,105373,10163225850,99430,96450,96450,-2980,-3,98810,-620,-0.62,96450,96450,1400-2-18,2021-05-08
254,كيان2,صندوق س. با درآمد ثابت كيان,65,6500000,6500000,28293,1,1,-28292,-100,1,-28292,-100,1,1,1400-2-18,2021-05-08
255,پاكشو,گروه صنعتي پاكشو,63,467376,2869688640,6320,6140,6140,-180,-2.85,6320,0,0,6140,6140,1400-2-18,2021-05-08
256,شاملا,معدني‌ املاح‌  ايران‌,63,285489,13849071390,50010,48510,48510,-1500,-3,49580,-430,-0.86,48510,48510,1400-2-18,2021-05-08
257,ضملي3003,اختيارخ فملي-12000-1400/03/02,62,817,430054000,438,840,479,41,9.36,526,88,20.09,362,840,1400-2-18,2021-05-08
258,قشرين,قند شيرين خراسان,61,1439830,16726505110,12101,11617,11617,-484,-4,11679,-422,-3.49,11617,11617,1400-2-18,2021-05-08
259,شبصير,توليدات پتروشيمي قائد بصير,61,37506,2434392140,66912,64905,64905,-2007,-3,66811,-101,-0.15,64905,64942,1400-2-18,2021-05-08
260,حفاري,حفاري شمال,60,480246,3044759640,6530,6340,6340,-190,-2.91,6520,-10,-0.15,6340,6340,1400-2-18,2021-05-08
261,آتيمس,صندوق س.آرمان آتيه درخشان مس-س,60,16093,2801210390,174288,174100,172560,-1728,-0.99,174064,-224,-0.13,172550,176440,1400-2-18,2021-05-08
262,آبادا,توليد نيروي برق آبادان,59,64692,789889320,12580,12210,12210,-370,-2.94,12570,-10,-0.08,12210,12210,1400-2-18,2021-05-08
263,وسبحان,سرمايه گذاري سبحان,58,3477866,9605865892,2847,2762,2762,-85,-2.99,2830,-17,-0.6,2762,2762,1400-2-18,2021-05-08
264,لبوتان,گروه‌صنعتي‌بوتان‌,58,35894,2093422110,60080,58280,58280,-1800,-3,60000,-80,-0.13,58280,59490,1400-2-18,2021-05-08
265,دپارس,پارس‌ دارو,58,68789,3213437310,47660,47000,45590,-2070,-4.34,47600,-60,-0.13,45590,47000,1400-2-18,2021-05-08
266,شكبير,پتروشيمي اميركبير,57,68642,5613730394,83441,81774,81773,-1668,-2,83346,-95,-0.11,81773,85000,1400-2-18,2021-05-08
267,وصنا,گروه‌صنايع‌بهشهرايران‌,55,793974,4350977520,5640,5480,5480,-160,-2.84,5630,-10,-0.18,5480,5480,1400-2-18,2021-05-08
268,وتوصا,گروه س توسعه صنعتي ايران,55,2023577,22785477020,11600,11260,11260,-340,-2.93,11440,-160,-1.38,11260,11260,1400-2-18,2021-05-08
269,زعف0008پ05,زعفران0008نگين زرين(پ),54,43002,5172571230,122563,122563,120799,-1764,-1.44,120287,-2276,-1.86,119000,122563,1400-2-18,2021-05-08
270,زرين,صندوق س. سهام زرين كوروش-س,54,270046,2478812394,9320,9190,9150,-170,-1.82,9179,-141,-1.51,9002,9300,1400-2-18,2021-05-08
271,افق ملت,صندوق س در سهام افق ملت,53,25727,3128152640,121240,121750,121500,260,0.21,121590,350,0.29,121300,121750,1400-2-18,2021-05-08
272,شفارا,پتروشيمي فارابي,53,1050634,3774927962,3742,3593,3593,-149,-3.98,3713,-29,-0.77,3593,3593,1400-2-18,2021-05-08
273,وسپه,سرمايه‌گذاري‌ سپه‌,51,516215,3200533000,6390,6200,6200,-190,-2.97,6380,-10,-0.16,6200,6200,1400-2-18,2021-05-08
274,غسالم,سالمين‌,49,379164,1462435548,3976,3857,3857,-119,-2.99,3972,-4,-0.1,3857,3857,1400-2-18,2021-05-08
275,فراز,صندوق س.سهام فراز داريك-س,48,194705,2004488194,10287,10301,10291,4,0.04,10295,8,0.08,10290,10302,1400-2-18,2021-05-08
276,ضملي7002,اختيارخ فملي-9720-1400/07/11,47,665,2304786000,2834,3299,3400,566,19.97,3466,632,22.3,2902,3900,1400-2-18,2021-05-08
277,هنوري102,اختيارف ت نوري59561-01/02/15,46,300000,978000000,4270,3260,3260,-1010,-23.65,3260,-1010,-23.65,3260,3260,1400-2-18,2021-05-08
278,كوير,توليدي فولاد سپيد فراب كوير,45,1204952,22749493760,19460,18880,18880,-580,-2.98,19300,-160,-0.82,18880,18880,1400-2-18,2021-05-08
279,اخزا815,اسنادخزانه-م15بودجه98-010406,43,96315,76792256681,796829,794513,796357,-472,-0.06,797303,474,0.06,794513,797800,1400-2-18,2021-05-08
280,اوصتا,صندوق انديشه ورزان صباتامين -د,43,854006,15857071283,18537,18561,18570,33,0.18,18568,31,0.17,18560,18570,1400-2-18,2021-05-08
281,گكوثر,هتل پارسيان كوثر اصفهان,42,602506,1339973344,2292,2224,2224,-68,-2.97,2290,-2,-0.09,2224,2224,1400-2-18,2021-05-08
282,بكهنوج,توليد برق ماهتاب كهنوج,42,438957,698380587,1640,1591,1591,-49,-2.99,1639,-1,-0.06,1591,1591,1400-2-18,2021-05-08
283,وهنر,گروه توسعه هنر ايران,39,199440,1591331760,8311,7979,7979,-332,-3.99,8283,-28,-0.34,7979,7979,1400-2-18,2021-05-08
284,كخاك,صنايع‌خاك‌چيني‌ايران‌,38,122888,4838100560,40580,39370,39370,-1210,-2.98,40460,-120,-0.3,39370,39370,1400-2-18,2021-05-08
285,فاراك,ماشين‌ سازي‌ اراك‌,38,580187,1347774401,2394,2323,2323,-71,-2.97,2392,-2,-0.08,2323,2323,1400-2-18,2021-05-08
286,رتكو,كنترل‌خوردگي‌تكين‌كو,37,400000,6960000000,17930,17400,17400,-530,-2.96,17850,-80,-0.45,17400,17400,1400-2-18,2021-05-08
287,قيستو,شركت قند بيستون,37,54601,1035496110,19312,18926,18926,-386,-2,19275,-37,-0.19,18926,19300,1400-2-18,2021-05-08
288,دمعيار,صندوق س. توازن معيار-د,37,422839,4267667040,10074,10090,10090,16,0.16,10093,19,0.19,10090,10096,1400-2-18,2021-05-08
289,ضخود7074,اختيارخ خودرو-1800-1400/07/07,37,1592,517654000,384,360,290,-94,-24.48,325,-59,-15.36,271,370,1400-2-18,2021-05-08
290,وپويا,سرمايه گذاري پويا,36,765913,4790019902,6447,6254,6254,-193,-2.99,6428,-19,-0.29,6254,6254,1400-2-18,2021-05-08
291,خودكفا,اقتصادي و خودكفايي آزادگان,35,102979,1820874678,18042,17682,17682,-360,-2,18025,-17,-0.09,17682,17682,1400-2-18,2021-05-08
292,اخزا808,اسنادخزانه-م8بودجه98-000817,34,70032,63357045563,902850,900000,904600,1750,0.19,904687,1837,0.2,900000,912000,1400-2-18,2021-05-08
293,ساينا,صنايع بهداشتي ساينا,34,40581,5910663301,150155,145651,145651,-4504,-3,149606,-549,-0.37,145651,145652,1400-2-18,2021-05-08
294,اخزا907,اسنادخزانه-م7بودجه99-020704,33,166124,102760412632,618829,617500,619185,356,0.06,618577,-252,-0.04,613551,620000,1400-2-18,2021-05-08
295,وبوعلي,سرمايه‌گذاري‌بوعلي‌,33,372864,2084309760,5760,5590,5590,-170,-2.95,5750,-10,-0.17,5590,5590,1400-2-18,2021-05-08
296,ضجار2002,اختيارخ وتجارت-2500-1400/02/22,33,1757,84774000,117,79,45,-72,-61.54,48,-69,-58.97,11,99,1400-2-18,2021-05-08
297,ضملي3002,اختيارخ فملي-10000-1400/03/02,32,111,241070000,2053,2032,2140,87,4.24,2172,119,5.8,1932,2500,1400-2-18,2021-05-08
298,ثروتم,صندوق س. ثروت آفرين پارسيان-س,32,38320,2707915480,71408,71574,70460,-948,-1.33,70666,-742,-1.04,70200,71575,1400-2-18,2021-05-08
299,اخزا814,اسنادخزانه-م14بودجه98-010318,32,100879,81260354748,803652,805501,805999,2347,0.29,805523,1871,0.23,801520,806000,1400-2-18,2021-05-08
300,اخزا911,اسنادخزانه-م11بودجه99-020906,31,35652,21249302483,597007,597000,596000,-1007,-0.17,596020,-987,-0.17,595300,598410,1400-2-18,2021-05-08
301,ضپاس2002,اختيارخ وپارس-3000-1400/02/29,30,1400,3676000,6,4,4,-2,-33.33,3,-3,-50,2,4,1400-2-18,2021-05-08
302,ساروج,بين المللي ساروج بوشهر,30,969559,17127890735,18025,17830,17665,-360,-2,17711,-314,-1.74,17665,17830,1400-2-18,2021-05-08
303,خزاميا,زامياد,30,99803,847327470,8750,8490,8490,-260,-2.97,8750,0,0,8490,8490,1400-2-18,2021-05-08
304,شوينده,مديريت صنعت شوينده ت.ص.بهشهر,30,508165,12805758000,25970,25200,25200,-770,-2.96,25770,-200,-0.77,25200,25200,1400-2-18,2021-05-08
305,اخزا905,اسنادخزانه-م5بودجه99-020218,29,173483,116160857005,668431,668500,671000,2569,0.38,669581,1150,0.17,666080,671000,1400-2-18,2021-05-08
306,كزغال,زغال سنگ پروده طبس,29,208691,6410361447,31667,30717,30717,-950,-3,31541,-126,-0.4,30717,30717,1400-2-18,2021-05-08
307,صنوين,صندوق سرمايه‌گذاري صنوين-مختلط,29,9026,924334900,102400,102510,102400,0,0,102410,10,0.01,102400,102510,1400-2-18,2021-05-08
308,اخزا904,اسنادخزانه-م4بودجه99-011215,28,57473,40078512176,695483,697400,698450,2967,0.43,697345,1862,0.27,694121,698700,1400-2-18,2021-05-08
309,سپر,صندوق س سپر سرمايه بيدار- ثابت,27,277534,3267983502,11769,11776,11775,6,0.05,11775,6,0.05,11775,11776,1400-2-18,2021-05-08
310,ثاخت,بين‌المللي‌توسعه‌ساختمان,27,150370,361339110,2477,2403,2403,-74,-2.99,2476,-1,-0.04,2403,2403,1400-2-18,2021-05-08
311,كالا,بورس كالاي ايران,27,7447,230410180,31890,30940,30940,-950,-2.98,31890,0,0,30940,30940,1400-2-18,2021-05-08
312,كبافق,معادن‌ بافق‌,27,13841,649004490,48340,46890,46890,-1450,-3,48320,-20,-0.04,46890,46890,1400-2-18,2021-05-08
313,بورس,بورس اوراق بهادار تهران,27,383334,12891522420,34660,33630,33630,-1030,-2.97,34410,-250,-0.72,33630,33630,1400-2-18,2021-05-08
314,ضجار2003,اختيارخ وتجارت-3000-1400/02/22,26,1195,2210000,5,3,1,-4,-80,2,-3,-60,1,3,1400-2-18,2021-05-08
315,وملي,گروه‌ صنعتي‌ ملي‌ (هلدينگ‌,26,11107,1838652780,170650,165540,165540,-5110,-2.99,170460,-190,-0.11,165540,165540,1400-2-18,2021-05-08
316,سبزوا,سيمان لار سبزوار,26,121335,390820035,3320,3221,3221,-99,-2.98,3319,-1,-0.03,3221,3221,1400-2-18,2021-05-08
317,وهور,مديريت انرژي اميد  تابان هور,25,279732,551911236,2034,1973,1973,-61,-3,2033,-1,-0.05,1973,1973,1400-2-18,2021-05-08
318,انرژي3,سايراشخاص بورس انرژي,25,1626,395833440,250960,243440,243440,-7520,-3,250910,-50,-0.02,243440,243440,1400-2-18,2021-05-08
319,هاي وب,داده گسترعصرنوين-هاي وب,24,39456,400872960,10470,10160,10160,-310,-2.96,10470,0,0,10160,10160,1400-2-18,2021-05-08
320,قرن,پديده شيمي قرن,24,18082,1086728200,61950,60100,60100,-1850,-2.99,61910,-40,-0.06,60100,60100,1400-2-18,2021-05-08
321,شراز,پالايش نفت شيراز,24,100521,10805605416,110820,107496,107496,-3324,-3,110079,-741,-0.67,107496,107496,1400-2-18,2021-05-08
322,اخزا914,اسنادخزانه-م14بودجه99-021025,23,8746,5072699564,582890,580144,581215,-1675,-0.29,580002,-2888,-0.5,579600,583000,1400-2-18,2021-05-08
323,كفپارس,فرآورده‌هاي‌ نسوز پارس‌,23,188564,598690700,3273,3175,3175,-98,-2.99,3272,-1,-0.03,3175,3175,1400-2-18,2021-05-08
324,اخزا809,اسنادخزانه-م9بودجه98-000923,23,22331,19808199860,885220,885401,885410,190,0.02,887027,1807,0.2,884005,888500,1400-2-18,2021-05-08
325,اخزا817,اسنادخزانه-م17بودجه98-010512,23,7396,5763299491,779725,778235,779500,-225,-0.03,779245,-480,-0.06,776202,780000,1400-2-18,2021-05-08
326,گنجين,صندوق س. گنجينه يكم آويد-د,22,276876,3536926738,12753,12782,12773,20,0.16,12774,21,0.16,12773,12782,1400-2-18,2021-05-08
327,اخزا818,اسنادخزانه-م18بودجه98-010614,22,21619,16592520557,766897,765000,769970,3073,0.4,767497,600,0.08,765000,769980,1400-2-18,2021-05-08
328,بموتو,موتوژن‌,22,5662,291593000,53090,51500,51500,-1590,-2.99,53080,-10,-0.02,51500,51500,1400-2-18,2021-05-08
329,ثبهساز,بهساز كاشانه تهران,22,153599,339300191,2277,2209,2209,-68,-2.99,2277,0,0,2209,2209,1400-2-18,2021-05-08
330,واميدح,ح.گروه مديريت سرمايه گذار اميد,21,94045,692171200,7820,7360,7360,-460,-5.88,7360,-460,-5.88,7360,7360,1400-2-18,2021-05-08
331,زپارس,ملي كشت و صنعت و دامپروري پارس,20,217380,29331083400,139100,134930,134930,-4170,-3,136580,-2520,-1.81,134930,134930,1400-2-18,2021-05-08
332,اخزا812,اسنادخزانه-م12بودجه98-001111,20,39422,34168915986,865495,861101,867000,1505,0.17,866747,1252,0.14,861101,867000,1400-2-18,2021-05-08
333,وپخش,داروپخش‌ (هلدينگ‌,20,5477,539210650,101490,98450,98450,-3040,-3,101460,-30,-0.03,98450,98450,1400-2-18,2021-05-08
334,سخند,صندوق س.سپهرخبرگان نفت-د,20,125500,1257046190,10149,10015,10019,-130,-1.28,10016,-133,-1.31,10015,10019,1400-2-18,2021-05-08
335,اخزا718,اسنادخزانه-م18بودجه97-000525,19,8457,7997874439,934716,945102,946999,12283,1.31,945711,10995,1.18,945099,946999,1400-2-18,2021-05-08
336,فخاس,فولاد خراسان,19,392620,9956843200,26140,25360,25360,-780,-2.98,26060,-80,-0.31,25360,25360,1400-2-18,2021-05-08
337,ملت,بيمه ملت,19,12908,195168960,15580,15120,15120,-460,-2.95,15580,0,0,15120,15120,1400-2-18,2021-05-08
338,ونيرو,سرمايه‌گذاري‌نيرو,18,76775,191937500,2577,2500,2500,-77,-2.99,2577,0,0,2500,2500,1400-2-18,2021-05-08
339,لپارس,پارس‌ الكتريك‌,17,41327,3666944710,91470,88730,88730,-2740,-3,91260,-210,-0.23,88730,88730,1400-2-18,2021-05-08
340,فسازان,غلتك سازان سپاهان,17,48405,1534922550,32690,31710,31710,-980,-3,32660,-30,-0.09,31710,31710,1400-2-18,2021-05-08
341,چكاپا,گروه صنايع كاغذ پارس,17,86666,436796640,5190,5040,5040,-150,-2.89,5190,0,0,5040,5040,1400-2-18,2021-05-08
342,رتاپ,تجارت الكترونيك  پارسيان,17,182005,1217613450,6890,6690,6690,-200,-2.9,6880,-10,-0.15,6690,6690,1400-2-18,2021-05-08
343,خمحركه,نيرو محركه‌,16,29601,132050061,4598,4461,4461,-137,-2.98,4598,0,0,4461,4461,1400-2-18,2021-05-08
344,پتاير,ايران‌ تاير,16,53966,191957062,3667,3557,3557,-110,-3,3667,0,0,3557,3557,1400-2-18,2021-05-08
345,وثنو,سرمايه گذاري ساختماني نوين,16,201843,934734933,4725,4631,4631,-94,-1.99,4721,-4,-0.08,4631,4631,1400-2-18,2021-05-08
346,زعف0008پ11,زعفران0008نگين سحرخيز(پ),16,9240,1127371500,124374,123000,122000,-2374,-1.91,122010,-2364,-1.9,121990,123000,1400-2-18,2021-05-08
347,ثشاهد,سرمايه‌ گذاري‌ شاهد,16,20617,347808790,17390,16870,16870,-520,-2.99,17390,0,0,16870,16870,1400-2-18,2021-05-08
348,فرابورس,فرابورس ايران,16,46394,1409032174,31310,30371,30371,-939,-3,31283,-27,-0.09,30371,30371,1400-2-18,2021-05-08
349,شپترو,پتروشيمي آبادان,16,560939,2521420805,4586,4495,4495,-91,-1.98,4574,-12,-0.26,4495,4495,1400-2-18,2021-05-08
350,كرازي,كارخانجات‌توليدي‌شيشه‌رازي‌,15,24131,526055800,22470,21800,21800,-670,-2.98,22460,-10,-0.04,21800,21800,1400-2-18,2021-05-08
351,مفاخر,توسعه فناوري اطلاعات خوارزمي,15,260114,15912213836,63065,61174,61174,-1891,-3,62445,-620,-0.98,61174,61174,1400-2-18,2021-05-08
352,حتايد,تايدواترخاورميانه,15,16651,410946680,25440,24680,24680,-760,-2.99,25430,-10,-0.04,24680,24680,1400-2-18,2021-05-08
353,نگين,ص.س. زمين و ساختمان نگين شهرري,15,1804,87071480,47530,48840,48390,860,1.81,48270,740,1.56,47530,48850,1400-2-18,2021-05-08
354,بكام,كارخانجات توليدي شهيد قندي,15,33512,127915304,3935,3817,3817,-118,-3,3935,0,0,3817,3817,1400-2-18,2021-05-08
355,اخزا804,اسنادخزانه-م4بودجه98-000421,15,6768,6531069877,961767,964000,965000,3233,0.34,964993,3226,0.34,964000,965501,1400-2-18,2021-05-08
356,باران,بيمه زندگي باران50%تاديه,14,101310,390752670,3745,3857,3857,112,2.99,3747,2,0.05,3857,3857,1400-2-18,2021-05-08
357,فجام,جام‌دارو,14,500503,5020045090,10330,10030,10030,-300,-2.9,10300,-30,-0.29,10030,10030,1400-2-18,2021-05-08
358,ضملي3000,اختيارخ فملي-8000-1400/03/02,14,220,870780000,3894,4039,3900,6,0.15,3958,64,1.64,3900,4039,1400-2-18,2021-05-08
359,ودي,بيمه  دي,14,161619,3280704081,20926,20299,20299,-627,-3,20884,-42,-0.2,20299,20299,1400-2-18,2021-05-08
360,اتكام,شركت بيمه اتكايي امين,14,51770,238452620,4748,4606,4606,-142,-2.99,4747,-1,-0.02,4606,4606,1400-2-18,2021-05-08
361,اخزا721,اسنادخزانه-م21بودجه97-000728,14,50451,46133691743,911348,910001,910005,-1343,-0.15,914426,3078,0.34,910000,915000,1400-2-18,2021-05-08
362,دلرح,ح . داروسازي‌ اكسير,14,10049,275714000,29100,29000,27360,-1740,-5.98,27440,-1660,-5.7,27360,29000,1400-2-18,2021-05-08
363,ضشنا2002,اختيارخ شپنا-12000-1400/02/27,14,363,6922000,104,11,29,-75,-72.12,19,-85,-81.73,11,199,1400-2-18,2021-05-08
364,اخزا806,اسنادخزانه-م6بودجه98-000519,14,24176,22971258470,948003,948003,950002,1999,0.21,950168,2165,0.23,946931,951000,1400-2-18,2021-05-08
365,دالبر,البرزدارو,14,89625,1282533750,14750,14310,14310,-440,-2.98,14740,-10,-0.07,14310,14310,1400-2-18,2021-05-08
366,هجرتح,ح . پخش هجرت,14,26777,479203182,18447,18000,17894,-553,-3,17896,-551,-2.99,17894,18000,1400-2-18,2021-05-08
367,زعف0008پ08,زعفران0008نگين روستا(پ),14,3269,394476100,121610,121400,120000,-1610,-1.32,120672,-938,-0.77,120000,121500,1400-2-18,2021-05-08
368,ختوقا,قطعات‌ اتومبيل‌ ايران‌,14,104360,254012240,2509,2434,2434,-75,-2.99,2509,0,0,2434,2434,1400-2-18,2021-05-08
369,چفيبر,فيبر ايران‌,14,23208,302632320,13870,13040,13040,-830,-5.98,13860,-10,-0.07,13040,13040,1400-2-18,2021-05-08
370,فافزا,فولاد افزا سپاهان,13,81988,4025446824,50099,49098,49098,-1001,-2,49893,-206,-0.41,49098,49098,1400-2-18,2021-05-08
371,وآيند,بانك  آينده,13,15171,243327669,16366,16039,16039,-327,-2,16365,-1,-0.01,16039,16039,1400-2-18,2021-05-08
372,ولپارس,ليزينگ پارسيان,13,70975,343589975,4990,4841,4841,-149,-2.99,4989,-1,-0.02,4841,4841,1400-2-18,2021-05-08
373,واتي,سرمايه‌ گذاري‌ آتيه‌ دماوند,13,130150,1283279000,10160,9860,9860,-300,-2.95,10150,-10,-0.1,9860,9860,1400-2-18,2021-05-08
374,بذر,صندوق س بذر اميد آفرين-سهام,13,12981,1172064530,90580,91380,89770,-810,-0.89,90290,-290,-0.32,89600,91380,1400-2-18,2021-05-08
375,شپاس,نفت پاسارگاد,13,438923,9158128395,21510,20865,20865,-645,-3,21388,-122,-0.57,20865,20865,1400-2-18,2021-05-08
376,سپيدار,سپيدار سيستم آسيا,13,3873,220931412,58808,57044,57044,-1764,-3,58800,-8,-0.01,57044,57044,1400-2-18,2021-05-08
377,فرآور,فرآوري‌موادمعدني‌ايران‌,13,201781,6868625240,35090,34040,34040,-1050,-2.99,34940,-150,-0.43,34040,34040,1400-2-18,2021-05-08
378,دسينا,داروسازي‌ سينا,12,204571,4737864360,23870,23160,23160,-710,-2.97,23800,-70,-0.29,23160,23160,1400-2-18,2021-05-08
379,تمحركه,ماشين سازي نيرو محركه,12,83934,2079464850,25280,24775,24775,-505,-2,25226,-54,-0.21,24775,24775,1400-2-18,2021-05-08
380,غپينو,پارس‌ مينو,12,13356,82139400,6340,6150,6150,-190,-3,6340,0,0,6150,6150,1400-2-18,2021-05-08
381,سپاها,سيمان‌سپاهان‌,12,50321,398039110,8150,7910,7910,-240,-2.94,8150,0,0,7910,7910,1400-2-18,2021-05-08
382,آسام,صندوق س.آرمان سپهر آشنا-م,12,9330,968199740,102050,102000,102900,850,0.83,103773,1723,1.69,102000,104000,1400-2-18,2021-05-08
383,سيستم,همكاران سيستم,12,34646,861992480,25640,24880,24880,-760,-2.96,25630,-10,-0.04,24880,24880,1400-2-18,2021-05-08
384,اخزا811,اسنادخزانه-م11بودجه98-001013,12,4168,3653991932,877156,877000,877500,344,0.04,876677,-479,-0.05,875850,878499,1400-2-18,2021-05-08
385,وكارح,ح . بانك‌ كارآفرين‌,12,155275,235707450,1614,1518,1518,-96,-5.95,1518,-96,-5.95,1518,1518,1400-2-18,2021-05-08
386,ثتوسا,س.توسعه و عمران استان اردبيل,11,18749,701512584,38974,37416,37416,-1558,-4,38917,-57,-0.15,37416,37416,1400-2-18,2021-05-08
387,دانا,بيمه دانا,11,238078,1530841540,6620,6430,6430,-190,-2.87,6610,-10,-0.15,6430,6430,1400-2-18,2021-05-08
388,ولساپا,ليزينگ رايان‌ سايپا,11,261780,839528460,3306,3207,3207,-99,-2.99,3304,-2,-0.06,3207,3207,1400-2-18,2021-05-08
389,مرقام,ايران‌ارقام‌,11,18849,357000060,19520,18940,18940,-580,-2.97,19520,0,0,18940,18940,1400-2-18,2021-05-08
390,اخزا820,اسنادخزانه-م20بودجه98-020806,11,12731,7754836253,613895,612382,608700,-5195,-0.85,609130,-4765,-0.78,608603,614880,1400-2-18,2021-05-08
391,خريخت,صنايع‌ريخته‌گري‌ايران‌,11,174372,495390852,2928,2841,2841,-87,-2.97,2927,-1,-0.03,2841,2841,1400-2-18,2021-05-08
392,ضپاس2001,اختيارخ وپارس-2500-1400/02/29,11,678,47698000,83,140,51,-32,-38.55,70,-13,-15.66,51,140,1400-2-18,2021-05-08
393,اخزا821,اسنادخزانه-م21بودجه98-020906,11,1567,938909187,601089,600000,599001,-2088,-0.35,599176,-1913,-0.32,599001,600000,1400-2-18,2021-05-08
394,دلر,داروسازي‌ اكسير,11,4543,156551780,35520,34460,34460,-1060,-2.98,35520,0,0,34460,34460,1400-2-18,2021-05-08
395,ضصاد3003,اختيارخ وبصادر-3000-1400/03/12,10,444,3350000,12,11,5,-7,-58.33,8,-4,-33.33,5,11,1400-2-18,2021-05-08
396,ضپاس7028,اختيارخ وپارس-2000-1400/07/28,10,81,40766000,586,570,500,-86,-14.68,503,-83,-14.16,500,579,1400-2-18,2021-05-08
397,شاروم,پتروشيمي اروميه,10,8203,153773438,19325,18746,18746,-579,-3,19323,-2,-0.01,18746,18746,1400-2-18,2021-05-08
398,تصميم2,صندوق س با درآمد ثابت تصميم,10,9200000,9200000,16280,1,1,-16279,-99.99,1,-16279,-99.99,1,1,1400-2-18,2021-05-08
399,دزهراوي,داروسازي‌زهراوي‌,10,10309,87111050,8710,8450,8450,-260,-2.99,8710,0,0,8450,8450,1400-2-18,2021-05-08
400,زير0003پ04,زيره سبز0003شركت مينوبذر(پ),10,675,388154690,571000,600000,570000,-1000,-0.18,575044,4044,0.71,570000,606790,1400-2-18,2021-05-08
401,اراد50,مرابحه عام دولت5-ش.خ0302,10,188100,188100000000,1000031,1000000,1000000,-31,0,1000000,-31,0,1000000,1000000,1400-2-18,2021-05-08
402,ضپيك2009,اختيارخ تاپيكو-10000-00/02/19,10,109,2547000,1111,30,15,-1096,-98.65,23,-1088,-97.93,15,30,1400-2-18,2021-05-08
403,غشهداب,كشت و صنعت شهداب ناب خراسان,10,72408,278336352,3962,3844,3844,-118,-2.98,3961,-1,-0.03,3844,3844,1400-2-18,2021-05-08
404,لسرما,سرما آفرين‌,10,43550,1018199000,24100,23380,23380,-720,-2.99,24080,-20,-0.08,23380,23380,1400-2-18,2021-05-08
405,چكارن,كارتن‌ ايران‌,10,48045,155233395,3330,3231,3231,-99,-2.97,3330,0,0,3231,3231,1400-2-18,2021-05-08
406,صايپا012,صكوك مرابحه سايپا012-3ماهه 16%,10,100000,100000200000,1000002,1000002,1000002,0,0,1000002,0,0,1000002,1000002,1400-2-18,2021-05-08
407,كماسه,تامين‌ ماسه‌ ريخته‌گري‌,10,4881,206905590,43700,42390,42390,-1310,-3,43690,-10,-0.02,42390,42390,1400-2-18,2021-05-08
408,اخزا810,اسنادخزانه-م10بودجه98-001006,10,21206,18690553559,877987,877003,879317,1330,0.15,881380,3393,0.39,877003,882000,1400-2-18,2021-05-08
409,رافزا,رايان هم افزا,9,559,57840848,106672,103472,103472,-3200,-3,106668,-4,0,103472,103472,1400-2-18,2021-05-08
410,نوين,بيمه نوين,9,23143,132933392,5921,5744,5744,-177,-2.99,5921,0,0,5744,5744,1400-2-18,2021-05-08
411,ضشنا2003,اختيارخ شپنا-14000-1400/02/27,9,619,819000,19,2,1,-18,-94.74,1,-18,-94.74,1,2,1400-2-18,2021-05-08
412,ثنور,سرمايه گذاري كوه نور,9,11576,107622072,9684,9297,9297,-387,-4,9682,-2,-0.02,9297,9297,1400-2-18,2021-05-08
413,ضجار2000,اختيارخ وتجارت-1800-1400/02/22,9,115,65054000,596,620,629,33,5.54,566,-30,-5.03,512,700,1400-2-18,2021-05-08
414,فسرب,ملي‌ سرب‌وروي‌ ايران‌,9,3208,245155360,78780,76420,76420,-2360,-3,78770,-10,-0.01,76420,76420,1400-2-18,2021-05-08
415,زعف0008پ10,زعفران0008نگين طلاي سرخ(پ),9,2750,338349750,127316,123150,124000,-3316,-2.6,123036,-4280,-3.36,122100,124000,1400-2-18,2021-05-08
416,ثفارس,عمران‌وتوسعه‌فارس‌,9,198641,1928804110,10010,9710,9710,-300,-3,10000,-10,-0.1,9710,9710,1400-2-18,2021-05-08
417,رطب0002پ01,رطب مضافتي0002افشارتعاون بم(پ),9,781,121403326,148044,155446,155446,7402,5,155446,7402,5,155446,155446,1400-2-18,2021-05-08
418,اراد35,مرابحه عام دولت3-ش.خ 0103,9,80000,75881828000,948599,996028,948600,1,0,948523,-76,-0.01,945000,996028,1400-2-18,2021-05-08
419,اخزا816,اسنادخزانه-م16بودجه98-010503,9,5243,4113431182,782400,783001,785001,2601,0.33,784557,2157,0.28,783000,785500,1400-2-18,2021-05-08
420,قثابت,قند ثابت‌ خراسان‌,9,3743,245615660,67640,65620,65620,-2020,-2.99,67630,-10,-0.01,65620,65620,1400-2-18,2021-05-08
421,تملي709,تسهيلات مسكن ب. ملي-آذر97,9,70,55122970,749973,787471,787471,37498,5,787471,37498,5,787471,787471,1400-2-18,2021-05-08
422,اخزا906,اسنادخزانه-م6بودجه99-020321,9,29215,22082965314,752143,720748,752143,0,0,755878,3735,0.5,720747,774707,1400-2-18,2021-05-08
423,بميلا,توسعه بازرگاني آهن وفولادميلاد,9,15813,217096677,14009,13729,13729,-280,-2,14006,-3,-0.02,13729,13729,1400-2-18,2021-05-08
424,پرديس,سرمايه گذاري پرديس,9,55879,294482330,5430,5270,5270,-160,-2.95,5430,0,0,5270,5270,1400-2-18,2021-05-08
425,شپاكسا,پاكسان‌,9,300790,7955895500,27260,26450,26450,-810,-2.97,27130,-130,-0.48,26450,26450,1400-2-18,2021-05-08
426,بخاور,بيمه زندگي خاورميانه,9,180830,1188233930,6774,6571,6571,-203,-3,6769,-5,-0.07,6571,6571,1400-2-18,2021-05-08
427,اخزا722,اسنادخزانه-م22بودجه97-000428,8,15656,15035187500,959175,961000,961500,2325,0.24,960347,1172,0.12,960000,962389,1400-2-18,2021-05-08
428,غزر,صنعتي زر ماكارون,8,7090,176470100,25650,24890,24890,-760,-2.96,25650,0,0,24890,24890,1400-2-18,2021-05-08
429,وملت,سرمايه گذاري ملت,8,15194,65319006,4386,4299,4299,-87,-1.98,4385,-1,-0.02,4299,4299,1400-2-18,2021-05-08
430,دتوليد,داروسازي توليد دارو,8,12908,332716608,26573,25776,25776,-797,-3,26568,-5,-0.02,25776,25776,1400-2-18,2021-05-08
431,بنيرو,نيروترانس‌,8,64030,934838000,15050,14600,14600,-450,-2.99,15040,-10,-0.07,14600,14600,1400-2-18,2021-05-08
432,وآرين,شركت توسعه اقتصادي آرين,8,19720,67600160,3497,3428,3428,-69,-1.97,3497,0,0,3428,3428,1400-2-18,2021-05-08
433,وسديد,گروه ‌صنعتي‌سديد,8,54870,156105150,2903,2845,2845,-58,-2,2903,0,0,2845,2845,1400-2-18,2021-05-08
434,سهگمت,سيمان‌هگمتان‌,8,3838,92265520,24780,24040,24040,-740,-2.99,24780,0,0,24040,24040,1400-2-18,2021-05-08
435,ستران,سيمان‌ تهران‌,8,14227,322952900,23400,22700,22700,-700,-2.99,23400,0,0,22700,22700,1400-2-18,2021-05-08
436,سيمرغ,سيمرغ,8,9966,176697180,18270,17730,17730,-540,-2.96,18270,0,0,17730,17730,1400-2-18,2021-05-08
437,اعتلا,شركت سرمايه گذاري اعتلاء البرز,8,10324,72711932,7260,7043,7043,-217,-2.99,7260,0,0,7043,7043,1400-2-18,2021-05-08
438,كمينا,شيشه سازي مينا,8,41455,1020580645,25121,24619,24619,-502,-2,25095,-26,-0.1,24619,24619,1400-2-18,2021-05-08
439,فروس,فروسيليس‌ ايران‌,7,28602,146442240,5270,5120,5120,-150,-2.85,5270,0,0,5120,5120,1400-2-18,2021-05-08
440,زبينا,كشاورزي و دامپروري بينالود,7,38357,145373030,3907,3790,3790,-117,-2.99,3907,0,0,3790,3790,1400-2-18,2021-05-08
441,آپ,آسان پرداخت پرشين,7,2942,49690380,17410,16890,16890,-520,-2.99,17410,0,0,16890,16890,1400-2-18,2021-05-08
442,غمارگ,مارگارين‌,7,200165,6103030850,31430,30490,30490,-940,-2.99,31310,-120,-0.38,30490,30490,1400-2-18,2021-05-08
443,ضفلا3003,اختيارخ فولاد-7133-1400/03/19,7,38,78730000,2080,2112,2090,10,0.48,2072,-8,-0.38,2000,2112,1400-2-18,2021-05-08
444,زقيام,كشت و دام قيام اصفهان,7,5145,144435585,28941,28073,28073,-868,-3,28938,-3,-0.01,28073,28073,1400-2-18,2021-05-08
445,حفارس,حمل و نقل بين المللي خليج فارس,7,20574,96286320,4824,4680,4680,-144,-2.99,4824,0,0,4680,4680,1400-2-18,2021-05-08
446,ضصاد3001,اختيارخ وبصادر-2000-1400/03/12,7,387,109679000,306,259,290,-16,-5.23,283,-23,-7.52,251,299,1400-2-18,2021-05-08
447,الماس,صندوق س.امين تدبيرگران فردا-س,7,1785,189210880,106321,106000,106000,-321,-0.3,106000,-321,-0.3,106000,106110,1400-2-18,2021-05-08
448,بمپنا,توليد برق عسلويه  مپنا,7,3916,266945888,70276,68168,68168,-2108,-3,70264,-12,-0.02,68168,68168,1400-2-18,2021-05-08
449,اخزا723,اسنادخزانه-م23بودجه97-000824,7,77005,69450188000,898020,900000,902000,3980,0.44,901892,3872,0.43,900000,902000,1400-2-18,2021-05-08
450,اراد33,مرابحه عام دولت3-ش.خ 0303,7,3900,3697549800,916152,871052,959999,43847,4.79,948090,31938,3.49,871052,961957,1400-2-18,2021-05-08
451,جوين,كشت و صنعت جوين,7,21858,106645182,4978,4879,4879,-99,-1.99,4977,-1,-0.02,4879,4879,1400-2-18,2021-05-08
452,وپست,پست بانك ايران,7,14980,294956200,20290,19690,19690,-600,-2.96,20290,0,0,19690,19690,1400-2-18,2021-05-08
453,ضخود7072,اختيارخ خودرو-1400-1400/07/07,7,77,47418000,739,666,600,-139,-18.81,616,-123,-16.64,500,666,1400-2-18,2021-05-08
454,زگلدشت,كشت و دام گلدشت نمونه اصفهان,7,13099,177308064,13954,13536,13536,-418,-3,13952,-2,-0.01,13536,13536,1400-2-18,2021-05-08
455,پكوير,كوير تاير,7,4080,50918400,12860,12480,12480,-380,-2.95,12860,0,0,12480,12480,1400-2-18,2021-05-08
456,همبين102,اختيارف ت مبين17952-01/02/10,7,178214,123680516,740,694,694,-46,-6.22,694,-46,-6.22,694,694,1400-2-18,2021-05-08
457,ضجار2001,اختيارخ وتجارت-2000-1400/02/22,7,73,32707000,520,500,361,-159,-30.58,448,-72,-13.85,361,500,1400-2-18,2021-05-08
458,غدشت,دشت‌ مرغاب‌,6,407,113740220,288100,279460,279460,-8640,-3,288080,-20,-0.01,279460,279460,1400-2-18,2021-05-08
459,شستان,پتروشيمي گلستان,6,111500,421581500,3858,3781,3781,-77,-2,3855,-3,-0.08,3781,3781,1400-2-18,2021-05-08
460,اخزا807,اسنادخزانه-م7بودجه98-000719,6,58758,54055660554,919000,919999,915844,-3156,-0.34,919971,971,0.11,915844,919999,1400-2-18,2021-05-08
461,غمينو,شركت صنايع غذايي مينو شرق,6,6573,72828840,11422,11080,11080,-342,-2.99,11421,-1,-0.01,11080,11080,1400-2-18,2021-05-08
462,وبيمه,سرمايه‌ گذاري‌ صنعت‌ بيمه‌,6,25568,69442688,2799,2716,2716,-83,-2.97,2799,0,0,2716,2716,1400-2-18,2021-05-08
463,ولملت,واسپاري ملت,6,13550,103251000,7850,7620,7620,-230,-2.93,7850,0,0,7620,7620,1400-2-18,2021-05-08
464,خمحور,توليدمحورخودرو,6,1474,90783660,63490,61590,61590,-1900,-2.99,63490,0,0,61590,61590,1400-2-18,2021-05-08
465,زملارد,كشاورزي و دامپروري ملارد شير,6,19991,728552004,37571,36444,36444,-1127,-3,37554,-17,-0.05,36444,36444,1400-2-18,2021-05-08
466,اميد,تامين سرمايه اميد,6,6720,50534400,7750,7520,7520,-230,-2.97,7750,0,0,7520,7520,1400-2-18,2021-05-08
467,دكيمي,كيميدارو,6,10185,296485350,30010,29110,29110,-900,-3,30000,-10,-0.03,29110,29110,1400-2-18,2021-05-08
468,ضسپا3001,اختيارخ خساپا-1600-1400/03/26,6,338,76796000,315,250,212,-103,-32.7,227,-88,-27.94,210,250,1400-2-18,2021-05-08
469,كپرور,فرآوري زغال سنگ پروده طبس,6,2419,85550354,36459,35366,35366,-1093,-3,36457,-2,-0.01,35366,35366,1400-2-18,2021-05-08
470,تليسه,دامداري تليسه نمونه,6,15710,66280490,4349,4219,4219,-130,-2.99,4349,0,0,4219,4219,1400-2-18,2021-05-08
471,بساما,بيمه سامان,6,4241,89209435,21685,21035,21035,-650,-3,21684,-1,0,21035,21035,1400-2-18,2021-05-08
472,شلعاب,لعابيران‌,6,3895,82807700,21910,21260,21260,-650,-2.97,21910,0,0,21260,21260,1400-2-18,2021-05-08
473,سمگا,گروه سرمايه گذاري ميراث فرهنگي,6,1984,55169088,28667,27807,27807,-860,-3,28666,-1,0,27807,27807,1400-2-18,2021-05-08
474,ضترا3004,اختيارخ شتران-10000-1400/03/09,6,123,9184000,100,100,43,-57,-57,75,-25,-25,40,100,1400-2-18,2021-05-08
475,زير0003پ01,زيره سبز0003كيميابذر(پ),6,278,169617174,602162,609999,570000,-32162,-5.34,610134,7972,1.32,570000,622870,1400-2-18,2021-05-08
476,بزاگرس,نيروگاه زاگرس كوثر,6,24675,171269175,7155,6941,6941,-214,-2.99,7154,-1,-0.01,6941,6941,1400-2-18,2021-05-08
477,تكمبا,كمباين‌ سازي‌ ايران‌,6,34049,259112890,7840,7610,7610,-230,-2.93,7840,0,0,7610,7610,1400-2-18,2021-05-08
478,شسينا,صنايع‌شيميايي‌سينا,6,879,112907550,132420,128450,128450,-3970,-3,132410,-10,-0.01,128450,128450,1400-2-18,2021-05-08
479,غگرجي,بيسكويت‌  گرجي‌,6,52583,929667440,18220,17680,17680,-540,-2.96,18210,-10,-0.05,17680,17680,1400-2-18,2021-05-08
480,ثنوسا,نوسازي‌وساختمان‌تهران‌,6,4664,58766400,12980,12600,12600,-380,-2.93,12980,0,0,12600,12600,1400-2-18,2021-05-08
481,ساوه,سيمان ساوه,6,1256,67998584,55813,54139,54139,-1674,-3,55811,-2,0,54139,54139,1400-2-18,2021-05-08
482,ولتجار,واسپاري تجارت وسرمايه ايرانيان,6,90000,726390000,8235,8071,8071,-164,-1.99,8229,-6,-0.07,8071,8071,1400-2-18,2021-05-08
483,كهمداح,ح . شيشه‌ همدان‌,6,14890,114653000,7700,7700,7700,0,0,7700,0,0,7700,7700,1400-2-18,2021-05-08
484,ضترا3002,اختيارخ شتران-8000-1400/03/09,6,19,8399000,778,300,399,-379,-48.71,442,-336,-43.19,300,500,1400-2-18,2021-05-08
485,كهمدا,شيشه‌ همدان‌,6,14202,139747680,10140,9840,9840,-300,-2.96,10140,0,0,9840,9840,1400-2-18,2021-05-08
486,غشاذر,پگاه‌آذربايجان‌غربي‌,6,154233,1496060100,10000,9700,9700,-300,-3,9990,-10,-0.1,9700,9700,1400-2-18,2021-05-08
487,شسم,توليد سموم‌ علف‌ كش,6,4165,381997140,89918,91716,91716,1798,2,89985,67,0.07,91716,91716,1400-2-18,2021-05-08
488,پلاست,كارخانجات توليدي پلاستيران,6,655,45131465,71773,68903,68903,-2870,-4,71766,-7,-0.01,68903,68903,1400-2-18,2021-05-08
489,اخزا713,اسنادخزانه-م13بودجه97-000518,6,1281,1218556500,948113,951000,952500,4387,0.46,951254,3141,0.33,951000,952500,1400-2-18,2021-05-08
490,زعف0008پ20,زعفران0008نگين وحدت جام(پ),6,1830,217522751,121966,118105,118351,-3615,-2.96,118865,-3101,-2.54,118105,119500,1400-2-18,2021-05-08
491,ضشنا8002,اختيارخ شپنا-7800-1400/08/16,5,73,140731000,2072,2001,1503,-569,-27.46,1928,-144,-6.95,1503,2001,1400-2-18,2021-05-08
492,تكنار,مجتمع معادن مس تكنار,5,546,62906844,117565,115214,115214,-2351,-2,117557,-8,-0.01,115214,115214,1400-2-18,2021-05-08
493,دامين,داروسازي‌ امين‌,5,21810,110794800,5230,5080,5080,-150,-2.87,5230,0,0,5080,5080,1400-2-18,2021-05-08
494,ضمخا7066,اختيارخ اخابر-11700-1400/07/28,5,86,51632000,601,602,600,-1,-0.17,600,-1,-0.17,600,602,1400-2-18,2021-05-08
495,وپترو,سرمايه‌گذاري صنايع پتروشيمي‌,5,4004,53533480,13780,13370,13370,-410,-2.98,13780,0,0,13370,13370,1400-2-18,2021-05-08
496,دبالك,مواد اوليه دارويي البرز بالك,5,10750,217128500,20822,20198,20198,-624,-3,20819,-3,-0.01,20198,20198,1400-2-18,2021-05-08
497,توريل,توكاريل,5,1528,37072336,25012,24262,24262,-750,-3,25011,-1,0,24262,24262,1400-2-18,2021-05-08
498,قاسم,قاسم ايران,5,27072,342921024,13058,12667,12667,-391,-2.99,13055,-3,-0.02,12667,12667,1400-2-18,2021-05-08
499,كحافظ,كاشي‌ وسراميك‌ حافظ‌,5,15527,180579010,11980,11630,11630,-350,-2.92,11980,0,0,11630,11630,1400-2-18,2021-05-08
500,قجام,فرآوردههاي غذايي وقندتربت‌جام‌,5,1950,30843150,16139,15817,15817,-322,-2,16138,-1,-0.01,15817,15817,1400-2-18,2021-05-08
501,كيميا,معدني كيمياي زنجان گستران,5,2611,44807371,17691,17161,17161,-530,-3,17691,0,0,17161,17161,1400-2-18,2021-05-08
502,لكما,كارخانجات‌مخابراتي‌ايران‌,5,43319,259350853,6109,5987,5987,-122,-2,6107,-2,-0.03,5987,5987,1400-2-18,2021-05-08
503,كفرآور,فرآورده هاي سيمان شرق,5,3550,82147000,23612,23140,23140,-472,-2,23610,-2,-0.01,23140,23140,1400-2-18,2021-05-08
504,ثاژن,سخت آژند,5,20000,189640000,9675,9482,9482,-193,-1.99,9671,-4,-0.04,9482,9482,1400-2-18,2021-05-08
505,چخزر,صنايع چوب خزر كاسپين,5,1253,65519370,53907,52290,52290,-1617,-3,53905,-2,0,52290,52290,1400-2-18,2021-05-08
506,سفار,سيمان‌فارس‌,5,11041,1632522260,152430,147860,147860,-4570,-3,152280,-150,-0.1,147860,147860,1400-2-18,2021-05-08
507,ضخود7073,اختيارخ خودرو-1600-1400/07/07,5,58,23700000,529,490,450,-79,-14.93,409,-120,-22.68,400,490,1400-2-18,2021-05-08
508,كفرا,فراورده‌ هاي‌ نسوزايران‌,5,3769,173336310,47410,45990,45990,-1420,-3,47400,-10,-0.02,45990,45990,1400-2-18,2021-05-08
509,تايرا,تراكتورسازي‌ايران‌,5,5564,145554240,26960,26160,26160,-800,-2.97,26960,0,0,26160,26160,1400-2-18,2021-05-08
510,كوثر,بيمه كوثر,5,3177,45205533,14669,14229,14229,-440,-3,14669,0,0,14229,14229,1400-2-18,2021-05-08
511,وبهمن,سرمايه‌گذاري‌بهمن‌,5,101801,1411979870,14290,13870,13870,-420,-2.94,14280,-10,-0.07,13870,13870,1400-2-18,2021-05-08
512,اخزا716,اسنادخزانه-م16بودجه97-000407,5,557,542520322,973753,974001,974386,633,0.07,974004,251,0.03,974000,974386,1400-2-18,2021-05-08
513,خمهر,مهركام‌پارس‌,5,34359,81018522,2430,2358,2358,-72,-2.96,2430,0,0,2358,2358,1400-2-18,2021-05-08
514,برن0003پ01,برنج طارم0003تجارت مازندران(پ),5,488,136520000,279196,279000,280000,804,0.29,279754,558,0.2,279000,280000,1400-2-18,2021-05-08
515,ورنا,سرمايه‌گذاري‌ رنا(هلدينگ‌,5,57974,307841940,5470,5310,5310,-160,-2.93,5470,0,0,5310,5310,1400-2-18,2021-05-08
516,كپارس,كاشي‌ پارس‌,5,684,101957040,153660,149060,149060,-4600,-2.99,153650,-10,-0.01,149060,149060,1400-2-18,2021-05-08
517,ضفلا3005,اختيارخ فولاد-9986-1400/03/19,5,215,16080000,91,78,72,-19,-20.88,75,-16,-17.58,72,78,1400-2-18,2021-05-08
518,پخش,پخش البرز,5,1062,32719158,31761,30809,30809,-952,-3,31760,-1,0,30809,30809,1400-2-18,2021-05-08
519,حريل,ريل پردازسير,5,6650,35929950,5570,5403,5403,-167,-3,5570,0,0,5403,5403,1400-2-18,2021-05-08
520,ضپيك2008,اختيارخ تاپيكو-9000-00/02/19,5,15,8970000,696,400,610,-86,-12.36,598,-98,-14.08,400,660,1400-2-18,2021-05-08
521,زمگسا,كشاورزي‌ ودامپروي‌ مگسال‌,4,952,30007040,32490,31520,31520,-970,-2.99,32490,0,0,31520,31520,1400-2-18,2021-05-08
522,سفانو,سيمان فارس نو,4,2389,81202110,35040,33990,33990,-1050,-3,35040,0,0,33990,33990,1400-2-18,2021-05-08
523,دسبحان,سبحان دارو,4,1219,22234560,18800,18240,18240,-560,-2.98,18800,0,0,18240,18240,1400-2-18,2021-05-08
524,ضپاس2000,اختيارخ وپارس-2000-1400/02/29,4,47,20700000,499,500,350,-149,-29.86,440,-59,-11.82,350,500,1400-2-18,2021-05-08
525,كلر,كلر پارس,4,554,69801230,129891,125995,125995,-3896,-3,129885,-6,0,125995,125995,1400-2-18,2021-05-08
526,ضفلا3006,اختيارخ فولاد-11413-1400/03/19,4,200,2000000,99,10,10,-89,-89.9,10,-89,-89.9,10,10,1400-2-18,2021-05-08
527,پارسيان,بيمه پارسيان,4,89073,836395470,9680,9390,9390,-290,-3,9670,-10,-0.1,9390,9390,1400-2-18,2021-05-08
528,ضجار7041,اختيارخ وتجارت-2997-1400/07/21,4,232,25000000,1,140,100,99,9900,108,107,10700,100,140,1400-2-18,2021-05-08
529,زعف0008پ12,زعفران0008پوشالمعمول سحرخيز(پ),4,230,19460250,84710,87490,83073,-1637,-1.93,84610,-100,-0.12,83073,87490,1400-2-18,2021-05-08
530,خنصير,مهندسي‌نصيرماشين‌,4,1299,136693770,108480,105230,105230,-3250,-3,108470,-10,-0.01,105230,105230,1400-2-18,2021-05-08
531,ضجار2005,اختيارخ وتجارت-4000-1400/02/22,4,184,1316000,1,8,5,4,400,7,6,600,5,9,1400-2-18,2021-05-08
532,سجام,مجتمع سيمان غرب آسيا,4,7917,33100977,4266,4181,4181,-85,-1.99,4266,0,0,4181,4181,1400-2-18,2021-05-08
533,فلامي,لاميران‌,4,5276,229400480,44820,43480,43480,-1340,-2.99,44810,-10,-0.02,43480,43480,1400-2-18,2021-05-08
534,كشرق,صنعتي و معدني شمال شرق شاهرود,4,10126,904251800,92061,89300,89300,-2761,-3,92010,-51,-0.06,89300,89300,1400-2-18,2021-05-08
535,فزرين,زرين معدن آسيا,4,1205,31503520,26952,26144,26144,-808,-3,26951,-1,0,26144,26144,1400-2-18,2021-05-08
536,سمايه,بانك سرمايه,4,16087,78391951,4972,4873,4873,-99,-1.99,4972,0,0,4873,4873,1400-2-18,2021-05-08
537,وگستر,گسترش سرمايه گذاري ايرانيان,4,2943,54168858,18975,18406,18406,-569,-3,18974,-1,-0.01,18406,18406,1400-2-18,2021-05-08
538,عيار2,صندوق سكه طلاي مفيد,4,40000,40000,23089,1,1,-23088,-100,1,-23088,-100,1,1,1400-2-18,2021-05-08
539,غبشهر,صنعتي‌ بهشهر,4,3000,73680000,25310,24560,24560,-750,-2.96,25310,0,0,24560,24560,1400-2-18,2021-05-08
540,اخزا720,اسنادخزانه-م20بودجه97-000324,4,515,504727006,980134,984500,980000,-134,-0.01,980052,-82,-0.01,980000,984500,1400-2-18,2021-05-08
541,قصفها,قنداصفهان‌,4,399,60628050,156640,151950,151950,-4690,-2.99,156630,-10,-0.01,151950,151950,1400-2-18,2021-05-08
542,صخابر102,صكوك اجاره مخابرات-3 ماهه 16%,4,1037,1036639100,1000000,959900,1000000,0,0,999652,-348,-0.03,959900,1000000,1400-2-18,2021-05-08
543,غنوش,نوش‌ مازندران‌,4,606,33426960,56860,55160,55160,-1700,-2.99,56860,0,0,55160,55160,1400-2-18,2021-05-08
544,فلوله,لوله‌وماشين‌سازي‌ايران‌,4,6589,141597610,22150,21490,21490,-660,-2.98,22150,0,0,21490,21490,1400-2-18,2021-05-08
545,ولبهمن,شركت بهمن ليزينگ,4,103000,761891000,7625,7397,7397,-228,-2.99,7621,-4,-0.05,7397,7397,1400-2-18,2021-05-08
546,شجم,صنايع پتروشيمي تخت جمشيد,4,25956,260987580,10260,10055,10055,-205,-2,10258,-2,-0.02,10055,10055,1400-2-18,2021-05-08
547,گكيش,توريستي ورفاهي آبادگران كيش,4,1576,73320248,48461,46523,46523,-1938,-4,48454,-7,-0.01,46523,46523,1400-2-18,2021-05-08
548,شگل,گلتاش‌,4,4205,41166950,10090,9790,9790,-300,-2.97,10090,0,0,9790,9790,1400-2-18,2021-05-08
549,غچين,كشت‌ و صنعت‌ چين‌ چين,4,5093,98091180,19850,19260,19260,-590,-2.97,19850,0,0,19260,19260,1400-2-18,2021-05-08
550,خوساز,محورسازان‌ايران‌خودرو,4,7300,56794000,8020,7780,7780,-240,-2.99,8020,0,0,7780,7780,1400-2-18,2021-05-08
551,ضشنا2001,اختيارخ شپنا-10000-1400/02/27,4,121,30890000,448,550,200,-248,-55.36,255,-193,-43.08,200,550,1400-2-18,2021-05-08
552,كسعدي,كاشي‌ سعدي‌,4,1933,40032430,21350,20710,20710,-640,-3,21350,0,0,20710,20710,1400-2-18,2021-05-08
553,ضشنا2000,اختيارخ شپنا-9000-1400/02/27,4,107,86640000,1305,820,800,-505,-38.7,810,-495,-37.93,800,820,1400-2-18,2021-05-08
554,دتماد,توليدمواداوليه‌داروپخش‌,4,133,5717670,44310,42990,42990,-1320,-2.98,44310,0,0,42990,42990,1400-2-18,2021-05-08
555,اخزا805,اسنادخزانه-م5بودجه98-000422,4,1070,1037443059,963000,965000,969900,6900,0.72,969573,6573,0.68,965000,969900,1400-2-18,2021-05-08
556,ثامان,سامان‌ گستراصفهان‌,4,3000,69570000,23900,23190,23190,-710,-2.97,23900,0,0,23190,23190,1400-2-18,2021-05-08
557,فوكا,فولاد كاويان,4,7574,88290118,11894,11657,11657,-237,-1.99,11893,-1,-0.01,11657,11657,1400-2-18,2021-05-08
558,دتوزيع,توزيع دارو پخش,4,519,25345365,50345,48835,48835,-1510,-3,50344,-1,0,48835,48835,1400-2-18,2021-05-08
559,ضمخا7067,اختيارخ اخابر-13700-1400/07/28,4,18,8944000,430,444,500,70,16.28,497,67,15.58,444,500,1400-2-18,2021-05-08
560,والبر,سرمايه‌ گذاري‌ البرز(هلدينگ‌,4,7994,125345920,16160,15680,15680,-480,-2.97,16160,0,0,15680,15680,1400-2-18,2021-05-08
561,ختور,رادياتور ايران‌,4,1486,28263720,19600,19020,19020,-580,-2.96,19600,0,0,19020,19020,1400-2-18,2021-05-08
562,كيسون,شركت كيسون,4,2380,26744060,11466,11237,11237,-229,-2,11466,0,0,11237,11237,1400-2-18,2021-05-08
563,واميد,گروه مديريت سرمايه گذاري اميد,4,5065,61286500,12470,12100,12100,-370,-2.97,12470,0,0,12100,12100,1400-2-18,2021-05-08
564,تپكو,توليدتجهيزات‌سنگين‌هپكو,4,11667,61893435,5413,5305,5305,-108,-2,5413,0,0,5305,5305,1400-2-18,2021-05-08
565,ضملي7004,اختيارخ فملي-13720-1400/07/11,4,35,14300000,1,500,600,599,59900,409,408,40800,300,600,1400-2-18,2021-05-08
566,بنو,بيمه تجارت نو,3,3101,95858112,31868,30912,30912,-956,-3,31866,-2,-0.01,30912,30912,1400-2-18,2021-05-08
567,تملي807,تسهيلات مسكن ب. ملي-مهر98,3,97,55784538,584437,613658,555216,-29221,-5,575098,-9339,-1.6,555216,613658,1400-2-18,2021-05-08
568,تبرك,گروه كارخانجات صنعتي تبرك,3,2227,42802940,19814,19220,19220,-594,-3,19813,-1,-0.01,19220,19220,1400-2-18,2021-05-08
569,تاپكيش,تجارت الكترونيك پارسيان كيش,3,1070,18892990,18203,17657,17657,-546,-3,18203,0,0,17657,17657,1400-2-18,2021-05-08
570,كمنگنز,معادن‌منگنزايران‌,3,1134,97217820,88380,85730,85730,-2650,-3,88370,-10,-0.01,85730,85730,1400-2-18,2021-05-08
571,ثاباد,توريستي ورفاهي آبادگران ايران,3,474,24908700,54170,52550,52550,-1620,-2.99,54170,0,0,52550,52550,1400-2-18,2021-05-08
572,كي بي سي,شركت كي بي سي,3,1200,30150000,25902,25125,25125,-777,-3,25902,0,0,25125,25125,1400-2-18,2021-05-08
573,هصيكو402,اختيارف ت تاصيكو13500-00/02/20,3,1077,3879354,3300,3602,3602,302,9.15,3602,302,9.15,3602,3602,1400-2-18,2021-05-08
574,كگاز,شيشه‌ و گاز,3,856,15596320,18780,18220,18220,-560,-2.98,18780,0,0,18220,18220,1400-2-18,2021-05-08
575,ضجار7040,اختيارخ وتجارت-2497-1400/07/21,3,22,7590000,370,345,345,-25,-6.76,345,-25,-6.76,345,345,1400-2-18,2021-05-08
576,اخزا813,اسنادخزانه-م13بودجه98-010219,3,1334,1089400342,816790,814538,817013,223,0.03,816642,-148,-0.02,814538,817013,1400-2-18,2021-05-08
577,خكاوه,سايپا ديزل,3,14166,50062644,3606,3534,3534,-72,-2,3606,0,0,3534,3534,1400-2-18,2021-05-08
578,سبجنو,سيمان‌ بجنورد,3,1291,74413240,59420,57640,57640,-1780,-3,59420,0,0,57640,57640,1400-2-18,2021-05-08
579,ددام,داروسازي زاگرس فارمد پارس,3,2469,52416870,21880,21230,21230,-650,-2.97,21880,0,0,21230,21230,1400-2-18,2021-05-08
580,وسيزد,شركت س استان يزد,3,12231,15190902,1280,1242,1242,-38,-2.97,1280,0,0,1242,1242,1400-2-18,2021-05-08
581,نطرين,عطرين نخ قم,3,5868,69037020,12128,11765,11765,-363,-2.99,12127,-1,-0.01,11765,11765,1400-2-18,2021-05-08
582,غصينو,صنعتي مينو,3,695,45171525,67005,64995,64995,-2010,-3,67004,-1,0,64995,64995,1400-2-18,2021-05-08
583,ضسپا3000,اختيارخ خساپا-1400-1400/03/26,3,115,46000000,513,400,400,-113,-22.03,400,-113,-22.03,400,400,1400-2-18,2021-05-08
584,ساربيل,سيمان آرتا اردبيل,3,450,23341500,53470,51870,51870,-1600,-2.99,53470,0,0,51870,51870,1400-2-18,2021-05-08
585,غپونه,نوش پونه مشهد,3,2281,40754627,18611,17867,17867,-744,-4,18609,-2,-0.01,17867,17867,1400-2-18,2021-05-08
586,رنيك,جنرال مكانيك,3,5948,128732564,22312,21643,21643,-669,-3,22310,-2,-0.01,21643,21643,1400-2-18,2021-05-08
587,سبهان,سيمان‌ بهبهان‌,3,1172,161653960,142190,137930,137930,-4260,-3,142180,-10,-0.01,137930,137930,1400-2-18,2021-05-08
588,ضمخا2000,اختيارخ اخابر-9000-1400/02/29,3,65,51935000,550,799,799,249,45.27,799,249,45.27,799,799,1400-2-18,2021-05-08
589,غشان,شيرپاستوريزه‌پگاه‌خراسان‌,3,140671,1049405660,7690,7460,7460,-230,-2.99,7690,0,0,7460,7460,1400-2-18,2021-05-08
590,ضمخا7071,اختيارخ اخابر-23700-1400/07/28,3,203,21115000,190,105,104,-86,-45.26,104,-86,-45.26,104,105,1400-2-18,2021-05-08
591,تپمپي,پمپ‌ سازي‌ ايران‌,3,3725,70141750,19410,18830,18830,-580,-2.99,19410,0,0,18830,18830,1400-2-18,2021-05-08
592,ضخوز7036,اختيارخ فخوز-9200-1400/07/14,3,15,80100000,1,5600,5300,5299,529900,5340,5339,533900,5300,5600,1400-2-18,2021-05-08
593,وآفري,بيمه كارآفرين,3,5965,19034315,3323,3191,3191,-132,-3.97,3323,0,0,3191,3191,1400-2-18,2021-05-08
594,كسرام,پارس‌ سرام‌,3,2650,21412000,8320,8080,8080,-240,-2.88,8320,0,0,8080,8080,1400-2-18,2021-05-08
595,غفارس,شير پاستوريزه پگاه فارس,3,2390,42479860,18323,17774,17774,-549,-3,18323,0,0,17774,17774,1400-2-18,2021-05-08
596,گواهي ظرفيت,گواهي ظرفيت نقدي,3,26859000,443146641000,15714,16499,16499,785,5,16499,785,5,16499,16499,1400-2-18,2021-05-08
597,دفرا,فرآورده‌هاي‌ تزريقي‌ ايران‌,3,19860,503252400,26120,25340,25340,-780,-2.99,26110,-10,-0.04,25340,25340,1400-2-18,2021-05-08
598,غگلپا,شير پاستوريزه پگاه گلپايگان,3,540,34451460,65772,63799,63799,-1973,-3,65771,-1,0,63799,63799,1400-2-18,2021-05-08
599,ضفار8048,اختيارخ فارس-5400-1400/08/05,3,21,58800000,1,2800,2800,2799,279900,2800,2799,279900,2800,2800,1400-2-18,2021-05-08
600,ضترا8056,اختيارخ شتران-2558-1400/08/09,3,8,19200000,2634,2400,2400,-234,-8.88,2400,-234,-8.88,2400,2400,1400-2-18,2021-05-08
601,افاد61,منفعت دولت6-ش.خاص140109,3,50000,49100000000,980000,985000,980000,0,0,982000,2000,0.2,980000,985000,1400-2-18,2021-05-08
602,گدنا,تهيه توزيع غذاي دنا آفرين فدك,3,513,16882317,33926,32909,32909,-1017,-3,33926,0,0,32909,32909,1400-2-18,2021-05-08
603,سصفها,سيمان‌اصفهان‌,3,581,71555960,126960,123160,123160,-3800,-2.99,126950,-10,-0.01,123160,123160,1400-2-18,2021-05-08
604,خعمرا,توسعه و عمران شهرستان نائين,3,10100,236572300,22741,23423,23423,682,3,22749,8,0.04,23423,23423,1400-2-18,2021-05-08
605,هجرت,پخش هجرت,2,630,17157420,28076,27234,27234,-842,-3,28076,0,0,27234,27234,1400-2-18,2021-05-08
606,حپارسا,توسعه حمل و نقل ريلي پارسيان,2,298,10183554,35229,34173,34173,-1056,-3,35229,0,0,34173,34173,1400-2-18,2021-05-08
607,غدام,خوراك‌  دام‌ پارس‌,2,41,15690700,394530,382700,382700,-11830,-3,394530,0,0,382700,382700,1400-2-18,2021-05-08
608,غديس,پاكديس,2,38390,500260090,13434,13031,13031,-403,-3,13430,-4,-0.03,13031,13031,1400-2-18,2021-05-08
609,پست0008پ02,پسته فندقي32-30طلاسبززرند0008,2,9,14863536,1700984,1651504,1651504,-49480,-2.91,1651504,-49480,-2.91,1651504,1651504,1400-2-18,2021-05-08
610,ضپيك7041,اختيارخ تاپيكو-7070-00/07/18,2,22,38600000,2023,1750,1800,-223,-11.02,1755,-268,-13.25,1750,1800,1400-2-18,2021-05-08
611,زعف0008پ09,زعفران0008نگين نوين(پ),2,82,9951635,122565,121500,119227,-3338,-2.72,121361,-1204,-0.98,119227,121500,1400-2-18,2021-05-08
612,شرق1400,مشاركت ليزينگ ايران وشرق140010,2,15,15038000,999830,1008000,999800,-30,0,1002533,2703,0.27,999800,1008000,1400-2-18,2021-05-08
613,اراد554,مرابحه عام دولت5-ش.خ 0209,2,20554000,17520347976000,970000,853230,851658,-118342,-12.2,852406,-117594,-12.12,851658,853230,1400-2-18,2021-05-08
614,ضترا3000,اختيارخ شتران-6000-1400/03/09,2,6,12000000,2500,2000,2000,-500,-20,2000,-500,-20,2000,2000,1400-2-18,2021-05-08
615,اراد704,مرابحه عام دولت70-ش.خ0112,2,12000000,11273712000000,943750,939452,939500,-4250,-0.45,939476,-4274,-0.45,939452,939500,1400-2-18,2021-05-08
616,ضبدر3003,اختيارخ شبندر-4270-1400/03/30,2,2,2800000,1545,1400,1400,-145,-9.39,1400,-145,-9.39,1400,1400,1400-2-18,2021-05-08
617,شپديس2,پتروشيمي پرديس,2,1700000,156417000000,92010,92010,92010,0,0,92010,0,0,92010,92010,1400-2-18,2021-05-08
618,ضشنا2005,اختيارخ شپنا-18000-1400/02/27,2,20,92000,12,5,1,-11,-91.67,5,-7,-58.33,1,5,1400-2-18,2021-05-08
619,ضپاس2003,اختيارخ وپارس-3500-1400/02/29,2,60,150000,2,3,2,0,0,2,0,0,2,3,1400-2-18,2021-05-08
620,ضشنا8003,اختيارخ شپنا-8800-1400/08/16,2,44,57243000,1597,1300,1301,-296,-18.53,1301,-296,-18.53,1300,1301,1400-2-18,2021-05-08
621,ضپاس2004,اختيارخ وپارس-4000-1400/02/29,2,2,11000,2,9,2,0,0,5,3,150,2,9,1400-2-18,2021-05-08
622,ثرود,سرمايه‌گذاري مسكن زاينده رود,2,4756,97222152,21074,20442,20442,-632,-3,21073,-1,0,20442,20442,1400-2-18,2021-05-08
623,غبهنوش,بهنوش‌ ايران‌,2,473,32821470,71530,69390,69390,-2140,-2.99,71530,0,0,69390,69390,1400-2-18,2021-05-08
624,ختراك,ريخته‌گري‌ تراكتورسازي‌ ايران‌,2,353,5326770,15550,15090,15090,-460,-2.96,15550,0,0,15090,15090,1400-2-18,2021-05-08
625,وليز,ليزينگ‌ايران‌,2,2771,25659460,9540,9260,9260,-280,-2.94,9540,0,0,9260,9260,1400-2-18,2021-05-08
626,بايكا,كارخانجات كابلسازي ‌ايران‌,2,626,25763030,41994,41155,41155,-839,-2,41993,-1,0,41155,41155,1400-2-18,2021-05-08
627,پست0008پ04,پسته فندقي32-30سبزدانه0008(پ),2,6,9530000,1576222,1525000,1620000,43778,2.78,1588333,12111,0.77,1525000,1620000,1400-2-18,2021-05-08
628,ولغدر,ليزينگ‌خودروغدير,2,770,18379900,24600,23870,23870,-730,-2.97,24600,0,0,23870,23870,1400-2-18,2021-05-08
629,ضخوز7037,اختيارخ فخوز-11200-1400/07/14,2,40,140000000,1,3500,3500,3499,349900,3500,3499,349900,3500,3500,1400-2-18,2021-05-08
630,وسنا,سرمايه گذاري نيروگاهي ايران,2,3975,59871450,15689,15062,15062,-627,-4,15687,-2,-0.01,15062,15062,1400-2-18,2021-05-08
631,دسبحا,گروه دارويي سبحان,2,609,11272590,19080,18510,18510,-570,-2.99,19080,0,0,18510,18510,1400-2-18,2021-05-08
632,خاذين,سايپاآذين‌,2,2400,11059200,4750,4608,4608,-142,-2.99,4750,0,0,4608,4608,1400-2-18,2021-05-08
633,وثخوز,سرمايه گذاري و توسعه خوزستان,2,1080,72444240,70608,67078,67078,-3530,-5,70595,-13,-0.02,67078,67078,1400-2-18,2021-05-08
634,خرينگ,رينگ‌سازي‌مشهد,2,200,10170000,52420,50850,50850,-1570,-3,52420,0,0,50850,50850,1400-2-18,2021-05-08
635,ضخوز7035,اختيارخ فخوز-8200-1400/07/14,2,20,126000000,6800,6300,6300,-500,-7.35,6300,-500,-7.35,6300,6300,1400-2-18,2021-05-08
636,كاذر,فرآورده‌هاي‌نسوزآذر,2,1220,38747200,32740,31760,31760,-980,-2.99,32740,0,0,31760,31760,1400-2-18,2021-05-08
637,وتوكا,سرمايه‌گذاري‌توكافولاد(هلدينگ,2,2205,25555950,11940,11590,11590,-350,-2.93,11940,0,0,11590,11590,1400-2-18,2021-05-08
638,دسانكو,داروسازي سبحان انكولوژي,2,760,10901440,14787,14344,14344,-443,-3,14787,0,0,14344,14344,1400-2-18,2021-05-08
639,ضترا8057,اختيارخ شتران-3000-1400/08/09,2,14,24600000,1800,1800,1600,-200,-11.11,1757,-43,-2.39,1600,1800,1400-2-18,2021-05-08
640,دلقما,دارويي‌ لقمان‌,2,5990,150289100,25860,25090,25090,-770,-2.98,25860,0,0,25090,25090,1400-2-18,2021-05-08
641,زعف0008پ19,زعفران0008نگين تروند قاينات(پ),2,91,10829000,121794,119000,119000,-2794,-2.29,119000,-2794,-2.29,119000,119000,1400-2-18,2021-05-08
642,شكربن,كربن‌ ايران‌,2,50180,4241715400,87140,84530,84530,-2610,-3,86910,-230,-0.26,84530,84530,1400-2-18,2021-05-08
643,زشگزا,شير و گوشت زاگرس شهركرد,2,12300,98240100,8234,7987,7987,-247,-3,8233,-1,-0.01,7987,7987,1400-2-18,2021-05-08
644,زشريف,كشت وصنعت شريف آباد,2,5163,26093802,5210,5054,5054,-156,-2.99,5210,0,0,5054,5054,1400-2-18,2021-05-08
645,سدور,سيمان‌ دورود,2,770,14468300,19370,18790,18790,-580,-2.99,19370,0,0,18790,18790,1400-2-18,2021-05-08
646,خزر,فنرسازي‌زر,2,540,24926400,47580,46160,46160,-1420,-2.98,47580,0,0,46160,46160,1400-2-18,2021-05-08
647,ضپيك2011,اختيارخ تاپيكو-14000-00/02/19,2,15,15000,55,1,1,-54,-98.18,1,-54,-98.18,1,1,1400-2-18,2021-05-08
648,ضبدر3001,اختيارخ شبندر-3416-1400/03/30,2,3,12150000,4800,4050,4050,-750,-15.63,4050,-750,-15.63,4050,4050,1400-2-18,2021-05-08
649,قشكر,شكرشاهرود,2,5204,19384900,3840,3725,3725,-115,-2.99,3840,0,0,3725,3725,1400-2-18,2021-05-08
650,اراد65,مرابحه عام دولتي65-ش.خ0210,2,1100,1064001000,968000,940010,970000,2000,0.21,967274,-726,-0.08,940010,970000,1400-2-18,2021-05-08
651,ضبدر3004,اختيارخ شبندر-5125-1400/03/30,2,2,3600000,1980,1800,1800,-180,-9.09,1800,-180,-9.09,1800,1800,1400-2-18,2021-05-08
652,سكرد,سيمان كردستان,2,1745,16577500,9790,9500,9500,-290,-2.96,9790,0,0,9500,9500,1400-2-18,2021-05-08
653,اراد37,مرابحه عام دولت3-ش.خ 0005,2,4500,4499999500,989145,1000000,999999,10854,1.1,1000000,10855,1.1,999999,1000000,1400-2-18,2021-05-08
654,خشرق,الكتريك‌ خودرو شرق‌,2,857,12426500,14940,14500,14500,-440,-2.95,14940,0,0,14500,14500,1400-2-18,2021-05-08
655,زنگان,صنعت روي زنگان,2,771,78128514,104468,101334,101334,-3134,-3,104463,-5,0,101334,101334,1400-2-18,2021-05-08
656,مهان01,اجاره مهرآيندگان لوتوس0311,2,100000,100000100000,1000001,1000001,1000001,0,0,1000001,0,0,1000001,1000001,1400-2-18,2021-05-08
657,فنرژي,گسترش صنايع انرژي آذرآب,2,2641,49141087,18986,18607,18607,-379,-2,18984,-2,-0.01,18607,18607,1400-2-18,2021-05-08
658,وسكرمان,س.سهام عدالت استان كرمان,2,10000,10000000,1030,1000,1000,-30,-2.91,1030,0,0,1000,1000,1400-2-18,2021-05-08
659,دابور,داروسازي‌ ابوريحان‌,2,290,10692300,38010,36870,36870,-1140,-3,38010,0,0,36870,36870,1400-2-18,2021-05-08
660,فولاد2,فولاد مباركه اصفهان,2,83500000,971845000000,11970,11970,11620,-350,-2.92,11639,-331,-2.77,11620,11970,1400-2-18,2021-05-08
661,هپارس102,اختيارف ت پارس-157010-01/02/05,2,3409,13731452,4051,4028,4028,-23,-0.57,4028,-23,-0.57,4028,4028,1400-2-18,2021-05-08
662,تكشا,گسترش‌صنايع‌وخدمات‌كشاورزي‌,2,237,10679220,46450,45060,45060,-1390,-2.99,46450,0,0,45060,45060,1400-2-18,2021-05-08
663,شاوان,پالايش نفت لاوان,2,323,26074498,83222,80726,80726,-2496,-3,83221,-1,0,80726,80726,1400-2-18,2021-05-08
664,نوري2,پتروشيمي نوري,2,2000000,112000000000,57290,56000,56000,-1290,-2.25,56000,-1290,-2.25,56000,56000,1400-2-18,2021-05-08
665,گپارس,امور رفاهي كارگزاران پارس,2,225,45068625,208651,200305,200305,-8346,-4,208631,-20,-0.01,200305,200305,1400-2-18,2021-05-08
666,شكف,كف,2,202,21022948,106197,104074,104074,-2123,-2,106193,-4,0,104074,104074,1400-2-18,2021-05-08
667,تملي805,تسهيلات مسكن ب. ملي-مرداد98,2,20,12863890,627507,658882,627507,0,0,643194,15687,2.5,627507,658882,1400-2-18,2021-05-08
668,صخود412,ص مرابحه خودرو412- 3ماهه 18%,2,152,151240000,995000,995000,995000,0,0,995000,0,0,995000,995000,1400-2-18,2021-05-08
669,ضجار2004,اختيارخ وتجارت-3500-1400/02/22,2,113,6913000,1,69,1,0,0,61,60,6000,1,69,1400-2-18,2021-05-08
670,دفارا,داروسازي‌ فارابي‌,2,270,16880400,64450,62520,62520,-1930,-2.99,64450,0,0,62520,62520,1400-2-18,2021-05-08
671,تملي703,تسهيلات مسكن ب. ملي-خرداد97,2,10,5809160,611490,580916,580916,-30574,-5,580916,-30574,-5,580916,580916,1400-2-18,2021-05-08
672,وكادو,تكادو,1,500,7907500,16137,15815,15815,-322,-2,16137,0,0,15815,15815,1400-2-18,2021-05-08
673,لخانه,لوازم‌ خانگي‌ پارس‌,1,10000,274140000,27973,27414,27414,-559,-2,27965,-8,-0.03,27414,27414,1400-2-18,2021-05-08
674,وسقم,شركت س استان قم,1,3670,5020560,1410,1368,1368,-42,-2.98,1410,0,0,1368,1368,1400-2-18,2021-05-08
675,سخواف,سيمان مجد خواف,1,310,5117480,16844,16508,16508,-336,-1.99,16844,0,0,16508,16508,1400-2-18,2021-05-08
676,واحيا2,م .صنايع و معادن احياء سپاهان,1,650000,87880650000,135201,135201,135201,0,0,135201,0,0,135201,135201,1400-2-18,2021-05-08
677,وارس,سرمايه گذاري ارس صبا,1,602,9958284,17231,16542,16542,-689,-4,17231,0,0,16542,16542,1400-2-18,2021-05-08
678,ضمخا7076,اختيارخ اخابر-9700-1400/07/28,1,10,9900000,1233,990,990,-243,-19.71,990,-243,-19.71,990,990,1400-2-18,2021-05-08
679,افاد614,منفعت دولت6-ش.خاص140109,1,1000000,980000000000,980000,980000,980000,0,0,980000,0,0,980000,980000,1400-2-18,2021-05-08
680,غشوكو,شوكو پارس,1,140,5360040,39881,38286,38286,-1595,-4,39881,0,0,38286,38286,1400-2-18,2021-05-08
681,اراد47,مرابحه عام دولت4-ش.خ 0008,1,100,98499000,981325,984990,984990,3665,0.37,984990,3665,0.37,984990,984990,1400-2-18,2021-05-08
682,افرا,افرانت,1,200,6653400,34295,33267,33267,-1028,-3,34295,0,0,33267,33267,1400-2-18,2021-05-08
683,ضشنا2004,اختيارخ شپنا-16000-1400/02/27,1,100,400000,10,4,4,-6,-60,4,-6,-60,4,4,1400-2-18,2021-05-08
684,ضمخا7078,اختيارخ اخابر-7700-1400/07/28,1,6,10800000,2000,1800,1800,-200,-10,1800,-200,-10,1800,1800,1400-2-18,2021-05-08
685,جهرم,پتروشيمي جهرم,1,3213,5474952,1774,1704,1704,-70,-3.95,1774,0,0,1704,1704,1400-2-18,2021-05-08
686,اراد834,مرابحه عام دولت83-ش.خ041220,1,10524000,9616452336000,1000000,913764,913764,-86236,-8.62,913764,-86236,-8.62,913764,913764,1400-2-18,2021-05-08
687,خليبل,ماليبل سايپا,1,1435,351575,238,245,245,7,2.94,238,0,0,245,245,1400-2-18,2021-05-08
688,خفناور,مهندسي صنعتي روان فن آور,1,1000,47460000,48428,47460,47460,-968,-2,48426,-2,0,47460,47460,1400-2-18,2021-05-08
689,ضفلا3001,اختيارخ فولاد-5706-1400/03/19,1,1,4000000,4300,4000,4000,-300,-6.98,4000,-300,-6.98,4000,4000,1400-2-18,2021-05-08
690,خموتور,موتورسازان‌تراكتورسازي‌ايران‌,1,408,5928240,14970,14530,14530,-440,-2.94,14970,0,0,14530,14530,1400-2-18,2021-05-08
691,كگل2,معدني و صنعتي گل گهر,1,4000000,53600000000,13400,13400,13400,0,0,13400,0,0,13400,13400,1400-2-18,2021-05-08
692,فايرا2,آلومينيوم‌ايران‌,1,15000000,272250000000,18150,18150,18150,0,0,18150,0,0,18150,18150,1400-2-18,2021-05-08
693,رايان106,مشاركت رايان سايپا-3ماهه16%,1,6,5792352,965392,965392,965392,0,0,965392,0,0,965392,965392,1400-2-18,2021-05-08
694,شپارس,بين‌ المللي‌ محصولات‌  پارس‌,1,459,9923580,22280,21620,21620,-660,-2.96,22280,0,0,21620,21620,1400-2-18,2021-05-08
695,لابسا,آبسال‌,1,255,13081500,52880,51300,51300,-1580,-2.99,52880,0,0,51300,51300,1400-2-18,2021-05-08
696,قنيشا,قند  نيشابور,1,95,5935600,64410,62480,62480,-1930,-3,64410,0,0,62480,62480,1400-2-18,2021-05-08
697,كقزوي,شيشه‌ قزوين‌,1,500,5018500,10241,10037,10037,-204,-1.99,10241,0,0,10037,10037,1400-2-18,2021-05-08
698,بالبر,كابل‌ البرز,1,90,5156100,59060,57290,57290,-1770,-3,59060,0,0,57290,57290,1400-2-18,2021-05-08
699,ضترا8059,اختيارخ شتران-3882-1400/08/09,1,2,2100000,1057,1050,1050,-7,-0.66,1050,-7,-0.66,1050,1050,1400-2-18,2021-05-08
700,فپنتا,سپنتا,1,30,11811900,405900,393730,393730,-12170,-3,405900,0,0,393730,393730,1400-2-18,2021-05-08
701,دارو,كارخانجات‌داروپخش‌,1,155,5026650,33430,32430,32430,-1000,-2.99,33430,0,0,32430,32430,1400-2-18,2021-05-08
702,مداران,داده‌پردازي‌ايران‌,1,190,4630300,25120,24370,24370,-750,-2.99,25120,0,0,24370,24370,1400-2-18,2021-05-08
703,وساشرقي,شركت س استان آذربايجان شرقي,1,6000,5646000,970,941,941,-29,-2.99,970,0,0,941,941,1400-2-18,2021-05-08
704,لخزر,پارس‌ خزر,1,100,18090000,186490,180900,180900,-5590,-3,186490,0,0,180900,180900,1400-2-18,2021-05-08
705,اخزا9082,اسنادخزانه-م8بودجه99-020606,1,730000,462820000000,628640,634000,634000,5360,0.85,634000,5360,0.85,634000,634000,1400-2-18,2021-05-08
706,شزنگ,تجهيزنيروي‌زنگان‌,1,22,5056282,234521,229831,229831,-4690,-2,234520,-1,0,229831,229831,1400-2-18,2021-05-08
707,افران2,صندوق س افرا نماد پايدار-ثابت,1,30668,30668,13248,1,1,-13247,-99.99,1,-13247,-99.99,1,1,1400-2-18,2021-05-08
708,ضصاد3002,اختيارخ وبصادر-2500-1400/03/12,1,15,1200000,140,80,80,-60,-42.86,80,-60,-42.86,80,80,1400-2-18,2021-05-08
709,مبين0122,اجاره اعتماد مبين تمدن010710,1,1458600,1458600000000,1000000,1000000,1000000,0,0,1000000,0,0,1000000,1000000,1400-2-18,2021-05-08
710,اپرداز,آتيه داده پرداز,1,49,1013565,21324,20685,20685,-639,-3,21324,0,0,20685,20685,1400-2-18,2021-05-08
711,بكاب,صنايع‌جوشكاب‌يزد,1,50,17455500,359900,349110,349110,-10790,-3,359900,0,0,349110,349110,1400-2-18,2021-05-08
712,ضپنا8002,اختيارخ رمپنا-13850-1400/08/05,1,10,24500000,2800,2450,2450,-350,-12.5,2450,-350,-12.5,2450,2450,1400-2-18,2021-05-08
713,داريك,صندوق س.اعتماد داريك-د,1,2000,21118000,10554,10559,10559,5,0.05,10559,5,0.05,10559,10559,1400-2-18,2021-05-08
714,كمند2,صندوق س. با درآمد ثابت كمند,1,102000000,102000000,10170,1,1,-10169,-99.99,1,-10169,-99.99,1,1,1400-2-18,2021-05-08
715,قشهد,شهد,1,684,13556880,20430,19820,19820,-610,-2.99,20430,0,0,19820,19820,1400-2-18,2021-05-08
716,اراد42,مرابحه عام دولت4-ش.خ 0106,1,500,503499500,1007500,1006999,1006999,-501,-0.05,1006999,-501,-0.05,1006999,1006999,1400-2-18,2021-05-08
717,ضپنا8001,اختيارخ رمپنا-11850-1400/08/05,1,22,94600000,4400,4300,4300,-100,-2.27,4300,-100,-2.27,4300,4300,1400-2-18,2021-05-08
718,مشير112,مشاركت شهرداري شيراز-3ماهه18%,1,10,9950000,990000,995000,995000,5000,0.51,995000,5000,0.51,995000,995000,1400-2-18,2021-05-08
719,دجابر,داروسازي‌ جابرابن‌حيان‌,1,500,9820000,20240,19640,19640,-600,-2.96,20240,0,0,19640,19640,1400-2-18,2021-05-08
720,اشاد10,مشاركت دولتي10-شرايط خاص001226,1,19600,18776800000,958000,958000,958000,0,0,958000,0,0,958000,958000,1400-2-18,2021-05-08
721,خچرخش,چرخشگر,1,10,177400,18280,17740,17740,-540,-2.95,18280,0,0,17740,17740,1400-2-18,2021-05-08
722,ضفار3001,اختيارخ فارس-9000-1400/03/05,1,36,5400000,200,150,150,-50,-25,150,-50,-25,150,150,1400-2-18,2021-05-08
723,داراب,پتروشيمي داراب,1,5000,11765000,2451,2353,2353,-98,-4,2451,0,0,2353,2353,1400-2-18,2021-05-08
724,صينا205,صكوك منفعت سينا دارو-3ماهه 19%,1,22,21560000,970000,980000,980000,10000,1.03,980000,10000,1.03,980000,980000,1400-2-18,2021-05-08
725,تملي804,تسهيلات مسكن ب. ملي-تير98,1,9,5394960,630989,599440,599440,-31549,-5,599440,-31549,-5,599440,599440,1400-2-18,2021-05-08
726,وتعاون,بيمه  تعاون,1,2621,16195159,6305,6179,6179,-126,-2,6305,0,0,6179,6179,1400-2-18,2021-05-08
727,سپرمي,پرميت‌,1,91,820001,8922,9011,9011,89,1,8922,0,0,9011,9011,1400-2-18,2021-05-08
728,حخزر,كشتيراني درياي خزر,1,369,10164105,28396,27545,27545,-851,-3,28396,0,0,27545,27545,1400-2-18,2021-05-08
729,كاسپين,داروسازي كاسپين تامين,1,201,5037864,25839,25064,25064,-775,-3,25839,0,0,25064,25064,1400-2-18,2021-05-08
730,ثزاگرس,سرمايه گذاري توسعه عمران زاگرس,1,1000,54163000,57013,54163,54163,-2850,-5,57005,-8,-0.01,54163,54163,1400-2-18,2021-05-08
731,سلامت64,مرابحه سلامت6واجدشرايط خاص1400,1,2629600,2629600000000,995000,1000000,1000000,5000,0.5,1000000,5000,0.5,1000000,1000000,1400-2-18,2021-05-08
732,نمرينو,ايران‌ مرينوس‌,1,46,5049880,113170,109780,109780,-3390,-3,113170,0,0,109780,109780,1400-2-18,2021-05-08
733,شتهران,داروسازي تهران شيمي,1,3000,23592000,7710,7864,7864,154,2,7710,0,0,7864,7864,1400-2-18,2021-05-08
734,وسخراش,شركت س استان خراسان شمالي,1,5622,7471638,1370,1329,1329,-41,-2.99,1370,0,0,1329,1329,1400-2-18,2021-05-08
735,صفارس307,صكوك اجاره فارس307- 3ماهه18%,1,300,288000000,943500,960000,960000,16500,1.75,960000,16500,1.75,960000,960000,1400-2-18,2021-05-08
736,اراد354,مرابحه عام دولت3-ش.خ 0103,1,3000000,2843670000000,948599,947890,947890,-709,-0.07,947890,-709,-0.07,947890,947890,1400-2-18,2021-05-08
737,وغدير2,سرمايه‌گذاري‌غدير(هلدينگ‌,1,20000000,191400000000,9720,9570,9570,-150,-1.54,9570,-150,-1.54,9570,9570,1400-2-18,2021-05-08
738,فبيرا,بسته‌ بندي‌ ايران‌,1,6559,19926242,3100,3038,3038,-62,-2,3100,0,0,3038,3038,1400-2-18,2021-05-08
739,غپآذر,شير پگاه آذربايجان شرقي,1,157,10008122,65717,63746,63746,-1971,-3,65717,0,0,63746,63746,1400-2-18,2021-05-08
740,ثنظام,س. ساختماني نظام مهندسي ايران,1,120,5578440,47435,46487,46487,-948,-2,47435,0,0,46487,46487,1400-2-18,2021-05-08
741,اخزا7182,اسنادخزانه-م18بودجه97-000525,1,363101,344219748000,934716,948000,948000,13284,1.42,948000,13284,1.42,948000,948000,1400-2-18,2021-05-08
742,دروز,داروسازي‌ روزدارو,1,150,5172000,35540,34480,34480,-1060,-2.98,35540,0,0,34480,34480,1400-2-18,2021-05-08
743,تبريز112,مشاركت شهرداري تبريز-3ماهه18%,1,81,78570000,970115,970000,970000,-115,-0.01,970000,-115,-0.01,970000,970000,1400-2-18,2021-05-08
744,زاگرس2,پتروشيمي زاگرس,1,1000000,197251000000,197251,197251,197251,0,0,197251,0,0,197251,197251,1400-2-18,2021-05-08
745,ضغدر3002,اختيارخ وغدير-8200-1400/03/26,1,12,21300000,1775,1775,1775,0,0,1775,0,0,1775,1775,1400-2-18,2021-05-08
746,ضفار8047,اختيارخ فارس-4400-1400/08/05,1,4,14800000,4000,3700,3700,-300,-7.5,3700,-300,-7.5,3700,3700,1400-2-18,2021-05-08
747,غويتا,ويتانا,1,300,5226900,17961,17423,17423,-538,-3,17961,0,0,17423,17423,1400-2-18,2021-05-08
748,ضغدر3003,اختيارخ وغدير-9200-1400/03/26,1,20,23600000,985,1180,1180,195,19.8,1180,195,19.8,1180,1180,1400-2-18,2021-05-08
749,زكوثر,سرمايه گذاري كشاورزي كوثر,1,537,11271630,21630,20990,20990,-640,-2.96,21630,0,0,20990,20990,1400-2-18,2021-05-08
750,اراد36,مرابحه عام دولت3-ش.خ 0104,1,100,99455500,1046900,994555,994555,-52345,-5,994555,-52345,-5,994555,994555,1400-2-18,2021-05-08
751,اراد61,مرابحه عام دولت61-ش.خ0309,1,16000,16000000000,1000000,1000000,1000000,0,0,1000000,0,0,1000000,1000000,1400-2-18,2021-05-08
752,حكمت01,مشاركت حكمت ايرانيان 140107,1,5,4937500,987500,987500,987500,0,0,987500,0,0,987500,987500,1400-2-18,2021-05-08
753,وسرمد,بيمه  سرمد,1,1632,9963360,6229,6105,6105,-124,-1.99,6229,0,0,6105,6105,1400-2-18,2021-05-08
754,ضپيك2010,اختيارخ تاپيكو-12000-00/02/19,1,5,5000,4,1,1,-3,-75,1,-3,-75,1,1,1400-2-18,2021-05-08
755,سباقر,سيمان باقران,1,322,5024488,15922,15604,15604,-318,-2,15922,0,0,15604,15604,1400-2-18,2021-05-08
756,اراد41,مرابحه عام دولت4-ش.خ 0006,1,5500,5499994500,999000,999999,999999,999,0.1,999999,999,0.1,999999,999999,1400-2-18,2021-05-08
757,غالبر,لبنيات‌ كالبر,1,510,10001100,20210,19610,19610,-600,-2.97,20210,0,0,19610,19610,1400-2-18,2021-05-08
758,كساوه,صنايع‌ كاشي‌ و سراميك‌ سينا,1,200,13690000,70560,68450,68450,-2110,-2.99,70560,0,0,68450,68450,1400-2-18,2021-05-08
759,زدشت,كشت و صنعت دشت خرم دره,1,400,11416800,29424,28542,28542,-882,-3,29424,0,0,28542,28542,1400-2-18,2021-05-08
760,خفولا,خدمات فني فولاد يزد,1,2337,99621636,43497,42628,42628,-869,-2,43493,-4,-0.01,42628,42628,1400-2-18,2021-05-08
761,شتران2,پالايش نفت تهران,1,63500000,499745000000,8110,7870,7870,-240,-2.96,7870,-240,-2.96,7870,7870,1400-2-18,2021-05-08
762,ضپيك2012,اختيارخ تاپيكو-16000-00/02/19,1,1,5000,50,5,5,-45,-90,5,-45,-90,5,5,1400-2-18,2021-05-08
763,ضشنا8000,اختيارخ شپنا-5800-1400/08/16,1,5,13255000,3501,2651,2651,-850,-24.28,2651,-850,-24.28,2651,2651,1400-2-18,2021-05-08
764,شپنا2,پالايش نفت اصفهان,1,50500000,500455000000,10210,9910,9910,-300,-2.94,9910,-300,-2.94,9910,9910,1400-2-18,2021-05-08
765,خكمك,كمك‌فنرايندامين‌,1,1000,26320000,27130,26320,26320,-810,-2.99,27130,0,0,26320,26320,1400-2-18,2021-05-08
766,پارسان2,گسترش نفت و گاز پارسيان,1,17000000,299540000000,17620,17620,17620,0,0,17620,0,0,17620,17620,1400-2-18,2021-05-08
767,اراد364,مرابحه عام دولت3-ش.خ 0104,1,100,104690000,1046900,1046900,1046900,0,0,1046900,0,0,1046900,1046900,1400-2-18,2021-05-08
768,آينده,بازرگاني آينده سازان بهشت پارس,1,401,7802257,19854,19457,19457,-397,-2,19854,0,0,19457,19457,1400-2-18,2021-05-08
769,اروند04,منفعت صبا اروند كاردان14001113,1,5,5044950,999000,1008990,1008990,9990,1,1008990,9990,1,1008990,1008990,1400-2-18,2021-05-08
770,فولاي,صنايع فولاد آلياژي يزد,1,243,11912832,50540,49024,49024,-1516,-3,50540,0,0,49024,49024,1400-2-18,2021-05-08
771,قهكمت,قندهكمتان‌,1,300,13410000,46080,44700,44700,-1380,-2.99,46080,0,0,44700,44700,1400-2-18,2021-05-08
772,سنير,سيمان‌ سفيد ني‌ريز,1,10,2418700,249350,241870,241870,-7480,-3,249350,0,0,241870,241870,1400-2-18,2021-05-08
773,ثعمرا,عمران و توسعه شاهد,1,500,6329500,13050,12659,12659,-391,-3,13050,0,0,12659,12659,1400-2-18,2021-05-08
774,حپترو,حمل و نقل پتروشيمي( سهامي عام,1,1000,52300000,53910,52300,52300,-1610,-2.99,53910,0,0,52300,52300,1400-2-18,2021-05-08
775,فيروزه4,صندوق شاخص30 شركت فيروزه- سهام,1,50000,6324100000,127730,126482,126482,-1248,-0.98,126482,-1248,-0.98,126482,126482,1400-2-18,2021-05-08
776,تنوين2,تامين سرمايه نوين,1,17000000,122400000000,7200,7200,7200,0,0,7200,0,0,7200,7200,1400-2-18,2021-05-08
777,وپسا,س. پتروشيمي ساختمان  خليج فارس,1,3000,8841000,3007,2947,2947,-60,-2,3007,0,0,2947,2947,1400-2-18,2021-05-08
778,داسوه,داروسازي‌ اسوه‌,1,150,5433000,37330,36220,36220,-1110,-2.97,37330,0,0,36220,36220,1400-2-18,2021-05-08
779,ولراز,ليزينگ رازي,1,100,5383200,56075,53832,53832,-2243,-4,56074,-1,0,53832,53832,1400-2-18,2021-05-08
780,حسير,ريل سير كوثر,1,355,5992045,17401,16879,16879,-522,-3,17401,0,0,16879,16879,1400-2-18,2021-05-08
781,شستان03,اجاره تجاري شستان14030915,1,4,4080000,1000000,1020000,1020000,20000,2,1020000,20000,2,1020000,1020000,1400-2-18,2021-05-08
782,ومعلم,بيمه معلم,1,4500,21766500,4986,4837,4837,-149,-2.99,4986,0,0,4837,4837,1400-2-18,2021-05-08
783,صايپا112,صكوك مرابحه سايپا112-3ماهه 16%,1,5,4850000,983371,970000,970000,-13371,-1.36,970000,-13371,-1.36,970000,970000,1400-2-18,2021-05-08
784,ضفار8049,اختيارخ فارس-6400-1400/08/05,1,11,20680000,2079,1880,1880,-199,-9.57,1880,-199,-9.57,1880,1880,1400-2-18,2021-05-08
785,پست0008پ08,پسته فندقي32-30مه ولات0008(پ),1,5,8050000,1553347,1610000,1610000,56653,3.65,1610000,56653,3.65,1610000,1610000,1400-2-18,2021-05-08
786,فملي2,ملي‌ صنايع‌ مس‌ ايران‌,1,80000000,918400000000,11830,11480,11480,-350,-2.96,11480,-350,-2.96,11480,11480,1400-2-18,2021-05-08
787,زفكا,كشت و دامداري فكا,1,3766,46382056,12696,12316,12316,-380,-2.99,12696,0,0,12316,12316,1400-2-18,2021-05-08
788,داوه,داروسازي آوه سينا,1,1000,19574000,20179,19574,19574,-605,-3,20179,0,0,19574,19574,1400-2-18,2021-05-08
789,ريشمك,توليد و صادرات ريشمك,1,996,54652512,56569,54872,54872,-1697,-3,56567,-2,0,54872,54872,1400-2-18,2021-05-08
790,كسرا,سراميك‌هاي‌صنعتي‌اردكان‌,1,9861,198994980,20800,20180,20180,-620,-2.98,20800,0,0,20180,20180,1400-2-18,2021-05-08
791,وحافظ,بيمه حافظ,1,154,9927610,65780,64465,64465,-1315,-2,65779,-1,0,64465,64465,1400-2-18,2021-05-08
