,نماد,نام,تعداد,حجم,ارزش,دیروز,اولین,آخرین معامله - مقدار,آخرین معامله - تغییر,آخرین معامله - درصد,قیمت پایانی - مقدار,قیمت پایانی - تغییر,قیمت پایانی - درصد,کمترین,بیشترین,تاریخ,gregorian_date
0,دارا يكم,صندوق واسطه گري مالي يكم-سهام,17654,14168566,1584384972710,109600,110010,110770,1170,1.07,111820,2220,2.03,110010,113550,1400-10-18,2022-01-08
1,پالايش,صندوق پالايشي يكم-سهام,15826,17512431,1253458533800,71290,71260,71190,-100,-0.14,71580,290,0.41,71150,72270,1400-10-18,2022-01-08
2,خودرو,ايران‌ خودرو,15463,823489624,1581780466449,1833,1850,1924,91,4.96,1921,88,4.8,1840,1924,1400-10-18,2022-01-08
3,بركت,گروه دارويي بركت,9928,27089396,458884218430,17570,17350,16750,-820,-4.67,16940,-630,-3.59,16700,17620,1400-10-18,2022-01-08
4,خساپا,سايپا,9879,441362031,741235679464,1607,1610,1664,57,3.55,1679,72,4.48,1610,1687,1400-10-18,2022-01-08
5,كمند,صندوق س. با درآمد ثابت كمند,7620,262470464,2629051891506,10168,10016,10017,-151,-1.49,10017,-151,-1.49,10016,10018,1400-10-18,2022-01-08
6,فملي,ملي‌ صنايع‌ مس‌ ايران‌,6384,70721711,512041229100,7250,7250,7250,0,0,7240,-10,-0.14,7130,7300,1400-10-18,2022-01-08
7,انرژي3,سايراشخاص بورس انرژي,6263,4187413,342543112370,84330,84330,80120,-4210,-4.99,81800,-2530,-3,80120,86000,1400-10-18,2022-01-08
8,خگستر,گسترش‌سرمايه‌گذاري‌ايران‌خودرو,6044,220707544,515608548285,2229,2230,2340,111,4.98,2336,107,4.8,2230,2340,1400-10-18,2022-01-08
9,شبندر,پالايش نفت بندرعباس,6043,57651834,378187973160,6480,6570,6520,40,0.62,6560,80,1.23,6490,6670,1400-10-18,2022-01-08
10,وبصادر,بانك صادرات ايران,5987,261719092,509766564861,1860,1870,1953,93,5,1948,88,4.73,1869,1953,1400-10-18,2022-01-08
11,تپكو,توليدتجهيزات‌سنگين‌هپكو,5899,134729160,344644500433,2631,2553,2583,-48,-1.82,2558,-73,-2.77,2553,2605,1400-10-18,2022-01-08
12,شتران,پالايش نفت تهران,5772,58055006,230877710043,3993,4039,3930,-63,-1.58,3977,-16,-0.4,3921,4055,1400-10-18,2022-01-08
13,فرابورس,فرابورس ايران,5746,18459857,305441089300,16754,16700,16280,-474,-2.83,16550,-204,-1.22,15990,17350,1400-10-18,2022-01-08
14,فولاد,فولاد مباركه اصفهان,5721,41338897,428292717090,10400,10400,10410,10,0.1,10360,-40,-0.38,10240,10560,1400-10-18,2022-01-08
15,وبملت,بانك ملت,5613,160283852,510531367250,3066,3100,3160,94,3.07,3185,119,3.88,3091,3219,1400-10-18,2022-01-08
16,خپارس,پارس‌ خودرو,5359,267621762,288997448392,1038,1030,1068,30,2.89,1080,42,4.05,1030,1089,1400-10-18,2022-01-08
17,كدما,معدني‌ دماوند,5329,5227104,357743701620,65860,66900,67250,1390,2.11,68440,2580,3.92,66110,69150,1400-10-18,2022-01-08
18,توسن,توسعه سامانه ي نرم افزاري نگين,4343,6204680,131604202150,20445,20550,21450,1005,4.92,21200,755,3.69,20550,21450,1400-10-18,2022-01-08
19,بورس,بورس اوراق بهادار تهران,4242,23967928,244629473450,10430,10430,9990,-440,-4.22,10210,-220,-2.11,9910,10690,1400-10-18,2022-01-08
20,شپنا,پالايش نفت اصفهان,4039,31975434,195309745860,6080,6060,6090,10,0.16,6110,30,0.49,6040,6280,1400-10-18,2022-01-08
21,خبهمن,گروه‌بهمن‌,3888,116549479,231913211445,1920,1940,1996,76,3.96,1990,70,3.65,1900,2015,1400-10-18,2022-01-08
22,خنصير,مهندسي‌نصيرماشين‌,3698,17867609,332782013970,18600,17670,18960,360,1.94,18620,20,0.11,17670,19290,1400-10-18,2022-01-08
23,وتجارت,بانك تجارت,3668,121689866,233785096898,1869,1950,1914,45,2.41,1921,52,2.78,1895,1952,1400-10-18,2022-01-08
24,فسبزوار,پارس فولاد سبزوار,3658,2338611,80145112600,34290,34150,34310,20,0.06,34270,-20,-0.06,34100,34400,1400-10-18,2022-01-08
25,امين,تامين سرمايه امين,3586,32913824,341645493120,10920,10380,10380,-540,-4.95,10380,-540,-4.95,10380,10380,1400-10-18,2022-01-08
26,كالا,بورس كالاي ايران,3513,8003891,217470634590,28110,28310,26710,-1400,-4.98,27170,-940,-3.34,26710,28310,1400-10-18,2022-01-08
27,فجهان,مجتمع جهان فولاد سيرجان,3453,22346304,122901389340,5500,5500,5500,0,0,5500,0,0,5480,5520,1400-10-18,2022-01-08
28,حآفرين,ريل پرداز نو آفرين,3035,26688432,108155742593,3996,3820,4090,94,2.35,4053,57,1.43,3820,4160,1400-10-18,2022-01-08
29,كيان,صندوق س. با درآمد ثابت كيان,2940,28627528,929858894214,32433,32481,32482,49,0.15,32481,48,0.15,32480,32484,1400-10-18,2022-01-08
30,نوري,پتروشيمي نوري,2863,1338922,142225087740,107100,107990,105200,-1900,-1.77,106220,-880,-0.82,104810,108300,1400-10-18,2022-01-08
31,ثبهساز,بهساز كاشانه تهران,2698,28061936,43102876829,1467,1498,1540,73,4.98,1536,69,4.7,1480,1540,1400-10-18,2022-01-08
32,گدنا,تهيه توزيع غذاي دنا آفرين فدك,2643,3203901,41777993860,12781,13190,12880,99,0.77,13040,259,2.03,12700,13350,1400-10-18,2022-01-08
33,حسير,ريل سير كوثر,2605,7593931,123340179530,16659,16900,15830,-829,-4.98,16240,-419,-2.52,15830,17090,1400-10-18,2022-01-08
34,تسه0009,امتيازتسهيلات مسكن آذر 1400,2589,63358,66546681424,1000313,1050328,1050328,50015,5,1050328,50015,5,1050328,1050328,1400-10-18,2022-01-08
35,كيمياتك,آريان كيميا تك,2557,697064,16691860580,23940,24000,23910,-30,-0.13,23950,10,0.04,23900,24200,1400-10-18,2022-01-08
36,شسينا,صنايع‌شيميايي‌سينا,2528,65877581,169321953163,2701,2566,2566,-135,-5,2570,-131,-4.85,2566,2600,1400-10-18,2022-01-08
37,غزر,صنعتي زر ماكارون,2523,3998109,36740695780,9350,9260,9050,-300,-3.21,9190,-160,-1.71,9010,9500,1400-10-18,2022-01-08
38,مديريت,س. و خدمات مديريت صند. ب كشوري,2520,2498471,22606906590,9107,9110,8960,-147,-1.61,9050,-57,-0.63,8950,9200,1400-10-18,2022-01-08
39,پارند,صندوق س. پارند پايدار سپهر,2453,82197580,823256002899,10167,10016,10016,-151,-1.49,10016,-151,-1.49,10015,10016,1400-10-18,2022-01-08
40,وسكرد,شركت س استان كردستان,2447,317987847,137294200966,439,435,433,-6,-1.37,432,-7,-1.59,429,444,1400-10-18,2022-01-08
41,وخارزم,سرمايه گذاري خوارزمي,2430,26623169,113303706030,4180,4140,4218,38,0.91,4256,76,1.82,4140,4379,1400-10-18,2022-01-08
42,سپيدار,سپيدار سيستم آسيا,2352,1566092,33372892350,20836,21100,20850,14,0.07,21300,464,2.23,20800,21850,1400-10-18,2022-01-08
43,خمحور,توليدمحورخودرو,2350,61806736,200641747234,3268,3300,3105,-163,-4.99,3246,-22,-0.67,3105,3431,1400-10-18,2022-01-08
44,لپارس,پارس‌ الكتريك‌,2332,1239175,132392514080,103490,102000,105500,2010,1.94,106840,3350,3.24,102000,108590,1400-10-18,2022-01-08
45,خزاميا,زامياد,2292,24910682,206971051860,7940,7870,8330,390,4.91,8310,370,4.66,7870,8330,1400-10-18,2022-01-08
46,ذوب,ذوب آهن اصفهان,2272,29389525,101909487991,3474,3430,3427,-47,-1.35,3468,-6,-0.17,3425,3525,1400-10-18,2022-01-08
47,امين يكم,صندوق درآمد ثابت امين يكم فردا,2266,61452531,619706916679,10079,10086,10084,5,0.05,10084,5,0.05,10074,10088,1400-10-18,2022-01-08
48,سخواف,سيمان مجد خواف,2167,19404674,119130190100,6161,5980,6340,179,2.91,6140,-21,-0.34,5980,6340,1400-10-18,2022-01-08
49,خزر,فنرسازي‌زر,2129,9164362,91173581580,10000,10040,9770,-230,-2.3,9950,-50,-0.5,9600,10360,1400-10-18,2022-01-08
50,آريا,پليمر آريا ساسول,2127,515751,56371618850,108789,108650,108800,11,0.01,109100,311,0.29,108650,111200,1400-10-18,2022-01-08
51,ضخود2019,اختيارخ خودرو-2500-1401/02/07,2121,77018,13586842000,147,154,173,26,17.69,176,29,19.73,152,194,1400-10-18,2022-01-08
52,كاما,باما,2105,13890932,90530827370,6620,6540,6400,-220,-3.32,6520,-100,-1.51,6370,6780,1400-10-18,2022-01-08
53,فسرب,ملي‌ سرب‌وروي‌ ايران‌,2102,42086553,79431018123,1964,1910,1874,-90,-4.58,1887,-77,-3.92,1866,1984,1400-10-18,2022-01-08
54,سمگا,گروه سرمايه گذاري ميراث فرهنگي,2087,11918681,118726370610,9958,10080,9760,-198,-1.99,9960,2,0.02,9760,10150,1400-10-18,2022-01-08
55,شاروم,پتروشيمي اروميه,2061,1547944,20652427830,13731,13320,13070,-661,-4.81,13340,-391,-2.85,13050,14090,1400-10-18,2022-01-08
56,شصدف,صنعتي دوده فام,2029,2419960,86838557000,35735,36100,35200,-535,-1.5,35900,165,0.46,34300,37000,1400-10-18,2022-01-08
57,سپيد,سپيد ماكيان,2006,1193943,70408620180,58790,59000,58410,-380,-0.65,58970,180,0.31,58410,60300,1400-10-18,2022-01-08
58,تاپكيش,تجارت الكترونيك پارسيان كيش,1976,20812808,385782197340,17717,18000,18600,883,4.98,18540,823,4.65,17900,18600,1400-10-18,2022-01-08
59,طلا,صندوق س.پشتوانه طلاي لوتوس,1971,2104739,182067078860,88217,88000,85586,-2631,-2.98,86503,-1714,-1.94,85500,88000,1400-10-18,2022-01-08
60,ثاميد,توسعه و عمران اميد,1943,8864086,12487590615,1396,1400,1405,9,0.64,1404,8,0.57,1385,1435,1400-10-18,2022-01-08
61,كماسه,تامين‌ ماسه‌ ريخته‌گري‌,1926,25833386,83233435250,3343,3330,3190,-153,-4.58,3222,-121,-3.62,3176,3385,1400-10-18,2022-01-08
62,غشصفا,شيرپاستوريزه‌پگاه‌اصفهان‌,1912,7218880,154321965850,22430,21310,21310,-1120,-4.99,21380,-1050,-4.68,21310,21900,1400-10-18,2022-01-08
63,غگيلا,شيرپاستوريزه پگاه گيلان,1873,2830685,44118183470,15307,14860,15660,353,2.31,15590,283,1.85,14700,16050,1400-10-18,2022-01-08
64,بوعلي,پتروشيمي بوعلي سينا,1858,644302,47822118380,74330,74330,73700,-630,-0.85,74280,-50,-0.07,73700,75480,1400-10-18,2022-01-08
65,اعتماد,صندوق س.اعتماد آفرين پارسيان-د,1830,24548220,1010966149870,41140,41183,41184,44,0.11,41183,43,0.1,41182,41185,1400-10-18,2022-01-08
66,شگويا,پتروشيمي تندگويان,1823,6434445,70967714810,11104,11010,11020,-84,-0.76,11050,-54,-0.49,10960,11250,1400-10-18,2022-01-08
67,سيتا,سرمايه گذاري سيمان تامين,1820,2712533,24544998550,9270,9050,8940,-330,-3.56,9130,-140,-1.51,8890,9160,1400-10-18,2022-01-08
68,بپيوند,برق و انرژي پيوندگستر پارس,1790,1308519,12158786280,9322,9220,9320,-2,-0.02,9300,-22,-0.24,9170,9500,1400-10-18,2022-01-08
69,افران,صندوق س افرا نماد پايدار-ثابت,1772,47026708,714542024922,15170,15194,15195,25,0.16,15194,24,0.16,15194,15196,1400-10-18,2022-01-08
70,وكبهمن,مديريت سرمايه گذاري كوثربهمن,1758,601288,5757544960,9529,9510,9550,21,0.22,9550,21,0.22,9480,9780,1400-10-18,2022-01-08
71,وسپهر,سرمايه گذاري مالي سپهرصادرات,1751,4361657,30828104080,7062,7100,7060,-2,-0.03,7060,-2,-0.03,7060,7110,1400-10-18,2022-01-08
72,خريختح,ح . صنايع‌ريخته‌گري‌ايران‌,1747,17218201,25279269208,7130,1530,1470,-5660,-79.38,1468,-5662,-79.41,1400,1530,1400-10-18,2022-01-08
73,كتوكا,توليدي و خدمات صنايع نسوز توكا,1727,13250530,98402060200,7186,7540,7270,84,1.17,7430,244,3.4,7210,7540,1400-10-18,2022-01-08
74,غچين,كشت‌ و صنعت‌ چين‌ چين,1706,10437624,123712179100,11310,11740,11870,560,4.95,11850,540,4.77,11660,11870,1400-10-18,2022-01-08
75,فاذر,صنايع‌ آذرآب‌,1663,73185948,65013457405,894,890,874,-20,-2.24,888,-6,-0.67,874,911,1400-10-18,2022-01-08
76,وهامون,سرمايه گذاري هامون صبا,1654,2899916,7818792927,2714,2678,2698,-16,-0.59,2705,-9,-0.33,2678,2734,1400-10-18,2022-01-08
77,ولپارس,ليزينگ پارسيان,1647,6698616,19144144357,2882,2805,2880,-2,-0.07,2858,-24,-0.83,2800,2950,1400-10-18,2022-01-08
78,غصينو,صنعتي مينو,1647,5912617,90562863860,15860,15900,15070,-790,-4.98,15320,-540,-3.4,15070,16340,1400-10-18,2022-01-08
79,صبا,سرمايه گذاري صبا تامين,1640,12469108,75573769950,6089,6090,6040,-49,-0.8,6070,-19,-0.31,6020,6160,1400-10-18,2022-01-08
80,فروي,ذوب روي اصفهان,1628,5231678,91700806890,16759,17590,17590,831,4.96,17530,771,4.6,17150,17590,1400-10-18,2022-01-08
81,شپديس,پتروشيمي پرديس,1625,770182,131227609480,170990,170990,167720,-3270,-1.91,170390,-600,-0.35,167710,175000,1400-10-18,2022-01-08
82,كزغال,زغال سنگ پروده طبس,1604,1357806,40978404450,30973,30800,30100,-873,-2.82,30200,-773,-2.5,29950,31100,1400-10-18,2022-01-08
83,پترول,گ.س.وت.ص.پتروشيمي خليج فارس,1597,29209727,66620176599,2345,2290,2271,-74,-3.16,2281,-64,-2.73,2261,2345,1400-10-18,2022-01-08
84,آپ,آسان پرداخت پرشين,1585,6160652,52360113180,8640,8650,8450,-190,-2.2,8500,-140,-1.62,8280,8770,1400-10-18,2022-01-08
85,وگردش,بانك گردشگري,1568,23385271,237837243500,10235,10000,10240,5,0.05,10170,-65,-0.64,9940,10270,1400-10-18,2022-01-08
86,لطيف,محصولات كاغذي لطيف,1566,2420723,98039281500,38602,40500,40500,1898,4.92,40500,1898,4.92,40500,40500,1400-10-18,2022-01-08
87,وغدير,سرمايه‌گذاري‌غدير(هلدينگ‌,1565,8725684,126078892510,14540,14450,14380,-160,-1.1,14450,-90,-0.62,14300,14600,1400-10-18,2022-01-08
88,بگيلان,توسعه مسير برق گيلان,1525,346491,4707200770,13358,13380,13500,142,1.06,13400,42,0.31,13380,13770,1400-10-18,2022-01-08
89,خصدرا,صنعتي‌ دريايي‌ ايران‌,1516,40873116,83571869217,2085,2094,2025,-60,-2.88,2045,-40,-1.92,2023,2130,1400-10-18,2022-01-08
90,شاراك,پتروشيمي شازند,1506,1948709,83693519590,44020,44020,42530,-1490,-3.38,43100,-920,-2.09,42120,44020,1400-10-18,2022-01-08
91,قچار,فراوردههاي غذايي وقند چهارمحال,1496,10343098,90600587600,8464,8850,8800,336,3.97,8760,296,3.5,8520,8880,1400-10-18,2022-01-08
92,ثبات,صندوق س. ثبات ويستا -د,1492,72332268,775244415940,10699,10717,10718,19,0.18,10718,19,0.18,10717,10719,1400-10-18,2022-01-08
93,ومدير,گ.مديريت ارزش سرمايه ص ب كشوري,1474,6589009,29598051240,4551,4484,4389,-162,-3.56,4492,-59,-1.3,4389,4600,1400-10-18,2022-01-08
94,غكورش,صنعت غذايي كورش,1469,895156,42283123020,47100,46750,46760,-340,-0.72,47200,100,0.21,46600,47900,1400-10-18,2022-01-08
95,وساغربي,شركت س استان آذربايجان غربي,1451,98195264,42578332497,436,436,434,-2,-0.46,434,-2,-0.46,428,442,1400-10-18,2022-01-08
96,شفنح,ح . پتروشيمي فناوران,1439,8472593,71472452740,8570,8680,8400,-170,-1.98,8440,-130,-1.52,8270,8680,1400-10-18,2022-01-08
97,شفن,پتروشيمي فناوران,1437,3664948,46249347200,12850,12760,12530,-320,-2.49,12760,-90,-0.7,12500,12900,1400-10-18,2022-01-08
98,قرن,پديده شيمي قرن,1395,2902138,65800668810,22590,23400,21960,-630,-2.79,22670,80,0.35,21810,23400,1400-10-18,2022-01-08
99,ولكار,ليزينگ كارآفرين,1390,1737494,6954806496,4043,3965,3980,-63,-1.56,4024,-19,-0.47,3960,4090,1400-10-18,2022-01-08
100,فنفت,صنايع تجهيزات نفت,1376,5231874,103919831930,19712,20200,19820,108,0.55,19860,148,0.75,19130,20300,1400-10-18,2022-01-08
101,رافزا,رايان هم افزا,1374,169550,9603919100,57593,55950,56100,-1493,-2.59,56950,-643,-1.12,55600,58100,1400-10-18,2022-01-08
102,وسكرمان,س.سهام عدالت استان كرمان,1335,147930011,63795560038,444,435,433,-11,-2.48,431,-13,-2.93,427,450,1400-10-18,2022-01-08
103,وسكرشا,س.سهام عدالت استان كرمانشاه,1332,150340318,66386349935,449,443,439,-10,-2.23,442,-7,-1.56,435,454,1400-10-18,2022-01-08
104,زملارد,كشاورزي و دامپروري ملارد شير,1330,3042968,25786006420,8804,8890,8370,-434,-4.93,8470,-334,-3.79,8370,8940,1400-10-18,2022-01-08
105,وپارس,بانك‌پارسيان‌,1328,25609069,48388234659,1887,1840,1873,-14,-0.74,1888,1,0.05,1840,1942,1400-10-18,2022-01-08
106,ثشاهد,سرمايه‌ گذاري‌ شاهد,1327,5747780,54632293200,9510,9500,9400,-110,-1.16,9500,-10,-0.11,9350,9840,1400-10-18,2022-01-08
107,ختور,رادياتور ايران‌,1323,6876207,85577334130,11910,12010,12450,540,4.53,12450,540,4.53,12010,12500,1400-10-18,2022-01-08
108,فارس,صنايع پتروشيمي خليج فارس,1322,8827545,94240883510,10740,10740,10670,-70,-0.65,10690,-50,-0.47,10520,10870,1400-10-18,2022-01-08
109,زاگرس,پتروشيمي زاگرس,1311,308354,62885252100,205846,212800,202150,-3696,-1.8,204650,-1196,-0.58,201750,212800,1400-10-18,2022-01-08
110,ولغدر,ليزينگ‌خودروغدير,1309,8846397,69994480920,8000,7600,8220,220,2.75,7910,-90,-1.13,7600,8340,1400-10-18,2022-01-08
111,حكشتي,كشتيراني جمهوري اسلامي ايران,1301,5223675,72557092830,13970,13430,13720,-250,-1.79,13920,-50,-0.36,13430,14250,1400-10-18,2022-01-08
112,ونوين,بانك‌اقتصادنوين‌,1273,26731589,94018637851,3389,3420,3525,136,4.01,3517,128,3.78,3334,3558,1400-10-18,2022-01-08
113,سحرخيز,صندوق س. گروه زعفران سحرخيز,1271,2878081,56396765266,19845,19650,19235,-610,-3.07,19595,-250,-1.26,19100,19980,1400-10-18,2022-01-08
114,فتوسا,توليد و توسعه سرب روي ايرانيان,1270,410747,4585325510,11093,10950,11280,187,1.69,11110,17,0.15,10950,11400,1400-10-18,2022-01-08
115,ختوقا,قطعات‌ اتومبيل‌ ايران‌,1264,48628352,127149172360,2498,2490,2622,124,4.96,2615,117,4.68,2477,2622,1400-10-18,2022-01-08
116,وسديد,گروه ‌صنعتي‌سديد,1262,20479182,21444007854,1067,1073,1042,-25,-2.34,1047,-20,-1.87,1035,1080,1400-10-18,2022-01-08
117,غنوش,نوش‌ مازندران‌,1252,3616653,46433393120,12880,12830,12620,-260,-2.02,12840,-40,-0.31,12290,13180,1400-10-18,2022-01-08
118,فخوز,فولاد  خوزستان,1236,10808940,68312927130,6390,6470,6250,-140,-2.19,6350,-40,-0.63,6210,6470,1400-10-18,2022-01-08
119,فگستر,گسترش صنايع روي ايرانيان,1232,858063,9274623800,10648,10650,10840,192,1.8,10750,102,0.96,10650,10950,1400-10-18,2022-01-08
120,فاراك,ماشين‌ سازي‌ اراك‌,1208,28204180,40515829553,1425,1417,1418,-7,-0.49,1437,12,0.84,1414,1475,1400-10-18,2022-01-08
121,ورنا,سرمايه‌گذاري‌ رنا(هلدينگ‌,1145,14147002,42349753309,2880,2939,2965,85,2.95,2994,114,3.96,2894,3024,1400-10-18,2022-01-08
122,ثاخت,بين‌المللي‌توسعه‌ساختمان,1138,19200748,36676080218,1879,1954,1900,21,1.12,1910,31,1.65,1879,1954,1400-10-18,2022-01-08
123,سمايه,بانك سرمايه,1128,18504930,85307375339,4751,4609,4609,-142,-2.99,4610,-141,-2.97,4609,4699,1400-10-18,2022-01-08
124,قتربت,قند تربت حيدريه,1119,163756,9129197000,54140,55750,55750,1610,2.97,55550,1410,2.6,55100,55750,1400-10-18,2022-01-08
125,ونيرو,سرمايه‌گذاري‌نيرو,1115,27064457,64721624682,2309,2340,2389,80,3.46,2391,82,3.55,2301,2424,1400-10-18,2022-01-08
126,فسپا,گروه‌صنعتي‌سپاهان‌,1106,4995254,83508588510,17040,17400,16650,-390,-2.29,16720,-320,-1.88,16220,17690,1400-10-18,2022-01-08
127,كلر,كلر پارس,1102,485110,47998694950,101833,100300,96750,-5083,-4.99,98950,-2883,-2.83,96750,102900,1400-10-18,2022-01-08
128,غگل,گلوكوزان‌,1073,12291430,38354604524,3090,3070,3140,50,1.62,3120,30,0.97,3070,3159,1400-10-18,2022-01-08
129,ولساپا,ليزينگ رايان‌ سايپا,1068,35277317,51337685739,1407,1405,1438,31,2.2,1455,48,3.41,1401,1477,1400-10-18,2022-01-08
130,خمحركه,نيرو محركه‌,1062,11738463,39757368182,3308,3271,3327,19,0.57,3387,79,2.39,3271,3450,1400-10-18,2022-01-08
131,وملي,گروه‌ صنعتي‌ ملي‌ (هلدينگ‌,1058,335480,48214729600,141680,139500,140370,-1310,-0.92,143720,2040,1.44,139500,147500,1400-10-18,2022-01-08
132,حتايد,تايدواترخاورميانه,1050,17390688,84630341958,4649,4730,4881,232,4.99,4866,217,4.67,4611,4881,1400-10-18,2022-01-08
133,خمهرح,ح . مهركام‌پارس‌,1049,22309028,13303687726,580,565,591,11,1.9,596,16,2.76,565,615,1400-10-18,2022-01-08
134,تملتح,ح . تامين سرمايه بانك ملت,1044,3305014,3795014896,1136,1150,1130,-6,-0.53,1148,12,1.06,1122,1180,1400-10-18,2022-01-08
135,ضخود2018,اختيارخ خودرو-2000-1401/02/07,1027,31958,11940801000,310,310,375,65,20.97,374,64,20.65,310,399,1400-10-18,2022-01-08
136,ملت,بيمه ملت,1018,67887213,81826797238,1202,1210,1188,-14,-1.16,1205,3,0.25,1176,1220,1400-10-18,2022-01-08
137,بكاب,صنايع‌جوشكاب‌يزد,1017,439900,33598805020,78860,75050,75000,-3860,-4.89,76380,-2480,-3.14,74920,81000,1400-10-18,2022-01-08
138,چكاپا,گروه صنايع كاغذ پارس,1010,11960347,35471838163,3000,3015,2902,-98,-3.27,2966,-34,-1.13,2850,3069,1400-10-18,2022-01-08
139,پيزد,مجتمع صنايع لاستيك يزد,1001,186356,9582858400,52619,52800,50950,-1669,-3.17,51850,-769,-1.46,50950,52800,1400-10-18,2022-01-08
140,سرو,صندوق س سروسودمند مدبران-سهام,997,1684743,117068207620,68630,68310,68990,360,0.52,69490,860,1.25,68310,70410,1400-10-18,2022-01-08
141,سفارس,سيمان فارس و خوزستان,984,5356409,85534229850,16030,16400,16030,0,0,15970,-60,-0.37,15640,16400,1400-10-18,2022-01-08
142,ثفارس,عمران‌وتوسعه‌فارس‌,971,4979961,33651275180,6660,6590,6600,-60,-0.9,6760,100,1.5,6570,6940,1400-10-18,2022-01-08
143,قثابت,قند ثابت‌ خراسان‌,962,23431592,41219843848,1786,1754,1740,-46,-2.58,1759,-27,-1.51,1730,1826,1400-10-18,2022-01-08
144,غبشهر,صنعتي‌ بهشهر,960,28042751,94533794428,3528,3500,3410,-118,-3.34,3371,-157,-4.45,3352,3526,1400-10-18,2022-01-08
145,شبصير,توليدات پتروشيمي قائد بصير,955,374053,40418381750,109921,110000,107100,-2821,-2.57,108050,-1871,-1.7,105000,112000,1400-10-18,2022-01-08
146,اپال,فرآوري معدني اپال كاني پارس,953,2312531,55024853570,23390,23400,23800,410,1.75,23570,180,0.77,23390,24100,1400-10-18,2022-01-08
147,آسيا,بيمه آسيا,943,22200749,39343896080,1738,1732,1769,31,1.78,1772,34,1.96,1720,1805,1400-10-18,2022-01-08
148,گشان,توسعه بين المللي پديده شانديز,938,1741524,31800948310,18345,18070,18150,-195,-1.06,18260,-85,-0.46,18000,18700,1400-10-18,2022-01-08
149,خكار,ايركا پارت صنعت,930,24634527,77508890927,3003,3011,3153,150,5,3146,143,4.76,3010,3153,1400-10-18,2022-01-08
150,وپويا,سرمايه گذاري پويا,911,1909779,6394918161,3357,3290,3350,-7,-0.21,3353,-4,-0.12,3285,3427,1400-10-18,2022-01-08
151,بترانس,ايران‌ ترانسفو,905,18592271,36569739802,1943,1915,1960,17,0.87,1967,24,1.24,1915,2030,1400-10-18,2022-01-08
152,شپترو,پتروشيمي آبادان,897,17221970,52948551402,3059,3140,2999,-60,-1.96,3074,15,0.49,2980,3140,1400-10-18,2022-01-08
153,ثنور,سرمايه گذاري كوه نور,891,8458894,70073074330,8278,8380,8110,-168,-2.03,8280,2,0.02,8050,8450,1400-10-18,2022-01-08
154,كرماشا,صنايع پتروشيمي كرمانشاه,891,880970,47774977780,55270,55990,53850,-1420,-2.57,54620,-650,-1.18,53580,55990,1400-10-18,2022-01-08
155,كيسون,شركت كيسون,885,24265630,39441735489,1660,1670,1611,-49,-2.95,1625,-35,-2.11,1611,1670,1400-10-18,2022-01-08
156,سكه0012پ01,تمام سكه طرح جديد0012رفاه,881,274700,337671539800,1247480,1251000,1225500,-21980,-1.76,1229237,-18243,-1.46,1219002,1251000,1400-10-18,2022-01-08
157,وساپا,سرمايه‌گذاري‌ سايپا,877,9695670,40695401984,4028,3981,4180,152,3.77,4197,169,4.2,3981,4229,1400-10-18,2022-01-08
158,بجهرم,توسعه مولد نيروگاهي جهرم,850,12844285,25560298547,1978,1970,1960,-18,-0.91,1990,12,0.61,1950,2020,1400-10-18,2022-01-08
159,شسپا,نفت سپاهان,829,12906751,42888094397,3383,3398,3329,-54,-1.6,3348,-35,-1.03,3285,3399,1400-10-18,2022-01-08
160,كرازي,كارخانجات‌توليدي‌شيشه‌رازي‌,821,30657504,38311979911,1278,1287,1239,-39,-3.05,1250,-28,-2.19,1235,1287,1400-10-18,2022-01-08
161,آگاس,صندوق س.هستي بخش آگاه-س,820,1452134,111661840856,76591,76599,76480,-111,-0.14,76895,304,0.4,76005,77733,1400-10-18,2022-01-08
162,وصنعت,سرمايه گذاري توسعه صنعت وتجارت,810,6058712,39765455960,6850,6970,6510,-340,-4.96,6560,-290,-4.23,6510,6970,1400-10-18,2022-01-08
163,زكوثر,سرمايه گذاري كشاورزي كوثر,809,2086730,28694316720,14090,13820,13680,-410,-2.91,13750,-340,-2.41,13450,14280,1400-10-18,2022-01-08
164,فجر,فولاد اميركبيركاشان,809,1086822,25092353470,23740,23400,22860,-880,-3.71,23090,-650,-2.74,22720,23750,1400-10-18,2022-01-08
165,وكار,بانك‌ كارآفرين‌,802,14250815,33496016309,2357,2345,2323,-34,-1.44,2351,-6,-0.25,2291,2379,1400-10-18,2022-01-08
166,حفاري,حفاري شمال,798,11646104,48743586933,4187,4190,4188,1,0.02,4185,-2,-0.05,4100,4283,1400-10-18,2022-01-08
167,شغدير,پتروشيمي غدير,788,644082,57026514260,89140,90900,88100,-1040,-1.17,88540,-600,-0.67,87920,90900,1400-10-18,2022-01-08
168,تسه0008,امتيازتسهيلات مسكن آبان1400,784,12243,12954950169,1007837,1058228,1058228,50391,5,1058152,50315,4.99,1030000,1058228,1400-10-18,2022-01-08
169,كاوه,فولاد كاوه جنوب كيش,779,2991992,40738902590,13880,13680,13450,-430,-3.1,13750,-130,-0.94,13380,14020,1400-10-18,2022-01-08
170,شاوان,پالايش نفت لاوان,777,765142,99334043100,130643,132100,128300,-2343,-1.79,129800,-843,-0.65,128050,133900,1400-10-18,2022-01-08
171,زدشت,كشت و صنعت دشت خرم دره,777,3172894,41799820880,12754,12250,13390,636,4.99,13170,416,3.26,12250,13390,1400-10-18,2022-01-08
172,خموتور,موتورسازان‌تراكتورسازي‌ايران‌,769,5521749,27233482990,4920,4763,4800,-120,-2.44,4932,12,0.24,4762,5095,1400-10-18,2022-01-08
173,قشهد,شهد,762,4860720,75964178650,15010,15760,15150,140,0.93,15630,620,4.13,15000,15760,1400-10-18,2022-01-08
174,پكرمان,گروه‌ صنعتي‌ بارز,758,2138796,41259154600,19880,19420,19170,-710,-3.57,19290,-590,-2.97,18890,19840,1400-10-18,2022-01-08
175,شبريز,پالايش نفت تبريز,757,1327599,44051285190,33270,33280,33100,-170,-0.51,33230,-40,-0.12,32830,34100,1400-10-18,2022-01-08
176,خودكفا,اقتصادي و خودكفايي آزادگان,746,5682769,36181933720,6526,6400,6340,-186,-2.85,6370,-156,-2.39,6340,6530,1400-10-18,2022-01-08
177,سصفها,سيمان‌اصفهان‌,746,1760764,45172598820,24570,24180,25790,1220,4.97,25660,1090,4.44,24180,25790,1400-10-18,2022-01-08
178,ديران,ايران‌دارو,741,1948066,33969464440,17420,16830,17080,-340,-1.95,17440,20,0.11,16600,18070,1400-10-18,2022-01-08
179,خرينگ,رينگ‌سازي‌مشهد,737,2061256,52427744930,24510,24100,25250,740,3.02,25430,920,3.75,24100,25730,1400-10-18,2022-01-08
180,غدام,خوراك‌  دام‌ پارس‌,736,294954,26432603730,91070,91050,88590,-2480,-2.72,89620,-1450,-1.59,87530,92980,1400-10-18,2022-01-08
181,پارس,پتروشيمي پارس,734,254653,45028306250,179160,179160,175850,-3310,-1.85,178090,-1070,-0.6,175000,179950,1400-10-18,2022-01-08
182,تسه0006,امتيازتسهيلات مسكن شهريور1400,733,17654,18660996726,1009496,1059970,1059970,50474,5,1057041,47545,4.71,1041850,1059970,1400-10-18,2022-01-08
183,شرنگي,شيميايي رنگين,730,159862,34539913150,214791,221000,216000,1209,0.56,216050,1259,0.59,209000,221000,1400-10-18,2022-01-08
184,شيران,س. صنايع‌شيميايي‌ايران,726,1614042,32484204260,20510,20300,20010,-500,-2.44,20350,-160,-0.78,19900,20530,1400-10-18,2022-01-08
185,خمهر,مهركام‌پارس‌,713,21819729,38171839653,1676,1661,1759,83,4.95,1749,73,4.36,1661,1759,1400-10-18,2022-01-08
186,وساخت,سرمايه‌ گذاري‌ ساختمان‌ايران‌,705,748714,24654266580,34050,33700,32700,-1350,-3.96,32930,-1120,-3.29,32350,34490,1400-10-18,2022-01-08
187,تاپيكو,س. نفت و گاز و پتروشيمي تأمين,699,3574702,51568392100,14460,14460,14270,-190,-1.31,14450,-10,-0.07,14260,14690,1400-10-18,2022-01-08
188,خبنيان,بنيان ديزل,694,1716758,2449813666,1502,1427,1427,-75,-4.99,1483,-19,-1.26,1427,1427,1400-10-18,2022-01-08
189,فپنتا,سپنتا,690,130981,64140069790,510420,516000,484900,-25520,-5,489690,-20730,-4.06,484900,516000,1400-10-18,2022-01-08
190,بكامح,ح.كارخانجات توليدي شهيد قندي,689,19847608,10115325834,532,524,500,-32,-6.02,510,-22,-4.14,491,542,1400-10-18,2022-01-08
191,بپاس,بيمه پاسارگاد,689,2543985,94130600400,37001,37000,37000,-1,0,37000,-1,0,36700,37100,1400-10-18,2022-01-08
192,خكرمان,گروه اقتصادي كرمان خودرو,681,11417681,38402695016,3306,3355,3312,6,0.18,3363,57,1.72,3231,3405,1400-10-18,2022-01-08
193,فلوله,لوله‌وماشين‌سازي‌ايران‌,676,18631181,18332555113,998,990,976,-22,-2.2,984,-14,-1.4,967,1020,1400-10-18,2022-01-08
194,هرمز,فولاد هرمزگان جنوب,674,2598723,38505440130,15095,15020,14710,-385,-2.55,15000,-95,-0.63,14550,15100,1400-10-18,2022-01-08
195,جوين,كشت و صنعت جوين,668,15575952,38374182100,2419,2491,2396,-23,-0.95,2464,45,1.86,2375,2491,1400-10-18,2022-01-08
196,شتوكا,توكا رنگ فولاد سپاهان,667,2412526,35576252200,15471,15000,14700,-771,-4.98,14750,-721,-4.66,14700,15700,1400-10-18,2022-01-08
197,وبانك,سرمايه گذاري گروه توسعه ملي,665,5107145,41796768750,8320,8190,8320,0,0,8260,-60,-0.72,8090,8370,1400-10-18,2022-01-08
198,سامان,بانك سامان,661,6076951,42994925530,6912,7100,6980,68,0.98,7080,168,2.43,6950,7110,1400-10-18,2022-01-08
199,ثتران,سرمايه گذاري مسكن تهران,659,8773895,25175795709,2931,2920,2841,-90,-3.07,2869,-62,-2.12,2820,2980,1400-10-18,2022-01-08
200,كفپارس,فرآورده‌هاي‌ نسوز پارس‌,655,8250062,22760198644,2842,2739,2740,-102,-3.59,2759,-83,-2.92,2700,2839,1400-10-18,2022-01-08
201,چكاوه,صنايع‌كاغذسازي‌كاوه‌,655,2872801,22335914090,7610,7560,7800,190,2.5,7770,160,2.1,7360,7990,1400-10-18,2022-01-08
202,تكشا,گسترش‌صنايع‌وخدمات‌كشاورزي‌,652,992178,40350126440,39080,40950,39850,770,1.97,40670,1590,4.07,39500,41030,1400-10-18,2022-01-08
203,تليسه,دامداري تليسه نمونه,645,8774977,19065863841,2209,2200,2160,-49,-2.22,2173,-36,-1.63,2122,2278,1400-10-18,2022-01-08
204,ورازي,بيمه رازي,635,23852200,29820881297,1287,1249,1249,-38,-2.95,1250,-37,-2.87,1249,1269,1400-10-18,2022-01-08
205,كبافق,معادن‌ بافق‌,634,905113,24527573130,28060,27200,26660,-1400,-4.99,27100,-960,-3.42,26660,28580,1400-10-18,2022-01-08
206,كچاد,معدني‌وصنعتي‌چادرملو,632,1916464,57348062450,30010,30010,29750,-260,-0.87,29970,-40,-0.13,29660,30040,1400-10-18,2022-01-08
207,غسالم,سالمين‌,630,7772002,20504890840,2657,2635,2620,-37,-1.39,2638,-19,-0.72,2613,2702,1400-10-18,2022-01-08
208,كمرجان,بازرگاني و توليدي مرجان كار,626,4343557,25069266280,5991,5980,5710,-281,-4.69,5770,-221,-3.69,5700,5980,1400-10-18,2022-01-08
209,خعمرا,توسعه و عمران شهرستان نائين,619,13395780,81307938820,5920,6090,6090,170,2.87,6070,150,2.53,5760,6090,1400-10-18,2022-01-08
210,حآسا,آسيا سير ارس,618,1822779,24148491330,13608,13930,12930,-678,-4.98,13250,-358,-2.63,12930,13930,1400-10-18,2022-01-08
211,همراه,شركت ارتباطات سيار ايران,613,2810765,22114924730,8030,7890,7850,-180,-2.24,8000,-30,-0.37,7790,8040,1400-10-18,2022-01-08
212,شفا,سرمايه گذاري شفادارو,609,2983049,35508325520,12420,12420,11800,-620,-4.99,11900,-520,-4.19,11800,12520,1400-10-18,2022-01-08
213,سيمرغ,سيمرغ,607,1364831,31209370350,22910,22570,22540,-370,-1.62,22870,-40,-0.17,22510,23190,1400-10-18,2022-01-08
214,كساوه,صنايع‌ كاشي‌ و سراميك‌ سينا,606,1704245,75818775500,43690,42400,44490,800,1.83,44490,800,1.83,42400,44890,1400-10-18,2022-01-08
215,غمارگ,مارگارين‌,606,10728477,27542460953,2581,2590,2566,-15,-0.58,2567,-14,-0.54,2500,2629,1400-10-18,2022-01-08
216,چافست,افست‌,605,3727130,32748989190,8490,8910,8730,240,2.83,8790,300,3.53,8510,8910,1400-10-18,2022-01-08
217,تملت,تامين سرمايه بانك ملت,603,5635735,13720298144,2442,2450,2450,8,0.33,2435,-7,-0.29,2360,2470,1400-10-18,2022-01-08
218,پارند2,صندوق س. پارند پايدار سپهر,598,59800000,59800000,10167,1,1,-10166,-99.99,1,-10166,-99.99,1,1,1400-10-18,2022-01-08
219,ومعادن,توسعه‌معادن‌وفلزات‌,594,3804216,36129876420,9590,9750,9590,0,0,9560,-30,-0.31,9390,9750,1400-10-18,2022-01-08
220,بالبر,كابل‌ البرز,589,1853311,41318420480,23200,22270,22330,-870,-3.75,22290,-910,-3.92,22040,23500,1400-10-18,2022-01-08
221,وهنر,گروه توسعه هنر ايران,583,7467173,18029268096,2358,2419,2428,70,2.97,2414,56,2.37,2361,2428,1400-10-18,2022-01-08
222,رتاپ,تجارت الكترونيك  پارسيان,582,1966990,10312857870,5260,5260,5240,-20,-0.38,5250,-10,-0.19,5150,5330,1400-10-18,2022-01-08
223,بالاس,مهندسي ساختمان تاسيسات راه آهن,571,1076664,30953954000,28884,28100,27650,-1234,-4.27,28750,-134,-0.46,27450,30300,1400-10-18,2022-01-08
224,قشكر,شكرشاهرود,570,9659878,22260388232,2326,2325,2252,-74,-3.18,2304,-22,-0.95,2250,2387,1400-10-18,2022-01-08
225,وخاور,بانك خاورميانه,563,19029473,95909556637,4984,5040,5060,76,1.52,5040,56,1.12,4921,5101,1400-10-18,2022-01-08
226,اخابر,مخابرات ايران,562,4602087,33300485130,7280,7280,7190,-90,-1.24,7270,-10,-0.14,7130,7450,1400-10-18,2022-01-08
227,فزرين,زرين معدن آسيا,561,2196059,24344176470,10850,11180,10990,140,1.29,11090,240,2.21,10900,11300,1400-10-18,2022-01-08
228,ماديرا,صنايع ماديران,561,3601365,19023948670,5308,5360,5270,-38,-0.72,5280,-28,-0.53,5150,5420,1400-10-18,2022-01-08
229,ثتوسا,س.توسعه و عمران استان اردبيل,559,1562341,21019916030,13084,13440,13470,386,2.95,13450,366,2.8,13080,13470,1400-10-18,2022-01-08
230,كوير,توليدي فولاد سپيد فراب كوير,557,5669672,29659327440,5250,5310,5160,-90,-1.71,5240,-10,-0.19,5140,5360,1400-10-18,2022-01-08
231,البرز,بيمه البرز,553,14013185,24050163667,1701,1701,1711,10,0.59,1716,15,0.88,1700,1751,1400-10-18,2022-01-08
232,دكپسول,توليد ژلاتين كپسول ايران,550,1247389,37308842100,30851,31500,30100,-751,-2.43,29900,-951,-3.08,29350,31500,1400-10-18,2022-01-08
233,پكويرح,ح. كوير تاير,550,3398595,9936424866,2954,2901,2923,-31,-1.05,2924,-30,-1.02,2830,3010,1400-10-18,2022-01-08
234,سنير,سيمان‌ سفيد ني‌ريز,548,467984,12704982860,27100,27210,26840,-260,-0.96,27140,40,0.15,26000,28170,1400-10-18,2022-01-08
235,تسه0007,امتيازتسهيلات مسكن مهر1400,546,7016,7433881829,1009397,1030000,1059866,50469,5,1059561,50164,4.97,1030000,1059866,1400-10-18,2022-01-08
236,سبزوا,سيمان لار سبزوار,546,7516775,13718951753,1828,1840,1800,-28,-1.53,1825,-3,-0.16,1800,1867,1400-10-18,2022-01-08
237,فنورد,نوردوقطعات‌ فولادي‌,542,371799,59436185410,154460,154460,162180,7720,5,159860,5400,3.5,154460,162180,1400-10-18,2022-01-08
238,وتوصا,گروه س توسعه صنعتي ايران,541,4108327,40775578590,10070,9910,10010,-60,-0.6,9930,-140,-1.39,9610,10140,1400-10-18,2022-01-08
239,خكمك,كمك‌فنرايندامين‌,541,1605591,36211903930,22280,22390,22400,120,0.54,22550,270,1.21,21800,23210,1400-10-18,2022-01-08
240,وصنا,گروه‌صنايع‌بهشهرايران‌,538,4628390,15195404804,3410,3272,3240,-170,-4.99,3283,-127,-3.72,3240,3393,1400-10-18,2022-01-08
241,پارسان,گسترش نفت و گاز پارسيان,536,2432224,80960365010,33480,33480,32660,-820,-2.45,33350,-130,-0.39,32550,34290,1400-10-18,2022-01-08
242,دماوند,توليد نيروي برق دماوند,533,1025310,18849103430,18827,18290,18290,-537,-2.85,18620,-207,-1.1,18260,18840,1400-10-18,2022-01-08
243,كارا,صندوق س. كارا -د,530,19986033,210467360961,10511,10530,10531,20,0.19,10531,20,0.19,10530,10531,1400-10-18,2022-01-08
244,گكوثر,هتل پارسيان كوثر اصفهان,529,8417271,12216075773,1440,1442,1432,-8,-0.56,1449,9,0.63,1412,1480,1400-10-18,2022-01-08
245,ساوه,سيمان ساوه,529,456752,21505802250,46864,47400,46950,86,0.18,47100,236,0.5,46350,47400,1400-10-18,2022-01-08
246,هماي,صندوق س هماي آگاه-ثابت,529,6488221,65516397756,10089,10097,10099,10,0.1,10098,9,0.09,10093,10104,1400-10-18,2022-01-08
247,سخاش,سيمان‌خاش‌,527,196938,16263565530,84600,84610,81900,-2700,-3.19,82580,-2020,-2.39,81160,85000,1400-10-18,2022-01-08
248,اعتلاح,ح سرمايه گذاري اعتلاء البرز,524,6216753,8391295759,1393,1385,1331,-62,-4.45,1350,-43,-3.09,1324,1400,1400-10-18,2022-01-08
249,غويتا,ويتانا,522,2476859,12481669690,5076,5000,5100,24,0.47,5050,-26,-0.51,4900,5230,1400-10-18,2022-01-08
250,تاصيكو,سرمايه گذاري صدرتامين,518,4115330,34939993900,8700,8510,8470,-230,-2.64,8630,-70,-0.8,8390,8690,1400-10-18,2022-01-08
251,نهال,صندوق س. طلاي سرخ نوويرا,518,1132681,22882123853,20417,20700,20001,-416,-2.04,20202,-215,-1.05,20001,20700,1400-10-18,2022-01-08
252,وليز,ليزينگ‌ايران‌,517,8865614,15448626007,1802,1733,1712,-90,-4.99,1743,-59,-3.27,1712,1829,1400-10-18,2022-01-08
253,اطلس,صندوق س.توسعه اندوخته آينده-س,510,80120,19289393357,240914,240006,239997,-917,-0.38,240756,-158,-0.07,239511,243100,1400-10-18,2022-01-08
254,غمهرا,توليدي‌مهرام‌,510,2189248,21008391330,9160,9130,9610,450,4.91,9600,440,4.8,9120,9610,1400-10-18,2022-01-08
255,خاذين,سايپاآذين‌,507,11344600,29636913136,2500,2547,2590,90,3.6,2612,112,4.48,2480,2625,1400-10-18,2022-01-08
256,ومهان,گروه توسعه مالي مهر آيندگان,507,7373309,33248930166,4499,4408,4528,29,0.64,4505,6,0.13,4408,4549,1400-10-18,2022-01-08
257,ددام,داروسازي زاگرس فارمد پارس,504,3393428,29970565050,9280,9020,8820,-460,-4.96,8830,-450,-4.85,8820,9100,1400-10-18,2022-01-08
258,پخش,پخش البرز,502,1204953,30020042400,23927,22900,25050,1123,4.69,24900,973,4.07,22900,25100,1400-10-18,2022-01-08
259,فاسمين,كالسيمين‌,500,2380846,40836728440,17300,17520,17000,-300,-1.73,17150,-150,-0.87,16930,17520,1400-10-18,2022-01-08
260,آ س پ,آ.س.پ,498,4241152,24977864570,5740,5580,5830,90,1.57,5890,150,2.61,5460,6020,1400-10-18,2022-01-08
261,وپسا,س. پتروشيمي ساختمان  خليج فارس,494,20153896,30168455270,1470,1458,1495,25,1.7,1497,27,1.84,1442,1514,1400-10-18,2022-01-08
262,ودي,بيمه  دي,493,4210221,17028966367,4061,4000,3858,-203,-5,4045,-16,-0.39,3858,4180,1400-10-18,2022-01-08
263,ميهن,بيمه ميهن,485,7946392,18287904237,2209,2146,2319,110,4.98,2301,92,4.16,2146,2319,1400-10-18,2022-01-08
264,غپينو,پارس‌ مينو,485,5550381,11733895035,2120,2120,2096,-24,-1.13,2115,-5,-0.24,2060,2161,1400-10-18,2022-01-08
265,شنفت,نفت‌ پارس‌,475,2220049,21651456810,10120,9750,9750,-370,-3.66,10000,-120,-1.19,9620,10120,1400-10-18,2022-01-08
266,شجم,صنايع پتروشيمي تخت جمشيد,472,1152584,14057225560,11994,11520,12090,96,0.8,12080,86,0.72,11520,12550,1400-10-18,2022-01-08
267,دانا,بيمه دانا,472,6057103,28565839591,4551,4552,4670,119,2.61,4716,165,3.63,4551,4778,1400-10-18,2022-01-08
268,زنگان,صنعت روي زنگان,470,456535,26852117500,56184,58450,58950,2766,4.92,58800,2616,4.66,57100,58950,1400-10-18,2022-01-08
269,غبهنوش,بهنوش‌ ايران‌,467,333540,19214681110,59470,57100,56500,-2970,-4.99,57610,-1860,-3.13,56500,59400,1400-10-18,2022-01-08
270,وملل,اعتباري ملل,467,5731960,54642951390,9114,8910,9560,446,4.89,9530,416,4.56,8910,9560,1400-10-18,2022-01-08
271,ولملت,واسپاري ملت,466,4114816,12493160265,3146,3006,2989,-157,-4.99,3051,-95,-3.02,2989,3194,1400-10-18,2022-01-08
272,رمپنا,گروه مپنا (سهامي عام),466,6058861,98990917730,16350,16160,16210,-140,-0.86,16340,-10,-0.06,16150,16600,1400-10-18,2022-01-08
273,كسرا,سراميك‌هاي‌صنعتي‌اردكان‌,465,2573408,36623794740,14040,14380,14000,-40,-0.28,14230,190,1.35,13800,14590,1400-10-18,2022-01-08
274,خفنر,فنرسازي‌خاور,465,2027562,14192103580,6840,6750,6990,150,2.19,6990,150,2.19,6750,7150,1400-10-18,2022-01-08
275,كترام,توليدي‌ كاشي‌ تكسرام‌,463,1571547,31942192410,20880,20010,20100,-780,-3.74,20330,-550,-2.63,19840,21030,1400-10-18,2022-01-08
276,فنوال,نورد آلومينيوم‌,458,1721104,40420857310,23380,24000,23500,120,0.51,23490,110,0.47,22360,24400,1400-10-18,2022-01-08
277,شگل,گلتاش‌,454,2541496,14971489420,5960,5920,5840,-120,-2.01,5890,-70,-1.17,5760,6120,1400-10-18,2022-01-08
278,پتاير,ايران‌ تاير,452,7921200,14872036050,1890,1860,1856,-34,-1.8,1878,-12,-0.63,1850,1933,1400-10-18,2022-01-08
279,ياقوت,صندوق س ياقوت آگاه-ثابت,449,3029015,42223427385,13918,13938,13940,22,0.16,13940,22,0.16,13938,13945,1400-10-18,2022-01-08
280,غشهداب,كشت و صنعت شهداب ناب خراسان,447,9772111,25113205229,2598,2520,2590,-8,-0.31,2570,-28,-1.08,2520,2648,1400-10-18,2022-01-08
281,غالبر,لبنيات‌ كالبر,443,1885296,21086252620,11440,11720,10880,-560,-4.9,11180,-260,-2.27,10870,11720,1400-10-18,2022-01-08
282,شلعاب,لعابيران‌,439,2046112,11416515510,5660,5660,5540,-120,-2.12,5600,-60,-1.06,5450,5770,1400-10-18,2022-01-08
283,حريل,ريل پردازسير,437,5469610,13157390791,2412,2401,2375,-37,-1.53,2406,-6,-0.25,2332,2480,1400-10-18,2022-01-08
284,ثاباد,توريستي ورفاهي آبادگران ايران,431,708420,28053831850,39710,37900,38680,-1030,-2.59,39600,-110,-0.28,37900,40900,1400-10-18,2022-01-08
285,زبينا,كشاورزي و دامپروري بينالود,428,5803376,13128491951,2282,2369,2225,-57,-2.5,2265,-17,-0.74,2200,2369,1400-10-18,2022-01-08
286,تسه0005,امتيازتسهيلات مسكن مرداد 1400,428,6070,6434625214,1011667,1025552,1062250,50583,5,1060070,48403,4.78,1000000,1062250,1400-10-18,2022-01-08
287,شفارس,صنايع‌ شيميايي‌ فارس‌,426,7512873,7545074044,1002,984,996,-6,-0.6,1003,1,0.1,984,1025,1400-10-18,2022-01-08
288,ضخود2020,اختيارخ خودرو-3000-1401/02/07,426,23982,2115918000,76,80,87,11,14.47,88,12,15.79,80,91,1400-10-18,2022-01-08
289,فباهنر,مس‌ شهيدباهنر,425,418293,11333064570,27480,27090,27000,-480,-1.75,27330,-150,-0.55,26720,27860,1400-10-18,2022-01-08
290,سكارون,سيمان كارون,423,448584,16001883150,36352,35300,35300,-1052,-2.89,35650,-702,-1.93,35300,36800,1400-10-18,2022-01-08
291,پرديسح,ح .  سرمايه گذاري پرديس,421,7125765,8831444117,1246,1225,1240,-6,-0.48,1239,-7,-0.56,1225,1258,1400-10-18,2022-01-08
292,وفتخار,سرمايه گذاري افتخار سهام,421,2345914,4144399623,1722,1723,1773,51,2.96,1752,30,1.74,1723,1773,1400-10-18,2022-01-08
293,وسنا,سرمايه گذاري نيروگاهي ايران,419,1885610,17324829810,9340,9620,9060,-280,-3,9190,-150,-1.61,9060,9620,1400-10-18,2022-01-08
294,وپترو,سرمايه‌گذاري صنايع پتروشيمي‌,418,1543336,16564251020,11150,11000,10900,-250,-2.24,10730,-420,-3.77,10600,11170,1400-10-18,2022-01-08
295,حتوكا,حمل‌ونقل‌توكا,415,1374526,16528905150,11870,11800,12100,230,1.94,12030,160,1.35,11800,12300,1400-10-18,2022-01-08
296,ثرود,سرمايه‌گذاري مسكن زاينده رود,413,3648776,19720811230,5640,5450,5360,-280,-4.96,5400,-240,-4.26,5360,5640,1400-10-18,2022-01-08
297,چدن,توليدي چدن سازان,413,5419312,12457691258,2324,2275,2275,-49,-2.11,2303,-21,-0.9,2251,2350,1400-10-18,2022-01-08
298,بهپاك,صنعتي بهپاك,410,5090362,34684096080,6865,6870,6750,-115,-1.68,6810,-55,-0.8,6610,7080,1400-10-18,2022-01-08
299,ارزش,صندوق س ارزش آفرين بيدار-سهام,410,1888411,17468498750,9210,9210,9130,-80,-0.87,9250,40,0.43,9130,9390,1400-10-18,2022-01-08
300,سشرق,سيمان‌ شرق‌,409,2176939,15768939440,7330,7380,7110,-220,-3,7240,-90,-1.23,7100,7450,1400-10-18,2022-01-08
301,فرآور,فرآوري‌موادمعدني‌ايران‌,409,514219,13669845940,26910,27100,26390,-520,-1.93,26610,-300,-1.11,25850,27600,1400-10-18,2022-01-08
302,دسانكو,داروسازي سبحان انكولوژي,408,1152521,14213259060,12308,12150,12130,-178,-1.45,12330,22,0.18,12110,12600,1400-10-18,2022-01-08
303,وهور,مديريت انرژي اميد  تابان هور,407,9210089,11208022956,1242,1200,1205,-37,-2.98,1233,-9,-0.72,1200,1237,1400-10-18,2022-01-08
304,توريل,توكاريل,407,1936829,15046754900,7988,7650,7610,-378,-4.73,7770,-218,-2.73,7590,8140,1400-10-18,2022-01-08
305,زكشت,كشاورزي مكانيزه اصفهان كشت,405,1063390,19060742700,18822,17890,17890,-932,-4.95,17920,-902,-4.79,17890,18490,1400-10-18,2022-01-08
306,داسوه,داروسازي‌ اسوه‌,402,4143398,111853508220,27830,27820,26440,-1390,-4.99,27000,-830,-2.98,26440,27830,1400-10-18,2022-01-08
307,شخارك,پتروشيمي‌ خارك‌,402,718673,35823363110,50270,50180,49990,-280,-0.56,50120,-150,-0.3,49000,50180,1400-10-18,2022-01-08
308,كامياب,صندوق س. كامياب آشنا-د,401,5805865,65139947354,11200,11220,11219,19,0.17,11220,20,0.18,11219,11220,1400-10-18,2022-01-08
309,كگل,معدني و صنعتي گل گهر,396,1966410,44159065970,22490,22500,22220,-270,-1.2,22480,-10,-0.04,22220,22640,1400-10-18,2022-01-08
310,صنوين,صندوق سرمايه‌گذاري صنوين-مختلط,396,72546,8344585830,116340,117980,113680,-2660,-2.29,115020,-1320,-1.13,113330,117980,1400-10-18,2022-01-08
311,خريخت,صنايع‌ريخته‌گري‌ايران‌,393,8610295,22820868277,2530,2529,2656,126,4.98,2650,120,4.74,2470,2656,1400-10-18,2022-01-08
312,آريان,سرمايه گذاري پارس آريان,393,3583450,47128128280,13484,13730,13200,-284,-2.11,13320,-164,-1.22,13080,13730,1400-10-18,2022-01-08
313,فايرا,آلومينيوم‌ايران‌,391,1140307,19260188890,16780,16660,17020,240,1.43,16810,30,0.18,16380,17030,1400-10-18,2022-01-08
314,نطرين,عطرين نخ قم,383,1193993,8227219580,6999,6970,6870,-129,-1.84,6940,-59,-0.84,6780,7180,1400-10-18,2022-01-08
315,چفيبر,فيبر ايران‌,380,2095866,14856949160,6930,7200,7000,70,1.01,7080,150,2.16,7000,7230,1400-10-18,2022-01-08
316,تابا,تابان نيرو سپاهان,378,712747,15640161100,22264,22750,21600,-664,-2.98,21950,-314,-1.41,21600,22750,1400-10-18,2022-01-08
317,دبالك,مواد اوليه دارويي البرز بالك,378,1724275,13981356600,7986,8160,8170,184,2.3,8100,114,1.43,7810,8280,1400-10-18,2022-01-08
318,كارين,صندوق س نگين سامان-ثابت,378,14397271,145439897902,10086,10103,10103,17,0.17,10102,16,0.16,10101,10103,1400-10-18,2022-01-08
319,زشريف,كشت وصنعت شريف آباد,375,4067709,13930789790,3304,3349,3382,78,2.36,3412,108,3.27,3305,3469,1400-10-18,2022-01-08
320,تسه0003,امتيازتسهيلات مسكن خرداد1400,375,4889,5273552105,1030393,1047442,1081912,51519,5,1078657,48264,4.68,1010000,1081912,1400-10-18,2022-01-08
321,بكهنوج,توليد برق ماهتاب كهنوج,374,12571359,13798847241,1118,1129,1080,-38,-3.4,1099,-19,-1.7,1075,1130,1400-10-18,2022-01-08
322,بكام,كارخانجات توليدي شهيد قندي,371,6517098,9954978866,1534,1555,1510,-24,-1.56,1530,-4,-0.26,1508,1570,1400-10-18,2022-01-08
323,ساينا,صنايع بهداشتي ساينا,369,198008,16124467300,80294,76600,84300,4006,4.99,81450,1156,1.44,76300,84300,1400-10-18,2022-01-08
324,سرچشمه,سرمايه گذاري مس سرچشمه,366,3806450,19616437640,5082,5180,5180,98,1.93,5150,68,1.34,5100,5320,1400-10-18,2022-01-08
325,ريشمك,توليد و صادرات ريشمك,363,1412956,43527891800,30208,30050,31200,992,3.28,30800,592,1.96,30050,31200,1400-10-18,2022-01-08
326,فسازانح,ح . غلتك سازان سپاهان,359,1779912,4831470012,2790,2630,2778,-12,-0.43,2714,-76,-2.72,2630,2800,1400-10-18,2022-01-08
327,ثپرديس,سرمايه گذاري مسكن پرديس,359,4974315,18499483628,3868,3675,3675,-193,-4.99,3719,-149,-3.85,3675,3854,1400-10-18,2022-01-08
328,فجام,جام‌دارو,356,3668562,14952801429,4226,4150,4021,-205,-4.85,4076,-150,-3.55,4015,4310,1400-10-18,2022-01-08
329,آكورد,صندوق س. آرمان آتي كوثر-د,351,7723634,279388052038,36120,36174,36174,54,0.15,36173,53,0.15,36173,36177,1400-10-18,2022-01-08
330,بنيرو,نيروترانس‌,350,8349042,15953888505,1876,1876,1878,2,0.11,1911,35,1.87,1802,1969,1400-10-18,2022-01-08
331,كفراح,ح . فراورده‌ هاي‌ نسوزايران‌,348,1725910,8607899056,4952,4512,5111,159,3.21,4987,35,0.71,4512,5185,1400-10-18,2022-01-08
332,گكيش,توريستي ورفاهي آبادگران كيش,348,736571,15673873250,21852,21500,21200,-652,-2.98,21300,-552,-2.53,21200,22050,1400-10-18,2022-01-08
333,كيميا,معدني كيمياي زنجان گستران,347,1026342,13427933030,12926,13190,12800,-126,-0.97,13070,144,1.11,12750,13490,1400-10-18,2022-01-08
334,غاذر,كشت‌وصنعت‌پياذر,347,629303,22056279850,35130,35000,35080,-50,-0.14,35050,-80,-0.23,34100,36100,1400-10-18,2022-01-08
335,تسه0004,امتيازتسهيلات مسكن تير1400,346,4671,4951836445,1009838,1041056,1060329,50491,5,1060123,50285,4.98,1035800,1060329,1400-10-18,2022-01-08
336,غبهار,كشت وصنعت بهاران گلبهار خراسان,345,872081,16542728430,18426,18970,18970,544,2.95,18970,544,2.95,18720,18970,1400-10-18,2022-01-08
337,انار,صندوق س.انارنماد ارزش-درسهام,344,715323,6665920030,9380,9460,9210,-170,-1.81,9320,-60,-0.64,9210,9480,1400-10-18,2022-01-08
338,رانفور,خدمات‌انفورماتيك‌,343,11911281,44173458340,3706,3689,3645,-61,-1.65,3708,2,0.05,3601,3780,1400-10-18,2022-01-08
339,خوساز,محورسازان‌ايران‌خودرو,340,1690978,12641957520,7370,7490,7350,-20,-0.27,7460,90,1.22,7310,7650,1400-10-18,2022-01-08
340,ارفع,شركت آهن و فولاد ارفع,340,813127,11496804850,14516,14580,14070,-446,-3.07,14450,-66,-0.45,14000,14580,1400-10-18,2022-01-08
341,ثالوند,سرمايه گذاري مسكن الوند,339,1777523,10681982750,6214,5990,5920,-294,-4.73,6060,-154,-2.48,5910,6190,1400-10-18,2022-01-08
342,حبندر,دريايي و کشتيراني خط دريابندر,337,1047028,14128829940,13853,13440,13460,-393,-2.84,13490,-363,-2.62,13440,13850,1400-10-18,2022-01-08
343,فروس,فروسيليس‌ ايران‌,334,2703721,16730463520,6170,6270,6200,30,0.49,6190,20,0.32,6080,6270,1400-10-18,2022-01-08
344,وسكاب,س.ص.بازنشستگي كاركنان بانكها,328,2652233,7783962542,2963,2979,2931,-32,-1.08,2948,-15,-0.51,2920,2980,1400-10-18,2022-01-08
345,قصفها,قنداصفهان‌,328,128304,9637786020,76130,73600,74310,-1820,-2.39,75470,-660,-0.87,73600,77000,1400-10-18,2022-01-08
346,زماهان,مجتمع توليد گوشت مرغ ماهان,327,1828687,12318075450,6874,7000,6730,-144,-2.09,6760,-114,-1.66,6600,7040,1400-10-18,2022-01-08
347,خشرق,الكتريك‌ خودرو شرق‌,327,1245445,14054061910,10930,10790,11010,80,0.73,11250,320,2.93,10610,11470,1400-10-18,2022-01-08
348,سنيرح,ح . سيمان‌ سفيدني‌ريز,325,383267,7138342330,18810,18500,18420,-390,-2.07,18620,-190,-1.01,18160,19200,1400-10-18,2022-01-08
349,كفرا,فراورده‌ هاي‌ نسوزايران‌,325,2887916,22609971240,7560,7400,7930,370,4.89,7830,270,3.57,7360,7930,1400-10-18,2022-01-08
350,تسه9908,امتياز تسهيلات مسكن آبان99,323,5976,6290508754,1003515,1020406,1053690,50175,5,1052629,49114,4.89,1020399,1053690,1400-10-18,2022-01-08
351,ستران,سيمان‌ تهران‌,322,765718,15131883900,19550,19060,19620,70,0.36,19760,210,1.07,19060,20180,1400-10-18,2022-01-08
352,وساشرقي,شركت س استان آذربايجان شرقي,318,32669704,14437815823,448,436,439,-9,-2.01,446,-2,-0.45,430,447,1400-10-18,2022-01-08
353,پرداخت,به پرداخت ملت,317,1107593,14999930590,13390,13650,13620,230,1.72,13530,140,1.05,13390,13880,1400-10-18,2022-01-08
354,ختراك,ريخته‌گري‌ تراكتورسازي‌ ايران‌,316,3036620,15291617630,4910,4862,5000,90,1.83,5035,125,2.55,4862,5135,1400-10-18,2022-01-08
355,مبين,مبين انرژي خليج فارس,315,1268378,31388291500,25130,25100,24220,-910,-3.62,25030,-100,-0.4,24210,25100,1400-10-18,2022-01-08
356,وگستر,گسترش سرمايه گذاري ايرانيان,315,2160228,10888344440,5181,5140,5040,-141,-2.72,5080,-101,-1.95,4930,5260,1400-10-18,2022-01-08
357,سخزر,سيمان‌ خزر,312,624474,10364295170,16650,16500,16500,-150,-0.9,16610,-40,-0.24,16110,16990,1400-10-18,2022-01-08
358,زفكا,كشت و دامداري فكا,309,3561659,27233309710,7849,7820,7490,-359,-4.57,7650,-199,-2.54,7490,7970,1400-10-18,2022-01-08
359,سنوين,سرمايه گذاري اقتصاد نوين,305,2505345,13867271980,5667,5500,5500,-167,-2.95,5540,-127,-2.24,5500,5820,1400-10-18,2022-01-08
360,تسه0002,امتيازتسهيلاتمسكن ارديبهشت1400,304,4061,4307504717,1011102,1028549,1061657,50555,5,1060700,49598,4.91,1028549,1061657,1400-10-18,2022-01-08
361,وايران,ليزينگ ايرانيان,304,4052949,11044107461,2747,2646,2700,-47,-1.71,2731,-16,-0.58,2646,2786,1400-10-18,2022-01-08
362,وصندوق,سرمايه‌گذاري‌صندوق‌بازنشستگي‌,301,2309346,27908288720,12450,12080,12150,-300,-2.41,12360,-90,-0.72,11970,12400,1400-10-18,2022-01-08
363,قلرست,قند لرستان‌,298,835447,12851866860,15430,15590,15110,-320,-2.07,15390,-40,-0.26,14910,16000,1400-10-18,2022-01-08
364,عيار,صندوق سكه طلاي مفيد,296,1073910,33312902006,31466,31399,30964,-502,-1.6,31020,-446,-1.42,30750,31590,1400-10-18,2022-01-08
365,كسرام,پارس‌ سرام‌,296,3090088,12983159643,4336,4160,4229,-107,-2.47,4216,-120,-2.77,4120,4407,1400-10-18,2022-01-08
366,بموتو,موتوژن‌,295,236731,17865028680,77100,75850,75000,-2100,-2.72,75680,-1420,-1.84,74700,77430,1400-10-18,2022-01-08
367,ميدكو,توسعه معادن وص.معدني خاورميانه,295,3909879,180549496640,46170,46170,46180,10,0.02,46180,10,0.02,46170,46200,1400-10-18,2022-01-08
368,پاكشو,گروه صنعتي پاكشو,294,6711041,40452288100,6100,5900,6090,-10,-0.16,6070,-30,-0.49,5900,6090,1400-10-18,2022-01-08
369,شكام,صنايع شيميايي كيمياگران امروز,294,1622142,46868302550,29424,29950,28450,-974,-3.31,28900,-524,-1.78,28350,29950,1400-10-18,2022-01-08
370,دتوليد,داروسازي توليد دارو,291,1098686,8567636220,7817,7860,7660,-157,-2.01,7810,-7,-0.09,7590,7950,1400-10-18,2022-01-08
371,كسعدي,كاشي‌ سعدي‌,290,2160877,15934928720,7440,7470,7310,-130,-1.75,7370,-70,-0.94,7230,7490,1400-10-18,2022-01-08
372,وسگيلا,شركت س استان گيلان,290,17044626,7496882597,448,434,447,-1,-0.22,446,-2,-0.45,434,449,1400-10-18,2022-01-08
373,ونيكي,سرمايه‌گذاري‌ ملي‌ايران‌,288,1630249,14964545730,9370,9150,9170,-200,-2.13,9330,-40,-0.43,9100,9360,1400-10-18,2022-01-08
374,شيراز,پتروشيمي‌شيراز,288,222688,16655939340,75960,75960,73320,-2640,-3.48,75760,-200,-0.26,73200,76000,1400-10-18,2022-01-08
375,خپويش,سازه‌ پويش‌,287,107069,6967771460,65600,63580,63840,-1760,-2.68,65360,-240,-0.37,63570,67650,1400-10-18,2022-01-08
376,وبيمه,سرمايه‌ گذاري‌ صنعت‌ بيمه‌,286,5356385,8452274304,1568,1565,1574,6,0.38,1574,6,0.38,1543,1610,1400-10-18,2022-01-08
377,اتكاي,بيمه اتكايي ايرانيان,285,2387072,23804017960,10074,10120,9990,-84,-0.83,9970,-104,-1.03,9830,10200,1400-10-18,2022-01-08
378,دتوزيع,توزيع دارو پخش,285,450927,11621047700,26145,25750,26300,155,0.59,25850,-295,-1.13,25400,26650,1400-10-18,2022-01-08
379,ضسپا1114,اختيارخ خساپا-2000-1400/11/20,282,13924,604168000,37,40,40,3,8.11,43,6,16.22,40,49,1400-10-18,2022-01-08
380,جم پيلن,پلي پروپيلن جم - جم پيلن,281,208807,25483418240,122890,122910,120500,-2390,-1.94,122670,-220,-0.18,120050,123600,1400-10-18,2022-01-08
381,ثمسكن,سرمايه‌گذاري‌ مسكن‌,280,4994835,17173705450,3534,3470,3371,-163,-4.61,3438,-96,-2.72,3370,3551,1400-10-18,2022-01-08
382,وتوكا,سرمايه‌گذاري‌توكافولاد(هلدينگ,280,1016231,7278936310,7240,7040,7090,-150,-2.07,7200,-40,-0.55,7040,7300,1400-10-18,2022-01-08
383,مدير,ص.س.مديريت ثروت ص.بازنشستگي-س,280,831319,7693777204,9216,9166,9171,-45,-0.49,9255,39,0.42,9160,9344,1400-10-18,2022-01-08
384,شبهرن,نفت‌ بهران‌,279,1413774,15730047740,11140,11160,11000,-140,-1.26,11140,0,0,10920,11200,1400-10-18,2022-01-08
385,ماني,صندوق س. با درآمد ثابت ماني,278,10294262,111068450628,10773,10789,10790,17,0.16,10789,16,0.15,10789,10790,1400-10-18,2022-01-08
386,زر,صندوق س.پشتوانه سكه طلاي زر,277,145023,7616351279,53691,53939,52016,-1675,-3.12,52518,-1173,-2.18,52016,53939,1400-10-18,2022-01-08
387,دزهراوي,داروسازي‌زهراوي‌,277,2013448,8351578612,4210,4120,4120,-90,-2.14,4175,-35,-0.83,4051,4240,1400-10-18,2022-01-08
388,سايرا,ايرانيت‌,276,545182,14022133000,25643,25150,25150,-493,-1.92,25700,57,0.22,25150,26150,1400-10-18,2022-01-08
389,كروي,توسعه‌ معادن‌ روي‌ ايران‌,274,516266,11773117400,23110,23200,22500,-610,-2.64,22950,-160,-0.69,22390,23390,1400-10-18,2022-01-08
390,واتي,سرمايه‌ گذاري‌ آتيه‌ دماوند,274,3357406,31366204270,9800,9600,9450,-350,-3.57,9340,-460,-4.69,9310,9800,1400-10-18,2022-01-08
391,فاهواز,نورد و لوله اهواز,273,3010115,15938543060,5323,5370,5250,-73,-1.37,5290,-33,-0.62,5220,5400,1400-10-18,2022-01-08
392,تسه9912,امتياز تسهيلات مسكن اسفند99,272,3501,3733315149,1017662,1045001,1068545,50883,5,1066357,48695,4.78,1035688,1068545,1400-10-18,2022-01-08
393,غمينو,شركت صنايع غذايي مينو شرق,271,1509639,5850076549,3938,3761,3793,-145,-3.68,3913,-25,-0.63,3761,4020,1400-10-18,2022-01-08
394,سيستم,همكاران سيستم,271,2745590,14243947430,5040,4860,5190,150,2.98,5140,100,1.98,4860,5290,1400-10-18,2022-01-08
395,تبرك,گروه كارخانجات صنعتي تبرك,269,1433808,11561104580,8070,8190,7970,-100,-1.24,8060,-10,-0.12,7930,8190,1400-10-18,2022-01-08
396,گوهران,سرمايه گذاري توسعه گوهران اميد,269,3018906,15799540920,5484,5300,5210,-274,-5,5230,-254,-4.63,5210,5330,1400-10-18,2022-01-08
397,شپاس,نفت پاسارگاد,269,520544,7952731490,15326,14850,15320,-6,-0.04,15300,-26,-0.17,14850,15740,1400-10-18,2022-01-08
398,تيپيكو,سرمايه گذاري دارويي تامين,268,1056179,19311797700,18500,18150,18110,-390,-2.11,18450,-50,-0.27,17980,18690,1400-10-18,2022-01-08
399,خچرخش,چرخشگر,266,1502846,10600498680,7060,6760,7050,-10,-0.14,7060,0,0,6760,7260,1400-10-18,2022-01-08
400,فسازان,غلتك سازان سپاهان,266,992078,4254989053,4432,4530,4299,-133,-3,4390,-42,-0.95,4244,4530,1400-10-18,2022-01-08
401,هجرت,پخش هجرت,264,1466341,37749235200,26954,25900,26100,-854,-3.17,25750,-1204,-4.47,25650,26500,1400-10-18,2022-01-08
402,گوهر,صندوق سكه طلاي كيان,263,468381,28552438910,61907,61901,60479,-1428,-2.31,60960,-947,-1.53,60300,61904,1400-10-18,2022-01-08
403,كنور,توسعه معدني و صنعتي صبانور,263,422991,7873256920,18920,18770,18450,-470,-2.48,18890,-30,-0.16,18430,18960,1400-10-18,2022-01-08
404,خراسان,پتروشيمي خراسان,263,144148,17362527440,121470,118750,119990,-1480,-1.22,121260,-210,-0.17,118750,122440,1400-10-18,2022-01-08
405,كاذر,فرآورده‌هاي‌نسوزآذر,262,776802,10019385010,12910,12950,12800,-110,-0.85,12900,-10,-0.08,12730,13250,1400-10-18,2022-01-08
406,لازما,كارخانه هاي صنعتي آزمايش,261,861098,21478887400,24953,25500,24250,-703,-2.82,24950,-3,-0.01,24250,25500,1400-10-18,2022-01-08
407,وثنو,سرمايه گذاري ساختماني نوين,260,2485434,9767858688,4043,3945,3922,-121,-2.99,3930,-113,-2.79,3922,4090,1400-10-18,2022-01-08
408,فوكا,فولاد كاويان,260,1133701,15658955220,14008,13700,13840,-168,-1.2,13920,-88,-0.63,13630,14100,1400-10-18,2022-01-08
409,وآوا,سرمايه گذاري آوا نوين,260,1391321,3542402419,2581,2500,2551,-30,-1.16,2573,-8,-0.31,2500,2630,1400-10-18,2022-01-08
410,كلوند,كاشي‌ الوند,258,649496,14332490880,22380,21920,22150,-230,-1.03,22080,-300,-1.34,21670,22710,1400-10-18,2022-01-08
411,وشهر,بانك شهر,258,1716242,7034597364,4081,4081,4083,2,0.05,4086,5,0.12,4069,4200,1400-10-18,2022-01-08
412,غگرجي,بيسكويت‌  گرجي‌,256,4149636,7704720981,1879,1837,1833,-46,-2.45,1867,-12,-0.64,1821,1890,1400-10-18,2022-01-08
413,ولصنم,ليزينگ‌صنعت‌ومعدن‌,255,2047999,7214635458,3552,3546,3480,-72,-2.03,3538,-14,-0.39,3447,3618,1400-10-18,2022-01-08
414,كپشير,پشم‌شيشه‌ايران‌,254,812142,8916314430,11300,11100,10800,-500,-4.42,11100,-200,-1.77,10760,11300,1400-10-18,2022-01-08
415,افرا,افرانت,254,515453,11131018550,23923,21550,21550,-2373,-9.92,22000,-1923,-8.04,21550,22500,1400-10-18,2022-01-08
416,تسه9911,امتياز تسهيلات مسكن بهمن99,254,3696,3917147809,1012553,1024353,1063180,50627,5,1059834,47281,4.67,1000000,1063180,1400-10-18,2022-01-08
417,فمراد,آلومراد,254,595182,7408965910,12790,12510,12410,-380,-2.97,12620,-170,-1.33,12250,12790,1400-10-18,2022-01-08
418,شفارا,پتروشيمي فارابي,254,2498930,14685332310,6041,5950,5860,-181,-3,5880,-161,-2.67,5860,6140,1400-10-18,2022-01-08
419,اهرم,صندوق س سهامي كاريزما- اهرمي,253,2004627,20049388320,9981,9930,10000,19,0.19,10000,19,0.19,9930,10030,1400-10-18,2022-01-08
420,پكوير,كوير تاير,253,751732,4010717600,5500,5570,5320,-180,-3.27,5450,-50,-0.91,5260,5570,1400-10-18,2022-01-08
421,كاردان,صندوق س تجارت شاخصي كاردان,253,60351,11039225630,182010,181080,180300,-1710,-0.94,182920,910,0.5,180210,185480,1400-10-18,2022-01-08
422,اعتلا,شركت سرمايه گذاري اعتلاء البرز,252,3082815,10963954213,3507,3470,3547,40,1.14,3543,36,1.03,3400,3640,1400-10-18,2022-01-08
423,بزاگرس,نيروگاه زاگرس كوثر,252,1897531,6053262009,3234,3295,3154,-80,-2.47,3216,-18,-0.56,3120,3295,1400-10-18,2022-01-08
424,كگاز,شيشه‌ و گاز,251,348405,5161966450,15260,14860,14650,-610,-4,15100,-160,-1.05,14510,15480,1400-10-18,2022-01-08
425,زعف0110پ20,زعفران0110نگين وحدت جام(پ),249,105259,42262715304,401334,408700,401400,66,0.02,401512,178,0.04,394000,408700,1400-10-18,2022-01-08
426,ضخود2017,اختيارخ خودرو-1800-1401/02/07,249,10580,4955405000,399,455,471,72,18.05,468,69,17.29,431,500,1400-10-18,2022-01-08
427,فاما,صنعتي‌ آما,249,492770,8941961200,18730,18000,18030,-700,-3.74,18370,-360,-1.92,17800,18840,1400-10-18,2022-01-08
428,كهمدا,شيشه‌ همدان‌,248,1643811,15779056140,9600,9560,9450,-150,-1.56,9600,0,0,9420,9840,1400-10-18,2022-01-08
429,پلاستح,ح.كارخانجات توليدي پلاستيران,245,1819046,5994131529,3262,3260,3215,-47,-1.44,3295,33,1.01,3215,3350,1400-10-18,2022-01-08
430,شپاكسا,پاكسان‌,245,452896,9117069250,20280,19940,20100,-180,-0.89,20190,-90,-0.44,19940,20790,1400-10-18,2022-01-08
431,قاسم,قاسم ايران,243,3362957,11486634214,3476,3375,3433,-43,-1.24,3429,-47,-1.35,3365,3490,1400-10-18,2022-01-08
432,دامين,داروسازي‌ امين‌,243,2757357,6509716752,2450,2475,2340,-110,-4.49,2410,-40,-1.63,2334,2475,1400-10-18,2022-01-08
433,جم,پتروشيمي جم,242,544136,27427908820,50580,50620,50490,-90,-0.18,50530,-50,-0.1,49990,50960,1400-10-18,2022-01-08
434,آوا,صندوق س.سهام آواي معيار-س,239,664091,5074972357,7546,7531,7581,35,0.46,7642,96,1.27,7510,7765,1400-10-18,2022-01-08
435,ثباغ,شهر سازي و خانه سازي باغميشه,239,670334,5085074830,7482,7310,7660,178,2.38,7520,38,0.51,7310,7760,1400-10-18,2022-01-08
436,فبيرا,بسته‌ بندي‌ ايران‌,238,4154671,7126143631,1733,1742,1710,-23,-1.33,1720,-13,-0.75,1682,1780,1400-10-18,2022-01-08
437,زشگزا,شير و گوشت زاگرس شهركرد,238,2401742,11496970472,4993,4862,4744,-249,-4.99,4828,-165,-3.3,4744,4991,1400-10-18,2022-01-08
438,دجابر,داروسازي‌ جابرابن‌حيان‌,236,543678,5596344630,10680,10340,10180,-500,-4.68,10530,-150,-1.4,10160,10800,1400-10-18,2022-01-08
439,اميد,تامين سرمايه اميد,234,2950103,26106685570,8830,8860,8850,20,0.23,8850,20,0.23,8830,8870,1400-10-18,2022-01-08
440,پرديس,سرمايه گذاري پرديس,233,1960021,6532747150,3391,3315,3295,-96,-2.83,3365,-26,-0.77,3291,3400,1400-10-18,2022-01-08
441,خاهن,آهنگري‌ تراكتورسازي‌ ايران‌,233,1149293,4962889712,4390,4347,4289,-101,-2.3,4376,-14,-0.32,4235,4447,1400-10-18,2022-01-08
442,آساميد,صندوق س.مشترك آسمان اميد -د,233,4710730,65077921394,13795,13815,13817,22,0.16,13815,20,0.14,13814,13817,1400-10-18,2022-01-08
443,سپاها,سيمان‌سپاهان‌,233,1431695,10503836370,7260,7190,7270,10,0.14,7310,50,0.69,7190,7490,1400-10-18,2022-01-08
444,سصوفي,سيمان‌ صوفيان‌,231,504136,7320165550,14260,14000,14150,-110,-0.77,14380,120,0.84,14000,14840,1400-10-18,2022-01-08
445,مارون,پتروشيمي مارون,231,38761,6640570250,173330,170150,170250,-3080,-1.78,173200,-130,-0.08,168550,177450,1400-10-18,2022-01-08
446,غفارس,شير پاستوريزه پگاه فارس,229,1347441,6896372690,5108,5030,5080,-28,-0.55,5110,2,0.04,5000,5200,1400-10-18,2022-01-08
447,وسپه,سرمايه‌گذاري‌ سپه‌,229,794332,6566942360,8270,8500,8280,10,0.12,8270,0,0,8120,8530,1400-10-18,2022-01-08
448,رنيك,جنرال مكانيك,228,615241,6785056290,11198,10800,10760,-438,-3.91,11120,-78,-0.7,10760,11420,1400-10-18,2022-01-08
449,سكرما,سيمان‌ كرمان‌,227,767114,11436863840,14940,14600,14980,40,0.27,14920,-20,-0.13,14430,15190,1400-10-18,2022-01-08
450,سغدير,توسعه سرمايه و صنعت غدير,223,530173,7704012720,14719,14720,14400,-319,-2.17,14640,-79,-0.54,14360,14850,1400-10-18,2022-01-08
451,پارتا,مجتمع‌صنعتي‌آرتاويل‌تاير,223,627323,11856431680,19465,18890,18890,-575,-2.95,19060,-405,-2.08,18890,19450,1400-10-18,2022-01-08
452,تسه0001,امتيازتسهيلات مسكن فروردين1400,222,2201,2338307946,1011930,1039645,1062526,50596,5,1062384,50454,4.99,1039645,1062526,1400-10-18,2022-01-08
453,وصندوقح,ح.سرمايه گذاري صندوق بازنشستگي,219,1697229,17784106060,10560,10360,10410,-150,-1.42,10480,-80,-0.76,10360,10630,1400-10-18,2022-01-08
454,وجامي,سرمايه گذاري جامي,217,1832524,7104148631,3986,3892,3867,-119,-2.99,3901,-85,-2.13,3867,3958,1400-10-18,2022-01-08
455,ولشرق,ليزينگ ايران و شرق,216,1976302,4411198299,2307,2201,2240,-67,-2.9,2284,-23,-1,2201,2290,1400-10-18,2022-01-08
456,ولملتح,ح . واسپاري ملت,215,2697435,3408308776,1330,1261,1235,-95,-7.14,1264,-66,-4.96,1221,1338,1400-10-18,2022-01-08
457,گپارس,امور رفاهي كارگزاران پارس,215,71620,7556385950,106320,103150,103150,-3170,-2.98,105500,-820,-0.77,103150,109400,1400-10-18,2022-01-08
458,اپرداز,آتيه داده پرداز,213,390830,8240138400,20464,21300,20800,336,1.64,20800,336,1.64,19900,21400,1400-10-18,2022-01-08
459,تسه9910,امتياز تسهيلات مسكن دي99,213,2169,2298296785,1013015,1034815,1063665,50650,5,1059611,46596,4.6,1000000,1063665,1400-10-18,2022-01-08
460,كي بي سي,شركت كي بي سي,210,421105,7397180660,16908,17580,17600,692,4.09,17220,312,1.85,16720,17750,1400-10-18,2022-01-08
461,اخزا002,اسنادخزانه-م2بودجه00-031024,210,325773,167207132280,510200,512000,513000,2800,0.55,513260,3060,0.6,511310,515000,1400-10-18,2022-01-08
462,تصميم,صندوق س با درآمد ثابت تصميم,209,2165260,40005098381,18461,18474,18479,18,0.1,18476,15,0.08,18474,18479,1400-10-18,2022-01-08
463,غديس,پاكديس,209,765078,8344668800,11095,10730,10760,-335,-3.02,10990,-105,-0.95,10710,11470,1400-10-18,2022-01-08
464,دلر,داروسازي‌ اكسير,208,274485,11191375850,41070,41500,40900,-170,-0.41,40890,-180,-0.44,40120,41500,1400-10-18,2022-01-08
465,وبوعلي,سرمايه‌گذاري‌بوعلي‌,208,1830492,6697363879,3640,3600,3648,8,0.22,3648,8,0.22,3591,3708,1400-10-18,2022-01-08
466,بشهاب,لامپ‌  پارس‌ شهاب‌,208,76812,10362462220,134330,134330,136000,1670,1.24,134730,400,0.3,130520,136000,1400-10-18,2022-01-08
467,تنوين,تامين سرمايه نوين,207,7193851,44844373540,6190,6220,6190,0,0,6230,40,0.65,6140,6290,1400-10-18,2022-01-08
468,سبهان,سيمان‌ بهبهان‌,205,81828,3514676680,43300,43000,42830,-470,-1.09,43220,-80,-0.18,42630,43340,1400-10-18,2022-01-08
469,لسرما,سرما آفرين‌,205,423442,8129809130,19030,19290,19180,150,0.79,19120,90,0.47,18940,19470,1400-10-18,2022-01-08
470,لابسا,آبسال‌,204,254245,8323035070,32620,33000,33260,640,1.96,32680,60,0.18,32000,33840,1400-10-18,2022-01-08
471,دروز,داروسازي‌ روزدارو,204,386281,10509748100,26270,26280,27580,1310,4.99,26900,630,2.4,25560,27580,1400-10-18,2022-01-08
472,داوه,داروسازي آوه سينا,204,934693,8359280030,9192,9100,8800,-392,-4.26,9050,-142,-1.54,8740,9250,1400-10-18,2022-01-08
473,غشهد,شهد ايران ‌,203,1010852,4394200492,4488,4328,4430,-58,-1.29,4445,-43,-0.96,4271,4435,1400-10-18,2022-01-08
474,خديزل,بهمن  ديزل,202,177933,9646390650,53244,54100,53800,556,1.04,53700,456,0.86,53050,54700,1400-10-18,2022-01-08
475,تماوند,تامين سرمايه دماوند,201,3627806,21185413570,5830,5840,5860,30,0.51,5840,10,0.17,5830,5900,1400-10-18,2022-01-08
476,قجام,فرآوردههاي غذايي وقندتربت‌جام‌,201,2319238,12676757590,5366,5460,5470,104,1.94,5470,104,1.94,5380,5470,1400-10-18,2022-01-08
477,نوين,بيمه نوين,201,2628552,9656077608,3671,3680,3671,0,0,3673,2,0.05,3600,3750,1400-10-18,2022-01-08
478,وسين,بيمه سينا,199,3097680,9546253943,2994,3066,3083,89,2.97,3075,81,2.71,2994,3083,1400-10-18,2022-01-08
479,تسه9903,امتياز تسهيلات مسكن خرداد99,199,1616,1739964449,1033394,1070000,1085063,51669,5,1076711,43317,4.19,1000000,1085063,1400-10-18,2022-01-08
480,تكمبا,كمباين‌ سازي‌ ايران‌,198,1559931,5694764497,3712,3711,3600,-112,-3.02,3688,-24,-0.65,3600,3745,1400-10-18,2022-01-08
481,قشرين,قند شيرين خراسان,195,1255014,7079655100,5807,5640,5640,-167,-2.88,5690,-117,-2.01,5640,5730,1400-10-18,2022-01-08
482,ولراز,ليزينگ رازي,195,266092,4764647750,17974,18350,17760,-214,-1.19,17910,-64,-0.36,17520,18350,1400-10-18,2022-01-08
483,ولانا,شركت ليزينگ آريا دانا,195,570141,6531613450,11491,11250,11260,-231,-2.01,11460,-31,-0.27,11240,11830,1400-10-18,2022-01-08
484,شپارس,بين‌ المللي‌ محصولات‌  پارس‌,194,772340,5666481860,7520,7230,7300,-220,-2.93,7450,-70,-0.93,7230,7500,1400-10-18,2022-01-08
485,سپر,صندوق س سپر سرمايه بيدار- ثابت,194,4596213,62178157109,13510,13528,13528,18,0.13,13528,18,0.13,13528,13531,1400-10-18,2022-01-08
486,ضخود2015,اختيارخ خودرو-1400-1401/02/07,194,6252,4470852000,621,680,723,102,16.43,715,94,15.14,680,780,1400-10-18,2022-01-08
487,سباقر,سيمان باقران,194,474631,5823579280,12589,12220,12420,-169,-1.34,12400,-189,-1.5,12220,12530,1400-10-18,2022-01-08
488,فولاژ,فولاد آلياژي ايران,193,452867,7797765160,17380,17730,17200,-180,-1.04,17360,-20,-0.12,17040,17730,1400-10-18,2022-01-08
489,سمازن,سيمان‌مازندران‌,192,532714,7453639980,13920,14000,14060,140,1.01,13960,40,0.29,13710,14220,1400-10-18,2022-01-08
490,تسه9902,امتياز تسهيلات مسكن ارديبهشت99,192,2194,2310216662,1002871,1021010,1053014,50143,5,1052970,50099,5,1021010,1053014,1400-10-18,2022-01-08
491,آبين,كشت و صنعت آبشيرين,192,2509694,4099763454,1604,1560,1580,-24,-1.5,1616,12,0.75,1559,1650,1400-10-18,2022-01-08
492,غگلستا,شير پاستوريزه پگاه گلستان,192,921877,8669221080,9511,9600,9210,-301,-3.16,9450,-61,-0.64,9160,9630,1400-10-18,2022-01-08
493,پلاست,كارخانجات توليدي پلاستيران,192,1264295,8744855040,7088,6880,6880,-208,-2.93,6930,-158,-2.23,6880,7180,1400-10-18,2022-01-08
494,پلاسك,پلاسكوكار,191,1083974,4627875247,4304,4331,4197,-107,-2.49,4293,-11,-0.26,4193,4450,1400-10-18,2022-01-08
495,تپمپي,پمپ‌ سازي‌ ايران‌,191,534619,10715994720,20270,20940,20140,-130,-0.64,20110,-160,-0.79,19600,20940,1400-10-18,2022-01-08
496,والبر,سرمايه‌ گذاري‌ البرز(هلدينگ‌,190,889928,6578957900,7470,7320,7280,-190,-2.54,7450,-20,-0.27,7280,7650,1400-10-18,2022-01-08
497,بفجر,فجر انرژي خليج فارس,187,894409,9771031630,11100,10980,10880,-220,-1.98,11080,-20,-0.18,10700,11090,1400-10-18,2022-01-08
498,هاي وب,داده گسترعصرنوين-هاي وب,187,1398649,11233928050,8120,8050,8050,-70,-0.86,8080,-40,-0.49,8000,8050,1400-10-18,2022-01-08
499,ثعمرا,عمران و توسعه شاهد,186,980428,6755132300,6946,6910,6800,-146,-2.1,6920,-26,-0.37,6800,7100,1400-10-18,2022-01-08
500,تسه9909,امتياز تسهيلات مسكن آذر99,185,1980,2096592556,1010216,1001500,1060726,50510,5,1058885,48669,4.82,1001500,1060726,1400-10-18,2022-01-08
501,حپترو,حمل و نقل پتروشيمي( سهامي عام,184,327638,6942683890,21720,21590,21050,-670,-3.08,21470,-250,-1.15,21020,21660,1400-10-18,2022-01-08
502,شراز,پالايش نفت شيراز,183,103263,11554406700,110879,110000,110850,-29,-0.03,111150,271,0.24,110000,113000,1400-10-18,2022-01-08
503,بميلا,توسعه بازرگاني آهن وفولادميلاد,180,1371151,11329509190,8262,8200,8270,8,0.1,8260,-2,-0.02,8150,8400,1400-10-18,2022-01-08
504,سپيدما,صندوق س. سپيد دماوند-د,180,7707953,89798180653,11644,11650,11651,7,0.06,11650,6,0.05,11650,11655,1400-10-18,2022-01-08
505,فن آوا,گروه فن آوا,180,446292,4679577650,10374,10350,10500,126,1.21,10430,56,0.54,10350,10670,1400-10-18,2022-01-08
506,بنو,بيمه تجارت نو,179,2042727,13219907420,6444,6400,6440,-4,-0.06,6470,26,0.4,6400,6540,1400-10-18,2022-01-08
507,دعبيد,لابراتوارداروسازي‌  دكترعبيدي‌,178,262181,4979456730,18890,18850,18870,-20,-0.11,18900,10,0.05,18390,19350,1400-10-18,2022-01-08
508,سدور,سيمان‌ دورود,178,1531612,8058320230,5310,5410,5200,-110,-2.07,5280,-30,-0.56,5180,5410,1400-10-18,2022-01-08
509,پارسيان,بيمه پارسيان,177,1655847,13684402550,8270,8300,8290,20,0.24,8270,0,0,8110,8310,1400-10-18,2022-01-08
510,كوثر,بيمه كوثر,177,1874852,7095384237,3823,3710,3800,-23,-0.6,3812,-11,-0.29,3710,3835,1400-10-18,2022-01-08
511,گنگين,اقتصادي نگين گردشگري ايرانيان,175,2124223,63024386050,29508,30200,29800,292,0.99,29650,142,0.48,29150,30200,1400-10-18,2022-01-08
512,وثوق,سرمايه گذاري وثوق امين,175,2048821,18833017360,9417,9150,9140,-277,-2.94,9190,-227,-2.41,9140,9650,1400-10-18,2022-01-08
513,سپ,پرداخت الكترونيك سامان كيش,172,150650,4893733760,31590,31940,32690,1100,3.48,31660,70,0.22,31650,32890,1400-10-18,2022-01-08
514,شدوص,دوده‌ صنعتي‌ پارس‌,172,1149710,14321094840,12500,12070,12510,10,0.08,12460,-40,-0.32,12070,12690,1400-10-18,2022-01-08
515,شرانل,نفت ايرانول,171,304547,14273824800,47230,46450,46500,-730,-1.55,47100,-130,-0.28,46450,47850,1400-10-18,2022-01-08
516,غپاك,لبنيات‌ پاك‌,171,612710,7602414130,12430,12010,12350,-80,-0.64,12420,-10,-0.08,12010,12600,1400-10-18,2022-01-08
517,كساپا,سايپاشيشه‌,171,445655,6759512990,15280,14860,15070,-210,-1.37,15230,-50,-0.33,14860,15720,1400-10-18,2022-01-08
518,ومعلم,بيمه معلم,170,1889418,3533217021,1913,1850,1870,-43,-2.25,1903,-10,-0.52,1846,1909,1400-10-18,2022-01-08
519,غپآذر,شير پگاه آذربايجان شرقي,170,889110,24957303600,29329,28200,27900,-1429,-4.87,28050,-1279,-4.36,27900,30000,1400-10-18,2022-01-08
520,وسبحان,سرمايه گذاري سبحان,167,1939569,4520008356,2351,2318,2320,-31,-1.32,2345,-6,-0.26,2318,2400,1400-10-18,2022-01-08
521,كيان2,صندوق س. با درآمد ثابت كيان,165,16500000,16500000,32433,1,1,-32432,-100,1,-32432,-100,1,1,1400-10-18,2022-01-08
522,فسا,پتروشيمي فسا,163,2462647,2167633590,906,888,879,-27,-2.98,900,-6,-0.66,879,901,1400-10-18,2022-01-08
523,زعف0110پ11,زعفران0110نگين سحرخيز(پ),163,276271,112239236264,408698,405002,405999,-2699,-0.66,406265,-2433,-0.6,401000,414000,1400-10-18,2022-01-08
524,وآفري,بيمه كارآفرين,162,1909195,7809803356,4139,4263,4050,-89,-2.15,4115,-24,-0.58,4015,4263,1400-10-18,2022-01-08
525,شوينده,مديريت صنعت شوينده ت.ص.بهشهر,162,262823,5001188630,19380,19000,19080,-300,-1.55,19260,-120,-0.62,18700,19880,1400-10-18,2022-01-08
526,لخزر,پارس‌ خزر,162,47150,5312306040,115810,112910,112900,-2910,-2.51,114670,-1140,-0.98,111600,115870,1400-10-18,2022-01-08
527,لبوتان,گروه‌صنعتي‌بوتان‌,161,102762,4245173170,42080,41100,41000,-1080,-2.57,41860,-220,-0.52,40380,42850,1400-10-18,2022-01-08
528,كحافظ,كاشي‌ وسراميك‌ حافظ‌,161,1156084,4549314718,3989,3900,3900,-89,-2.23,3972,-17,-0.43,3871,4049,1400-10-18,2022-01-08
529,ولقمان,سرمايه گذاري لقمان,160,789297,2218829627,2745,2827,2780,35,1.28,2759,14,0.51,2740,2827,1400-10-18,2022-01-08
530,دتماد,توليدمواداوليه‌داروپخش‌,160,144055,5820184360,40700,40000,39920,-780,-1.92,40580,-120,-0.29,39900,41400,1400-10-18,2022-01-08
531,واميد,گروه مديريت سرمايه گذاري اميد,160,1392074,20133980260,14440,14700,14450,10,0.07,14440,0,0,14180,14700,1400-10-18,2022-01-08
532,حشكوه,دليجان طلايي شكوه پارس,160,4145687,13229468575,3276,3251,3294,18,0.55,3191,-85,-2.59,3178,3294,1400-10-18,2022-01-08
533,سپاس,صندوق س. پاداش سهامداري-ثابت,159,2676690,26815168657,10165,10019,10020,-145,-1.43,10018,-147,-1.45,10016,10020,1400-10-18,2022-01-08
534,غپونه,نوش پونه مشهد,158,714545,8218052010,11743,11400,11450,-293,-2.5,11540,-203,-1.73,11400,11820,1400-10-18,2022-01-08
535,وتوسم,سرمايه‌گذاري‌توسعه‌ملي‌,158,455876,3984094820,8800,8710,8630,-170,-1.93,8780,-20,-0.23,8610,8890,1400-10-18,2022-01-08
536,وبرق,س.کارکنان صنعت برق زنجان وقزوي,158,190865,18847918750,101803,98750,98750,-3053,-3,98750,-3053,-3,98750,98750,1400-10-18,2022-01-08
537,سفانو,سيمان فارس نو,157,362430,8890858280,25490,25320,24260,-1230,-4.83,24900,-590,-2.31,24240,25400,1400-10-18,2022-01-08
538,زقيام,كشت و دام قيام اصفهان,156,5063743,6886690480,1296,1360,1360,64,4.94,1324,28,2.16,1360,1360,1400-10-18,2022-01-08
539,غشوكو,شوكو پارس,155,765780,5875701870,7732,7870,7510,-222,-2.87,7700,-32,-0.41,7510,7870,1400-10-18,2022-01-08
540,تسه9906,امتياز تسهيلات مسكن شهريور99,155,1608,1723242954,1022135,1044695,1073241,51106,5,1071668,49533,4.85,1005401,1073241,1400-10-18,2022-01-08
541,زيتون,صندوق س زيتون نماد پايا- مختلط,154,495935,4742570520,9560,9610,9510,-50,-0.52,9560,0,0,9510,9750,1400-10-18,2022-01-08
542,شكربن,كربن‌ ايران‌,154,56551,4966914480,89970,87250,87560,-2410,-2.68,89240,-730,-0.81,87250,90360,1400-10-18,2022-01-08
543,حپارسا,توسعه حمل و نقل ريلي پارسيان,153,153511,4468944150,29290,29300,29450,160,0.55,29250,-40,-0.14,28550,30700,1400-10-18,2022-01-08
544,تسه9905,امتياز تسهيلات مسكن مرداد99,153,1568,1679097470,1026211,1030000,1077521,51310,5,1070853,44642,4.35,1011666,1077521,1400-10-18,2022-01-08
545,كخاكح,ح . صنايع‌خاك‌چيني‌ايران‌,152,571446,5585095890,9790,9430,9660,-130,-1.33,9770,-20,-0.2,9310,9900,1400-10-18,2022-01-08
546,تسه9904,امتياز تسهيلات مسكن تير99,152,1312,1387669090,1008063,1058466,1058466,50403,5,1057675,49612,4.92,1000111,1058466,1400-10-18,2022-01-08
547,شدوصح,ح . دوده‌ صنعتي‌ پارس‌,150,1031808,7630977520,7400,7150,7390,-10,-0.14,7400,0,0,7150,7590,1400-10-18,2022-01-08
548,مفاخر,توسعه فناوري اطلاعات خوارزمي,150,153342,4062547100,27362,27400,26000,-1362,-4.98,27100,-262,-0.96,26000,27400,1400-10-18,2022-01-08
549,زعف0110پ05,زعفران0110نگين زرين(پ),149,63295,25491336130,402325,400000,402700,375,0.09,402739,414,0.1,391800,408000,1400-10-18,2022-01-08
550,بسويچ,پارس‌سويچ‌,149,243596,3341523720,14070,13520,13660,-410,-2.91,13990,-80,-0.57,13520,14200,1400-10-18,2022-01-08
551,سكرد,سيمان كردستان,149,713545,3401168957,4605,4730,4688,83,1.8,4640,35,0.76,4609,4811,1400-10-18,2022-01-08
552,دفارا,داروسازي‌ فارابي‌,148,237355,2970242640,12790,12820,12420,-370,-2.89,12730,-60,-0.47,12360,13000,1400-10-18,2022-01-08
553,وبشهر,توسعه‌ صنايع‌ بهشهر(هلدينگ,148,1146420,7890964100,6940,6770,6870,-70,-1.01,6930,-10,-0.14,6760,6980,1400-10-18,2022-01-08
554,ضسپا1112,اختيارخ خساپا-1600-1400/11/20,148,4887,915926000,145,170,197,52,35.86,187,42,28.97,170,206,1400-10-18,2022-01-08
555,زعف0110پ19,زعفران0110نگين تروند قاينات(پ),147,107492,43087459331,400695,402000,402996,2301,0.57,400843,148,0.04,391001,405000,1400-10-18,2022-01-08
556,سفار,سيمان‌فارس‌,146,70279,3679642710,53690,51190,52010,-1680,-3.13,53350,-340,-0.63,51190,53000,1400-10-18,2022-01-08
557,مداران,داده‌پردازي‌ايران‌,146,248177,3849855690,15120,15700,15710,590,3.9,15220,100,0.66,15200,15710,1400-10-18,2022-01-08
558,ضخود2016,اختيارخ خودرو-1600-1401/02/07,146,4776,2771128000,501,560,580,79,15.77,580,79,15.77,559,599,1400-10-18,2022-01-08
559,تسه9907,امتياز تسهيلات مسكن مهر99,145,1218,1302890016,1019860,1011111,1070853,50993,5,1069696,49836,4.89,1001908,1070853,1400-10-18,2022-01-08
560,حسينا,توسعه خدمات دريايي وبندري سينا,145,169787,7664252250,44565,45500,44600,35,0.08,44850,285,0.64,44200,45950,1400-10-18,2022-01-08
561,تايرا,تراكتورسازي‌ايران‌,143,261164,5268139050,20670,20120,20380,-290,-1.4,20570,-100,-0.48,19870,20540,1400-10-18,2022-01-08
562,شاملاح,ح . معدني‌ املاح‌  ايران‌,141,692935,4987453570,7260,7630,7230,-30,-0.41,7200,-60,-0.83,7000,7630,1400-10-18,2022-01-08
563,كپرور,فرآوري زغال سنگ پروده طبس,141,277106,7588552650,27664,26800,26850,-814,-2.94,27500,-164,-0.59,26800,28000,1400-10-18,2022-01-08
564,فافزا,فولاد افزا سپاهان,141,225034,6800359550,31031,30300,30150,-881,-2.84,30450,-581,-1.87,30150,31500,1400-10-18,2022-01-08
565,اخزا004,اسنادخزانه-م4بودجه00-030522,140,164605,93030440620,560650,565000,563910,3260,0.58,565170,4520,0.81,563910,565570,1400-10-18,2022-01-08
566,شاملا,معدني‌ املاح‌  ايران‌,138,479994,5815897710,12230,12440,12150,-80,-0.65,12190,-40,-0.33,11850,12440,1400-10-18,2022-01-08
567,سدشت,صنايع سيمان دشتستان,138,95215,2339036630,25680,25400,24570,-1110,-4.32,25500,-180,-0.7,24400,25400,1400-10-18,2022-01-08
568,خكاوه,سايپا ديزل,138,3181860,11982884760,3657,3766,3766,109,2.98,3766,109,2.98,3766,3766,1400-10-18,2022-01-08
569,كقزوي,شيشه‌ قزوين‌,138,1562894,12775998420,8380,8280,8170,-210,-2.51,8170,-210,-2.51,8130,8580,1400-10-18,2022-01-08
570,پاسا,ايران‌ياساتايرورابر,136,203062,2748914820,13830,13280,13310,-520,-3.76,13780,-50,-0.36,13280,14190,1400-10-18,2022-01-08
571,واعتبار,سرمايه گذاري اعتبار ايران,136,893817,2573190779,2929,2929,2869,-60,-2.05,2920,-9,-0.31,2825,3015,1400-10-18,2022-01-08
572,دكيمي,كيميدارو,136,214426,3675954340,17840,17000,17000,-840,-4.71,17660,-180,-1.01,16950,18010,1400-10-18,2022-01-08
573,ولشرقح,ح . ليزينگ ايران و شرق,136,1679191,1216966900,741,745,713,-28,-3.78,725,-16,-2.16,711,749,1400-10-18,2022-01-08
574,غشان,شيرپاستوريزه‌پگاه‌خراسان‌,135,765654,3017718863,4032,3845,3900,-132,-3.27,4013,-19,-0.47,3840,4010,1400-10-18,2022-01-08
575,شپلي,پلي اكريل ايران,135,1660423,10593498740,6202,6380,6380,178,2.87,6380,178,2.87,6380,6380,1400-10-18,2022-01-08
576,شتوكاح,ح . توكا رنگ فولاد سپاهان,135,430847,5329825010,12926,12290,12290,-636,-4.92,12370,-556,-4.3,12280,12890,1400-10-18,2022-01-08
577,زمگسا,كشاورزي‌ ودامپروي‌ مگسال‌,134,314186,5643625850,18210,17700,17900,-310,-1.7,18120,-90,-0.49,17620,18470,1400-10-18,2022-01-08
578,دكوثر,داروسازي‌ كوثر,132,831654,2231016408,2715,2608,2663,-52,-1.92,2710,-5,-0.18,2608,2715,1400-10-18,2022-01-08
579,زگلدشت,كشت و دام گلدشت نمونه اصفهان,130,545994,4878792710,8978,8660,8670,-308,-3.43,8960,-18,-0.2,8660,9210,1400-10-18,2022-01-08
580,شصفها,پتروشيمي‌ اصفهان‌,130,98988,11956082650,119646,117650,120000,354,0.3,120600,954,0.8,117500,122000,1400-10-18,2022-01-08
581,ضملت1133,اختيارخ وبملت-3000-1400/11/13,127,5539,1556845000,239,250,260,21,8.79,281,42,17.57,245,330,1400-10-18,2022-01-08
582,شزنگ,تجهيزنيروي‌زنگان‌,127,84353,9776512700,112531,115900,115900,3369,2.99,115750,3219,2.86,115900,115900,1400-10-18,2022-01-08
583,آتيمس,صندوق س.آرمان آتيه درخشان مس-س,124,8307,1495610979,179622,180450,181540,1918,1.07,180042,420,0.23,178630,181850,1400-10-18,2022-01-08
584,بمپنا,توليد برق عسلويه  مپنا,124,505782,2996989240,6080,5840,5860,-220,-3.62,6050,-30,-0.49,5840,6000,1400-10-18,2022-01-08
585,دشيمي,شيمي‌ داروئي‌ داروپخش‌,124,450508,9749266760,21740,21680,21310,-430,-1.98,21680,-60,-0.28,21300,22010,1400-10-18,2022-01-08
586,سقاين,سيمان‌ قائن‌,123,140030,5784621610,42010,40600,41170,-840,-2,41740,-270,-0.64,40600,42670,1400-10-18,2022-01-08
587,ركيش,كارت اعتباري ايران كيش,122,903956,5668651020,6140,6140,6300,160,2.61,6190,50,0.81,5930,6430,1400-10-18,2022-01-08
588,اخزا001,اسنادخزانه-م1بودجه00-030821,121,342827,182646690780,529600,534000,534990,5390,1.02,532770,3170,0.6,531200,535000,1400-10-18,2022-01-08
589,تسه9812,امتياز تسهيلات مسكن اسفند98,120,913,962794107,1004323,1054539,1054539,50216,5,1054539,50216,5,1054539,1054539,1400-10-18,2022-01-08
590,كاريس,صندوق س.سپهر كاريزما-س,120,443134,5837460885,13124,13289,13154,30,0.23,13173,49,0.37,13063,13290,1400-10-18,2022-01-08
591,تسه9901,امتياز تسهيلات مسكن فروردين99,120,1000,1062036500,1011647,1044877,1062229,50582,5,1062036,50389,4.98,1044877,1062229,1400-10-18,2022-01-08
592,دارا,صندوق س. دارا الگوريتم-د,119,475800,4780430270,10033,10051,10042,9,0.09,10047,14,0.14,10034,10051,1400-10-18,2022-01-08
593,كگهر,سنگ آهن گهرزمين,119,263081,12672589900,48110,48150,48150,40,0.08,48100,-10,-0.02,48100,48700,1400-10-18,2022-01-08
594,خاتم,صندوق س خاتم ايساتيس پويا-ثابت,119,2933197,37000714620,12605,12619,12616,11,0.09,12614,9,0.07,12614,12619,1400-10-18,2022-01-08
595,وآرين,شركت توسعه اقتصادي آرين,116,1242125,2207629220,1769,1717,1740,-29,-1.64,1771,2,0.11,1717,1810,1400-10-18,2022-01-08
596,سخوز,سيمان خوزستان,115,173523,3836386260,22440,22060,22110,-330,-1.47,22350,-90,-0.4,22020,22400,1400-10-18,2022-01-08
597,سكه0012پ04,تمام سكه طرح جديد0012صادرات,114,32600,40015181300,1248977,1240000,1226998,-21979,-1.76,1227459,-21518,-1.72,1220000,1240001,1400-10-18,2022-01-08
598,بايكا,كارخانجات كابلسازي ‌ايران‌,112,231358,3471478960,15455,15010,15000,-455,-2.94,15290,-165,-1.07,15000,15420,1400-10-18,2022-01-08
599,ولبهمن,شركت بهمن ليزينگ,109,1683759,10522927170,6238,6140,6280,42,0.67,6250,12,0.19,6140,6290,1400-10-18,2022-01-08
600,دابور,داروسازي‌ ابوريحان‌,108,263286,5779349750,21920,21310,21740,-180,-0.82,21930,10,0.05,21310,22100,1400-10-18,2022-01-08
601,وملت,سرمايه گذاري ملت,108,4258354,10402662547,2396,2443,2443,47,1.96,2443,47,1.96,2430,2443,1400-10-18,2022-01-08
602,وبهمن,سرمايه‌گذاري‌بهمن‌,106,426850,5859362680,13900,13780,13570,-330,-2.37,13830,-70,-0.5,13520,13990,1400-10-18,2022-01-08
603,ساروم,سيمان‌اروميه‌,106,85914,3280769530,38450,39430,38070,-380,-0.99,38390,-60,-0.16,37810,39430,1400-10-18,2022-01-08
604,تشتاد,صنايع توليدي اشتاد ايران‌,106,850663,4102198931,4900,4765,4880,-20,-0.41,4868,-32,-0.65,4753,4985,1400-10-18,2022-01-08
605,ثامان,سامان‌ گستراصفهان‌,106,360515,3198245310,8950,8610,8960,10,0.11,8930,-20,-0.22,8610,8990,1400-10-18,2022-01-08
606,اوان,مبين وان كيش,104,218275,2110419150,9987,9950,9600,-387,-3.88,9940,-47,-0.47,9530,9960,1400-10-18,2022-01-08
607,درهآور,دارويي ره آورد تامين,104,91896,1918723900,20729,20200,20500,-229,-1.1,20750,21,0.1,20200,21500,1400-10-18,2022-01-08
608,تكنو,تكنوتار,104,605817,3802952000,6540,6230,6310,-230,-3.52,6470,-70,-1.07,6220,6420,1400-10-18,2022-01-08
609,ارمغان,ص سرمايه گذاري ارمغان ايرانيان,104,1346550,13482901264,10160,0,10011,-149,-1.47,10013,-147,-1.45,10007,10015,1400-10-18,2022-01-08
610,نمرينو,ايران‌ مرينوس‌,103,51914,3874795160,77160,75000,73960,-3200,-4.15,76490,-670,-0.87,73350,78580,1400-10-18,2022-01-08
611,بخاور,بيمه زندگي خاورميانه,103,2304769,4879467076,2211,2123,2148,-63,-2.85,2179,-32,-1.45,2101,2168,1400-10-18,2022-01-08
612,سهرمز,سيمان‌هرمزگان‌,102,198507,3240942810,16520,16700,16420,-100,-0.61,16480,-40,-0.24,15820,16700,1400-10-18,2022-01-08
613,زعف0110پ16,زعفران0110نگين بيرجند(پ),100,65139,26114496628,400412,395000,400000,-412,-0.1,400904,492,0.12,392000,405000,1400-10-18,2022-01-08
614,شمواد,توليد مواداوليه الياف مصنوعي,99,79735,3576114750,43978,44850,44850,872,1.98,44600,622,1.41,44850,44850,1400-10-18,2022-01-08
615,كطبس,ذغال‌سنگ‌ نگين‌ ط‌بس‌,99,88361,4011194260,46120,45510,45000,-1120,-2.43,45920,-200,-0.43,44510,46800,1400-10-18,2022-01-08
616,قنقش,قند نقش جهان,99,604351,80106725050,129988,132550,132550,2562,1.97,132550,2562,1.97,132550,132550,1400-10-18,2022-01-08
617,سرود,سيمان‌شاهرود,97,113263,2384760370,21420,21700,20730,-690,-3.22,21360,-60,-0.28,20730,21840,1400-10-18,2022-01-08
618,حبندرح,ح.دريايي وكشتيراني خط دريابندر,97,2911708,29031496420,10270,9970,9970,-300,-2.92,9970,-300,-2.92,9970,10000,1400-10-18,2022-01-08
619,وتوشه,سرمايه‌ گذاري‌ پارس‌ توشه‌,96,970370,5128656680,5350,5260,5350,0,0,5330,-20,-0.37,5230,5400,1400-10-18,2022-01-08
620,وارس,سرمايه گذاري ارس صبا,96,348962,3818407290,10759,10900,10580,-179,-1.66,10830,71,0.66,10580,11000,1400-10-18,2022-01-08
621,تسه9811,امتياز تسهيلات مسكن بهمن98,96,792,830869776,999122,1049078,1049078,49956,5,1049078,49956,5,1049078,1049078,1400-10-18,2022-01-08
622,عيار2,صندوق سكه طلاي مفيد,95,950000,950000,31466,1,1,-31465,-100,1,-31465,-100,1,1,1400-10-18,2022-01-08
623,ساربيل,سيمان آرتا اردبيل,95,124397,2653463070,21680,21430,21300,-380,-1.75,21620,-60,-0.28,21210,21820,1400-10-18,2022-01-08
624,سكه0112پ03,تمام سكه طرح جديد0112سامان,95,17500,21425931200,1249607,1242500,1225000,-24607,-1.97,1224339,-25268,-2.02,1211000,1242500,1400-10-18,2022-01-08
625,وپخش,داروپخش‌ (هلدينگ‌,94,100090,3276171180,33600,33650,32500,-1100,-3.27,33540,-60,-0.18,32410,33650,1400-10-18,2022-01-08
626,حخزر,كشتيراني درياي خزر,93,289971,3978442360,13615,13150,13940,325,2.39,13640,25,0.18,13150,14100,1400-10-18,2022-01-08
627,غشاذر,پگاه‌آذربايجان‌غربي‌,92,465274,2236826839,4915,4990,4732,-183,-3.72,4899,-16,-0.33,4719,4991,1400-10-18,2022-01-08
628,سغرب,سيمان‌غرب‌,92,140056,1973294440,14450,14570,13920,-530,-3.67,14400,-50,-0.35,13910,14570,1400-10-18,2022-01-08
629,ضشنا1048,اختيارخ شپنا-5450-1400/10/19,91,1292,1299635080,499,501,560,61,12.22,548,49,9.82,501,595,1400-10-18,2022-01-08
630,سلار,شركت سيمان لارستان,90,146963,3273429650,22903,22250,22250,-653,-2.85,22700,-203,-0.89,22250,22900,1400-10-18,2022-01-08
631,فيروزه,صندوق شاخص30 شركت فيروزه- سهام,89,19167,3213033990,166950,169530,167000,50,0.03,167630,680,0.41,167000,169990,1400-10-18,2022-01-08
632,وتعاون,بيمه تعاون,89,522109,848983824,1701,1616,1616,-85,-5,1697,-4,-0.24,1616,1677,1400-10-18,2022-01-08
633,اخزا007,اسنادخزانه-م7بودجه00-030912,88,351285,184869208310,523470,524270,526600,3130,0.6,526270,2800,0.53,524270,529490,1400-10-18,2022-01-08
634,دالبر,البرزدارو,87,194356,2329116500,11860,11870,12000,140,1.18,11880,20,0.17,11730,12260,1400-10-18,2022-01-08
635,غگلپا,شير پاستوريزه پگاه گلپايگان,86,57921,3199773550,56270,54000,54050,-2220,-3.95,56050,-220,-0.39,53950,56350,1400-10-18,2022-01-08
636,قمرو,قند مرودشت‌,86,140247,3120464900,22550,22540,22100,-450,-2,22490,-60,-0.27,21800,22940,1400-10-18,2022-01-08
637,اخزا917,اسنادخزانه-م17بودجه99-010226,84,274289,254819978100,927500,929000,929490,1990,0.21,929020,1520,0.16,927300,930930,1400-10-18,2022-01-08
638,كمينا,شيشه سازي مينا,84,367174,2968827650,8311,8420,8070,-241,-2.9,8240,-71,-0.85,8070,8420,1400-10-18,2022-01-08
639,زعف0110پ18,زعفران0110نگين بهرامن(پ),83,32402,13069648197,401096,396101,399000,-2096,-0.52,403359,2263,0.56,395010,405007,1400-10-18,2022-01-08
640,كصدف,كاشي صدف سرام استقلال آباده,83,234019,4905473100,21585,21000,21100,-485,-2.25,21250,-335,-1.55,20950,21150,1400-10-18,2022-01-08
641,ما,بيمه  ما,83,400469,1944646490,4731,4922,4830,99,2.09,4747,16,0.34,4771,4922,1400-10-18,2022-01-08
642,سجامح,ح.مجتمع سيمان غرب آسيا,83,1178457,900696098,775,798,760,-15,-1.94,764,-11,-1.42,756,798,1400-10-18,2022-01-08
643,سجام,مجتمع سيمان غرب آسيا,83,927474,1892531989,2098,2038,2036,-62,-2.96,2087,-11,-0.52,2036,2080,1400-10-18,2022-01-08
644,وكادو,تكادو,82,681230,9933363360,14348,14000,14340,-8,-0.06,14580,232,1.62,14000,14730,1400-10-18,2022-01-08
645,ضملت1134,اختيارخ وبملت-3500-1400/11/13,80,2616,168538000,50,50,66,16,32,64,14,28,50,80,1400-10-18,2022-01-08
646,دپارس,پارس‌ دارو,80,78534,2258200240,28580,29250,28700,120,0.42,28610,30,0.1,27970,29700,1400-10-18,2022-01-08
647,شساخت,مهندسي و ساختمان صنايع نفت,80,176735,7813846450,44152,45300,44200,48,0.11,44150,-2,0,43050,45300,1400-10-18,2022-01-08
648,بفجرح,ح . فجر انرژي خليج فارس,80,499846,4388434800,8670,8430,8820,150,1.73,8780,110,1.27,8430,8830,1400-10-18,2022-01-08
649,كاسپين,داروسازي كاسپين تامين,80,51846,1143093950,22500,22500,21950,-550,-2.44,22450,-50,-0.22,21850,22750,1400-10-18,2022-01-08
650,ولتجار,واسپاري تجارت وسرمايه ايرانيان,80,860214,2197635543,2608,2530,2530,-78,-2.99,2596,-12,-0.46,2530,2656,1400-10-18,2022-01-08
651,خلنت,لنت‌ ترمزايران‌,79,82787,5448212470,62680,65810,65810,3130,4.99,63760,1080,1.72,65810,65810,1400-10-18,2022-01-08
652,لوتوس,تامين سرمايه لوتوس پارسيان,79,607283,3470844290,5720,5720,5720,0,0,5720,0,0,5620,5730,1400-10-18,2022-01-08
653,هكشو208,اختيارف ت پاكشو10000-02/08/29,78,6230118,3700690092,558,594,594,36,6.45,594,36,6.45,594,594,1400-10-18,2022-01-08
654,فردا,صندوق س آواي فرداي زاگرس-ثابت,78,1335885,16247388177,12144,12162,12163,19,0.16,12162,18,0.15,12162,12163,1400-10-18,2022-01-08
655,دارو,كارخانجات‌داروپخش‌,77,112689,3317324730,30340,29040,29640,-700,-2.31,30170,-170,-0.56,29040,30150,1400-10-18,2022-01-08
656,داريك,صندوق س.اعتماد داريك-د,76,2974989,36067363044,12123,12125,12127,4,0.03,12124,1,0.01,12010,12170,1400-10-18,2022-01-08
657,اخزا006,اسنادخزانه-م6بودجه00-030723,76,244121,132719448890,539090,545970,542660,3570,0.66,543660,4570,0.85,540010,545970,1400-10-18,2022-01-08
658,فخاس,فولاد خراسان,76,60463,1343280390,22570,21880,21900,-670,-2.97,22570,0,0,21810,22560,1400-10-18,2022-01-08
659,شكبير,پتروشيمي اميركبير,75,47948,4419656650,93681,94000,92900,-781,-0.83,93600,-81,-0.09,91750,94000,1400-10-18,2022-01-08
660,قيستو,شركت قند بيستون,73,242156,5194246200,20855,21450,21450,595,2.85,21150,295,1.41,21450,21450,1400-10-18,2022-01-08
661,وبازار,صندوق س شاخصي بازارآشنا,73,343429,4013457630,11610,11800,11600,-10,-0.09,11690,80,0.69,11550,11890,1400-10-18,2022-01-08
662,كهربا,صندوق س.پشتوانه سكه طلا كهربا,73,252632,2649360089,10715,10721,10490,-225,-2.1,10487,-228,-2.13,10423,10750,1400-10-18,2022-01-08
663,ثاژن,سخت آژند,72,555780,2162376066,3872,3949,3949,77,1.99,3880,8,0.21,3805,3949,1400-10-18,2022-01-08
664,اخزا003,اسنادخزانه-م3بودجه00-030418,72,74286,42629917070,571430,573520,575880,4450,0.78,573860,2430,0.43,572620,576000,1400-10-18,2022-01-08
665,زرين,صندوق س. سهام زرين كوروش-س,71,222229,2829494018,12695,12793,12720,25,0.2,12732,37,0.29,12690,12930,1400-10-18,2022-01-08
666,دقاضي,داروسازي شهيد قاضي,71,89201,2410755300,26438,27100,26800,362,1.37,26600,162,0.61,26500,27200,1400-10-18,2022-01-08
667,ضخود2021,اختيارخ خودرو-3500-1401/02/07,71,2794,132451000,47,47,46,-1,-2.13,47,0,0,45,50,1400-10-18,2022-01-08
668,كخاك,صنايع‌خاك‌چيني‌ايران‌,70,125163,1739269950,14060,14000,13770,-290,-2.06,14050,-10,-0.07,13620,14200,1400-10-18,2022-01-08
669,دحاوي,الحاوي,69,559330,2420408226,4458,4454,4325,-133,-2.98,4425,-33,-0.74,4325,4454,1400-10-18,2022-01-08
670,دسبحا,گروه دارويي سبحان,69,282251,5269738570,18940,18330,18510,-430,-2.27,18880,-60,-0.32,18330,18950,1400-10-18,2022-01-08
671,سبجنو,سيمان‌ بجنورد,69,44281,1632742890,36910,36660,37000,90,0.24,36910,0,0,36660,37540,1400-10-18,2022-01-08
672,ويسا,سرمايه گذاري ايساتيس پويا,68,1394751,10534165720,7363,7363,7580,217,2.95,7550,187,2.54,7363,7580,1400-10-18,2022-01-08
673,وامين,س. امين توان آفرين ساز,68,174257,2147808920,12486,12360,12330,-156,-1.25,12480,-6,-0.05,12190,12360,1400-10-18,2022-01-08
674,وزمين,بانك ايران زمين,68,2260704,18390936050,8290,8130,8140,-150,-1.81,8140,-150,-1.81,8130,8400,1400-10-18,2022-01-08
675,قپيرا,فرآورده‌هاي‌غدايي‌وقندپيرانشهر,67,270595,2225305070,8460,8500,8190,-270,-3.19,8420,-40,-0.47,8120,8790,1400-10-18,2022-01-08
676,تكنار,مجتمع معادن مس تكنار,66,53636,2708295750,51344,51300,50900,-444,-0.86,51100,-244,-0.48,49900,51950,1400-10-18,2022-01-08
677,رتكو,كنترل‌خوردگي‌تكين‌كو,66,105998,748873080,7210,6870,6940,-270,-3.74,7200,-10,-0.14,6870,7210,1400-10-18,2022-01-08
678,كشرق,صنعتي و معدني شمال شرق شاهرود,66,38442,2586013200,68332,65050,66500,-1832,-2.68,68150,-182,-0.27,65050,68250,1400-10-18,2022-01-08
679,اخزا910,اسنادخزانه-م10بودجه99-020807,65,48733,33115384690,677490,678610,682500,5010,0.74,679530,2040,0.3,677710,685000,1400-10-18,2022-01-08
680,فافق,صنايع مس افق كرمان,65,2621460,8671789680,3410,3308,3308,-102,-2.99,3319,-91,-2.67,3308,3308,1400-10-18,2022-01-08
681,كفرآور,فرآورده هاي سيمان شرق,64,68377,1285580610,19355,18780,18780,-575,-2.97,19280,-75,-0.39,18780,19200,1400-10-18,2022-01-08
682,الماس,صندوق س.امين تدبيرگران فردا-س,63,18031,1769612290,98088,95600,98000,-88,-0.09,98143,55,0.06,95600,99874,1400-10-18,2022-01-08
683,اخزا005,اسنادخزانه-م5بودجه00-030626,63,178517,98438423390,547910,550990,550230,2320,0.42,551420,3510,0.64,549010,554990,1400-10-18,2022-01-08
684,ساراب,سيمان‌ داراب‌,62,119151,1934780330,16450,16680,16020,-430,-2.61,16420,-30,-0.18,16010,16680,1400-10-18,2022-01-08
685,برن0104پ01,برنج طارم0104تجارت مازندران(پ),61,4865,2717772602,559514,561000,560999,1485,0.27,558638,-876,-0.16,538002,561000,1400-10-18,2022-01-08
686,اخزا008,اسنادخزانه-م8بودجه00-030919,60,282939,148513245460,520820,524970,524990,4170,0.8,524890,4070,0.78,523570,526000,1400-10-18,2022-01-08
687,اتكام,بيمه اتكايي امين,58,575224,2806385843,4947,4850,4905,-42,-0.85,4934,-13,-0.26,4850,4959,1400-10-18,2022-01-08
688,سدبير,س. تدبيرگران فارس وخوزستان,58,35555,1326201500,39257,37300,37300,-1957,-4.99,39050,-207,-0.53,37300,37300,1400-10-18,2022-01-08
689,اخزا812,اسنادخزانه-م12بودجه98-001111,57,110134,108695517930,986390,988800,988000,1610,0.16,986940,550,0.06,986000,988800,1400-10-18,2022-01-08
690,وايرا,سرمايه گذاري صنايع ايران,56,223663,954644005,4323,4222,4235,-88,-2.04,4318,-5,-0.12,4222,4330,1400-10-18,2022-01-08
691,ثمين,صندوق س. ثروت افزون ثمين-س,56,2086921,21229622524,10299,10171,10160,-139,-1.35,10173,-126,-1.22,10150,10485,1400-10-18,2022-01-08
692,صايند,صندوق س. گنجينه آينده روشن-د,55,583710,5845363870,10017,10038,10018,1,0.01,10014,-3,-0.03,10010,10039,1400-10-18,2022-01-08
693,بساما,بيمه سامان,55,56030,1093310170,19826,19050,19360,-466,-2.35,19800,-26,-0.13,19020,19670,1400-10-18,2022-01-08
694,سمتاز,سيمان ممتازان كرمان,53,100826,1420832180,14499,14150,14080,-419,-2.89,14440,-59,-0.41,14070,14290,1400-10-18,2022-01-08
695,كامياب2,صندوق س. كامياب آشنا-د,51,5100000,5100000,11200,1,1,-11199,-99.99,1,-11199,-99.99,1,1,1400-10-18,2022-01-08
696,پدرخش,درخشان‌ تهران‌,50,309608,2024836320,6230,6540,6540,310,4.98,6270,40,0.64,6540,6540,1400-10-18,2022-01-08
697,زعف0110پ10,زعفران0110نگين طلاي سرخ(پ),50,11299,4579184045,406577,401000,400003,-6574,-1.62,405273,-1304,-0.32,400003,414999,1400-10-18,2022-01-08
698,ضپال2007,اختيارخ اپال-32000-1401/02/12,49,1475,245392000,174,170,218,44,25.29,166,-8,-4.6,157,219,1400-10-18,2022-01-08
699,دسينا,داروسازي‌ سينا,49,122240,2474702960,20500,19810,20470,-30,-0.15,20460,-40,-0.2,19810,20490,1400-10-18,2022-01-08
700,داريوش,صندوق س. ثروت داريوش -س,48,150385,1444160405,9485,9570,9565,80,0.84,9603,118,1.24,9531,9620,1400-10-18,2022-01-08
701,ومشان,س. فني و مهندسي مشانير,47,55296,2347315200,41233,42450,42450,1217,2.95,41900,667,1.62,42450,42450,1400-10-18,2022-01-08
702,وثخوز,سرمايه گذاري و توسعه خوزستان,46,272055,7685553750,27430,28250,28250,820,2.99,28050,620,2.26,28250,28250,1400-10-18,2022-01-08
703,ضصاد1113,اختيارخ وبصادر-2000-1400/11/06,46,1830,152120000,58,94,87,29,50,83,25,43.1,60,109,1400-10-18,2022-01-08
704,سشمال,سيمان‌ شمال‌,46,175563,1332136180,7580,7450,7500,-80,-1.06,7580,0,0,7450,7750,1400-10-18,2022-01-08
705,سكه0011پ02,تمام سكه طرح جديد0011ملت,46,6200,7622615900,1249066,1240000,1223501,-25565,-2.05,1229454,-19612,-1.57,1223013,1240000,1400-10-18,2022-01-08
706,آساس,صندوق س.آسمان آرماني سهام-س,45,18882,3119385250,164431,164440,164510,79,0.05,165204,773,0.47,164440,167970,1400-10-18,2022-01-08
707,اخزا815,اسنادخزانه-م15بودجه98-010406,44,41444,37647840610,910830,904000,907150,-3680,-0.4,908400,-2430,-0.27,904000,909000,1400-10-18,2022-01-08
708,سهگمت,سيمان‌هگمتان‌,44,57908,1182343460,20700,20210,20400,-300,-1.45,20680,-20,-0.1,20210,20690,1400-10-18,2022-01-08
709,اخزا901,اسنادخزانه-م1بودجه99-010621,43,25622,22249501680,866120,864000,869080,2960,0.34,868370,2250,0.26,864000,872000,1400-10-18,2022-01-08
710,سكه0111پ05,تمام سكه طرح جديد0111آينده,43,8400,10326609800,1247557,1231003,1225000,-22557,-1.81,1229358,-18199,-1.46,1218983,1240000,1400-10-18,2022-01-08
711,سيدكو,سرمايه گذاري توسعه صنايع سيمان,42,177732,1022424220,5860,5650,5710,-150,-2.56,5850,-10,-0.17,5650,5790,1400-10-18,2022-01-08
712,اوصتا,صندوق انديشه ورزان صباتامين -د,40,198079,4186725592,21107,21108,21138,31,0.15,21137,30,0.14,21108,21138,1400-10-18,2022-01-08
713,قنيشا,قند  نيشابور,39,57227,2460761000,45260,43000,43000,-2260,-4.99,44870,-390,-0.86,43000,43000,1400-10-18,2022-01-08
714,اخزا903,اسنادخزانه-م3بودجه99-011110,39,16218,13031503830,799930,800000,803980,4050,0.51,803520,3590,0.45,800000,807700,1400-10-18,2022-01-08
715,پسهند,صنايع‌ لاستيكي‌  سهند,38,78785,2272962690,28960,29000,28130,-830,-2.87,28940,-20,-0.07,27910,29440,1400-10-18,2022-01-08
716,ثاصفا,شركت‌ ساختمان‌ اصفهان‌,37,131235,1042005900,7714,7940,7940,226,2.93,7750,36,0.47,7940,7940,1400-10-18,2022-01-08
717,فيروزا,صندوق بادرآمد ثابت فيروزه آسيا,32,284948,7459548587,26151,26180,26180,29,0.11,26179,28,0.11,26171,26180,1400-10-18,2022-01-08
718,فالوم,آلومتك‌,31,109677,2122249950,19947,19350,19350,-597,-2.99,19350,-597,-2.99,19350,19350,1400-10-18,2022-01-08
719,ضصاد1114,اختيارخ وبصادر-2500-1400/11/06,31,627,4054000,9,18,9,0,0,6,-3,-33.33,3,18,1400-10-18,2022-01-08
720,ضصاد1111,اختيارخ وبصادر-1600-1400/11/06,30,909,345944000,294,350,390,96,32.65,381,87,29.59,350,398,1400-10-18,2022-01-08
721,گوهر2,صندوق سكه طلاي كيان,30,300000,300000,61907,1,1,-61906,-100,1,-61906,-100,1,1,1400-10-18,2022-01-08
722,گنجين,صندوق س. گنجينه يكم آويد-د,29,79490,1155360153,14523,14533,14540,17,0.12,14535,12,0.08,14533,14542,1400-10-18,2022-01-08
723,اخزا902,اسنادخزانه-م2بودجه99-011019,29,34751,28220903870,810780,810010,813000,2220,0.27,812090,1310,0.16,810010,816700,1400-10-18,2022-01-08
724,ضشنا1049,اختيارخ شپنا-6540-1400/10/19,27,813,4517770,11,4,1,-10,-90.91,3,-8,-72.73,1,10,1400-10-18,2022-01-08
725,اخزا909,اسنادخزانه-م9بودجه99-020316,27,48870,36221281410,738510,739990,741000,2490,0.34,741180,2670,0.36,739990,741600,1400-10-18,2022-01-08
726,ضسپا1113,اختيارخ خساپا-1800-1400/11/20,26,1107,93919000,62,86,119,57,91.94,85,23,37.1,76,119,1400-10-18,2022-01-08
727,ضصاد1112,اختيارخ وبصادر-1800-1400/11/06,26,347,61473000,118,150,170,52,44.07,177,59,50,150,195,1400-10-18,2022-01-08
728,ضكاريس903,اختيارخ كاريس-16000-14010930,26,2036,3057017000,1490,1500,1596,106,7.11,1501,11,0.74,1500,1599,1400-10-18,2022-01-08
729,اخزا908,اسنادخزانه-م8بودجه99-020606,25,48499,34212088000,702670,704000,705000,2330,0.33,705420,2750,0.39,703500,706000,1400-10-18,2022-01-08
730,هفارس104,اختيارف ت فارس-11832-01/04/12,25,297994,297994,1,1,1,0,0,1,0,0,1,1,1400-10-18,2022-01-08
731,زعف0110پ08,زعفران0110نگين روستا(پ),24,9813,3959635100,400000,395001,405000,5000,1.25,403509,3509,0.88,395000,405000,1400-10-18,2022-01-08
732,كمان,س.خ.كمان كاريزما 35% تاديه,21,900000,346164300000,383290,384627,384627,1337,0.35,384627,1337,0.35,384627,384627,1400-10-18,2022-01-08
733,ضكاريس902,اختيارخ كاريس-14000-14010930,21,2003,5508700000,2730,2750,2900,170,6.23,2750,20,0.73,2750,2900,1400-10-18,2022-01-08
734,ساذري,آذريت‌,20,33579,256543560,7867,7640,7640,-227,-2.89,7640,-227,-2.89,7640,7640,1400-10-18,2022-01-08
735,فراز,صندوق س.سهام فراز داريك-س,20,91828,1307387344,14235,14236,14239,4,0.03,14237,2,0.01,14236,14239,1400-10-18,2022-01-08
736,اخزا914,اسنادخزانه-م14بودجه99-021025,19,25512,16584407970,646670,646750,660000,13330,2.06,650060,3390,0.52,646750,663000,1400-10-18,2022-01-08
737,اخزا918,اسنادخزانه-م18بودجه99-010323,19,26549,24248883460,914520,911510,915390,870,0.1,913360,-1160,-0.13,911500,915490,1400-10-18,2022-01-08
738,وحافظح,ح . بيمه حافظ,19,210498,785672920,3950,3871,3713,-237,-6,3732,-218,-5.52,3713,3871,1400-10-18,2022-01-08
739,ضسپا1111,اختيارخ خساپا-1400-1400/11/20,19,622,188548000,290,310,320,30,10.34,303,13,4.48,294,325,1400-10-18,2022-01-08
740,اخزا816,اسنادخزانه-م16بودجه98-010503,18,15985,14291569260,891720,893000,894800,3080,0.35,894060,2340,0.26,892030,894800,1400-10-18,2022-01-08
741,اخزا010,اسناد خزانه-م10بودجه00-031115,18,155668,79871345280,506545,517770,513000,6455,1.27,513088,6543,1.29,513000,517770,1400-10-18,2022-01-08
742,افق ملت,صندوق س در سهام افق ملت,18,6700,923246110,138120,139000,137010,-1110,-0.8,137800,-320,-0.23,137000,139000,1400-10-18,2022-01-08
743,ثنام,س ساختماني ب نام آوران مهندسي,18,27206,241589280,9150,8880,8880,-270,-2.95,8880,-270,-2.95,8880,8880,1400-10-18,2022-01-08
744,اخزا904,اسنادخزانه-م4بودجه99-011215,17,43591,34439684600,788290,788000,792000,3710,0.47,790060,1770,0.22,787100,793000,1400-10-18,2022-01-08
745,شستان,پتروشيمي گلستان,16,67549,254592181,3696,3769,3769,73,1.98,3700,4,0.11,3769,3769,1400-10-18,2022-01-08
746,بذر,صندوق س بذر اميد آفرين-سهام,16,522847,50424237750,96050,96820,96440,390,0.41,96440,390,0.41,96050,96820,1400-10-18,2022-01-08
747,ثروتم,صندوق س. ثروت آفرين پارسيان-س,16,15710,1323821590,85054,85612,83704,-1350,-1.59,84266,-788,-0.93,83704,85612,1400-10-18,2022-01-08
748,اخزا911,اسنادخزانه-م11بودجه99-020906,15,39082,26194070860,666520,667000,667140,620,0.09,670230,3710,0.56,667000,677470,1400-10-18,2022-01-08
749,اراد50,مرابحه عام دولت5-ش.خ0302,15,281200,281200000000,1000000,1000000,1000000,0,0,1000000,0,0,1000000,1000000,1400-10-18,2022-01-08
750,پلوله,گازلوله‌,15,22894,507102100,22830,22150,22150,-680,-2.98,22800,-30,-0.13,22150,22150,1400-10-18,2022-01-08
751,حرهشا,رهشاد سپاهان (سهامي عام,15,2725,216501250,81877,79450,79450,-2427,-2.96,79450,-2427,-2.96,79450,79450,1400-10-18,2022-01-08
752,ضملت1132,اختيارخ وبملت-2500-1400/11/13,14,353,270442000,684,737,750,66,9.65,766,82,11.99,737,800,1400-10-18,2022-01-08
753,خبازرس,بازرسي مهندسي و صنعتي ايران,14,13920,307632000,22775,22100,22100,-675,-2.96,22750,-25,-0.11,22100,22100,1400-10-18,2022-01-08
754,فنرژي,گسترش صنايع انرژي آذرآب,14,62508,643207320,10490,10290,10290,-200,-1.91,10290,-200,-1.91,10290,10290,1400-10-18,2022-01-08
755,دمعيار,صندوق س. توازن معيار-د,14,78457,762101131,9718,9717,9710,-8,-0.08,9714,-4,-0.04,9710,9717,1400-10-18,2022-01-08
756,اخزا907,اسنادخزانه-م7بودجه99-020704,14,50001,34606628500,691540,692000,692000,460,0.07,692120,580,0.08,692000,692500,1400-10-18,2022-01-08
757,كباده,توليد خاك نسوزاستقلال آباده,14,18841,632115550,32600,33550,33550,950,2.91,32650,50,0.15,33550,33550,1400-10-18,2022-01-08
758,ضجار2013,اختيارخ وتجارت-2000-1401/02/21,13,370,122770000,302,330,340,38,12.58,332,30,9.93,320,345,1400-10-18,2022-01-08
759,ضملي1160,اختيارخ فملي-6000-1400/11/03,13,88,217088000,1200,1200,1299,99,8.25,1233,33,2.75,1050,1299,1400-10-18,2022-01-08
760,سخند,صندوق س.سپهرخبرگان نفت-د,12,102180,1025381370,10153,10048,10041,-112,-1.1,10035,-118,-1.16,10018,10048,1400-10-18,2022-01-08
761,لپيام,گسترش صنايع پيام,12,5232,137078400,26984,26200,26200,-784,-2.91,26950,-34,-0.13,26200,26200,1400-10-18,2022-01-08
762,ضفلا1163,اختيارخ فولاد-10000-1400/11/24,12,73,75464000,1167,1200,1011,-156,-13.37,1034,-133,-11.4,1010,1200,1400-10-18,2022-01-08
763,ساروج,بين المللي ساروج بوشهر,12,12867,216240030,16519,17340,16900,381,2.31,16520,1,0.01,16710,17340,1400-10-18,2022-01-08
764,خفولا,خدمات فني فولاد يزد,11,45677,1027732500,23177,22500,22500,-677,-2.92,23100,-77,-0.33,22500,22500,1400-10-18,2022-01-08
765,غناب,روغن‌ نباتي‌ ناب,11,3748,544584400,141074,145300,145300,4226,3,141300,226,0.16,145300,145300,1400-10-18,2022-01-08
766,اخزا821,اسنادخزانه-م21بودجه98-020906,11,1628,1091825310,665000,670970,670960,5960,0.9,670650,5650,0.85,666500,670980,1400-10-18,2022-01-08
767,وحافظ,بيمه حافظ,11,248463,1667186730,6914,6710,6710,-204,-2.95,6880,-34,-0.49,6710,6710,1400-10-18,2022-01-08
768,اخزا813,اسنادخزانه-م13بودجه98-010219,11,10151,9484675000,932360,934500,934500,2140,0.23,934360,2000,0.21,932500,934500,1400-10-18,2022-01-08
769,واحصا,احياء صنايع خراسان,11,7725,278486250,37122,36050,36050,-1072,-2.89,36050,-1072,-2.89,36050,36050,1400-10-18,2022-01-08
770,فيروزه2,صندوق شاخص30 شركت فيروزه- سهام,10,100000,100000,166950,1,1,-166949,-100,1,-166949,-100,1,1,1400-10-18,2022-01-08
771,زعف0110پ09,زعفران0110نگين نوين(پ),10,5525,2217383482,405515,399998,404999,-516,-0.13,401336,-4179,-1.03,399000,405000,1400-10-18,2022-01-08
772,اخزا817,اسنادخزانه-م17بودجه98-010512,10,3242,2880893310,887420,886550,889990,2570,0.29,888620,1200,0.14,886550,889990,1400-10-18,2022-01-08
773,ضپال2006,اختيارخ اپال-28000-1401/02/12,10,22,13951000,650,620,661,11,1.69,634,-16,-2.46,620,661,1400-10-18,2022-01-08
774,ضملت1131,اختيارخ وبملت-2000-1400/11/13,10,231,281120000,1127,1150,1200,73,6.48,1217,90,7.99,1150,1250,1400-10-18,2022-01-08
775,اخزا905,اسنادخزانه-م5بودجه99-020218,10,7091,5363333990,751620,754010,756970,5350,0.71,756360,4740,0.63,754010,757970,1400-10-18,2022-01-08
776,نتوس,پشم‌ بافي‌ توس,10,165132,1854432360,11575,11230,11230,-345,-2.98,11510,-65,-0.56,11230,11230,1400-10-18,2022-01-08
777,اگ010155,گام بانك اقتصاد نوين0101,10,53990,50750600000,937000,940000,940000,3000,0.32,940000,3000,0.32,940000,940000,1400-10-18,2022-01-08
778,تپولا,مهندسي مرآت پولاد,9,61595,927004750,15508,15050,15050,-458,-2.95,15460,-48,-0.31,15050,15050,1400-10-18,2022-01-08
779,كشم0101پ01,كشمش سبز0101خليل آباد(پ),9,121,76959710,639191,650000,623120,-16071,-2.51,636031,-3160,-0.49,623120,650000,1400-10-18,2022-01-08
780,پادا,صندوق س.پاداش سرمايه پارس-س,9,1916,202846800,106160,106180,106300,140,0.13,105870,-290,-0.27,105300,106300,1400-10-18,2022-01-08
781,فكمند,گسترش قطعه سازي كمند,9,26054,880625200,34819,33800,33800,-1019,-2.93,34750,-69,-0.2,33800,33800,1400-10-18,2022-01-08
782,ضپاس1011,اختيارخ وپارس-2000-1400/10/22,9,221,809000,7,40,5,-2,-28.57,4,-3,-42.86,2,40,1400-10-18,2022-01-08
783,ضملي1161,اختيارخ فملي-7000-1400/11/03,9,94,57300000,511,300,348,-163,-31.9,305,-206,-40.31,300,348,1400-10-18,2022-01-08
784,ضپاس2012,اختيارخ وپارس-1800-1401/02/28,9,250,90000000,440,360,360,-80,-18.18,360,-80,-18.18,360,360,1400-10-18,2022-01-08
785,جهرم,پتروشيمي جهرم,8,47037,60818841,1332,1293,1293,-39,-2.93,1332,0,0,1293,1293,1400-10-18,2022-01-08
786,ضمخا2015,اختيارخ اخابر-8000-1401/02/28,8,12,8700000,1,800,600,599,59900,725,724,72400,600,800,1400-10-18,2022-01-08
787,سپيدما2,صندوق س. سپيد دماوند-د,8,80000000,80000000,11644,1,1,-11643,-99.99,1,-11643,-99.99,1,1,1400-10-18,2022-01-08
788,وسخراج,شركت س استان خراسان جنوبي,8,43217,85958613,2209,1989,1989,-220,-9.96,2209,0,0,1989,1989,1400-10-18,2022-01-08
789,ضبدر1163,اختيارخ شبندر-6000-1400/11/13,8,16,13705000,880,890,879,-1,-0.11,857,-23,-2.61,805,890,1400-10-18,2022-01-08
790,سفاسي,شركت فارسيت اهواز,8,22028,74212332,3473,3369,3369,-104,-2.99,3472,-1,-0.03,3369,3369,1400-10-18,2022-01-08
791,ضفلا1165,اختيارخ فولاد-14000-1400/11/24,7,110,7650000,100,100,55,-45,-45,70,-30,-30,55,100,1400-10-18,2022-01-08
792,نيرو,نيرو سرمايه,7,4036,118658400,30283,29400,29400,-883,-2.92,30250,-33,-0.11,29400,29400,1400-10-18,2022-01-08
793,وسخوز,شركت س استان خوزستان,7,64795,39071385,634,603,603,-31,-4.89,634,0,0,603,603,1400-10-18,2022-01-08
794,نخو0102پ01,نخود متوسط0102شيري(پ),7,95,35634988,372240,390851,360023,-12217,-3.28,375105,2865,0.77,360001,390852,1400-10-18,2022-01-08
795,ثنظام,س. ساختماني نظام مهندسي ايران,7,15706,264489040,17351,16840,16840,-511,-2.95,16840,-511,-2.95,16840,16840,1400-10-18,2022-01-08
796,لخانه,لوازم‌ خانگي‌ پارس‌,6,2783,42023300,15557,15100,15100,-457,-2.94,15560,3,0.02,15100,15100,1400-10-18,2022-01-08
797,ضپنا2012,اختيارخ رمپنا-12000-1401/02/07,6,10,59300000,5960,6000,5800,-160,-2.68,5930,-30,-0.5,5800,6000,1400-10-18,2022-01-08
798,وسقم,شركت س استان قم,6,385000,487795000,1333,1267,1267,-66,-4.95,1332,-1,-0.08,1267,1267,1400-10-18,2022-01-08
799,ويستا,صندوق س. ويستا -س,6,17405,177531000,10195,10200,10200,5,0.05,10200,5,0.05,10200,10200,1400-10-18,2022-01-08
800,ضفلا1164,اختيارخ فولاد-12000-1400/11/24,6,71,20687000,262,330,190,-72,-27.48,291,29,11.07,189,330,1400-10-18,2022-01-08
801,طخود2018,اختيارف خودرو-2000-1401/02/07,6,52,9283000,238,190,190,-48,-20.17,179,-59,-24.79,163,200,1400-10-18,2022-01-08
802,فردا2,صندوق س آواي فرداي زاگرس-ثابت,6,600000,600000,12144,1,1,-12143,-99.99,1,-12143,-99.99,1,1,1400-10-18,2022-01-08
803,ضفلا1162,اختيارخ فولاد-9000-1400/11/24,6,32,46513000,1797,500,1501,-296,-16.47,1454,-343,-19.09,500,1650,1400-10-18,2022-01-08
804,تملي804,تسهيلات مسكن ب. ملي-تير98,5,68,46786720,724252,688040,688040,-36212,-5,688040,-36212,-5,688040,688040,1400-10-18,2022-01-08
805,طپاس1011,اختيارف وپارس-2000-1400/10/22,5,57,5280000,60,100,100,40,66.67,93,33,55,85,100,1400-10-18,2022-01-08
806,آسام,صندوق س.آرمان سپهر آشنا-م,5,1550,184233200,119710,119200,118800,-910,-0.76,118860,-850,-0.71,118800,119200,1400-10-18,2022-01-08
807,اخزا820,اسنادخزانه-م20بودجه98-020806,5,3400,2298600000,662500,676000,676500,14000,2.11,676060,13560,2.05,676000,676500,1400-10-18,2022-01-08
808,ضترا1133,اختيارخ شتران-4411-1400/11/10,5,160,40003482,135,140,108,-27,-20,110,-25,-18.52,100,140,1400-10-18,2022-01-08
809,فارس4,صنايع پتروشيمي خليج فارس,5,4102564103,40000000004250,10740,9750,9750,-990,-9.22,9750,-990,-9.22,9750,9750,1400-10-18,2022-01-08
810,ثبات2,صندوق س. ثبات ويستا -د,5,47000000,47000000,10699,1,1,-10698,-99.99,1,-10698,-99.99,1,1,1400-10-18,2022-01-08
811,امين يكم2,صندوق درآمد ثابت امين يكم فردا,5,5000000,5000000,10079,1,1,-10078,-99.99,1,-10078,-99.99,1,1,1400-10-18,2022-01-08
812,آگاس2,صندوق س.هستي بخش آگاه-س,5,700000,700000,76591,1,1,-76590,-100,1,-76590,-100,1,1,1400-10-18,2022-01-08
813,ضكاريس900,اختيارخ كاريس-10000-14010930,5,63,317070000,5200,5490,5010,-190,-3.65,5033,-167,-3.21,5010,5490,1400-10-18,2022-01-08
814,طلا2,صندوق س.پشتوانه طلاي لوتوس,5,500000,500000,88217,1,1,-88216,-100,1,-88216,-100,1,1,1400-10-18,2022-01-08
815,ضشنا1046,اختيارخ شپنا-4360-1400/10/19,4,22,62938665,1584,1550,1600,16,1.01,1559,-25,-1.58,1550,1600,1400-10-18,2022-01-08
816,ضسپا1110,اختيارخ خساپا-1200-1400/11/20,4,45,23030000,473,511,530,57,12.05,512,39,8.25,510,530,1400-10-18,2022-01-08
817,زعف0110پ21,زعفران0110نگين ملل(پ),4,29,11683473,401319,402000,395505,-5814,-1.45,402878,1559,0.39,395020,404996,1400-10-18,2022-01-08
818,هنوري102,اختيارف ت نوري59561-01/02/15,4,60162,60162,1,1,1,0,0,1,0,0,1,1,1400-10-18,2022-01-08
819,ضشنا1047,اختيارخ شپنا-4905-1400/10/19,4,32,55899605,1002,952,956,-46,-4.59,952,-50,-4.99,951,956,1400-10-18,2022-01-08
820,ثهام,صندوق س ثروت هامرز-سهام,4,66449,714174610,10770,10750,10720,-50,-0.46,10750,-20,-0.19,10720,10900,1400-10-18,2022-01-08
821,دفاراح,ح . داروسازي‌ فارابي‌,4,8407,87432800,10640,10400,10400,-240,-2.26,10400,-240,-2.26,10400,10400,1400-10-18,2022-01-08
822,پا ه 17,بار پايه هفته 17,4,34000,17510000,385,515,515,130,33.77,515,130,33.77,515,515,1400-10-18,2022-01-08
823,ضپنا2013,اختيارخ رمپنا-14000-1401/02/07,4,24,103070000,4756,4760,4250,-506,-10.64,4295,-461,-9.69,4250,4760,1400-10-18,2022-01-08
824,ضجار2014,اختيارخ وتجارت-2500-1401/02/21,3,105,18730000,173,190,180,7,4.05,178,5,2.89,170,190,1400-10-18,2022-01-08
825,سيناد,صندوق س.سپهرسودمند سينا-د,3,1157,11595454,10021,10022,10022,1,0.01,10022,1,0.01,10022,10022,1400-10-18,2022-01-08
826,ثجوان,تامين مسكن جوانان,3,13365,59166855,4563,4427,4427,-136,-2.98,4562,-1,-0.02,4427,4427,1400-10-18,2022-01-08
827,زير0103پ01,زيره سبز0103كيميابذر(پ),3,30,30900000,1030000,1030000,1030000,0,0,1030000,0,0,1030000,1030000,1400-10-18,2022-01-08
828,ضملي1159,اختيارخ فملي-5000-1400/11/03,3,7,29600000,2067,2100,2150,83,4.02,2114,47,2.27,2100,2150,1400-10-18,2022-01-08
829,صبا1404,اجاصبابدون ضامن بارتبه اعتباري,3,150000,150000000000,1000000,1000000,1000000,0,0,1000000,0,0,1000000,1000000,1400-10-18,2022-01-08
830,كابگن,توليدي و صنعتي آبگينه‌,3,1600,10384000,6429,6490,6490,61,0.95,6490,61,0.95,6490,6490,1400-10-18,2022-01-08
831,مشهد0012,مشاركت شهرداري مشهد-3ماهه20%,3,27,27000000,995000,1000000,1000000,5000,0.5,1000000,5000,0.5,1000000,1000000,1400-10-18,2022-01-08
832,وشمال,س. چشم انداز توسعه شمال,3,288,18316800,64879,63600,63600,-1279,-1.97,63600,-1279,-1.97,63600,63600,1400-10-18,2022-01-08
833,ضخود2022,اختيارخ خودرو-4000-1401/02/07,3,101,4015000,11,15,40,29,263.64,40,29,263.64,15,40,1400-10-18,2022-01-08
834,داريك2,صندوق س.اعتماد داريك-د,3,21000000,21000000,12123,1,1,-12122,-99.99,1,-12122,-99.99,1,1,1400-10-18,2022-01-08
835,اراد45,مرابحه عام دولت4-ش.خ 0107,3,5600,5403994000,961990,964990,965000,3010,0.31,965000,3010,0.31,964990,965000,1400-10-18,2022-01-08
836,اخزا009,اسناد خزانه-م9بودجه00-031101,3,100,51790250,520380,523910,513650,-6730,-1.29,517900,-2480,-0.48,510140,523910,1400-10-18,2022-01-08
837,حگردش,ريل گردش ايرانيان,3,4233,16081167,3916,3799,3799,-117,-2.99,3916,0,0,3799,3799,1400-10-18,2022-01-08
838,وسرضوي,س.سهام عدالت استان خراسان رضوي,3,79304,54640456,725,689,689,-36,-4.97,725,0,0,689,689,1400-10-18,2022-01-08
839,خفناور,مهندسي صنعتي روان فن آور,3,441,15831900,36973,35900,35900,-1073,-2.9,35900,-1073,-2.9,35900,35900,1400-10-18,2022-01-08
840,اخزا814,اسنادخزانه-م14بودجه98-010318,3,814,745718360,915350,916010,916440,1090,0.12,916120,770,0.08,916000,916440,1400-10-18,2022-01-08
841,اوج,صندوق س.اوج دماوند-س,3,1020,10202040,10004,10002,10002,-2,-0.02,10002,-2,-0.02,10002,10002,1400-10-18,2022-01-08
842,ثعتما,س. ساختماني اعتماد گستر,3,6743,148683150,22729,22050,22050,-679,-2.99,22700,-29,-0.13,22050,22050,1400-10-18,2022-01-08
843,خساپا2,سايپا,2,100000000,168700000000,1607,1687,1687,80,4.98,1687,80,4.98,1687,1687,1400-10-18,2022-01-08
844,ضچاد2015,اختيارخ كچاد-36000-1401/02/05,2,2,400000,1,200,200,199,19900,200,199,19900,200,200,1400-10-18,2022-01-08
845,ضپاس1010,اختيارخ وپارس-1800-1400/10/22,2,40,4800000,88,120,120,32,36.36,120,32,36.36,120,120,1400-10-18,2022-01-08
846,شتولي,تولي‌پرس‌,2,1288,26017600,20564,20200,20200,-364,-1.77,20550,-14,-0.07,20200,20200,1400-10-18,2022-01-08
847,خاتم2,صندوق س خاتم ايساتيس پويا-ثابت,2,2000000,2000000,12605,1,1,-12604,-99.99,1,-12604,-99.99,1,1,1400-10-18,2022-01-08
848,صخود041,ص مرابحه خودرو041- 3ماهه 18%,2,16000,15872000000,992000,992000,992000,0,0,992000,0,0,992000,992000,1400-10-18,2022-01-08
849,اخزا9172,اسنادخزانه-م17بودجه99-010226,2,2103000,1954683900000,927500,929500,929300,1800,0.19,929474,1974,0.21,929300,929500,1400-10-18,2022-01-08
850,اخزا9182,اسنادخزانه-م18بودجه99-010323,2,766000,699204800000,914520,912800,912800,-1720,-0.19,912800,-1720,-0.19,912800,912800,1400-10-18,2022-01-08
851,ضبدر1164,اختيارخ شبندر-7000-1400/11/13,2,11,1185000,192,100,185,-7,-3.65,108,-84,-43.75,100,185,1400-10-18,2022-01-08
852,فبستم,صنايع ‌بسته‌بندي‌ مشهد,2,103,96511,910,937,937,27,2.97,937,27,2.97,937,937,1400-10-18,2022-01-08
853,ضپنا2011,اختيارخ رمپنا-10000-1401/02/07,2,10,77000000,8000,7700,7700,-300,-3.75,7700,-300,-3.75,7700,7700,1400-10-18,2022-01-08
854,ثقزوي,شركت عمران و سازندگي قزوين,2,470,10927500,23944,23250,23250,-694,-2.9,23250,-694,-2.9,23250,23250,1400-10-18,2022-01-08
855,ضپنا2010,اختيارخ رمپنا-9000-1401/02/07,2,20,173000000,8985,8650,8650,-335,-3.73,8650,-335,-3.73,8650,8650,1400-10-18,2022-01-08
856,اخزا906,اسنادخزانه-م6بودجه99-020321,2,518,383320000,740290,740000,740000,-290,-0.04,740000,-290,-0.04,740000,740000,1400-10-18,2022-01-08
857,داريك4,صندوق س.اعتماد داريك-د,2,37990000,455705600000,12123,12040,11963,-160,-1.32,11995,-128,-1.06,11963,12040,1400-10-18,2022-01-08
858,اراد334,مرابحه عام دولت3-ش.خ 0303,2,3194000,2753884367000,989990,862211,862200,-127790,-12.91,862205,-127785,-12.91,862200,862211,1400-10-18,2022-01-08
859,انار2,صندوق س.انارنماد ارزش-درسهام,2,140000,140000,9380,1,1,-9379,-99.99,1,-9379,-99.99,1,1,1400-10-18,2022-01-08
860,ثمين2,صندوق س. ثروت افزون ثمين-س,2,2000000,2000000,10299,1,1,-10298,-99.99,1,-10298,-99.99,1,1,1400-10-18,2022-01-08
861,سپرمي,پرميت‌,2,969,12025290,12295,12410,12410,115,0.94,12300,5,0.04,12410,12410,1400-10-18,2022-01-08
862,وسالت,بانك قرض الحسنه رسالت,2,101,128977,1240,1277,1277,37,2.98,1277,37,2.98,1277,1277,1400-10-18,2022-01-08
863,اراد404,مرابحه عام دولت4-ش.خ 0207,2,2024000,1875859392000,1000000,926816,926800,-73200,-7.32,926808,-73192,-7.32,926800,926816,1400-10-18,2022-01-08
864,ضذوب3000,اختيارخ ذوب-2000-1401/03/04,2,42,79800000,1900,1900,1900,0,0,1900,0,0,1900,1900,1400-10-18,2022-01-08
865,سرو2,صندوق س سروسودمند مدبران-سهام,2,690000,690000,68630,1,1,-68629,-100,1,-68629,-100,1,1,1400-10-18,2022-01-08
866,سپيدما4,صندوق س. سپيد دماوند-د,2,75025000,881306775000,11644,11771,11721,77,0.66,11747,103,0.88,11721,11771,1400-10-18,2022-01-08
867,آرمان,بيمه آرمان,1,90000,450900000,5157,5010,5010,-147,-2.85,5150,-7,-0.14,5010,5010,1400-10-18,2022-01-08
868,پست0108پ09,پسته بادامي32-30مه ولات0108(پ),1,3,6600000,2200000,2200000,2200000,0,0,2200000,0,0,2200000,2200000,1400-10-18,2022-01-08
869,صشستا311,صكوك اجاره شستا311-بدون ضامن,1,100,99000000,1005907,990000,990000,-15907,-1.58,990000,-15907,-1.58,990000,990000,1400-10-18,2022-01-08
870,ضمخا1035,اختيارخ اخابر-7000-1400/10/26,1,1,250000,479,250,250,-229,-47.81,250,-229,-47.81,250,250,1400-10-18,2022-01-08
871,زير0103پ02,زيره سبز0103 دانش(پ),1,1,1038000,1044217,1038000,1038000,-6217,-0.6,1038000,-6217,-0.6,1038000,1038000,1400-10-18,2022-01-08
872,اراد61,مرابحه عام دولت61-ش.خ0309,1,10000,10000000000,1000000,1000000,1000000,0,0,1000000,0,0,1000000,1000000,1400-10-18,2022-01-08
873,افاد54,منفعت دولت5-ش.خاص لوتوس0108,1,2000,1860000000,956410,930000,930000,-26410,-2.76,930000,-26410,-2.76,930000,930000,1400-10-18,2022-01-08
874,اراد72,مرابحه عام دولت72-ش.خ0311,1,500,470000000,944576,940000,940000,-4576,-0.48,940000,-4576,-0.48,940000,940000,1400-10-18,2022-01-08
875,اخزا0032,اسنادخزانه-م3بودجه00-030418,1,272936,157074668000,571430,575500,575500,4070,0.71,575500,4070,0.71,575500,575500,1400-10-18,2022-01-08
876,اراد55,مرابحه عام دولت5-ش.خ 0209,1,6000,5536620000,914600,922770,922770,8170,0.89,922770,8170,0.89,922770,922770,1400-10-18,2022-01-08
877,ضمخا1037,اختيارخ اخابر-9000-1400/10/26,1,20,40000,20,2,2,-18,-90,2,-18,-90,2,2,1400-10-18,2022-01-08
878,ضفرابورس1200,اختيارخ فرابورس-19000-14001218,1,1,1799000,1500,1799,1799,299,19.93,1799,299,19.93,1799,1799,1400-10-18,2022-01-08
879,ضپنا2016,اختيارخ رمپنا-20000-1401/02/07,1,2,1480000,100,740,740,640,640,740,640,640,740,740,1400-10-18,2022-01-08
880,پارتا4,مجتمع‌صنعتي‌آرتاويل‌تاير,1,400000,7624000000,19465,19060,19060,-405,-2.08,19060,-405,-2.08,19060,19060,1400-10-18,2022-01-08
881,فسديد,لوله‌وتجهيزات‌ سديد - ورشكسته,1,53,5019100,95631,94700,94700,-931,-0.97,94700,-931,-0.97,94700,94700,1400-10-18,2022-01-08
882,صشستا3112,صكوك اجاره شستا311-بدون ضامن,1,20000,19452000000,1005907,972600,972600,-33307,-3.31,972600,-33307,-3.31,972600,972600,1400-10-18,2022-01-08
883,شستان03,اجاره تجاري شستان14030915,1,5,5100000,1030000,1020000,1020000,-10000,-0.97,1020000,-10000,-0.97,1020000,1020000,1400-10-18,2022-01-08
884,ضصاد3014,اختيارخ وبصادر-1800-1401/03/11,1,1,640000,1,640,640,639,63900,640,639,63900,640,640,1400-10-18,2022-01-08
885,دقاضي2,داروسازي شهيد قاضي,1,1000000,26550000000,26438,26550,26550,112,0.42,26550,112,0.42,26550,26550,1400-10-18,2022-01-08
886,ضمخا2011,اختيارخ اخابر-4500-1401/02/28,1,32,105600000,1,3300,3300,3299,329900,3300,3299,329900,3300,3300,1400-10-18,2022-01-08
887,سيلام,سيمان‌ ايلام‌,1,1000,6500000,6840,6500,6500,-340,-4.97,6840,0,0,6500,6500,1400-10-18,2022-01-08
888,صنفت312,صكوك منفعت نفت312-6ماهه 18/5%,1,2000,1980000000,994950,990000,990000,-4950,-0.5,990000,-4950,-0.5,990000,990000,1400-10-18,2022-01-08
889,ضمخا1036,اختيارخ اخابر-8000-1400/10/26,1,10,710000,100,71,71,-29,-29,71,-29,-29,71,71,1400-10-18,2022-01-08
890,كارا2,صندوق س. كارا -د,1,8600000,8600000,10511,1,1,-10510,-99.99,1,-10510,-99.99,1,1,1400-10-18,2022-01-08
891,ضغدر1131,اختيارخ وغدير-12000-1400/11/20,1,3,10500000,3495,3500,3500,5,0.14,3500,5,0.14,3500,3500,1400-10-18,2022-01-08
892,نگين,ص.س. زمين و ساختمان نگين شهرري,1,400,20732000,51830,51830,51830,0,0,51830,0,0,51830,51830,1400-10-18,2022-01-08
893,شرق1400,مشاركت ليزينگ ايران وشرق140010,1,10,10000000,1000000,1000000,1000000,0,0,1000000,0,0,1000000,1000000,1400-10-18,2022-01-08
894,اراد554,مرابحه عام دولت5-ش.خ 0209,1,90000,84798000000,914600,942200,942200,27600,3.02,942200,27600,3.02,942200,942200,1400-10-18,2022-01-08
895,تماوند2,تامين سرمايه دماوند,1,17500000,103250000000,5830,5900,5900,70,1.2,5900,70,1.2,5900,5900,1400-10-18,2022-01-08
896,اراد854,مرابحه عام دولت85-ش.خ010704,1,4000000,3906660000000,968000,976665,976665,8665,0.9,976665,8665,0.9,976665,976665,1400-10-18,2022-01-08
897,سفارود,كارخانه فارسيت درود,1,400,5420000,13821,13550,13550,-271,-1.96,13550,-271,-1.96,13550,13550,1400-10-18,2022-01-08
898,كرماشا2,صنايع پتروشيمي كرمانشاه,1,600000,33825000000,55270,56375,56375,1105,2,56375,1105,2,56375,56375,1400-10-18,2022-01-08
899,وگردش2,بانك گردشگري,1,49900000,505986000000,10235,10140,10140,-95,-0.93,10140,-95,-0.93,10140,10140,1400-10-18,2022-01-08
900,صگل309,صكوك اجاره گل گهر309-3ماهه20%,1,1000,1076000000,1100000,1076000,1076000,-24000,-2.18,1076000,-24000,-2.18,1076000,1076000,1400-10-18,2022-01-08
901,كمند2,صندوق س. با درآمد ثابت كمند,1,96700000,96700000,10168,1,1,-10167,-99.99,1,-10167,-99.99,1,1,1400-10-18,2022-01-08
902,شگويات.ف0104,اختيارف.تبعي شگويا010408,1,10000,10000,1,1,1,0,0,1,0,0,1,1,1400-10-18,2022-01-08
903,پارند4,صندوق س. پارند پايدار سپهر,1,27000000,270432000000,10167,10016,10016,-151,-1.49,10016,-151,-1.49,10016,10016,1400-10-18,2022-01-08
904,شجم2,صنايع پتروشيمي تخت جمشيد,1,64498556,779787542040,11994,12090,12090,96,0.8,12090,96,0.8,12090,12090,1400-10-18,2022-01-08
905,تفيرو,مهندسي فيروزا,1,512,9943040,19048,19420,19420,372,1.95,19050,2,0.01,19420,19420,1400-10-18,2022-01-08
906,ضفلا1160,اختيارخ فولاد-7000-1400/11/24,1,2,6044000,3600,3022,3022,-578,-16.06,3022,-578,-16.06,3022,3022,1400-10-18,2022-01-08
907,پست0108پ10,پسته فندقي34-32مه ولات0108(پ),1,10,21500000,2150000,2150000,2150000,0,0,2150000,0,0,2150000,2150000,1400-10-18,2022-01-08
908,اخزا8122,اسنادخزانه-م12بودجه98-001111,1,100000,98700000000,986390,987000,987000,610,0.06,987000,610,0.06,987000,987000,1400-10-18,2022-01-08
909,ضترا1134,اختيارخ شتران-5294-1400/11/10,1,20,1133500,30,25,25,-5,-16.67,25,-5,-16.67,25,25,1400-10-18,2022-01-08
910,مبين011,اجاره اعتماد مبين لوتوس010710,1,1000,961100000,970000,961100,961100,-8900,-0.92,961100,-8900,-0.92,961100,961100,1400-10-18,2022-01-08
911,ملت2,بيمه ملت,1,50000000,59650000000,1202,1193,1193,-9,-0.75,1193,-9,-0.75,1193,1193,1400-10-18,2022-01-08
912,پا ر 1,بار پايه روز 1,1,1250,650000,730,520,520,-210,-28.77,520,-210,-28.77,520,520,1400-10-18,2022-01-08
913,ضكاريس901,اختيارخ كاريس-12000-14010930,1,1,5490000,4000,5490,5490,1490,37.25,5490,1490,37.25,5490,5490,1400-10-18,2022-01-08
914,وخاور2,بانك خاورميانه,1,20000000,100000000000,4984,5000,5000,16,0.32,5000,16,0.32,5000,5000,1400-10-18,2022-01-08
915,افران2,صندوق س افرا نماد پايدار-ثابت,1,17000000,17000000,15170,1,1,-15169,-99.99,1,-15169,-99.99,1,1,1400-10-18,2022-01-08
916,زرين2,صندوق س. سهام زرين كوروش-س,1,200000,200000,12695,1,1,-12694,-99.99,1,-12694,-99.99,1,1,1400-10-18,2022-01-08
917,هپارس102,اختيارف ت پارس-157010-01/02/05,1,15000,15000,1,1,1,0,0,1,0,0,1,1,1400-10-18,2022-01-08
918,ضغدر1132,اختيارخ وغدير-14000-1400/11/20,1,10,13500000,2240,1350,1350,-890,-39.73,1350,-890,-39.73,1350,1350,1400-10-18,2022-01-08
919,فولاد2,فولاد مباركه اصفهان,1,3190000,33839520000,10400,10608,10608,208,2,10608,208,2,10608,10608,1400-10-18,2022-01-08
920,هفارس014,اختيارف ت فارس11832-1401/04/12,1,36000,36000,1,1,1,0,0,1,0,0,1,1,1400-10-18,2022-01-08
921,پست0108پ08,پسته فندقي32-30مه ولات0108(پ),1,3,6626316,2223658,2208772,2208772,-14886,-0.67,2208772,-14886,-0.67,2208772,2208772,1400-10-18,2022-01-08
922,شكف,كف,1,62,5136700,84523,82850,82850,-1673,-1.98,82850,-1673,-1.98,82850,82850,1400-10-18,2022-01-08
923,اراد38,مرابحه عام دولت3-ش.خ 0105,1,1000,970000000,952050,970000,970000,17950,1.89,970000,17950,1.89,970000,970000,1400-10-18,2022-01-08
924,حاريا,كشتيراني آريا,1,400,5268000,13438,13170,13170,-268,-1.99,13170,-268,-1.99,13170,13170,1400-10-18,2022-01-08
925,ضفلا1166,اختيارخ فولاد-16000-1400/11/24,1,10,500000,50,50,50,0,0,50,0,0,50,50,1400-10-18,2022-01-08
