,نماد,نام,تعداد,حجم,ارزش,دیروز,اولین,آخرین معامله - مقدار,آخرین معامله - تغییر,آخرین معامله - درصد,قیمت پایانی - مقدار,قیمت پایانی - تغییر,قیمت پایانی - درصد,کمترین,بیشترین,تاریخ,gregorian_date
0,سپيد,سپيد ماكيان,36236,2540662,67556202580,25330,26590,26590,1260,4.97,26590,1260,4.97,26590,26590,1400-5-5,2021-07-27
1,شستا,سرمايه گذاري تامين اجتماعي,25932,120555980,1503472244520,12960,12960,12340,-620,-4.78,12470,-490,-3.78,12320,12960,1400-5-5,2021-07-27
2,لطيف,محصولات كاغذي لطيف,23023,2693200,164045472017,63787,62300,60598,-3189,-5,60911,-2876,-4.51,60598,62355,1400-5-5,2021-07-27
3,پالايش,صندوق پالايشي يكم-سهام,19603,14901047,1043913709900,71290,70650,69610,-1680,-2.36,70060,-1230,-1.73,69570,70900,1400-5-5,2021-07-27
4,بركت,گروه دارويي بركت,18203,34268969,1303854369740,39570,38850,38110,-1460,-3.69,38050,-1520,-3.84,37600,39000,1400-5-5,2021-07-27
5,فگستر,گسترش صنايع روي ايرانيان,17880,8483640,124859274764,15186,15200,14800,-386,-2.54,14718,-468,-3.08,14442,15210,1400-5-5,2021-07-27
6,ذوب,سهامي ذوب آهن  اصفهان,17146,465174208,1839275166888,3791,3980,3899,108,2.85,3954,163,4.3,3852,3980,1400-5-5,2021-07-27
7,ولكار,ليزينگ كارآفرين,15992,10988094,44797383743,4235,4235,4024,-211,-4.98,4077,-158,-3.73,4024,4235,1400-5-5,2021-07-27
8,گدنا,تهيه توزيع غذاي دنا آفرين فدك,15945,5632502,119795364037,21795,21765,21050,-745,-3.42,21269,-526,-2.41,20706,22386,1400-5-5,2021-07-27
9,ومدير,گ.مديريت ارزش سرمايه ص ب كشوري,15393,43478100,179536808779,4272,4211,4089,-183,-4.28,4129,-143,-3.35,4085,4270,1400-5-5,2021-07-27
10,بوعلي,پتروشيمي بوعلي سينا,13887,13550816,749420555400,53030,53900,55680,2650,5,55300,2270,4.28,53560,55680,1400-5-5,2021-07-27
11,دارا يكم,صندوق واسطه گري مالي يكم-سهام,13561,5989958,703389663030,120510,119110,116000,-4510,-3.74,117430,-3080,-2.56,115100,120000,1400-5-5,2021-07-27
12,فولاد,فولاد مباركه اصفهان,13499,106614974,1123802677170,10790,10760,10420,-370,-3.43,10540,-250,-2.32,10410,10800,1400-5-5,2021-07-27
13,خساپا,سايپا,13397,503251215,870031288074,1809,1774,1719,-90,-4.98,1729,-80,-4.42,1719,1810,1400-5-5,2021-07-27
14,غكورش,صنعت غذايي كورش,12464,10342580,422796643580,41380,41800,39810,-1570,-3.79,40880,-500,-1.21,39710,42500,1400-5-5,2021-07-27
15,فتوسا,توليد و توسعه سرب روي ايرانيان,11723,5851651,85293759948,15150,15220,14393,-757,-5,14576,-574,-3.79,14393,15220,1400-5-5,2021-07-27
16,اپال,فرآوري معدني اپال كاني پارس,11715,6742735,143080178270,20860,21000,21250,390,1.87,21220,360,1.73,20800,21660,1400-5-5,2021-07-27
17,نوري,پتروشيمي نوري,10769,8218048,686905532080,80730,82780,83880,3150,3.9,83580,2850,3.53,81500,84760,1400-5-5,2021-07-27
18,كرمان,س. توسعه و عمران استان كرمان,10539,352161778,452608102165,1345,1315,1278,-67,-4.98,1285,-60,-4.46,1278,1330,1400-5-5,2021-07-27
19,كاما,باما,9751,62568375,750233032470,12470,12300,11850,-620,-4.97,11990,-480,-3.85,11850,12600,1400-5-5,2021-07-27
20,شپنا,پالايش نفت اصفهان,9199,65762226,781291907140,12560,11940,11860,-700,-5.57,11880,-680,-5.41,11710,12100,1400-5-5,2021-07-27
21,ومعادن,توسعه‌معادن‌وفلزات‌,8990,170606013,1848287471360,10370,10560,10550,180,1.74,10830,460,4.44,10360,10880,1400-5-5,2021-07-27
22,شاروم,پتروشيمي اروميه,8852,5215194,80290904225,15411,15790,15060,-351,-2.28,15396,-15,-0.1,14641,16020,1400-5-5,2021-07-27
23,زملارد,كشاورزي و دامپروري ملارد شير,8826,5786731,180481252608,29794,30800,31283,1489,5,31189,1395,4.68,30020,31283,1400-5-5,2021-07-27
24,چخزر,صنايع چوب خزر كاسپين,8458,2549118,102059416053,40008,41298,38801,-1207,-3.02,40037,29,0.07,38300,41690,1400-5-5,2021-07-27
25,شگويا,پتروشيمي تندگويان,7799,40739574,443414572523,10867,10971,10820,-47,-0.43,10884,17,0.16,10601,11165,1400-5-5,2021-07-27
26,غگل,گلوكوزان‌,7515,98333828,366852639228,3674,3857,3630,-44,-1.2,3731,57,1.55,3550,3857,1400-5-5,2021-07-27
27,وخارزم,سرمايه گذاري خوارزمي,7122,66858408,396469782260,6030,6100,5860,-170,-2.82,5930,-100,-1.66,5730,6250,1400-5-5,2021-07-27
28,خگستر,گسترش‌سرمايه‌گذاري‌ايران‌خودرو,7092,198499532,514117625758,2709,2667,2574,-135,-4.98,2590,-119,-4.39,2574,2679,1400-5-5,2021-07-27
29,كدما,معدني‌ دماوند,7013,3257002,621543665390,182530,191650,191650,9120,5,190830,8300,4.55,177000,191650,1400-5-5,2021-07-27
30,كزغال,زغال سنگ پروده طبس,6709,3398405,113615119974,34549,34210,32880,-1669,-4.83,33432,-1117,-3.23,32831,34250,1400-5-5,2021-07-27
31,فاهواز,نورد و لوله اهواز,6666,43709470,327561441593,7455,7381,7529,74,0.99,7494,39,0.52,7381,7529,1400-5-5,2021-07-27
32,هاي وب,داده گسترعصرنوين-هاي وب,6427,57504007,513849374550,9080,9070,8780,-300,-3.3,8940,-140,-1.54,8690,9150,1400-5-5,2021-07-27
33,كچاد,معدني‌وصنعتي‌چادرملو,6412,31185690,864909503790,26580,26940,27400,820,3.09,27730,1150,4.33,26940,27900,1400-5-5,2021-07-27
34,فاراكح,ح . ماشين‌ سازي‌ اراك‌,6386,181361263,168613795282,1020,999,918,-102,-10,930,-90,-8.82,918,999,1400-5-5,2021-07-27
35,پترول,گ.س.وت.ص.پتروشيمي خليج فارس,6238,33689772,319204684830,9600,9590,9370,-230,-2.4,9470,-130,-1.35,9290,9800,1400-5-5,2021-07-27
36,ثبهساز,بهساز كاشانه تهران,6039,27469232,59921991485,2212,2150,2132,-80,-3.62,2181,-31,-1.4,2110,2265,1400-5-5,2021-07-27
37,كگل,معدني و صنعتي گل گهر,5817,70604858,1456105422660,19680,20070,20610,930,4.73,20620,940,4.78,19850,20660,1400-5-5,2021-07-27
38,آريا,پليمر آريا ساسول,5639,3688430,334797100471,90974,91450,90992,18,0.02,90770,-204,-0.22,89660,91700,1400-5-5,2021-07-27
39,رافزا,رايان هم افزا,5479,973332,72653182821,78106,77200,74460,-3646,-4.67,74644,-3462,-4.43,74201,77221,1400-5-5,2021-07-27
40,غزر,صنعتي زر ماكارون,5465,2913420,66969415480,23730,23450,22560,-1170,-4.93,22990,-740,-3.12,22560,23980,1400-5-5,2021-07-27
41,كمند,صندوق س. با درآمد ثابت كمند,5366,223163093,2257436361414,10110,10115,10115,5,0.05,10116,6,0.06,10115,10117,1400-5-5,2021-07-27
42,سيتا,سرمايه گذاري سيمان تامين,5244,10227441,149823096790,15070,14900,14560,-510,-3.38,14650,-420,-2.79,14320,15000,1400-5-5,2021-07-27
43,كالا,بورس كالاي ايران,5220,12118897,276517584640,22760,22760,22020,-740,-3.25,22820,60,0.26,21910,23850,1400-5-5,2021-07-27
44,ثاميد,توسعه و عمران اميد,5169,33179884,54977232698,1716,1702,1633,-83,-4.84,1657,-59,-3.44,1631,1718,1400-5-5,2021-07-27
45,فروي,ذوب روي اصفهان,4987,7551154,240185921988,33251,31950,31589,-1662,-5,31808,-1443,-4.34,31589,33060,1400-5-5,2021-07-27
46,امين يكم,صندوق درآمد ثابت امين يكم فردا,4973,153154515,1533392272763,10010,10015,10011,1,0.01,10012,2,0.02,10005,10016,1400-5-5,2021-07-27
47,وسپهر,سرمايه گذاري مالي سپهرصادرات,4837,15132284,140583966091,9279,9293,9290,11,0.12,9290,11,0.12,9290,9301,1400-5-5,2021-07-27
48,وكبهمن,مديريت سرمايه گذاري كوثربهمن,4766,1901604,20613654507,11115,10940,10835,-280,-2.52,10840,-275,-2.47,10771,11280,1400-5-5,2021-07-27
49,آبادا,توليد نيروي برق آبادان,4764,4182814,56076403840,13150,12810,13120,-30,-0.23,13410,260,1.98,12570,13750,1400-5-5,2021-07-27
50,خپارس,پارس‌ خودرو,4602,207932986,239655477320,1198,1185,1139,-59,-4.92,1153,-45,-3.76,1139,1194,1400-5-5,2021-07-27
51,شتران,پالايش نفت تهران,4545,35533067,329994978220,9920,9300,9270,-650,-6.55,9290,-630,-6.35,9180,9450,1400-5-5,2021-07-27
52,خكاوه,سايپا ديزل,4496,103073297,464871337538,4447,4580,4324,-123,-2.77,4510,63,1.42,4314,4580,1400-5-5,2021-07-27
53,وتجارت,بانك تجارت,4070,148610187,380061448801,2727,2530,2649,-78,-2.86,2557,-170,-6.23,2490,2650,1400-5-5,2021-07-27
54,سدور,سيمان‌ دورود,4051,30810159,302992611000,9530,9200,10000,470,4.93,9830,300,3.15,9200,10000,1400-5-5,2021-07-27
55,وپارس,بانك‌پارسيان‌,4026,86815234,232827905023,2795,2720,2656,-139,-4.97,2682,-113,-4.04,2656,2779,1400-5-5,2021-07-27
56,ولپارس,ليزينگ پارسيان,4005,4782283,19470983869,4173,4100,4061,-112,-2.68,4071,-102,-2.44,4050,4130,1400-5-5,2021-07-27
57,بپيوند,برق و انرژي پيوندگستر پارس,3903,2628089,30625198052,12073,11850,11470,-603,-4.99,11653,-420,-3.48,11470,11900,1400-5-5,2021-07-27
58,تسه0004,امتيازتسهيلات مسكن تير1400,3851,100499,59878530652,600947,592000,599200,-1747,-0.29,595812,-5135,-0.85,585051,610000,1400-5-5,2021-07-27
59,امين,تامين سرمايه امين,3810,2600624,19584325110,7520,7530,7540,20,0.27,7530,10,0.13,7520,7540,1400-5-5,2021-07-27
60,غچين,كشت‌ و صنعت‌ چين‌ چين,3568,17323913,334471566350,18750,19240,18630,-120,-0.64,19310,560,2.99,18200,19680,1400-5-5,2021-07-27
61,كاوه,فولاد كاوه جنوب كيش,3516,21554220,386760426600,18760,19000,17830,-930,-4.96,17940,-820,-4.37,17830,19000,1400-5-5,2021-07-27
62,تاپيكو,س. نفت و گاز و پتروشيمي تأمين,3508,33823688,462593282930,14220,14190,13610,-610,-4.29,13680,-540,-3.8,13510,14190,1400-5-5,2021-07-27
63,وسخوز,شركت س استان خوزستان,3501,206244971,102702204939,519,505,494,-25,-4.82,498,-21,-4.05,494,514,1400-5-5,2021-07-27
64,وسكرمان,س.سهام عدالت استان كرمان,3492,205834284,102286975129,518,502,494,-24,-4.63,497,-21,-4.05,493,514,1400-5-5,2021-07-27
65,غگيلا,شيرپاستوريزه پگاه گيلان,3418,5745220,111664607246,20243,20500,19231,-1012,-5,19436,-807,-3.99,19231,20500,1400-5-5,2021-07-27
66,بگيلان,توسعه مسير برق گيلان,3400,581757,11803688985,20986,20986,20200,-786,-3.75,20750,-236,-1.12,20020,20999,1400-5-5,2021-07-27
67,فخوز,فولاد  خوزستان,3285,17421369,274040180430,15940,16230,15580,-360,-2.26,15730,-210,-1.32,15400,16230,1400-5-5,2021-07-27
68,حكشتي,كشتيراني جمهوري اسلامي ايران,3262,17828061,312544946380,18320,18000,17410,-910,-4.97,17530,-790,-4.31,17410,18310,1400-5-5,2021-07-27
69,شفن,پتروشيمي فناوران,3227,740423,242267346550,313790,319900,323500,9710,3.09,327200,13410,4.27,318000,329470,1400-5-5,2021-07-27
70,وپويا,سرمايه گذاري پويا,3225,6050697,26805496302,4598,4460,4382,-216,-4.7,4430,-168,-3.65,4369,4543,1400-5-5,2021-07-27
71,غنوش,نوش‌ مازندران‌,3181,3403067,132526264260,38670,39530,37750,-920,-2.38,38940,270,0.7,37000,40370,1400-5-5,2021-07-27
72,خزر,فنرسازي‌زر,3125,10274863,201678407380,20520,20700,19500,-1020,-4.97,19630,-890,-4.34,19500,20700,1400-5-5,2021-07-27
73,صبا,سرمايه گذاري صبا تامين,3101,12772029,110489385280,8738,8645,8610,-128,-1.46,8655,-83,-0.95,8550,8890,1400-5-5,2021-07-27
74,شغدير,پتروشيمي غدير,3071,4598424,342384719980,71460,74990,74280,2820,3.95,74460,3000,4.2,73000,75030,1400-5-5,2021-07-27
75,غمهرا,توليدي‌مهرام‌,3060,3870579,270477870480,107040,70000,67960,-39080,-36.51,69880,-37160,-34.72,66500,73500,1400-5-5,2021-07-27
76,كيان,صندوق س. با درآمد ثابت كيان,3011,57778187,1710390508617,29584,29599,29602,18,0.06,29603,19,0.06,29593,29606,1400-5-5,2021-07-27
77,حفاري,حفاري شمال,3001,47340240,294153963170,6520,6200,6200,-320,-4.91,6210,-310,-4.75,6200,6320,1400-5-5,2021-07-27
78,ختور,رادياتور ايران‌,2988,10739574,208295987780,19070,18510,19000,-70,-0.37,19400,330,1.73,18510,20000,1400-5-5,2021-07-27
79,وسديد,گروه ‌صنعتي‌سديد,2941,57348411,94421835461,2783,1670,1637,-1146,-41.18,1646,-1137,-40.86,1637,1670,1400-5-5,2021-07-27
80,وآيند,بانك  آينده,2920,14964074,175922523382,11700,11880,11330,-370,-3.16,11756,56,0.48,11242,12100,1400-5-5,2021-07-27
81,فارس,صنايع پتروشيمي خليج فارس,2828,35550599,374720011610,10610,10710,10390,-220,-2.07,10540,-70,-0.66,10300,10760,1400-5-5,2021-07-27
82,مداران,داده‌پردازي‌ايران‌,2684,7168395,178576731010,24440,23230,24730,290,1.19,24910,470,1.92,23230,25660,1400-5-5,2021-07-27
83,پيزد,مجتمع صنايع لاستيك يزد,2649,673321,45949600532,68647,69000,68647,0,0,68243,-404,-0.59,65215,69819,1400-5-5,2021-07-27
84,سيمرغ,سيمرغ,2596,11470217,205976084520,17290,18150,17770,480,2.78,17960,670,3.88,17410,18150,1400-5-5,2021-07-27
85,جم پيلن,پلي پروپيلن جم - جم پيلن,2549,8533130,759939197600,84820,89060,89060,4240,5,89060,4240,5,86610,89060,1400-5-5,2021-07-27
86,وغدير,سرمايه‌گذاري‌غدير(هلدينگ‌,2543,19723712,253918755690,13060,13050,12790,-270,-2.07,12870,-190,-1.45,12750,13060,1400-5-5,2021-07-27
87,اعتماد,صندوق س.اعتماد آفرين پارسيان-د,2525,67065300,2531708479500,37732,37750,37749,17,0.05,37750,18,0.05,37749,37752,1400-5-5,2021-07-27
88,خرينگ,رينگ‌سازي‌مشهد,2518,4873194,168538158030,34330,36000,33600,-730,-2.13,34580,250,0.73,32620,36040,1400-5-5,2021-07-27
89,شبهرن,نفت‌ بهران‌,2517,12193866,172361492380,13630,14310,13960,330,2.42,14140,510,3.74,13750,14310,1400-5-5,2021-07-27
90,وخارزمح,ح.سرمايه گذاري خوارزمي,2502,200261512,863697910122,4700,5170,4230,-470,-10,4313,-387,-8.23,4230,5170,1400-5-5,2021-07-27
91,ثاخت,بين‌المللي‌توسعه‌ساختمان,2497,49316758,115006379806,2388,2425,2290,-98,-4.1,2332,-56,-2.35,2269,2450,1400-5-5,2021-07-27
92,دلقما,دارويي‌ لقمان‌,2465,3833776,164656572850,42700,44700,42740,40,0.09,42950,250,0.59,40720,44830,1400-5-5,2021-07-27
93,زكوثر,سرمايه گذاري كشاورزي كوثر,2447,4626121,84805723960,18460,18920,17920,-540,-2.93,18330,-130,-0.7,17800,18920,1400-5-5,2021-07-27
94,فاراك,ماشين‌ سازي‌ اراك‌,2430,61927785,120976755040,2045,2040,1943,-102,-4.99,1954,-91,-4.45,1943,2040,1400-5-5,2021-07-27
95,ماديرا,صنايع ماديران,2351,17690120,126713225500,7453,7310,7081,-372,-4.99,7163,-290,-3.89,7081,7450,1400-5-5,2021-07-27
96,سفارس,سيمان فارس و خوزستان,2345,14374443,300293313190,21660,21050,20700,-960,-4.43,20890,-770,-3.55,20580,21600,1400-5-5,2021-07-27
97,ودي,بيمه  دي,2290,13243576,113132077953,8704,8755,8346,-358,-4.11,8542,-162,-1.86,8269,9050,1400-5-5,2021-07-27
98,اخابر,مخابرات ايران,2203,24953659,220222820850,9200,9100,8750,-450,-4.89,8830,-370,-4.02,8740,9160,1400-5-5,2021-07-27
99,تابا,تابان نيرو سپاهان,2199,3611462,122893414973,33343,34343,34343,1000,3,34029,686,2.06,32343,34343,1400-5-5,2021-07-27
100,وبانك,سرمايه گذاري گروه توسعه ملي,2185,25523555,203918592640,8060,8140,7890,-170,-2.11,7990,-70,-0.87,7810,8340,1400-5-5,2021-07-27
101,واميد,گروه مديريت سرمايه گذاري اميد,2181,35381193,406309536510,10970,11120,11380,410,3.74,11480,510,4.65,11120,11510,1400-5-5,2021-07-27
102,فباهنر,مس‌ شهيدباهنر,2163,5932588,143795001070,23300,24120,24000,700,3,24240,940,4.03,23670,24460,1400-5-5,2021-07-27
103,فملي,ملي‌ صنايع‌ مس‌ ايران‌,2095,20647804,255916556250,12370,12370,12480,110,0.89,12390,20,0.16,12370,12500,1400-5-5,2021-07-27
104,ميهن,بيمه ميهن,2079,22853721,93141130052,3989,4068,4103,114,2.86,4076,87,2.18,3992,4177,1400-5-5,2021-07-27
105,حفارس,حمل و نقل بين المللي خليج فارس,2057,22679167,80674037298,3711,3580,3526,-185,-4.99,3557,-154,-4.15,3526,3700,1400-5-5,2021-07-27
106,خزاميا,زامياد,2027,21277325,143491398500,6990,7010,6650,-340,-4.86,6740,-250,-3.58,6650,7080,1400-5-5,2021-07-27
107,كگهر,سنگ آهن گهرزمين,2014,10392238,462884635767,42438,43750,44559,2121,5,44541,2103,4.96,43100,44559,1400-5-5,2021-07-27
108,بترانس,ايران‌ ترانسفو,1993,40828437,96661241350,2452,2411,2330,-122,-4.98,2367,-85,-3.47,2330,2450,1400-5-5,2021-07-27
109,فاسمين,كالسيمين‌,1984,8396812,133594303880,16350,16500,15560,-790,-4.83,15910,-440,-2.69,15550,16500,1400-5-5,2021-07-27
110,زمگسا,كشاورزي‌ ودامپروي‌ مگسال‌,1979,2782800,74465608950,26240,26800,26370,130,0.5,26760,520,1.98,26300,27100,1400-5-5,2021-07-27
111,ثفارس,عمران‌وتوسعه‌فارس‌,1947,13483658,96131703040,7410,7410,7040,-370,-4.99,7130,-280,-3.78,7040,7500,1400-5-5,2021-07-27
112,زاگرس,پتروشيمي زاگرس,1945,653322,139744883134,211942,218990,211880,-62,-0.03,213899,1957,0.92,208100,218990,1400-5-5,2021-07-27
113,قنيشا,قند  نيشابور,1939,3273174,190173187590,60470,61000,59840,-630,-1.04,58100,-2370,-3.92,57450,61100,1400-5-5,2021-07-27
114,كبافق,معادن‌ بافق‌,1927,2194233,82458960590,37650,38690,36670,-980,-2.6,37580,-70,-0.19,35980,38690,1400-5-5,2021-07-27
115,غسالم,سالمين‌,1923,21213394,74785898643,3582,3620,3425,-157,-4.38,3525,-57,-1.59,3403,3659,1400-5-5,2021-07-27
116,شبصير,توليدات پتروشيمي قائد بصير,1892,2689715,230085134377,88760,85500,84500,-4260,-4.8,85543,-3217,-3.62,84322,89000,1400-5-5,2021-07-27
117,وبصادر,بانك صادرات ايران,1873,53201548,111788887616,2222,2120,2092,-130,-5.85,2102,-120,-5.4,2078,2123,1400-5-5,2021-07-27
118,ونوين,بانك‌اقتصادنوين‌,1870,39091349,182209056840,4811,4713,4586,-225,-4.68,4661,-150,-3.12,4571,4770,1400-5-5,2021-07-27
119,وپاسار,بانك  پاسارگاد,1864,23446948,359351686040,15320,15620,15340,20,0.13,15330,10,0.07,15100,15620,1400-5-5,2021-07-27
120,هرمز,فولاد هرمزگان جنوب,1859,11603253,170288619356,15272,15000,14576,-696,-4.56,14676,-596,-3.9,14509,15190,1400-5-5,2021-07-27
121,وسلرستا,شركت س استان لرستان,1857,107637522,53780161168,523,510,498,-25,-4.78,500,-23,-4.4,497,515,1400-5-5,2021-07-27
122,شپديس,پتروشيمي پرديس,1857,1506806,205486182910,136380,137500,136550,170,0.12,136370,-10,-0.01,134000,138500,1400-5-5,2021-07-27
123,تيپيكو,سرمايه گذاري دارويي تامين,1838,8514542,171008379280,20170,20490,19840,-330,-1.64,20080,-90,-0.45,19500,20500,1400-5-5,2021-07-27
124,تليسه,دامداري تليسه نمونه,1775,18228488,61613222020,3400,3509,3278,-122,-3.59,3380,-20,-0.59,3253,3509,1400-5-5,2021-07-27
125,آسيا,بيمه آسيا,1760,40399130,73979819621,1809,1807,1805,-4,-0.22,1831,22,1.22,1775,1879,1400-5-5,2021-07-27
126,ولغدر,ليزينگ‌خودروغدير,1757,3381498,68665010260,20300,21170,20050,-250,-1.23,20310,10,0.05,19330,21170,1400-5-5,2021-07-27
127,وسهرمز,شركت س استان هرمزگان,1752,98784952,49286497512,523,515,497,-26,-4.97,499,-24,-4.59,497,530,1400-5-5,2021-07-27
128,افق,فروشگاههاي زنجيره اي افق كوروش,1750,2365943,142191184310,61850,60500,61150,-700,-1.13,60100,-1750,-2.83,59000,62500,1400-5-5,2021-07-27
129,سبهان,سيمان‌ بهبهان‌,1716,1251395,88851501940,73560,69890,69890,-3670,-4.99,71000,-2560,-3.48,69890,73960,1400-5-5,2021-07-27
130,خودكفا,اقتصادي و خودكفايي آزادگان,1710,7628278,122599391514,16281,16750,15793,-488,-3,16072,-209,-1.28,15793,16750,1400-5-5,2021-07-27
131,وصنا,گروه‌صنايع‌بهشهرايران‌,1695,20613009,119824105410,5570,5840,5800,230,4.13,5810,240,4.31,5640,5840,1400-5-5,2021-07-27
132,غپينو,پارس‌ مينو,1682,13779304,78718236460,5950,5970,5660,-290,-4.87,5710,-240,-4.03,5660,5970,1400-5-5,2021-07-27
133,شاوان,پالايش نفت لاوان,1663,2821081,264046258728,91963,93200,92990,1027,1.12,93598,1635,1.78,92000,97490,1400-5-5,2021-07-27
134,فاذر,صنايع‌ آذرآب‌,1611,61175655,79369939950,1353,1360,1286,-67,-4.95,1297,-56,-4.14,1286,1360,1400-5-5,2021-07-27
135,بكهنوج,توليد برق ماهتاب كهنوج,1599,29439771,47999543283,1683,1680,1599,-84,-4.99,1630,-53,-3.15,1599,1730,1400-5-5,2021-07-27
136,زفكا,كشت و دامداري فكا,1585,8514630,99125797578,11137,11280,11693,556,4.99,11642,505,4.53,11091,11693,1400-5-5,2021-07-27
137,ثشاهد,سرمايه‌ گذاري‌ شاهد,1580,5149605,76553258490,15330,15410,14570,-760,-4.96,14870,-460,-3,14570,15410,1400-5-5,2021-07-27
138,ساوه,سيمان ساوه,1567,1017726,54117402607,55198,54462,53840,-1358,-2.46,53175,-2023,-3.66,52651,54462,1400-5-5,2021-07-27
139,وساپا,سرمايه‌گذاري‌ سايپا,1547,19602474,97052607980,5120,5010,4870,-250,-4.88,4950,-170,-3.32,4870,5150,1400-5-5,2021-07-27
140,وگستر,گسترش سرمايه گذاري ايرانيان,1547,5998040,78467574529,13657,13890,12975,-682,-4.99,13082,-575,-4.21,12975,13890,1400-5-5,2021-07-27
141,سخاش,سيمان‌خاش‌,1542,770383,85843619110,115740,109960,109960,-5780,-4.99,111430,-4310,-3.72,109960,119300,1400-5-5,2021-07-27
142,طلا,صندوق س.پشتوانه طلاي لوتوس,1533,2140281,168662613165,77100,78182,78799,1699,2.2,78804,1704,2.21,78182,79500,1400-5-5,2021-07-27
143,پاسا,ايران‌ياساتايرورابر,1521,5323451,109815256030,20960,21170,20490,-470,-2.24,20630,-330,-1.57,19920,21670,1400-5-5,2021-07-27
144,وپترو,سرمايه‌گذاري صنايع پتروشيمي‌,1512,5560593,76128869160,13930,14000,13450,-480,-3.45,13690,-240,-1.72,13300,14240,1400-5-5,2021-07-27
145,شيران,س. صنايع‌شيميايي‌ايران,1500,3634823,87082503350,23940,23900,23570,-370,-1.55,23960,20,0.08,23500,24690,1400-5-5,2021-07-27
146,اتكاي,بيمه اتكايي ايرانيان,1492,5204979,50867164386,10074,10300,9571,-503,-4.99,9773,-301,-2.99,9571,10300,1400-5-5,2021-07-27
147,كلوند,كاشي‌ الوند,1488,4670931,106298370620,23670,23700,22490,-1180,-4.99,22760,-910,-3.84,22490,23700,1400-5-5,2021-07-27
148,بجهرم,توسعه مولد نيروگاهي جهرم,1482,22051712,55297809649,2605,2590,2475,-130,-4.99,2508,-97,-3.72,2475,2590,1400-5-5,2021-07-27
149,افرا,افرانت,1468,2776635,80656782033,28421,29841,28895,474,1.67,29048,627,2.21,27000,29841,1400-5-5,2021-07-27
150,تملت,تامين سرمايه بانك ملت,1458,7975608,38006508420,4928,4928,4750,-178,-3.61,4765,-163,-3.31,4682,4999,1400-5-5,2021-07-27
151,غاذر,كشت‌وصنعت‌پياذر,1444,1674779,52356565270,32550,33300,30930,-1620,-4.98,31260,-1290,-3.96,30930,33300,1400-5-5,2021-07-27
152,وهور,مديريت انرژي اميد  تابان هور,1434,32416931,53176635666,1702,1750,1620,-82,-4.82,1640,-62,-3.64,1617,1750,1400-5-5,2021-07-27
153,شرانل,نفت ايرانول,1430,3171206,158929279896,48230,50641,49440,1210,2.51,50116,1886,3.91,48900,50641,1400-5-5,2021-07-27
154,داسوه,داروسازي‌ اسوه‌,1420,3386045,108707137600,30650,32180,32180,1530,4.99,32100,1450,4.73,31120,32180,1400-5-5,2021-07-27
155,پارند,صندوق س. پارند پايدار سپهر,1415,53631110,602640434611,11230,11237,11237,7,0.06,11237,7,0.06,11236,11243,1400-5-5,2021-07-27
156,وتوصا,گروه س توسعه صنعتي ايران,1409,6982747,61574323290,9120,9290,8670,-450,-4.93,8820,-300,-3.29,8670,9290,1400-5-5,2021-07-27
157,سپيدما,صندوق س. سپيد دماوند-د,1405,68425199,735430979292,10741,10752,10752,11,0.1,10748,7,0.07,10747,10752,1400-5-5,2021-07-27
158,ومهان,گروه توسعه مالي مهر آيندگان,1404,6262641,87531859440,13816,13899,13812,-4,-0.03,13977,161,1.17,13700,14120,1400-5-5,2021-07-27
159,دتوزيع,توزيع دارو پخش,1384,1951051,56671256880,30124,29990,28618,-1506,-5,29047,-1077,-3.58,28618,30400,1400-5-5,2021-07-27
160,ثامان,سامان‌ گستراصفهان‌,1371,6761728,97768856530,20660,15000,14250,-6410,-31.03,14460,-6200,-30.01,14250,15000,1400-5-5,2021-07-27
161,غمارگ,مارگارين‌,1371,4861891,124247640770,24870,26110,25240,370,1.49,25560,690,2.77,24510,26110,1400-5-5,2021-07-27
162,خمحركه,نيرو محركه‌,1368,14304778,55472567328,4038,3995,3837,-201,-4.98,3878,-160,-3.96,3837,3995,1400-5-5,2021-07-27
163,ساربيل,سيمان آرتا اردبيل,1357,1733297,69731218110,42160,40600,40060,-2100,-4.98,40230,-1930,-4.58,40060,41510,1400-5-5,2021-07-27
164,دسانكو,داروسازي سبحان انكولوژي,1355,5808553,72721612230,12369,12785,12371,2,0.02,12520,151,1.22,12007,12894,1400-5-5,2021-07-27
165,ستران,سيمان‌ تهران‌,1343,3851165,96181731790,25140,24600,25010,-130,-0.52,24970,-170,-0.68,24600,25440,1400-5-5,2021-07-27
166,فسپا,گروه‌صنعتي‌سپاهان‌,1337,2582201,101003977100,40250,40900,38240,-2010,-4.99,39120,-1130,-2.81,38240,41290,1400-5-5,2021-07-27
167,بكام,كارخانجات توليدي شهيد قندي,1314,20433151,56813341366,2799,2785,2744,-55,-1.96,2780,-19,-0.68,2721,2830,1400-5-5,2021-07-27
168,غگلپا,شير پاستوريزه پگاه گلپايگان,1312,2276463,164907298232,69151,69231,72608,3457,5,72440,3289,4.76,69231,72608,1400-5-5,2021-07-27
169,حريل,ريل پردازسير,1305,12854943,48256493980,3887,3865,3693,-194,-4.99,3754,-133,-3.42,3693,3910,1400-5-5,2021-07-27
170,قچار,فراوردههاي غذايي وقند چهارمحال,1305,7078741,122425372474,18000,17100,17100,-900,-5,17295,-705,-3.92,17100,17980,1400-5-5,2021-07-27
171,وسپه,سرمايه‌گذاري‌ سپه‌,1294,20179499,163335372870,7760,7870,8010,250,3.22,8090,330,4.25,7650,8140,1400-5-5,2021-07-27
172,فسرب,ملي‌ سرب‌وروي‌ ايران‌,1292,1044613,75688440780,74130,75000,71370,-2760,-3.72,72460,-1670,-2.25,70430,75000,1400-5-5,2021-07-27
173,ثنوسا,نوسازي‌وساختمان‌تهران‌,1289,10042604,88813563230,9290,9010,8830,-460,-4.95,8840,-450,-4.84,8830,9200,1400-5-5,2021-07-27
174,شلعاب,لعابيران‌,1283,4098187,40197329880,10120,10100,9640,-480,-4.74,9810,-310,-3.06,9620,10100,1400-5-5,2021-07-27
175,زبينا,كشاورزي و دامپروري بينالود,1273,16628017,47083874432,2884,2928,2780,-104,-3.61,2832,-52,-1.8,2740,2966,1400-5-5,2021-07-27
176,سصفها,سيمان‌اصفهان‌,1262,1502676,92454217470,64050,61710,60850,-3200,-5,61530,-2520,-3.93,60850,65500,1400-5-5,2021-07-27
177,ديران,ايران‌دارو,1242,5019904,84389629960,17420,17250,16550,-870,-4.99,16810,-610,-3.5,16550,17420,1400-5-5,2021-07-27
178,شبريز,پالايش نفت تبريز,1241,4653931,145725622460,32510,31350,31280,-1230,-3.78,31310,-1200,-3.69,31030,31880,1400-5-5,2021-07-27
179,وآرين,شركت توسعه اقتصادي آرين,1239,14361358,44753314619,3195,3228,3100,-95,-2.97,3116,-79,-2.47,3100,3228,1400-5-5,2021-07-27
180,غبشهر,صنعتي‌ بهشهر,1226,6898224,175935391180,24750,25980,25400,650,2.63,25500,750,3.03,24510,25980,1400-5-5,2021-07-27
181,تيپيكوح,ح . سرمايه گذاري دارويي تامين,1215,3247068,47752343501,1000,15000,14420,13420,1342,14706,13706,1370.6,14210,15400,1400-5-5,2021-07-27
182,تاپكيش,تجارت الكترونيك پارسيان كيش,1198,4838672,70367918955,15124,15211,14368,-756,-5,14543,-581,-3.84,14368,15390,1400-5-5,2021-07-27
183,كدماح,ح . معدني‌ دماوند,1185,1214985,137728558850,124200,124820,111780,-12420,-10,113360,-10840,-8.73,111780,124820,1400-5-5,2021-07-27
184,كگاز,شيشه‌ و گاز,1175,5513660,94960291150,16580,15810,17400,820,4.95,17220,640,3.86,15810,17400,1400-5-5,2021-07-27
185,زنگان,صنعت روي زنگان,1174,756398,49738728409,65004,66000,63800,-1204,-1.85,65757,753,1.16,62821,67590,1400-5-5,2021-07-27
186,آگاس,صندوق س.هستي بخش آگاه-س,1166,1546106,113650690469,74014,74001,73300,-714,-0.96,73508,-506,-0.68,72900,74444,1400-5-5,2021-07-27
187,ونيرو,سرمايه‌گذاري‌نيرو,1156,26474779,68637315133,2689,2680,2556,-133,-4.95,2593,-96,-3.57,2555,2699,1400-5-5,2021-07-27
188,سرو,صندوق س سروسودمند مدبران-سهام,1153,1164230,80907431810,70240,70000,69000,-1240,-1.77,69490,-750,-1.07,68940,70120,1400-5-5,2021-07-27
189,سيستم,همكاران سيستم,1147,3038906,88796908140,27910,28490,29290,1380,4.94,29220,1310,4.69,28490,29300,1400-5-5,2021-07-27
190,سصوفي,سيمان‌ صوفيان‌,1146,5203738,87820543250,17560,16990,16800,-760,-4.33,16880,-680,-3.87,16690,17400,1400-5-5,2021-07-27
191,حآسا,آسيا سير ارس,1145,2450883,64636232350,27635,26700,26254,-1381,-5,26373,-1262,-4.57,26254,27587,1400-5-5,2021-07-27
192,خفنر,فنرسازي‌خاور,1140,9878881,65590767850,6870,6880,6550,-320,-4.66,6640,-230,-3.35,6530,6920,1400-5-5,2021-07-27
193,غصينو,صنعتي مينو,1140,1815090,87022589851,50133,48000,47627,-2506,-5,47944,-2189,-4.37,47627,50000,1400-5-5,2021-07-27
194,تسه0003,امتيازتسهيلات مسكن خرداد1400,1132,20787,12554850898,610887,611011,626999,16112,2.64,603976,-6911,-1.13,590000,630000,1400-5-5,2021-07-27
195,دماوند,توليد نيروي برق دماوند,1131,1808186,48528550243,27634,27895,26566,-1068,-3.86,26982,-652,-2.36,26254,27895,1400-5-5,2021-07-27
196,وملي,گروه‌ صنعتي‌ ملي‌ (هلدينگ‌,1129,365686,54072845510,147570,144200,146040,-1530,-1.04,147870,300,0.2,144200,151000,1400-5-5,2021-07-27
197,پتاير,ايران‌ تاير,1129,20977891,57533385469,2943,2800,2740,-203,-6.9,2743,-200,-6.8,2670,2800,1400-5-5,2021-07-27
198,ولشرق,ليزينگ ايران و شرق,1122,9809699,60885235577,6446,6490,6179,-267,-4.14,6207,-239,-3.71,6124,6490,1400-5-5,2021-07-27
199,وبشهر,توسعه‌ صنايع‌ بهشهر(هلدينگ,1122,13581976,155200337750,11800,12000,11210,-590,-5,11430,-370,-3.14,11210,12000,1400-5-5,2021-07-27
200,حتايد,تايدواترخاورميانه,1117,4038139,98050396210,24510,24150,24580,70,0.29,24280,-230,-0.94,23500,24700,1400-5-5,2021-07-27
201,سشرق,سيمان‌ شرق‌,1113,13113297,98010597290,7810,7510,7430,-380,-4.87,7470,-340,-4.35,7420,7810,1400-5-5,2021-07-27
202,تبرك,گروه كارخانجات صنعتي تبرك,1113,3903625,54255810742,14357,14470,13640,-717,-4.99,13899,-458,-3.19,13640,14700,1400-5-5,2021-07-27
203,كهمدا,شيشه‌ همدان‌,1112,6516253,59791506210,9570,9420,9200,-370,-3.87,9180,-390,-4.08,9100,9600,1400-5-5,2021-07-27
204,وصنعت,سرمايه گذاري توسعه صنعت وتجارت,1110,6211558,33550119850,5490,5450,5360,-130,-2.37,5400,-90,-1.64,5310,5570,1400-5-5,2021-07-27
205,كلر,كلر پارس,1110,958392,100935116705,109672,107000,104189,-5483,-5,105317,-4355,-3.97,104189,109700,1400-5-5,2021-07-27
206,ساروم,سيمان‌اروميه‌,1108,3247304,117765862770,37510,37100,36990,-520,-1.39,36270,-1240,-3.31,35640,37500,1400-5-5,2021-07-27
207,وپست,پست بانك ايران,1102,2575086,56554832090,21990,22200,21390,-600,-2.73,21960,-30,-0.14,21140,22630,1400-5-5,2021-07-27
208,غپاك,لبنيات‌ پاك‌,1094,3260070,58212623320,18120,17500,17800,-320,-1.77,17860,-260,-1.43,17500,18260,1400-5-5,2021-07-27
209,درازك,دارويي‌ رازك‌,1089,4342506,149345834650,32220,33630,34570,2350,7.29,34390,2170,6.73,33630,34890,1400-5-5,2021-07-27
210,فرآور,فرآوري‌موادمعدني‌ايران‌,1078,2839962,81991612450,30060,29500,28580,-1480,-4.92,28870,-1190,-3.96,28560,30580,1400-5-5,2021-07-27
211,فلامي,لاميران‌,1068,1190151,31966957060,27370,27930,26020,-1350,-4.93,26860,-510,-1.86,26010,28000,1400-5-5,2021-07-27
212,رانفور,خدمات‌انفورماتيك‌,1062,9777055,59068938190,6290,6320,6070,-220,-3.5,6070,-220,-3.5,5980,6320,1400-5-5,2021-07-27
213,آ س پ,آ.س.پ,1060,3957071,35931728191,9393,9470,8927,-466,-4.96,9080,-313,-3.33,8924,9470,1400-5-5,2021-07-27
214,دانا,بيمه دانا,1052,12839882,69249360390,5650,5540,5370,-280,-4.96,5390,-260,-4.6,5370,5590,1400-5-5,2021-07-27
215,نوين,بيمه نوين,1047,10687021,54677942922,5260,5260,5100,-160,-3.04,5116,-144,-2.74,5003,5300,1400-5-5,2021-07-27
216,دشيمي,شيمي‌ داروئي‌ داروپخش‌,1036,3255556,83348831920,26000,26820,25810,-190,-0.73,25600,-400,-1.54,24700,26820,1400-5-5,2021-07-27
217,ختوقا,قطعات‌ اتومبيل‌ ايران‌,1028,17698308,39249824518,2312,2309,2197,-115,-4.97,2218,-94,-4.07,2197,2350,1400-5-5,2021-07-27
218,سقاين,سيمان‌ قائن‌,1025,831509,54155597380,63350,61020,65210,1860,2.94,65130,1780,2.81,60230,66510,1400-5-5,2021-07-27
219,وجامي,سرمايه گذاري جامي,1024,3469826,44132219852,12922,12535,12535,-387,-2.99,12719,-203,-1.57,12535,13250,1400-5-5,2021-07-27
220,ثغرب,شركت سرمايه گذاري مسكن شمالغرب,1023,5569984,33937157212,6361,6430,6043,-318,-5,6093,-268,-4.21,6043,6460,1400-5-5,2021-07-27
221,سپاها,سيمان‌سپاهان‌,1018,8613994,74042708520,8840,8770,8620,-220,-2.49,8600,-240,-2.71,8440,8770,1400-5-5,2021-07-27
222,پارسان,گسترش نفت و گاز پارسيان,1014,5652486,145362040260,25950,26000,25600,-350,-1.35,25720,-230,-0.89,25560,26150,1400-5-5,2021-07-27
223,تاصيكو,سرمايه گذاري صدرتامين,1010,7955810,84130396850,10650,10750,10420,-230,-2.16,10600,-50,-0.47,10270,10800,1400-5-5,2021-07-27
224,دتماد,توليدمواداوليه‌داروپخش‌,1006,1979332,93803652510,46140,47900,46910,770,1.67,47390,1250,2.71,46520,48370,1400-5-5,2021-07-27
225,ديرانح,ح . ‌ايران‌دارو,1002,3393996,35086132900,10870,11170,10000,-870,-8,10340,-530,-4.88,9880,11170,1400-5-5,2021-07-27
226,تكشا,گسترش‌صنايع‌وخدمات‌كشاورزي‌,1002,1443070,42292568560,30180,30500,28680,-1500,-4.97,29310,-870,-2.88,28680,30690,1400-5-5,2021-07-27
227,ريشمك,توليد و صادرات ريشمك,993,1812484,84237682237,48733,48732,46297,-2436,-5,46476,-2257,-4.63,46297,48732,1400-5-5,2021-07-27
228,شسينا,صنايع‌شيميايي‌سينا,988,492304,33878701070,72190,70720,68590,-3600,-4.99,68820,-3370,-4.67,68590,71500,1400-5-5,2021-07-27
229,قاسم,قاسم ايران,985,5363279,49813174449,9716,9360,9231,-485,-4.99,9288,-428,-4.41,9231,9714,1400-5-5,2021-07-27
230,شتوكا,توكا رنگ فولاد سپاهان,985,1515647,46413091430,31386,31500,30227,-1159,-3.69,30623,-763,-2.43,30044,31968,1400-5-5,2021-07-27
231,ولساپا,ليزينگ رايان‌ سايپا,979,16661597,45686671378,2803,2850,2699,-104,-3.71,2742,-61,-2.18,2683,2850,1400-5-5,2021-07-27
232,ثرود,سرمايه‌گذاري مسكن زاينده رود,972,3817058,62069556856,16972,16972,16124,-848,-5,16261,-711,-4.19,16124,17300,1400-5-5,2021-07-27
233,ثعمرا,عمران و توسعه شاهد,964,3798124,39322636976,10677,10850,10144,-533,-4.99,10353,-324,-3.03,10144,10850,1400-5-5,2021-07-27
234,بموتو,موتوژن‌,944,976539,62056239210,65920,64600,63500,-2420,-3.67,63550,-2370,-3.6,62630,66920,1400-5-5,2021-07-27
235,وآوا,سرمايه گذاري آوا نوين,943,6452300,33914152725,5502,5411,5227,-275,-5,5256,-246,-4.47,5227,5502,1400-5-5,2021-07-27
236,خمهر,مهركام‌پارس‌,943,26326443,56214735175,2211,2115,2101,-110,-4.98,2135,-76,-3.44,2101,2250,1400-5-5,2021-07-27
237,ورنا,سرمايه‌گذاري‌ رنا(هلدينگ‌,943,18679105,84450696242,4746,4730,4509,-237,-4.99,4521,-225,-4.74,4509,4730,1400-5-5,2021-07-27
238,گكوثر,هتل پارسيان كوثر اصفهان,941,13973279,32776529632,2356,2439,2338,-18,-0.76,2346,-10,-0.42,2300,2439,1400-5-5,2021-07-27
239,وتوكا,سرمايه‌گذاري‌توكافولاد(هلدينگ,940,6036409,54335384720,9310,9190,8850,-460,-4.94,9000,-310,-3.33,8850,9440,1400-5-5,2021-07-27
240,كسعدي,كاشي‌ سعدي‌,938,2923811,34106529420,12110,11800,11510,-600,-4.95,11670,-440,-3.63,11510,12140,1400-5-5,2021-07-27
241,وايران,ليزينگ ايرانيان,937,5996923,44435446870,7480,7400,7500,20,0.27,7410,-70,-0.94,7160,7690,1400-5-5,2021-07-27
242,سهگمت,سيمان‌هگمتان‌,932,1876142,48212753740,26140,26010,26000,-140,-0.54,25700,-440,-1.68,25010,26990,1400-5-5,2021-07-27
243,شصدف,صنعتي دوده فام,931,4139147,136587711853,43582,32999,32999,-10583,-24.28,32999,-10583,-24.28,32999,32999,1400-5-5,2021-07-27
244,پكوير,كوير تاير,921,6627680,88569317200,13990,13600,13300,-690,-4.93,13360,-630,-4.5,13300,13980,1400-5-5,2021-07-27
245,سكه0012پ01,تمام سكه طرح جديد0012رفاه,913,284500,310065603200,1070398,1080122,1087890,17492,1.63,1089861,19463,1.82,1080122,1098500,1400-5-5,2021-07-27
246,رتاپ,تجارت الكترونيك  پارسيان,905,6653979,39588095110,6210,6100,5910,-300,-4.83,5950,-260,-4.19,5900,6190,1400-5-5,2021-07-27
247,حسير,ريل سير كوثر,901,6895028,147172778319,21922,21923,21000,-922,-4.21,21345,-577,-2.63,20827,23019,1400-5-5,2021-07-27
248,شجم,صنايع پتروشيمي تخت جمشيد,901,17964787,201059078391,11423,11085,11290,-133,-1.16,11192,-231,-2.02,11081,11490,1400-5-5,2021-07-27
249,خاهن,آهنگري‌ تراكتورسازي‌ ايران‌,894,3948796,32518091280,8570,8500,8150,-420,-4.9,8230,-340,-3.97,8150,8570,1400-5-5,2021-07-27
250,كفپارس,فرآورده‌هاي‌ نسوز پارس‌,880,14259912,46587042022,3367,3399,3230,-137,-4.07,3267,-100,-2.97,3230,3399,1400-5-5,2021-07-27
251,دزهراوي,داروسازي‌زهراوي‌,879,5500961,35714425060,6720,6630,6390,-330,-4.91,6490,-230,-3.42,6390,6850,1400-5-5,2021-07-27
252,ولانا,شركت ليزينگ آريا دانا,879,1228829,30622234761,25308,25471,24549,-759,-3,24920,-388,-1.53,24549,25650,1400-5-5,2021-07-27
253,دبالك,مواد اوليه دارويي البرز بالك,866,2635491,40709642002,16032,15719,15232,-800,-4.99,15447,-585,-3.65,15231,16190,1400-5-5,2021-07-27
254,قشكر,شكرشاهرود,866,10991465,31944636423,3023,2983,2872,-151,-5,2906,-117,-3.87,2872,3000,1400-5-5,2021-07-27
255,سمگا,گروه سرمايه گذاري ميراث فرهنگي,866,6198267,148592092652,23977,23001,24001,24,0.1,23973,-4,-0.02,23001,24890,1400-5-5,2021-07-27
256,وسكاب,س.ص.بازنشستگي كاركنان بانكها,857,11970086,32445326958,2769,2726,2674,-95,-3.43,2711,-58,-2.09,2670,2800,1400-5-5,2021-07-27
257,غمينو,شركت صنايع غذايي مينو شرق,854,3193996,26236076699,8554,8620,8127,-427,-4.99,8214,-340,-3.97,8127,8620,1400-5-5,2021-07-27
258,خاتم,صندوق س خاتم ايساتيس پويا-ثابت,854,46553858,539001734980,11568,11585,11582,14,0.12,11578,10,0.09,11577,11585,1400-5-5,2021-07-27
259,شپاس,نفت پاسارگاد,852,2353462,41622689508,17752,17870,17320,-432,-2.43,17686,-66,-0.37,16870,18320,1400-5-5,2021-07-27
260,سفار,سيمان‌فارس‌,840,303247,31541113310,109220,104520,103760,-5460,-5,104010,-5210,-4.77,103760,106990,1400-5-5,2021-07-27
261,زشريف,كشت وصنعت شريف آباد,837,5485865,25979294050,4735,4572,4600,-135,-2.85,4736,1,0.02,4572,4920,1400-5-5,2021-07-27
262,افران,صندوق س افرا نماد پايدار-ثابت,837,26285759,364450709902,13857,13867,13865,8,0.06,13865,8,0.06,13862,13867,1400-5-5,2021-07-27
263,ونيكي,سرمايه‌گذاري‌ ملي‌ايران‌,830,9129146,86560739370,9510,9600,9340,-170,-1.79,9480,-30,-0.32,9310,9680,1400-5-5,2021-07-27
264,بزاگرس,نيروگاه زاگرس كوثر,828,6917760,32168058200,4822,4790,4605,-217,-4.5,4650,-172,-3.57,4581,4868,1400-5-5,2021-07-27
265,همراه,شركت ارتباطات سيار ايران,828,13620809,120348242740,8420,8430,8850,430,5.11,8840,420,4.99,8430,8850,1400-5-5,2021-07-27
266,ارفع,شركت آهن و فولاد ارفع,828,2583921,36648955446,14170,14163,14328,158,1.12,14177,7,0.05,13980,14499,1400-5-5,2021-07-27
267,غويتا,ويتانا,827,2297560,22367825259,10138,10119,9632,-506,-4.99,9735,-403,-3.98,9632,10119,1400-5-5,2021-07-27
268,چافست,افست‌,826,1888962,26791630540,14180,14010,13780,-400,-2.82,14180,0,0,13700,14500,1400-5-5,2021-07-27
269,وبيمه,سرمايه‌ گذاري‌ صنعت‌ بيمه‌,826,20430888,36564230785,1802,1831,1799,-3,-0.17,1790,-12,-0.67,1761,1831,1400-5-5,2021-07-27
270,ومعلم,بيمه معلم,822,6476512,26502671236,4280,4210,4067,-213,-4.98,4092,-188,-4.39,4066,4280,1400-5-5,2021-07-27
271,خشرق,الكتريك‌ خودرو شرق‌,812,3878400,45155701370,11990,12000,11410,-580,-4.84,11640,-350,-2.92,11400,12190,1400-5-5,2021-07-27
272,چكارن,كارتن‌ ايران‌,809,11265089,29674355447,2754,2736,2617,-137,-4.97,2634,-120,-4.36,2617,2750,1400-5-5,2021-07-27
273,سخزر,سيمان‌ خزر,808,2800502,69119607590,23860,24250,24500,640,2.68,24680,820,3.44,23220,25050,1400-5-5,2021-07-27
274,دكپسول,توليد ژلاتين كپسول ايران,798,1195654,40664909308,34389,35800,34010,-379,-1.1,34011,-378,-1.1,32670,35800,1400-5-5,2021-07-27
275,شفارس,صنايع‌ شيميايي‌ فارس‌,789,20430183,40700855585,2087,2000,1983,-104,-4.98,1992,-95,-4.55,1983,2058,1400-5-5,2021-07-27
276,غشصفا,شيرپاستوريزه‌پگاه‌اصفهان‌,785,3181318,77445515530,23260,23800,24420,1160,4.99,24340,1080,4.64,23270,24420,1400-5-5,2021-07-27
277,غبهنوش,بهنوش‌ ايران‌,783,666820,42003054280,65250,66450,61990,-3260,-5,62990,-2260,-3.46,61990,66790,1400-5-5,2021-07-27
278,دتوليد,داروسازي توليد دارو,780,2071939,29210815918,14676,14810,13943,-733,-4.99,14098,-578,-3.94,13943,14820,1400-5-5,2021-07-27
279,فروس,فروسيليس‌ ايران‌,780,8996270,47160583270,5390,5250,5280,-110,-2.04,5240,-150,-2.78,5130,5440,1400-5-5,2021-07-27
280,وسگلستا,شركت س استان گلستان,764,50399657,37295746180,778,740,740,-38,-4.88,740,-38,-4.88,740,740,1400-5-5,2021-07-27
281,تسه0002,امتيازتسهيلاتمسكن ارديبهشت1400,762,15131,9126720591,608886,610000,592000,-16886,-2.77,603180,-5706,-0.94,580010,610000,1400-5-5,2021-07-27
282,وبوعلي,سرمايه‌گذاري‌بوعلي‌,754,8654408,34109014484,4108,4165,3906,-202,-4.92,3941,-167,-4.07,3903,4165,1400-5-5,2021-07-27
283,معيار ,سرمايه گذاري معيار صنعت پارس,754,691456,29788419208,42772,44000,42870,98,0.23,43081,309,0.72,41500,44055,1400-5-5,2021-07-27
284,پارس,پتروشيمي پارس,750,735370,124083913960,168730,171000,166040,-2690,-1.59,168740,10,0.01,166000,171100,1400-5-5,2021-07-27
285,وثوق,سرمايه گذاري وثوق امين,745,4869941,85596393693,17392,16871,17913,521,3,17576,184,1.06,16871,17913,1400-5-5,2021-07-27
286,سمازن,سيمان‌مازندران‌,742,3913671,54486034090,14130,13800,13850,-280,-1.98,13920,-210,-1.49,13540,14290,1400-5-5,2021-07-27
287,كنور,توسعه معدني و صنعتي صبانور,739,2024367,124170744180,58310,61100,62200,3890,6.67,61340,3030,5.2,60300,62940,1400-5-5,2021-07-27
288,واحيا,م .صنايع و معادن احياء سپاهان,734,1436654,251855787475,170366,169000,175470,5104,3,175307,4941,2.9,169000,175476,1400-5-5,2021-07-27
289,ونفت,سرمايه‌گذاري‌ صنعت‌ نفت‌,734,3298613,51528046790,16340,16000,15530,-810,-4.96,15620,-720,-4.41,15530,16270,1400-5-5,2021-07-27
290,ثجوان,تامين مسكن جوانان,734,5163932,52175000098,9824,10118,9890,66,0.67,10104,280,2.85,9845,10118,1400-5-5,2021-07-27
291,ولصنم,ليزينگ‌صنعت‌ومعدن‌,731,2674846,20339885640,7930,7900,7540,-390,-4.92,7600,-330,-4.16,7540,7900,1400-5-5,2021-07-27
292,والبر,سرمايه‌ گذاري‌ البرز(هلدينگ‌,730,4930403,45783428210,9490,9350,9260,-230,-2.42,9290,-200,-2.11,9110,9580,1400-5-5,2021-07-27
293,نمرينو,ايران‌ مرينوس‌,729,801529,73210234700,87330,84090,91690,4360,4.99,91340,4010,4.59,84090,91690,1400-5-5,2021-07-27
294,رنيك,جنرال مكانيك,728,1805202,30540303488,17727,17200,16841,-886,-5,16918,-809,-4.56,16841,17600,1400-5-5,2021-07-27
295,شيراز,پتروشيمي‌شيراز,728,1032930,62454023710,60530,61000,60490,-40,-0.07,60490,-40,-0.07,59010,61500,1400-5-5,2021-07-27
296,زشگزا,شير و گوشت زاگرس شهركرد,727,5327986,30600563593,6019,6000,5820,-199,-3.31,5743,-276,-4.59,5719,6000,1400-5-5,2021-07-27
297,زدشت,كشت و صنعت دشت خرم دره,727,1297287,25855548655,20495,20720,19471,-1024,-5,19930,-565,-2.76,19471,20899,1400-5-5,2021-07-27
298,خموتور,موتورسازان‌تراكتورسازي‌ايران‌,725,3306838,31307144670,9840,9800,9350,-490,-4.98,9470,-370,-3.76,9350,9990,1400-5-5,2021-07-27
299,ددام,داروسازي زاگرس فارمد پارس,720,2890775,36010478630,12970,12650,12330,-640,-4.93,12460,-510,-3.93,12330,13090,1400-5-5,2021-07-27
300,مرقام,ايران‌ارقام‌,717,3975982,62829015150,16460,16110,15640,-820,-4.98,15800,-660,-4.01,15640,16390,1400-5-5,2021-07-27
301,شنفت,نفت‌ پارس‌,717,1021275,61641152520,61550,62800,60780,-770,-1.25,60360,-1190,-1.93,58480,62800,1400-5-5,2021-07-27
302,فوكا,فولاد كاويان,712,5011100,71310301193,14238,13811,14000,-238,-1.67,14230,-8,-0.06,13811,14410,1400-5-5,2021-07-27
303,شدوص,دوده‌ صنعتي‌ پارس‌,710,1828499,37423442430,21120,21000,20120,-1000,-4.73,20470,-650,-3.08,20080,21440,1400-5-5,2021-07-27
304,شپاكسا,پاكسان‌,703,2503089,50191845830,20790,21100,19760,-1030,-4.95,20050,-740,-3.56,19760,21100,1400-5-5,2021-07-27
305,كاسپين,داروسازي كاسپين تامين,689,2126180,43608020618,21536,20700,20460,-1076,-5,20510,-1026,-4.76,20460,21500,1400-5-5,2021-07-27
306,اميد,تامين سرمايه اميد,674,5519259,32194702320,6050,6150,5760,-290,-4.79,5830,-220,-3.64,5750,6150,1400-5-5,2021-07-27
307,ومشان,س. فني و مهندسي مشانير,664,491367,33183538630,67810,69843,69840,2030,2.99,67533,-277,-0.41,65776,69843,1400-5-5,2021-07-27
308,تپمپي,پمپ‌ سازي‌ ايران‌,658,1566764,25859407460,16520,16700,16150,-370,-2.24,16500,-20,-0.12,16130,16960,1400-5-5,2021-07-27
309,كاذر,فرآورده‌هاي‌نسوزآذر,654,2427268,35540977200,15260,15370,14500,-760,-4.98,14640,-620,-4.06,14500,15560,1400-5-5,2021-07-27
310,دكيمي,كيميدارو,651,923983,19943081050,21470,21720,21300,-170,-0.79,21580,110,0.51,21000,22100,1400-5-5,2021-07-27
311,دلر,داروسازي‌ اكسير,650,1456196,48688262580,33810,33850,34010,200,0.59,33440,-370,-1.09,32500,34260,1400-5-5,2021-07-27
312,بنيرو,نيروترانس‌,645,14682686,33894737413,2418,2350,2298,-120,-4.96,2308,-110,-4.55,2298,2429,1400-5-5,2021-07-27
313,كسرام,پارس‌ سرام‌,644,5597650,39314575920,7350,7060,6990,-360,-4.9,7020,-330,-4.49,6990,7300,1400-5-5,2021-07-27
314,تنوين,تامين سرمايه نوين,632,37689086,261371222040,6900,7030,6900,0,0,6930,30,0.43,6720,7030,1400-5-5,2021-07-27
315,لابسا,آبسال‌,631,746845,28101400380,36610,37990,36920,310,0.85,37630,1020,2.79,36920,38390,1400-5-5,2021-07-27
316,كحافظ,كاشي‌ وسراميك‌ حافظ‌,630,3004681,28856162880,9680,9400,9480,-200,-2.07,9600,-80,-0.83,9250,9850,1400-5-5,2021-07-27
317,دجابر,داروسازي‌ جابرابن‌حيان‌,626,1539481,20721196360,13910,13990,13220,-690,-4.96,13460,-450,-3.24,13220,13990,1400-5-5,2021-07-27
318,كساپا,سايپاشيشه‌,626,1392460,29708052820,22350,22350,21240,-1110,-4.97,21330,-1020,-4.56,21240,22350,1400-5-5,2021-07-27
319,ثتران,سرمايه گذاري مسكن تهران,626,7163924,23795558916,3346,3232,3280,-66,-1.97,3322,-24,-0.72,3230,3420,1400-5-5,2021-07-27
320,شاراك,پتروشيمي شازند,626,10364395,327307594100,30080,31580,31580,1500,4.99,31580,1500,4.99,31580,31580,1400-5-5,2021-07-27
321,تسه0001,امتيازتسهيلات مسكن فروردين1400,615,9198,5539062148,608769,610000,599000,-9769,-1.6,602203,-6566,-1.08,582222,610000,1400-5-5,2021-07-27
322,وسبحان,سرمايه گذاري سبحان,609,12906890,35174068994,2729,2730,2701,-28,-1.03,2725,-4,-0.15,2691,2768,1400-5-5,2021-07-27
323,تسه9908,امتياز تسهيلات مسكن آبان99,606,21664,13103650558,603085,600020,610000,6915,1.15,604858,1773,0.29,578000,610000,1400-5-5,2021-07-27
324,بشهاب,لامپ‌  پارس‌ شهاب‌,605,343103,34455835200,103140,107260,102000,-1140,-1.11,100420,-2720,-2.64,97990,107260,1400-5-5,2021-07-27
325,حپارسا,توسعه حمل و نقل ريلي پارسيان,604,1949798,63884296658,34156,32700,32449,-1707,-5,32765,-1391,-4.07,32449,34190,1400-5-5,2021-07-27
326,دامين,داروسازي‌ امين‌,601,8051542,30014680282,3883,3870,3690,-193,-4.97,3728,-155,-3.99,3689,3870,1400-5-5,2021-07-27
327,سكرد,سيمان كردستان,593,4561989,29041472070,6630,6330,6370,-260,-3.92,6370,-260,-3.92,6310,6590,1400-5-5,2021-07-27
328,قجام,فرآوردههاي غذايي وقندتربت‌جام‌,590,7397013,52537866454,7396,7101,7101,-295,-3.99,7103,-293,-3.96,7101,7227,1400-5-5,2021-07-27
329,فنورد,نوردوقطعات‌ فولادي‌,587,193914,36583478680,191650,185800,192300,650,0.34,188660,-2990,-1.56,182200,194000,1400-5-5,2021-07-27
330,پدرخش,درخشان‌ تهران‌,582,1186744,28690650850,25300,25570,24040,-1260,-4.98,24180,-1120,-4.43,24040,25570,1400-5-5,2021-07-27
331,ثپرديس,سرمايه گذاري مسكن پرديس,578,3285350,18673884782,5944,5750,5647,-297,-5,5684,-260,-4.37,5647,5993,1400-5-5,2021-07-27
332,خچرخش,چرخشگر,573,2267800,24217979770,10740,10980,10640,-100,-0.93,10680,-60,-0.56,10300,10980,1400-5-5,2021-07-27
333,فسازان,غلتك سازان سپاهان,571,1582123,45493662660,30010,29670,28510,-1500,-5,28750,-1260,-4.2,28510,29680,1400-5-5,2021-07-27
334,مارون,پتروشيمي مارون,568,167617,29240309425,176566,172510,175002,-1564,-0.89,175946,-620,-0.35,172510,177600,1400-5-5,2021-07-27
335,دتوليدح,ح. داروسازي توليد دارو,565,2034550,20324401856,10359,10359,9842,-517,-4.99,9990,-369,-3.56,9842,10359,1400-5-5,2021-07-27
336,سغرب,سيمان‌غرب‌,564,1703047,42139081460,25850,25010,24560,-1290,-4.99,24740,-1110,-4.29,24560,25800,1400-5-5,2021-07-27
337,كمنگنز,معادن‌منگنزايران‌,560,487928,33747560750,69610,70600,68140,-1470,-2.11,69170,-440,-0.63,67000,70890,1400-5-5,2021-07-27
338,شوينده,مديريت صنعت شوينده ت.ص.بهشهر,557,1220739,27044856320,23190,23180,22050,-1140,-4.92,22150,-1040,-4.48,22040,23250,1400-5-5,2021-07-27
339,پلاسك,پلاسكوكار,554,3769699,25766750020,7090,6930,6780,-310,-4.37,6840,-250,-3.53,6740,7170,1400-5-5,2021-07-27
340,شپارس,بين‌ المللي‌ محصولات‌  پارس‌,554,1967081,32831491200,17250,17420,16390,-860,-4.99,16690,-560,-3.25,16390,17420,1400-5-5,2021-07-27
341,ركيشح,ح. كارت اعتباري ايران كيش,552,3542041,17324881309,5226,5170,4790,-436,-8.34,4891,-335,-6.41,4781,5320,1400-5-5,2021-07-27
342,چكاوه,صنايع‌كاغذسازي‌كاوه‌,551,2166380,28244843470,13110,13620,13280,170,1.3,13040,-70,-0.53,12800,13620,1400-5-5,2021-07-27
343,غشهداب,كشت و صنعت شهداب ناب خراسان,549,8141284,28799948034,3692,3620,3508,-184,-4.98,3538,-154,-4.17,3508,3650,1400-5-5,2021-07-27
344,كفرا,فراورده‌ هاي‌ نسوزايران‌,546,1319363,31490430640,24640,23550,24050,-590,-2.39,23870,-770,-3.13,23410,24390,1400-5-5,2021-07-27
345,پرداخت,به پرداخت ملت,546,989443,20626445880,20800,21000,20260,-540,-2.6,20840,40,0.19,20180,21250,1400-5-5,2021-07-27
346,درهآور,دارويي ره آورد تامين,544,807679,24489436998,31522,30480,29946,-1576,-5,30321,-1201,-3.81,29946,31958,1400-5-5,2021-07-27
347,تسه9912,امتياز تسهيلات مسكن اسفند99,543,8497,5121452858,608424,585222,593000,-15424,-2.54,602737,-5687,-0.93,585222,610000,1400-5-5,2021-07-27
348,مبين,مبين انرژي خليج فارس,536,2647763,46973919840,17670,18170,17740,70,0.4,17700,30,0.17,17610,18170,1400-5-5,2021-07-27
349,غپآذر,شير پگاه آذربايجان شرقي,531,615000,24975262088,42273,41460,40160,-2113,-5,40610,-1663,-3.93,40160,42012,1400-5-5,2021-07-27
350,پرديس,سرمايه گذاري پرديس,531,3843079,18824468207,4927,4895,4862,-65,-1.32,4898,-29,-0.59,4840,4939,1400-5-5,2021-07-27
351,شفارا,پتروشيمي فارابي,530,5248150,25473198963,4739,4850,4858,119,2.51,4854,115,2.43,4671,4881,1400-5-5,2021-07-27
352,كشرق,صنعتي و معدني شمال شرق شاهرود,529,604840,38191406123,62903,61500,62699,-204,-0.32,63143,240,0.38,60160,64900,1400-5-5,2021-07-27
353,قشير,قند شيروان قوچان و بجنورد,528,1364363,22970378810,17228,17300,16367,-861,-5,16836,-392,-2.28,16367,17740,1400-5-5,2021-07-27
354,شكلر,نيروكلر,527,801886,25841868550,33250,33000,31640,-1610,-4.84,32230,-1020,-3.07,31600,33300,1400-5-5,2021-07-27
355,توريل,توكاريل,517,1794636,25258637376,14550,14300,13823,-727,-5,14075,-475,-3.26,13823,14608,1400-5-5,2021-07-27
356,تسه9911,امتياز تسهيلات مسكن بهمن99,517,20716,12596461239,607639,595150,605000,-2639,-0.43,608055,416,0.07,580011,610001,1400-5-5,2021-07-27
357,ثاصفا,شركت‌ ساختمان‌ اصفهان‌,516,1148610,28808500491,25700,25080,24929,-771,-3,25081,-619,-2.41,24929,25500,1400-5-5,2021-07-27
358,وآذر,سرمايه‌گذاري‌توسعه‌آذربايجان‌,515,377878,23397620190,65030,62250,61780,-3250,-5,61920,-3110,-4.78,61780,63500,1400-5-5,2021-07-27
359,دفرا,فرآورده‌هاي‌ تزريقي‌ ايران‌,513,1712472,46484806280,25950,25610,27240,1290,4.97,27140,1190,4.59,25600,27240,1400-5-5,2021-07-27
360,ثباغ,شهر سازي و خانه سازي باغميشه,513,2134316,25489515725,12337,12577,11721,-616,-4.99,11943,-394,-3.19,11721,12577,1400-5-5,2021-07-27
361,غشاذر,پگاه‌آذربايجان‌غربي‌,508,2865244,20851885550,7570,7300,7200,-370,-4.89,7280,-290,-3.83,7200,7500,1400-5-5,2021-07-27
362,وملل,اعتباري ملل,505,3565946,45983086153,12907,13000,12750,-157,-1.22,12896,-11,-0.09,12520,13140,1400-5-5,2021-07-27
363,كارين,صندوق س نگين سامان-ثابت,499,14293405,143348101920,10024,10030,10029,5,0.05,10029,5,0.05,10028,10030,1400-5-5,2021-07-27
364,داوه,داروسازي آوه سينا,499,1180952,20296704449,17827,17600,16936,-891,-5,17187,-640,-3.59,16936,17849,1400-5-5,2021-07-27
365,لسرما,سرما آفرين‌,499,1189008,23967795780,21020,21000,19970,-1050,-5,20160,-860,-4.09,19970,21550,1400-5-5,2021-07-27
366,سيدكو,سرمايه گذاري توسعه صنايع سيمان,496,4982362,33139354090,6750,6570,6880,130,1.93,6650,-100,-1.48,6430,6890,1400-5-5,2021-07-27
367,خوساز,محورسازان‌ايران‌خودرو,495,5422472,35376594840,6820,6790,6680,-140,-2.05,6520,-300,-4.4,6480,6790,1400-5-5,2021-07-27
368,سجام,مجتمع سيمان غرب آسيا,489,3530407,13443804104,3788,3890,3766,-22,-0.58,3808,20,0.53,3675,3901,1400-5-5,2021-07-27
369,ساراب,سيمان‌ داراب‌,487,1770332,34141948150,19830,19720,19160,-670,-3.38,19290,-540,-2.72,19000,19890,1400-5-5,2021-07-27
370,سخوز,سيمان خوزستان,484,1345429,32380063200,24810,24290,24010,-800,-3.22,24070,-740,-2.98,23870,24600,1400-5-5,2021-07-27
371,فن آوا,گروه فن آوا,484,3707153,64913566939,17353,17870,16950,-403,-2.32,17510,157,0.9,16950,17873,1400-5-5,2021-07-27
372,اطلس,صندوق س.توسعه اندوخته آينده-س,483,150139,35235338614,235968,236989,233110,-2858,-1.21,234685,-1283,-0.54,232000,237100,1400-5-5,2021-07-27
373,وسگيلا,شركت س استان گيلان,482,27892485,15370251535,579,551,551,-28,-4.84,566,-13,-2.25,551,557,1400-5-5,2021-07-27
374,كرماشا,صنايع پتروشيمي كرمانشاه,475,725011,29594089880,41030,41000,40670,-360,-0.88,40920,-110,-0.27,40000,41500,1400-5-5,2021-07-27
375,رتكو,كنترل‌خوردگي‌تكين‌كو,473,1486881,18888162210,13230,13250,12570,-660,-4.99,12700,-530,-4.01,12570,13470,1400-5-5,2021-07-27
376,غشان,شيرپاستوريزه‌پگاه‌خراسان‌,467,4783280,28312256640,6190,6030,5890,-300,-4.85,5920,-270,-4.36,5890,6190,1400-5-5,2021-07-27
377,دعبيد,لابراتوارداروسازي‌  دكترعبيدي‌,467,776089,19821170430,25100,25710,25200,100,0.4,25290,190,0.76,25000,25930,1400-5-5,2021-07-27
378,فردا,صندوق س آواي فرداي زاگرس-ثابت,466,20674940,229905435999,11113,11120,11120,7,0.06,11120,7,0.06,11119,11121,1400-5-5,2021-07-27
379,شخارك,پتروشيمي‌ خارك‌,466,689946,30413720920,45680,45000,43810,-1870,-4.09,45120,-560,-1.23,42750,45010,1400-5-5,2021-07-27
380,اعتلا,شركت سرمايه گذاري اعتلاء البرز,466,2089042,14770418114,7226,7140,7005,-221,-3.06,7070,-156,-2.16,6900,7289,1400-5-5,2021-07-27
381,سهرمز,سيمان‌هرمزگان‌,465,1019749,18618690730,19180,18730,18230,-950,-4.95,18260,-920,-4.8,18230,18730,1400-5-5,2021-07-27
382,وپسا,س. پتروشيمي ساختمان  خليج فارس,464,10242872,18970419870,1876,1913,1890,14,0.75,1852,-24,-1.28,1839,1913,1400-5-5,2021-07-27
383,وايرا,سرمايه گذاري صنايع ايران,459,2378750,19832391495,8419,8600,8286,-133,-1.58,8337,-82,-0.97,8167,8669,1400-5-5,2021-07-27
384,لخزر,پارس‌ خزر,458,140690,17424766710,127710,128000,121330,-6380,-5,123850,-3860,-3.02,121330,129360,1400-5-5,2021-07-27
385,سرود,سيمان‌شاهرود,457,3698060,87317377210,24780,24770,23550,-1230,-4.96,23610,-1170,-4.72,23550,24770,1400-5-5,2021-07-27
386,شكربن,كربن‌ ايران‌,453,702717,65655322510,97950,94500,93060,-4890,-4.99,93430,-4520,-4.61,93060,97000,1400-5-5,2021-07-27
387,قپيرا,فرآورده‌هاي‌غدايي‌وقندپيرانشهر,453,5628016,43058508970,8000,7820,7630,-370,-4.63,7650,-350,-4.38,7600,7900,1400-5-5,2021-07-27
388,فافزا,فولاد افزا سپاهان,450,476546,20008686073,41038,42268,41535,497,1.21,41987,949,2.31,40300,42269,1400-5-5,2021-07-27
389,زر,صندوق س.پشتوانه سكه طلاي زر,448,411115,19799077419,46936,47594,48124,1188,2.53,48159,1223,2.61,47594,48860,1400-5-5,2021-07-27
390,كيان2,صندوق س. با درآمد ثابت كيان,435,43500000,43500000,29584,1,1,-29583,-100,1,-29583,-100,1,1,1400-5-5,2021-07-27
391,عيار,صندوق سكه طلاي مفيد,433,577426,16056448362,27326,27799,27750,424,1.55,27807,481,1.76,27351,28180,1400-5-5,2021-07-27
392,ضسپا8041,اختيارخ خساپا-1600-1400/08/26,432,14709,5753683000,498,480,380,-118,-23.69,391,-107,-21.49,375,480,1400-5-5,2021-07-27
393,غشهد,شهد ايران ‌,431,3919770,19602066735,5208,5230,4948,-260,-4.99,5001,-207,-3.97,4948,5230,1400-5-5,2021-07-27
394,ثمسكن,سرمايه‌گذاري‌ مسكن‌,428,5276820,24127680187,4763,4680,4525,-238,-5,4572,-191,-4.01,4525,4830,1400-5-5,2021-07-27
395,وتوسم,سرمايه‌گذاري‌توسعه‌ملي‌,427,2090110,16425221470,8120,8180,7790,-330,-4.06,7860,-260,-3.2,7720,8180,1400-5-5,2021-07-27
396,غالبر,لبنيات‌ كالبر,424,730520,10924527370,15970,15110,14850,-1120,-7.01,15180,-790,-4.95,14360,15480,1400-5-5,2021-07-27
397,كطبس,ذغال‌سنگ‌ نگين‌ ط‌بس‌,423,588844,32812034790,58090,56320,55190,-2900,-4.99,55720,-2370,-4.08,55190,57730,1400-5-5,2021-07-27
398,جوين,كشت و صنعت جوين,420,3912267,15227704665,3979,3950,3860,-119,-2.99,3892,-87,-2.19,3860,4006,1400-5-5,2021-07-27
399,خكمك,كمك‌فنرايندامين‌,419,1143417,19113695250,17430,17320,16560,-870,-4.99,16720,-710,-4.07,16560,17670,1400-5-5,2021-07-27
400,دپارس,پارس‌ دارو,418,601347,21028050660,35820,34750,34480,-1340,-3.74,34970,-850,-2.37,34200,36120,1400-5-5,2021-07-27
401,زقيام,كشت و دام قيام اصفهان,417,1361810,28232997516,21763,21700,20675,-1088,-5,20732,-1031,-4.74,20675,21700,1400-5-5,2021-07-27
402,دسانكوح,ح . داروسازي سبحان انكولوژي,414,762730,6667309227,8716,8360,8512,-204,-2.34,8741,25,0.29,8360,8990,1400-5-5,2021-07-27
403,زگلدشت,كشت و دام گلدشت نمونه اصفهان,413,1313707,15123974647,11869,11540,11276,-593,-5,11512,-357,-3.01,11276,12078,1400-5-5,2021-07-27
404,مفاخر,توسعه فناوري اطلاعات خوارزمي,408,413542,15997555394,39932,40531,37936,-1996,-5,38684,-1248,-3.13,37936,40531,1400-5-5,2021-07-27
405,وسهمدا,شركت س استان همدان,407,22447181,12551220471,585,556,575,-10,-1.71,572,-13,-2.22,556,609,1400-5-5,2021-07-27
406,خراسان,پتروشيمي خراسان,405,300052,22799435080,76480,74500,74930,-1550,-2.03,76270,-210,-0.27,74500,78000,1400-5-5,2021-07-27
407,كي بي سي,شركت كي بي سي,404,895326,20769628208,23622,22820,23540,-82,-0.35,23198,-424,-1.79,22441,24439,1400-5-5,2021-07-27
408,والبرح,ح . سرمايه گذاري‌البرز(هلدينگ‌,402,1885455,14760971322,8077,8077,7760,-317,-3.92,7829,-248,-3.07,7360,8077,1400-5-5,2021-07-27
409,ختراك,ريخته‌گري‌ تراكتورسازي‌ ايران‌,401,1643030,20493935790,13040,13000,12390,-650,-4.98,12470,-570,-4.37,12390,13270,1400-5-5,2021-07-27
410,ركيش,كارت اعتباري ايران كيش,396,2111791,15161160920,7520,7400,7150,-370,-4.92,7230,-290,-3.86,7150,7400,1400-5-5,2021-07-27
411,قمرو,قند مرودشت‌,393,1028517,25586297140,25920,25420,24630,-1290,-4.98,24880,-1040,-4.01,24630,26890,1400-5-5,2021-07-27
412,بهپاك,صنعتي بهپاك,393,3269005,25274128002,8034,8000,7633,-401,-4.99,7731,-303,-3.77,7633,8010,1400-5-5,2021-07-27
413,مدير,ص.س.مديريت ثروت ص.بازنشستگي-س,393,2074951,18130152818,8837,8796,8706,-131,-1.48,8738,-99,-1.12,8700,8800,1400-5-5,2021-07-27
414,تشتاد,صنايع توليدي اشتاد ايران‌,392,4264889,32375351617,7378,7305,7599,221,3,7591,213,2.89,7305,7599,1400-5-5,2021-07-27
415,ارزش,صندوق س ارزش آفرين بيدار-سهام,392,2741264,25395166960,9360,9390,9170,-190,-2.03,9260,-100,-1.07,9130,9400,1400-5-5,2021-07-27
416,كاريس,صندوق س.سپهر كاريزما-س,389,2061614,27058241889,13202,13426,13173,-29,-0.22,13125,-77,-0.58,13010,13426,1400-5-5,2021-07-27
417,لوتوس,تامين سرمايه لوتوس پارسيان,387,3405332,27076423890,8080,7990,8000,-80,-0.99,7960,-120,-1.49,7810,8060,1400-5-5,2021-07-27
418,گوهرانح,ح . س. توسعه گوهران اميد,387,1758950,6506247051,3746,3683,3680,-66,-1.76,3699,-47,-1.25,3600,3849,1400-5-5,2021-07-27
419,حخزر,كشتيراني درياي خزر,387,381448,9437475958,24774,24864,24799,25,0.1,24753,-21,-0.08,24283,25406,1400-5-5,2021-07-27
420,تكنو,تكنوتار,387,749855,12228417920,16860,17280,16020,-840,-4.98,16420,-440,-2.61,16020,17280,1400-5-5,2021-07-27
421,هجرت,پخش هجرت,387,1081733,25573309864,23668,24500,23507,-161,-0.68,23641,-27,-0.11,22907,24600,1400-5-5,2021-07-27
422,زكشت,كشاورزي مكانيزه اصفهان كشت,386,515556,14696898677,29777,28289,28289,-1488,-5,28507,-1270,-4.27,28289,29470,1400-5-5,2021-07-27
423,غپونه,نوش پونه مشهد,386,3233649,47083948510,14138,14562,14562,424,3,14561,423,2.99,14279,14562,1400-5-5,2021-07-27
424,تسه9910,امتياز تسهيلات مسكن دي99,383,6396,3866956249,605276,590500,605000,-276,-0.05,604590,-686,-0.11,575013,620000,1400-5-5,2021-07-27
425,دسبحا,گروه دارويي سبحان,379,1467698,22563316050,15970,15650,15260,-710,-4.45,15370,-600,-3.76,15180,16180,1400-5-5,2021-07-27
426,فاما,صنعتي‌ آما,377,1257737,20044664550,15760,16300,15900,140,0.89,15940,180,1.14,15120,16300,1400-5-5,2021-07-27
427,واتي,سرمايه‌ گذاري‌ آتيه‌ دماوند,375,2548316,28043332130,11010,10640,10900,-110,-1,11000,-10,-0.09,10640,11350,1400-5-5,2021-07-27
428,شكبير,پتروشيمي اميركبير,370,281602,23156999210,80448,82861,81020,572,0.71,80848,400,0.5,80570,82861,1400-5-5,2021-07-27
429,پكرمان,گروه‌ صنعتي‌ بارز,369,821371,21677995150,27350,26350,26300,-1050,-3.84,26570,-780,-2.85,26230,27500,1400-5-5,2021-07-27
430,حتوكا,حمل‌ونقل‌توكا,367,1258653,24443202760,20340,19450,19330,-1010,-4.97,19420,-920,-4.52,19330,19970,1400-5-5,2021-07-27
431,كخاك,صنايع‌خاك‌چيني‌ايران‌,366,939913,32205086420,35950,34330,34160,-1790,-4.98,34260,-1690,-4.7,34160,35590,1400-5-5,2021-07-27
432,وسنا,سرمايه گذاري نيروگاهي ايران,366,1459880,20538728617,14392,14000,13961,-431,-2.99,14069,-323,-2.24,13961,14398,1400-5-5,2021-07-27
433,وارس,سرمايه گذاري ارس صبا,363,1925501,28527639870,15233,15600,14990,-243,-1.6,14816,-417,-2.74,14777,15600,1400-5-5,2021-07-27
434,ولبهمن,شركت بهمن ليزينگ,360,2363860,16604571868,7074,7349,7050,-24,-0.34,7024,-50,-0.71,7000,7349,1400-5-5,2021-07-27
435,ياقوت,صندوق س ياقوت آگاه-ثابت,358,3285646,41864311984,12734,12770,12740,6,0.05,12742,8,0.06,12739,12770,1400-5-5,2021-07-27
436,گنگين,اقتصادي نگين گردشگري ايرانيان,358,3144070,62086872419,19707,20000,19706,-1,-0.01,19747,40,0.2,19640,20000,1400-5-5,2021-07-27
437,فنفت,صنايع تجهيزات نفت,356,772293,20166212086,25542,26300,26000,458,1.79,26112,570,2.23,24950,26308,1400-5-5,2021-07-27
438,دسبحان,سبحان دارو,356,770432,13959358600,18970,18080,18030,-940,-4.96,18140,-830,-4.38,18030,18920,1400-5-5,2021-07-27
439,تسه9909,امتياز تسهيلات مسكن آذر99,354,4833,2906338471,605422,587150,585001,-20421,-3.37,601353,-4069,-0.67,581000,624499,1400-5-5,2021-07-27
440,سكرما,سيمان‌ كرمان‌,352,1648933,26978835330,17120,16500,16280,-840,-4.91,16360,-760,-4.44,16270,17500,1400-5-5,2021-07-27
441,كارين2,صندوق س نگين سامان-ثابت,350,35000000,35000000,10024,1,1,-10023,-99.99,1,-10023,-99.99,1,1,1400-5-5,2021-07-27
442,واعتبار,سرمايه گذاري اعتبار ايران,345,2722889,21925895420,8380,8090,7970,-410,-4.89,8050,-330,-3.94,7970,8460,1400-5-5,2021-07-27
443,شفا,سرمايه گذاري شفادارو,342,360561,14220835540,40210,41750,39940,-270,-0.67,39620,-590,-1.47,38690,41750,1400-5-5,2021-07-27
444,تصميم,صندوق س با درآمد ثابت تصميم,340,2608288,44195203751,16934,16947,16945,11,0.06,16944,10,0.06,16942,16947,1400-5-5,2021-07-27
445,گوهران,سرمايه گذاري توسعه گوهران اميد,333,2349832,11870850395,5095,5165,5003,-92,-1.81,5061,-34,-0.67,4910,5166,1400-5-5,2021-07-27
446,سبجنو,سيمان‌ بجنورد,331,514476,20528352940,40400,40300,39240,-1160,-2.87,39900,-500,-1.24,38900,41600,1400-5-5,2021-07-27
447,غفارس,شير پاستوريزه پگاه فارس,326,1793590,32187075860,18888,17944,17944,-944,-5,17946,-942,-4.99,17944,18597,1400-5-5,2021-07-27
448,ولملت,واسپاري ملت,323,4400201,22150291810,5270,5140,5010,-260,-4.93,5030,-240,-4.55,5010,5270,1400-5-5,2021-07-27
449,خلنت,لنت‌ ترمزايران‌,322,377480,18058014810,50320,47810,47820,-2500,-4.97,47840,-2480,-4.93,47810,49690,1400-5-5,2021-07-27
450,ساينا,صنايع بهداشتي ساينا,321,84762,9106724424,112195,107700,106586,-5609,-5,109026,-3169,-2.82,106586,112000,1400-5-5,2021-07-27
451,سشمال,سيمان‌ شمال‌,320,1423134,13351718840,9740,9300,9300,-440,-4.52,9390,-350,-3.59,9260,9890,1400-5-5,2021-07-27
452,وزمين,بانك ايران زمين,317,2582824,26743265350,10494,10494,10205,-289,-2.75,10354,-140,-1.33,10075,10499,1400-5-5,2021-07-27
453,گوهر,صندوق سكه طلاي كيان,314,275355,15106695909,53515,54279,54706,1191,2.23,54863,1348,2.52,53671,56929,1400-5-5,2021-07-27
454,آساميد,صندوق س.مشترك آسمان اميد -د,308,13298236,165934110751,12469,12476,12478,9,0.07,12478,9,0.07,12476,12483,1400-5-5,2021-07-27
455,خديزل,بهمن  ديزل,301,274794,13597832903,49914,49500,49925,11,0.02,49618,-296,-0.59,47420,50789,1400-5-5,2021-07-27
456,سباقر,سيمان باقران,300,2295882,35745201915,15869,16100,15400,-469,-2.96,15569,-300,-1.89,15393,16100,1400-5-5,2021-07-27
457,فخاس,فولاد خراسان,300,489346,10738481810,22520,22350,21890,-630,-2.8,22460,-60,-0.27,21780,22350,1400-5-5,2021-07-27
458,كقزوي,شيشه‌ قزوين‌,299,2103325,15750966400,7544,7320,7450,-94,-1.25,7489,-55,-0.73,7320,7599,1400-5-5,2021-07-27
459,فپنتا,سپنتا,294,35856,13741298410,378060,390000,379750,1690,0.45,382850,4790,1.27,378060,394900,1400-5-5,2021-07-27
460,پخش,پخش البرز,292,806210,15207946034,19310,19400,18900,-410,-2.12,18864,-446,-2.31,18480,19400,1400-5-5,2021-07-27
461,اتكام,شركت بيمه اتكايي امين,290,1472624,7423881930,5064,4871,5030,-34,-0.67,5053,-11,-0.22,4850,5240,1400-5-5,2021-07-27
462,وتوشه,سرمايه‌ گذاري‌ پارس‌ توشه‌,290,1951302,12168037950,6470,6280,6150,-320,-4.95,6270,-200,-3.09,6150,6400,1400-5-5,2021-07-27
463,دكوثر,داروسازي‌ كوثر,286,2632116,12542043910,5240,4990,4750,-490,-9.35,4800,-440,-8.4,4750,4990,1400-5-5,2021-07-27
464,دسينا,داروسازي‌ سينا,283,963574,20601265090,22050,22450,20950,-1100,-4.99,21380,-670,-3.04,20950,22450,1400-5-5,2021-07-27
465,قصفها,قنداصفهان‌,280,177789,15690068050,93540,90000,87500,-6040,-6.46,88250,-5290,-5.66,86120,91000,1400-5-5,2021-07-27
466,اوصتا,صندوق انديشه ورزان صباتامين -د,275,18111328,350091723018,19316,19327,19326,10,0.05,19330,14,0.07,19326,19330,1400-5-5,2021-07-27
467,وصندوق,سرمايه‌گذاري‌صندوق‌بازنشستگي‌,271,4000386,59507960670,14800,14900,15000,200,1.35,14840,40,0.27,14800,15390,1400-5-5,2021-07-27
468,قهكمت,قندهكمتان‌,271,278718,9898964670,36360,34720,35580,-780,-2.15,35760,-600,-1.65,34720,36950,1400-5-5,2021-07-27
469,اپرداز,آتيه داده پرداز,269,437787,8318725339,19485,19480,18870,-615,-3.16,19210,-275,-1.41,18511,20170,1400-5-5,2021-07-27
470,شگل,گلتاش‌,268,840093,6534963620,8070,7730,7690,-380,-4.71,7930,-140,-1.73,7680,8070,1400-5-5,2021-07-27
471,فجر,فولاد اميركبيركاشان,267,567906,18792009540,34830,33090,33090,-1740,-5,33820,-1010,-2.9,33090,33090,1400-5-5,2021-07-27
472,كپرور,فرآوري زغال سنگ پروده طبس,267,469440,16083129900,35046,35910,33652,-1394,-3.98,34260,-786,-2.24,33600,35910,1400-5-5,2021-07-27
473,سرچشمه,سرمايه گذاري مس سرچشمه,266,1784615,12039920144,7047,6695,6695,-352,-5,6795,-252,-3.58,6695,6970,1400-5-5,2021-07-27
474,خاذين,سايپاآذين‌,261,4494708,14940776712,3489,3318,3315,-174,-4.99,3324,-165,-4.73,3315,3412,1400-5-5,2021-07-27
475,وثنو,سرمايه گذاري ساختماني نوين,261,1564041,7082836775,4651,4620,4512,-139,-2.99,4562,-89,-1.91,4512,4620,1400-5-5,2021-07-27
476,فسا,پتروشيمي فسا,261,4493396,6207043754,1422,1447,1380,-42,-2.95,1395,-27,-1.9,1380,1447,1400-5-5,2021-07-27
477,وليز,ليزينگ‌ايران‌,257,1778875,11303457780,6680,6350,6350,-330,-4.94,6420,-260,-3.89,6350,6500,1400-5-5,2021-07-27
478,بفجر,فجر انرژي خليج فارس,254,650122,15817523860,24620,25440,23890,-730,-2.97,24550,-70,-0.28,23550,25440,1400-5-5,2021-07-27
479,تسه9907,امتياز تسهيلات مسكن مهر99,248,3217,1932668066,604975,589699,629999,25024,4.14,600767,-4208,-0.7,574758,629999,1400-5-5,2021-07-27
480,سيلام,سيمان‌ ايلام‌,248,2081542,17742374850,8940,8570,8500,-440,-4.92,8520,-420,-4.7,8500,8850,1400-5-5,2021-07-27
481,وكار,بانك‌ كارآفرين‌,245,3280869,10576725284,3319,3220,3190,-129,-3.89,3299,-20,-0.6,3163,3343,1400-5-5,2021-07-27
482,سفانو,سيمان فارس نو,244,299347,9124842800,30810,32140,30380,-430,-1.4,30610,-200,-0.65,29940,32140,1400-5-5,2021-07-27
483,آكورد,صندوق س. آرمان آتي كوثر-د,239,2256827,75040601651,33220,33250,33252,32,0.1,33250,30,0.09,33250,33257,1400-5-5,2021-07-27
484,اخزا910,اسنادخزانه-م10بودجه99-020807,237,563289,364134639480,642815,640010,645504,2689,0.42,646444,3629,0.56,640010,648589,1400-5-5,2021-07-27
485,وساشرقي,شركت س استان آذربايجان شرقي,236,15120216,12111293016,843,801,801,-42,-4.98,835,-8,-0.95,801,801,1400-5-5,2021-07-27
486,خكار,ايركا پارت صنعت,236,1056797,17724832670,17190,17190,16340,-850,-4.94,16770,-420,-2.44,16340,17190,1400-5-5,2021-07-27
487,فبيرا,بسته‌ بندي‌ ايران‌,233,2452668,6006699814,2516,2499,2441,-75,-2.98,2474,-42,-1.67,2441,2500,1400-5-5,2021-07-27
488,آوا,صندوق س.سهام آواي معيار-س,222,2612903,18339029881,7045,7040,7024,-21,-0.3,7019,-26,-0.37,7000,7070,1400-5-5,2021-07-27
489,دارو,كارخانجات‌داروپخش‌,219,647080,15096218920,24500,23600,23280,-1220,-4.98,23330,-1170,-4.78,23280,24000,1400-5-5,2021-07-27
490,وساخت,سرمايه‌ گذاري‌ ساختمان‌ايران‌,216,673626,35634815400,50390,52900,52900,2510,4.98,52900,2510,4.98,52900,52900,1400-5-5,2021-07-27
491,ضسپا8039,اختيارخ خساپا-1200-1400/08/26,213,4049,2811101000,842,944,677,-165,-19.6,694,-148,-17.58,660,950,1400-5-5,2021-07-27
492,قزوين,كارخانجات‌ قند قزوين‌,212,537536,14765501190,26750,26750,28080,1330,4.97,27460,710,2.65,26750,28080,1400-5-5,2021-07-27
493,دالبر,البرزدارو,210,608117,7979216250,13660,13330,12980,-680,-4.98,13390,-270,-1.98,12980,13690,1400-5-5,2021-07-27
494,تسه9810,امتياز تسهيلات مسكن دي98,209,4597,2735727578,600714,600002,600000,-714,-0.12,595111,-5603,-0.93,580000,610000,1400-5-5,2021-07-27
495,تسه9902,امتياز تسهيلات مسكن ارديبهشت99,207,3318,2005239571,605469,600000,634699,29230,4.83,604352,-1117,-0.18,580001,634700,1400-5-5,2021-07-27
496,اوان,مبين وان كيش,206,221280,7926699796,37214,35360,35470,-1744,-4.69,36450,-764,-2.05,35354,37196,1400-5-5,2021-07-27
497,فايرا,آلومينيوم‌ايران‌,204,1939500,27327889110,15120,13900,14590,-530,-3.51,14600,-520,-3.44,13880,14590,1400-5-5,2021-07-27
498,دروز,داروسازي‌ روزدارو,203,619510,19477258070,31500,31520,31390,-110,-0.35,31440,-60,-0.19,30610,31700,1400-5-5,2021-07-27
499,تسه9906,امتياز تسهيلات مسكن شهريور99,202,7605,4624137136,604717,601000,600001,-4716,-0.78,608039,3322,0.55,576000,610000,1400-5-5,2021-07-27
500,صملي404,صكوك اجاره صملي404-6ماهه18%,200,2000000,2000000000000,1000000,1000000,1000000,0,0,1000000,0,0,1000000,1000000,1400-5-5,2021-07-27
501,شاملا,معدني‌ املاح‌  ايران‌,199,226905,8838400800,40070,40000,39200,-870,-2.17,39380,-690,-1.72,38500,40160,1400-5-5,2021-07-27
502,تماوند,تامين سرمايه دماوند,198,3354203,17737829325,5390,5436,5300,-90,-1.67,5288,-102,-1.89,5229,5436,1400-5-5,2021-07-27
503,زپارس,ملي كشت و صنعت و دامپروري پارس,198,211383,24762937410,118800,118800,117320,-1480,-1.25,117150,-1650,-1.39,113830,120900,1400-5-5,2021-07-27
504,گپارس,امور رفاهي كارگزاران پارس,194,37219,4469297995,122892,124655,119206,-3686,-3,121626,-1266,-1.03,119206,126368,1400-5-5,2021-07-27
505,آتيمس,صندوق س.آرمان آتيه درخشان مس-س,185,45977,8604995682,184564,184610,188390,3826,2.07,187159,2595,1.41,183330,190000,1400-5-5,2021-07-27
506,پارسيان,بيمه پارسيان,185,1270420,11384690380,9110,9110,8660,-450,-4.94,9020,-90,-0.99,8660,9170,1400-5-5,2021-07-27
507,وخاور,بانك خاورميانه,183,2849979,16512428170,5860,5880,5710,-150,-2.56,5830,-30,-0.51,5650,5900,1400-5-5,2021-07-27
508,كاردان,صندوق س تجارت شاخصي كاردان,183,90914,16074022190,177100,177150,176000,-1100,-0.62,176800,-300,-0.17,175100,177150,1400-5-5,2021-07-27
509,فيروزه,صندوق شاخص30 شركت فيروزه- سهام,181,66612,10154408490,152810,153580,152990,180,0.12,152440,-370,-0.24,151130,154240,1400-5-5,2021-07-27
510,وكادو,تكادو,180,1052548,18830959934,18425,18050,17873,-552,-3,17891,-534,-2.9,17873,18070,1400-5-5,2021-07-27
511,واحصا,احياء صنايع خراسان,177,185980,7058691307,39120,37951,37947,-1173,-3,38256,-864,-2.21,37947,38050,1400-5-5,2021-07-27
512,پخشح,ح. پخش البرز,177,506475,8039005073,16599,15880,15780,-819,-4.93,15872,-727,-4.38,15770,16360,1400-5-5,2021-07-27
513,وبهمن,سرمايه‌گذاري‌بهمن‌,176,1349512,18960643600,13390,14050,14050,660,4.93,14050,660,4.93,14050,14050,1400-5-5,2021-07-27
514,پسهند,صنايع‌ لاستيكي‌  سهند,172,353312,10603061830,30760,30930,29610,-1150,-3.74,30200,-560,-1.82,29290,31350,1400-5-5,2021-07-27
515,سنوين,سرمايه گذاري اقتصاد نوين,169,1007837,8424324679,8293,8500,8360,67,0.81,8347,54,0.65,8305,8500,1400-5-5,2021-07-27
516,تسه9904,امتياز تسهيلات مسكن تير99,169,1569,947143149,605623,600000,634998,29375,4.85,603660,-1963,-0.32,575342,634998,1400-5-5,2021-07-27
517,ما,بيمه  ما,168,749304,5860179260,7930,7950,7790,-140,-1.77,7890,-40,-0.5,7730,8000,1400-5-5,2021-07-27
518,تسه9905,امتياز تسهيلات مسكن مرداد99,168,2490,1510071208,603656,610000,581769,-21887,-3.63,606454,2798,0.46,578182,610000,1400-5-5,2021-07-27
519,غبهار,كشت وصنعت بهاران گلبهار خراسان,166,315510,6096039748,19894,19420,19298,-596,-3,19543,-351,-1.76,19298,19430,1400-5-5,2021-07-27
520,بالاس,مهندسي ساختمان تاسيسات راه آهن,166,203415,8082990008,39849,37857,40001,152,0.38,39788,-61,-0.15,37857,40998,1400-5-5,2021-07-27
521,ارمغان,ص سرمايه گذاري ارمغان ايرانيان,162,3346752,33789686165,10092,10100,10101,9,0.09,10096,4,0.04,10094,10106,1400-5-5,2021-07-27
522,خپويش,سازه‌ پويش‌,158,256421,14433938090,53610,56290,56290,2680,5,55950,2340,4.36,56290,56290,1400-5-5,2021-07-27
523,زفكاح,ح . كشت و دامداري فكا,156,9592807,76769748940,7747,8100,8000,253,3.27,8003,256,3.3,8000,8110,1400-5-5,2021-07-27
524,سپ,پرداخت الكترونيك سامان كيش,151,1031359,28148273700,27450,27490,26900,-550,-2,27370,-80,-0.29,26120,27490,1400-5-5,2021-07-27
525,غشوكو,شوكو پارس,147,384944,12010252800,30292,31200,31200,908,3,31200,908,3,31200,31200,1400-5-5,2021-07-27
526,كيميا,معدني كيمياي زنجان گستران,146,826372,11887019467,14400,14999,14550,150,1.04,14388,-12,-0.08,13750,14999,1400-5-5,2021-07-27
527,سبزوا,سيمان لار سبزوار,143,3145046,10249704914,3430,3259,3259,-171,-4.99,3307,-123,-3.59,3259,3259,1400-5-5,2021-07-27
528,كفرآور,فرآورده هاي سيمان شرق,141,376155,7083582388,19394,18814,18813,-581,-3,18973,-421,-2.17,18813,19318,1400-5-5,2021-07-27
529,آساس,صندوق س.آسمان آرماني سهام-س,138,33992,5661606754,167100,167899,166798,-302,-0.18,166557,-543,-0.32,165550,167899,1400-5-5,2021-07-27
530,تسه9903,امتياز تسهيلات مسكن خرداد99,137,1680,1023582358,603075,600000,629999,26924,4.46,609275,6200,1.03,588363,629999,1400-5-5,2021-07-27
531,نطرين,عطرين نخ قم,136,366417,3370669983,9683,9199,9199,-484,-5,9569,-114,-1.18,9199,9199,1400-5-5,2021-07-27
532,ساروج,بين المللي ساروج بوشهر,133,587097,10804919575,18382,18790,18680,298,1.62,18404,22,0.12,17920,18790,1400-5-5,2021-07-27
533,سكه0012پ04,تمام سكه طرح جديد0012صادرات,133,34500,37579868900,1073255,1087000,1089980,16725,1.56,1089271,16016,1.49,1084000,1100000,1400-5-5,2021-07-27
534,سپاس,صندوق س. پاداش سهامداري-ثابت,132,2230960,22650008870,10111,10976,10118,7,0.07,10153,42,0.42,10115,10976,1400-5-5,2021-07-27
535,وبازار,صندوق س شاخصي بازارآشنا,131,777418,8988638170,11490,11420,11570,80,0.7,11560,70,0.61,11420,11700,1400-5-5,2021-07-27
536,سدشت,صنايع سيمان دشتستان,131,45065,2459823490,56530,54370,54170,-2360,-4.17,56340,-190,-0.34,54000,56850,1400-5-5,2021-07-27
537,دقاضي,داروسازي شهيد قاضي,129,128419,3524142597,27582,27240,27000,-582,-2.11,27532,-50,-0.18,26765,28300,1400-5-5,2021-07-27
538,كسرا,سراميك‌هاي‌صنعتي‌اردكان‌,127,354095,5808883550,17320,16850,16200,-1120,-6.47,16940,-380,-2.19,16010,16850,1400-5-5,2021-07-27
539,زرين,صندوق س. سهام زرين كوروش-س,126,325951,3647344799,11175,11349,11250,75,0.67,11190,15,0.13,11150,11349,1400-5-5,2021-07-27
540,فيروزا,صندوق بادرآمد ثابت فيروزه آسيا,125,541988,13043658771,23968,24040,24100,132,0.55,24066,98,0.41,23970,24125,1400-5-5,2021-07-27
541,تسه9806,امتياز تسهيلات مسكن شهريور98,122,2108,1260199207,600462,572010,600000,-462,-0.08,597817,-2645,-0.44,572010,606996,1400-5-5,2021-07-27
542,سكه0011پ02,تمام سكه طرح جديد0011ملت,122,16700,18203185100,1070377,1085000,1086401,16024,1.5,1090011,19634,1.83,1082800,1099900,1400-5-5,2021-07-27
543,اخزا901,اسنادخزانه-م1بودجه99-010621,121,114254,91663433873,802147,801101,801133,-1014,-0.13,802278,131,0.02,799555,803900,1400-5-5,2021-07-27
544,كوثر,بيمه كوثر,117,696802,9631162849,14498,13800,13774,-724,-4.99,14316,-182,-1.26,13774,14300,1400-5-5,2021-07-27
545,وبرق,س.کارکنان صنعت برق زنجان وقزوي,114,166844,15251376884,88749,91411,91411,2662,3,91411,2662,3,91411,91411,1400-5-5,2021-07-27
546,سدبير,س. تدبيرگران فارس وخوزستان,114,493642,24691972840,81966,50020,50020,-31946,-38.97,50020,-31946,-38.97,50020,50020,1400-5-5,2021-07-27
547,ثنور,سرمايه گذاري كوه نور,110,4054181,27653568601,9326,6821,6821,-2505,-26.86,6821,-2505,-26.86,6821,6821,1400-5-5,2021-07-27
548,بسويچ,پارس‌سويچ‌,110,371570,9860568780,27730,26350,26380,-1350,-4.87,27180,-550,-1.98,26350,27880,1400-5-5,2021-07-27
549,بپاس,بيمه پاسارگاد,109,438013,25530025718,55511,58286,58286,2775,5,56050,539,0.97,58286,58286,1400-5-5,2021-07-27
550,ضمخا7076,اختيارخ اخابر-9700-1400/07/28,106,3738,3826934000,1298,1350,1055,-243,-18.72,1024,-274,-21.11,1000,1350,1400-5-5,2021-07-27
551,تسه9812,امتياز تسهيلات مسكن اسفند98,106,1139,682186788,599838,570000,629829,29991,5,598935,-903,-0.15,570000,629829,1400-5-5,2021-07-27
552,فراز,صندوق س.سهام فراز داريك-س,105,693135,8438692652,12159,12161,12180,21,0.17,12175,16,0.13,12161,12190,1400-5-5,2021-07-27
553,تسه9901,امتياز تسهيلات مسكن فروردين99,105,926,560602456,601189,584099,595002,-6187,-1.03,605402,4213,0.7,576055,631000,1400-5-5,2021-07-27
554,فالوم,آلومتك‌,102,398763,7937377515,20520,19905,19905,-615,-3,20005,-515,-2.51,19905,19905,1400-5-5,2021-07-27
555,تسه9811,امتياز تسهيلات مسكن بهمن98,98,958,573922949,601835,600001,609999,8164,1.36,599084,-2751,-0.46,577111,630000,1400-5-5,2021-07-27
556,فولاژ,فولاد آلياژي ايران,98,925035,15612371740,17240,16750,16890,-350,-2.03,17170,-70,-0.41,16720,17240,1400-5-5,2021-07-27
557,باران,بيمه زندگي باران50%تاديه,98,734557,3180620739,4460,4327,4327,-133,-2.98,4416,-44,-0.99,4327,4500,1400-5-5,2021-07-27
558,سحرخيز,صندوق س. گروه زعفران سحرخيز,98,461026,4213603982,9134,9134,9150,16,0.18,9140,6,0.07,9105,9194,1400-5-5,2021-07-27
559,اخزا908,اسنادخزانه-م8بودجه99-020606,96,257486,171561858740,663648,665140,667104,3456,0.52,666296,2648,0.4,661017,670000,1400-5-5,2021-07-27
560,دمعيار,صندوق س. توازن معيار-د,95,4121217,41315886710,10021,10025,10025,4,0.04,10025,4,0.04,10025,10030,1400-5-5,2021-07-27
561,اخزا902,اسنادخزانه-م2بودجه99-011019,95,250267,188646963542,752826,751555,756000,3174,0.42,753783,957,0.13,749000,756581,1400-5-5,2021-07-27
562,نهال,صندوق س. طلاي سرخ نوويرا,93,383895,3574986665,9358,9300,9333,-25,-0.27,9312,-46,-0.49,9233,9389,1400-5-5,2021-07-27
563,صايند,صندوق س. گنجينه آينده روشن-د,87,582020,5878570680,10075,10072,10094,19,0.19,10100,25,0.25,10072,10110,1400-5-5,2021-07-27
564,چدن,توليدي چدن سازان,86,1345672,5539769200,4295,4130,4100,-195,-4.54,4226,-69,-1.61,4010,4130,1400-5-5,2021-07-27
565,تسه9809,امتياز تسهيلات مسكن آذر98,86,1394,835554991,600723,600001,590000,-10723,-1.79,599394,-1329,-0.22,580777,620000,1400-5-5,2021-07-27
566,ضپال2006,اختيارخ اپال-28000-1401/02/12,86,1643,2833139000,1609,1700,1800,191,11.87,1724,115,7.15,1651,2450,1400-5-5,2021-07-27
567,شلرد,كود شيميايي اوره لردگان,84,2719582,20614431560,7546,7580,7580,34,0.45,7572,26,0.34,7580,7580,1400-5-5,2021-07-27
568,تسه9808,امتياز تسهيلات مسكن آبان98,84,1182,717350601,600975,600001,610000,9025,1.5,606896,5921,0.99,590262,630000,1400-5-5,2021-07-27
569,تسه9805,امتياز تسهيلات مسكن مرداد98,83,1220,724069557,599868,571125,594000,-5868,-0.98,593500,-6368,-1.06,571125,605000,1400-5-5,2021-07-27
570,سپر,صندوق س سپر سرمايه بيدار- ثابت,81,781048,9649357463,12347,12355,12355,8,0.06,12354,7,0.06,12353,12355,1400-5-5,2021-07-27
571,افق ملت,صندوق س در سهام افق ملت,81,19890,2805874470,141440,141000,140010,-1430,-1.01,141070,-370,-0.26,140010,142250,1400-5-5,2021-07-27
572,اخزا903,اسنادخزانه-م3بودجه99-011110,81,149102,110958224526,743063,739321,747969,4906,0.66,744177,1114,0.15,739321,747969,1400-5-5,2021-07-27
573,فردا2,صندوق س آواي فرداي زاگرس-ثابت,80,8000000,8000000,11113,1,1,-11112,-99.99,1,-11112,-99.99,1,1,1400-5-5,2021-07-27
574,هفارس104,اختيارف ت فارس-11832-01/04/12,80,3062137,3062137,1,1,1,0,0,1,0,0,1,1,1400-5-5,2021-07-27
575,تسه9807,امتياز تسهيلات مسكن مهر98,74,801,480312589,604215,576122,600000,-4215,-0.7,599641,-4574,-0.76,576122,604900,1400-5-5,2021-07-27
576,اخزا914,اسنادخزانه-م14بودجه99-021025,65,141911,88542350190,620014,618000,628800,8786,1.42,623929,3915,0.63,618000,628800,1400-5-5,2021-07-27
577,زعف0008پ10,زعفران0008نگين طلاي سرخ(پ),62,236500,32554360000,138589,137650,137694,-895,-0.65,137651,-938,-0.68,137100,137694,1400-5-5,2021-07-27
578,اخزا909,اسنادخزانه-م9بودجه99-020316,62,283975,197883263551,695248,695700,697000,1752,0.25,696833,1585,0.23,692555,699837,1400-5-5,2021-07-27
579,اخزا907,اسنادخزانه-م7بودجه99-020704,61,180327,118417469761,653369,653001,655808,2439,0.37,656682,3313,0.51,652000,661988,1400-5-5,2021-07-27
580,لپارس,پارس‌ الكتريك‌,59,79417,5543357120,70540,69800,69860,-680,-0.96,70260,-280,-0.4,69800,69860,1400-5-5,2021-07-27
581,كساوه,صنايع‌ كاشي‌ و سراميك‌ سينا,56,219553,12064437350,57840,54950,54950,-2890,-5,55390,-2450,-4.24,54950,54950,1400-5-5,2021-07-27
582,ضپاس7029,اختيارخ وپارس-2500-1400/07/28,56,1692,933880000,653,625,533,-120,-18.38,552,-101,-15.47,456,625,1400-5-5,2021-07-27
583,سكه0112پ03,تمام سكه طرح جديد0112سامان,51,8900,9709705800,1076697,1080000,1090000,13303,1.24,1090978,14281,1.33,1080000,1098000,1400-5-5,2021-07-27
584,شزنگ,تجهيزنيروي‌زنگان‌,44,44406,6036551640,140144,135940,135940,-4204,-3,137468,-2676,-1.91,135940,135940,1400-5-5,2021-07-27
585,حسينا,توسعه خدمات دريايي وبندري سينا,43,50329,2911404300,59407,57990,58400,-1007,-1.7,59096,-311,-0.52,56560,59160,1400-5-5,2021-07-27
586,ضپاس7030,اختيارخ وپارس-3000-1400/07/28,42,2092,615737000,398,360,300,-98,-24.62,294,-104,-26.13,261,360,1400-5-5,2021-07-27
587,بساما,بيمه سامان,42,42686,1145544192,27664,27000,26600,-1064,-3.85,27621,-43,-0.16,26281,28340,1400-5-5,2021-07-27
588,كروي,توسعه‌ معادن‌ روي‌ ايران‌,39,64922,1408448820,22460,22170,21070,-1390,-6.19,22410,-50,-0.22,21070,22170,1400-5-5,2021-07-27
589,ضپال2007,اختيارخ اپال-32000-1401/02/12,38,896,747052000,802,819,801,-1,-0.12,834,32,3.99,800,849,1400-5-5,2021-07-27
590,ضمخا7071,اختيارخ اخابر-23700-1400/07/28,37,1390,75357000,50,55,56,6,12,54,4,8,51,56,1400-5-5,2021-07-27
591,تكنار,مجتمع معادن مس تكنار,36,64607,6599992692,105315,102156,102156,-3159,-3,103062,-2253,-2.14,102156,102156,1400-5-5,2021-07-27
592,شستان,پتروشيمي گلستان,34,299578,845684116,2879,2822,2822,-57,-1.98,2869,-10,-0.35,2822,2877,1400-5-5,2021-07-27
593,اخزا004,اسنادخزانه-م4بودجه00-030522,33,118206,65139994236,540459,546700,554987,14528,2.69,551072,10613,1.96,541003,558990,1400-5-5,2021-07-27
594,اوصتا2,صندوق انديشه ورزان صباتامين -د,33,25800000,25800000,19316,1,1,-19315,-99.99,1,-19315,-99.99,1,1,1400-5-5,2021-07-27
595,ثروتم,صندوق س. ثروت آفرين پارسيان-س,33,46040,3847193510,83897,83636,83300,-597,-0.71,83562,-335,-0.4,83119,84053,1400-5-5,2021-07-27
596,وپخش,داروپخش‌ (هلدينگ‌,31,269101,7015463070,24830,26070,26070,1240,4.99,25060,230,0.93,26070,26070,1400-5-5,2021-07-27
597,فماك,ماداكتو استيل كرد,28,1400000,32200000000,20444,23000,23000,2556,12.5,23000,2556,12.5,23000,23000,1400-5-5,2021-07-27
598,خصدرا,صنعتي‌ دريايي‌ ايران‌,27,1371956,3126687724,2309,2279,2279,-30,-1.3,2305,-4,-0.17,2279,2279,1400-5-5,2021-07-27
599,هاميد104,اختيارف ت ثاميد-2050-01/04/20,27,1000000,1000000,1,1,1,0,0,1,0,0,1,1,1400-5-5,2021-07-27
600,دارا,صندوق س. دارا الگوريتم-د,27,685766,6859726656,9996,10005,10000,4,0.04,10003,7,0.07,9997,10008,1400-5-5,2021-07-27
601,تمحركه,ماشين سازي نيرو محركه,26,69843,942531285,13912,13495,13495,-417,-3,13871,-41,-0.29,13495,13495,1400-5-5,2021-07-27
602,اراد50,مرابحه عام دولت5-ش.خ0302,26,330000,330000300000,1000001,1000000,1000001,0,0,1000001,0,0,1000000,1000001,1400-5-5,2021-07-27
603,زعف0008پ05,زعفران0008نگين زرين(پ),25,10389,1324037442,128006,134000,126500,-1506,-1.18,127446,-560,-0.44,126000,134000,1400-5-5,2021-07-27
604,هنوري102,اختيارف ت نوري59561-01/02/15,25,300000,300000,1,1,1,0,0,1,0,0,1,1,1400-5-5,2021-07-27
605,اخزا911,اسنادخزانه-م11بودجه99-020906,25,109445,69940559979,634013,634500,640000,5987,0.94,639048,5035,0.79,634000,640000,1400-5-5,2021-07-27
606,اخزا904,اسنادخزانه-م4بودجه99-011215,24,33486,24514122174,729799,726529,734000,4201,0.58,732071,2272,0.31,726529,734000,1400-5-5,2021-07-27
607,پلوله,گازلوله‌,24,40307,1214651445,31067,30135,30135,-932,-3,30947,-120,-0.39,30135,30135,1400-5-5,2021-07-27
608,اخزا815,اسنادخزانه-م15بودجه98-010406,21,26987,22564053625,833835,833112,837000,3165,0.38,836108,2273,0.27,833112,837000,1400-5-5,2021-07-27
609,الماس,صندوق س.امين تدبيرگران فردا-س,21,4481,507959188,114423,112435,112437,-1986,-1.74,113358,-1065,-0.93,112435,114999,1400-5-5,2021-07-27
610,عيار2,صندوق سكه طلاي مفيد,21,210000,210000,27326,1,1,-27325,-100,1,-27325,-100,1,1,1400-5-5,2021-07-27
611,زعف0008پ16,زعفران0008نگين بيرجند(پ),21,8593,1085623290,126445,126500,126996,551,0.44,126338,-107,-0.08,125500,126996,1400-5-5,2021-07-27
612,اخزا809,اسنادخزانه-م9بودجه98-000923,21,13307,12345890327,927347,927000,928503,1156,0.12,927774,427,0.05,926000,929000,1400-5-5,2021-07-27
613,خبازرس,بازرسي مهندسي و صنعتي ايران,20,49289,1237696079,25887,25111,25111,-776,-3,25788,-99,-0.38,25111,25111,1400-5-5,2021-07-27
614,ضسپا8042,اختيارخ خساپا-1800-1400/08/26,20,870,293638000,396,350,329,-67,-16.92,338,-58,-14.65,313,389,1400-5-5,2021-07-27
615,گنجين,صندوق س. گنجينه يكم آويد-د,20,129364,1724520972,13319,13319,13330,11,0.08,13331,12,0.09,13319,13332,1400-5-5,2021-07-27
616,تملي802,تسهيلات مسكن ب. ملي-ارديبهشت98,19,217,181822724,803282,843445,843446,40164,5,837893,34611,4.31,763118,843446,1400-5-5,2021-07-27
617,سفاسي,شركت فارسيت اهواز,19,38004,282787764,7832,7441,7441,-391,-4.99,7820,-12,-0.15,7441,7441,1400-5-5,2021-07-27
618,زعف0008پ09,زعفران0008نگين نوين(پ),19,2747,367701132,132933,131400,134000,1067,0.8,133856,923,0.69,131400,135000,1400-5-5,2021-07-27
619,اخزا812,اسنادخزانه-م12بودجه98-001111,18,26388,23749186332,906452,906000,906452,0,0,899999,-6453,-0.71,861130,908998,1400-5-5,2021-07-27
620,اخزا821,اسنادخزانه-م21بودجه98-020906,18,30153,19272587424,633986,634004,640000,6014,0.95,639160,5174,0.82,634003,640000,1400-5-5,2021-07-27
621,جهرمح,ح.پتروشيمي جهرم,18,841376,303286464,367,389,345,-22,-5.99,360,-7,-1.91,345,389,1400-5-5,2021-07-27
622,زعف0008پ15,زعفران0008پوشالمعمول طلاسرخ(پ),17,29824,3086784000,102000,103500,103500,1500,1.47,103500,1500,1.47,103500,103500,1400-5-5,2021-07-27
623,اخزا820,اسنادخزانه-م20بودجه98-020806,17,5063,3284276589,644690,646000,649964,5274,0.82,648682,3992,0.62,646000,649964,1400-5-5,2021-07-27
624,ضسپا8044,اختيارخ خساپا-2500-1400/08/26,17,486,92751000,249,120,161,-88,-35.34,191,-58,-23.29,120,198,1400-5-5,2021-07-27
625,آسام,صندوق س.آرمان سپهر آشنا-م,17,7970,880836520,110180,111923,110210,30,0.03,110519,339,0.31,109920,111923,1400-5-5,2021-07-27
626,سخند,صندوق س.سپهرخبرگان نفت-د,17,240910,2414188180,10017,10020,10030,13,0.13,10021,4,0.04,10018,10040,1400-5-5,2021-07-27
627,صنوين,صندوق سرمايه‌گذاري صنوين-مختلط,17,21527,2404042220,111710,114100,111000,-710,-0.64,111680,-30,-0.03,111000,114100,1400-5-5,2021-07-27
628,اخزا811,اسنادخزانه-م11بودجه98-001013,17,12492,11467371022,915305,917000,916856,1551,0.17,917977,2672,0.29,916854,919800,1400-5-5,2021-07-27
629,تپكو,توليدتجهيزات‌سنگين‌هپكو,16,26612,140378300,5382,5275,5275,-107,-1.99,5382,0,0,5275,5275,1400-5-5,2021-07-27
630,تملي701,تسهيلات مسكن ب. ملي-فروردين97,15,372,342072978,907129,952485,867293,-39836,-4.39,919551,12422,1.37,867293,952485,1400-5-5,2021-07-27
631,خريخت,صنايع‌ريخته‌گري‌ايران‌,15,54822,163460880,3166,3000,2920,-246,-7.77,3164,-2,-0.06,2920,3000,1400-5-5,2021-07-27
632,زعف0008پ08,زعفران0008نگين روستا(پ),14,9877,1264168373,127739,137693,127500,-239,-0.19,127991,252,0.2,127500,137693,1400-5-5,2021-07-27
633,اخزا817,اسنادخزانه-م17بودجه98-010512,14,10624,8698090126,819415,816501,820020,605,0.07,818721,-694,-0.08,816501,821268,1400-5-5,2021-07-27
634,زير0103پ04,زيره سبز0103شركت مينوبذر(پ),13,346,253286500,756111,730000,745000,-11111,-1.47,732042,-24069,-3.18,700030,760000,1400-5-5,2021-07-27
635,ضسپا8043,اختيارخ خساپا-2000-1400/08/26,13,315,90240000,343,300,280,-63,-18.37,286,-57,-16.62,200,320,1400-5-5,2021-07-27
636,اراد61,مرابحه عام دولت61-ش.خ0309,12,120000,120000120000,1000001,1000001,1000001,0,0,1000001,0,0,1000001,1000001,1400-5-5,2021-07-27
637,هفجر102,اختيارف ت بفجر8626-01/02/11,12,698010,698010,1,1,1,0,0,1,0,0,1,1,1400-5-5,2021-07-27
638,اخزا808,اسنادخزانه-م8بودجه98-000817,12,6128,5796650640,944583,944600,946001,1418,0.15,945929,1346,0.14,944600,946011,1400-5-5,2021-07-27
639,بالبر,كابل‌ البرز,12,45638,2129925460,49120,46670,46670,-2450,-4.99,48750,-370,-0.75,46670,46670,1400-5-5,2021-07-27
640,جهرم,پتروشيمي جهرم,12,60653,95528475,1657,1575,1575,-82,-4.95,1656,-1,-0.06,1575,1575,1400-5-5,2021-07-27
641,وسرضوي,س.سهام عدالت استان خراسان رضوي,12,220563,182185038,869,826,826,-43,-4.95,869,0,0,826,826,1400-5-5,2021-07-27
642,طلا2,صندوق س.پشتوانه طلاي لوتوس,12,1200000,1200000,77100,1,1,-77099,-100,1,-77099,-100,1,1,1400-5-5,2021-07-27
643,شگويات.ف0104,اختيارف.تبعي شگويا010408,11,73888,73888,1,1,1,0,0,1,0,0,1,1,1400-5-5,2021-07-27
644,تملي703,تسهيلات مسكن ب. ملي-خرداد97,11,358,281912412,767864,785899,806257,38393,5,787465,19601,2.55,729471,806257,1400-5-5,2021-07-27
645,ضمخا7075,اختيارخ اخابر-8700-1400/07/28,11,81,115552000,1704,1000,1215,-489,-28.7,1427,-277,-16.26,1000,1600,1400-5-5,2021-07-27
646,ضفلا7003,اختيارخ فولاد-8160-1400/07/25,10,108,427952088,3000,3099,2780,-220,-7.33,2826,-174,-5.8,2780,3099,1400-5-5,2021-07-27
647,گكيشح,ح.توريستي ورفاهي آبادگران كيش,10,59049,1989749870,35722,37865,33580,-2142,-6,33697,-2025,-5.67,33579,37865,1400-5-5,2021-07-27
648,بذر,صندوق س بذر اميد آفرين-سهام,10,4944,484956960,98130,98090,98090,-40,-0.04,98090,-40,-0.04,98090,98090,1400-5-5,2021-07-27
649,مكرما304,مشاركت ش كرمانشاه304-3ماهه18%,10,95000,95000000000,1000000,1000000,1000000,0,0,1000000,0,0,1000000,1000000,1400-5-5,2021-07-27
650,تملي612,تسهيلات مسكن بانك ملي-اسفند96,10,91,58936732,662760,630010,695898,33138,5,647656,-15104,-2.28,630000,695898,1400-5-5,2021-07-27
651,زعف0008پ11,زعفران0008نگين سحرخيز(پ),10,90265,11734450000,132519,130000,130000,-2519,-1.9,130000,-2519,-1.9,130000,130000,1400-5-5,2021-07-27
652,ضسپا8040,اختيارخ خساپا-1400-1400/08/26,10,105,54202000,632,570,500,-132,-20.89,516,-116,-18.35,459,570,1400-5-5,2021-07-27
653,كتوكا,توليدي و خدمات صنايع نسوز توكا,10,9782,282249828,30372,28854,28854,-1518,-5,30342,-30,-0.1,28854,28854,1400-5-5,2021-07-27
654,ضفلا7006,اختيارخ فولاد-12440-1400/07/25,9,19,20099072,799,800,749,-50,-6.26,755,-44,-5.51,748,800,1400-5-5,2021-07-27
655,شستا003,اجاره تامين اجتماعي-سپهر000523,9,770,770000000,1000000,1000000,1000000,0,0,1000000,0,0,1000000,1000000,1400-5-5,2021-07-27
656,تملي706,تسهيلات مسكن ب. ملي-شهريور97,9,108,95291600,869750,913236,899499,29749,3.42,882330,12580,1.45,826263,913236,1400-5-5,2021-07-27
657,اخزا816,اسنادخزانه-م16بودجه98-010503,9,3962,3264989952,825740,823003,824001,-1739,-0.21,824076,-1664,-0.2,823003,824990,1400-5-5,2021-07-27
658,اخزا721,اسنادخزانه-م21بودجه97-000728,8,4617,4411727660,955390,955500,957900,2510,0.26,955540,150,0.02,955500,957900,1400-5-5,2021-07-27
659,ضپاس7031,اختيارخ وپارس-3500-1400/07/28,8,58,15786000,252,100,170,-82,-32.54,272,20,7.94,100,290,1400-5-5,2021-07-27
660,شستا002,اجاره تامين اجتماعي-تمدن000523,8,90000,90000000000,1000000,1000000,1000000,0,0,1000000,0,0,1000000,1000000,1400-5-5,2021-07-27
661,زعف0008پ12,زعفران0008پوشالمعمول سحرخيز(پ),8,7500,773450000,101000,103500,102000,1000,0.99,103127,2127,2.11,102000,103500,1400-5-5,2021-07-27
662,بكاب,صنايع‌جوشكاب‌يزد,8,388,125684840,340970,323930,323930,-17040,-5,340820,-150,-0.04,323930,323930,1400-5-5,2021-07-27
663,آكورد2,صندوق س. آرمان آتي كوثر-د,8,800000,800000,33220,1,1,-33219,-100,1,-33219,-100,1,1,1400-5-5,2021-07-27
664,ضصاد8033,اختيارخ وبصادر-2489-1400/08/12,7,317,89241000,285,266,280,-5,-1.75,282,-3,-1.05,266,300,1400-5-5,2021-07-27
665,اخزا806,اسنادخزانه-م6بودجه98-000519,7,7616,7558173222,992152,992122,992433,281,0.03,992407,255,0.03,992122,993495,1400-5-5,2021-07-27
666,وسكرشا,س.سهام عدالت استان كرمانشاه,7,136738,119509012,919,874,874,-45,-4.9,919,0,0,874,874,1400-5-5,2021-07-27
667,صخود412,ص مرابحه خودرو412- 3ماهه 18%,7,70000,69650000000,995000,995000,995000,0,0,995000,0,0,995000,995000,1400-5-5,2021-07-27
668,اخزا813,اسنادخزانه-م13بودجه98-010219,7,3666,3155376200,858389,858100,861000,2611,0.3,860714,2325,0.27,858100,861000,1400-5-5,2021-07-27
669,ضترا8058,اختيارخ شتران-3442-1400/08/09,7,52,181700000,3500,3500,3490,-10,-0.29,3494,-6,-0.17,3490,3500,1400-5-5,2021-07-27
670,سنير,سيمان‌ سفيد ني‌ريز,7,203,32666760,169380,160920,160920,-8460,-4.99,169360,-20,-0.01,160920,160920,1400-5-5,2021-07-27
671,قيستو,شركت قند بيستون,7,53083,704623742,13014,13274,13274,260,2,13049,35,0.27,13274,13274,1400-5-5,2021-07-27
672,تسه99012,امتياز تسهيلات مسكن فروردين99,7,546,5460,601189,10,10,-601179,-100,10,-601179,-100,10,10,1400-5-5,2021-07-27
673,ثهام,صندوق س ثروت هامرز-سهام,6,2132,21640300,10114,10150,10150,36,0.36,10150,36,0.36,10150,10151,1400-5-5,2021-07-27
674,آرمان,بيمه آرمان,6,20840,136814600,6565,6565,6565,0,0,6565,0,0,6565,6565,1400-5-5,2021-07-27
675,ثتوسا,س.توسعه و عمران استان اردبيل,6,1969,70830837,37866,35973,35973,-1893,-5,37852,-14,-0.04,35973,35973,1400-5-5,2021-07-27
676,صشستا311,صكوك اجاره شستا311-بدون ضامن,6,30000,30000000000,999259,1000000,1000000,741,0.07,1000000,741,0.07,1000000,1000000,1400-5-5,2021-07-27
677,بايكا,كارخانجات كابلسازي ‌ايران‌,6,2243,55146398,25346,24586,24586,-760,-3,25342,-4,-0.02,24586,24586,1400-5-5,2021-07-27
678,اراد33,مرابحه عام دولت3-ش.خ 0303,6,5000,4647913000,901813,946899,940000,38187,4.23,929583,27770,3.08,881015,946899,1400-5-5,2021-07-27
679,كترام,توليدي‌ كاشي‌ تكسرام‌,6,862,35910920,43850,41660,41660,-2190,-4.99,43840,-10,-0.02,41660,41660,1400-5-5,2021-07-27
680,زماهان,مجتمع توليد گوشت مرغ ماهان,6,2855,45811330,16890,16046,16046,-844,-5,16887,-3,-0.02,16046,16046,1400-5-5,2021-07-27
681,تملي710,تسهيلات مسكن ب. ملي-دي97,6,56,47688164,811143,851000,851699,40556,5,851574,40431,4.98,851000,851700,1400-5-5,2021-07-27
682,شرق1400,مشاركت ليزينگ ايران وشرق140010,6,482,481994200,1008000,999800,1000000,-8000,-0.79,999988,-8012,-0.79,999800,1000000,1400-5-5,2021-07-27
683,ضچاد7032,اختيارخ كچاد-15870-1400/07/04,6,15,180000000,11500,12000,12000,500,4.35,12000,500,4.35,12000,12000,1400-5-5,2021-07-27
684,ضجار7040,اختيارخ وتجارت-2497-1400/07/21,6,7,2499000,473,210,399,-74,-15.64,357,-116,-24.52,210,480,1400-5-5,2021-07-27
685,سپيدما2,صندوق س. سپيد دماوند-د,6,60000000,60000000,10741,1,1,-10740,-99.99,1,-10740,-99.99,1,1,1400-5-5,2021-07-27
686,اطلس2,صندوق س.توسعه اندوخته آينده-س,6,60000,60000,235968,1,1,-235967,-100,1,-235967,-100,1,1,1400-5-5,2021-07-27
687,داريك,صندوق س.اعتماد داريك-د,6,4390,47723645,10857,10876,10865,8,0.07,10871,14,0.13,10865,10876,1400-5-5,2021-07-27
688,زعف0008پ20,زعفران0008نگين وحدت جام(پ),6,1180,149787800,127112,127000,126800,-312,-0.25,126939,-173,-0.14,126800,127500,1400-5-5,2021-07-27
689,دشيري,شيرين دارو,6,381,75417426,208364,197946,197946,-10418,-5,208281,-83,-0.04,197946,197946,1400-5-5,2021-07-27
690,اخزا814,اسنادخزانه-م14بودجه98-010318,6,47151,39912593002,844148,843002,846490,2342,0.28,846485,2337,0.28,843002,846490,1400-5-5,2021-07-27
691,فلات,گروه صنايع معادن فلات ايرانيان,6,14000,196070000,14742,14005,14005,-737,-5,14727,-15,-0.1,14005,14005,1400-5-5,2021-07-27
692,ضفلا7004,اختيارخ فولاد-9586-1400/07/25,5,21,55468728,1684,1938,1730,46,2.73,1884,200,11.88,1730,1949,1400-5-5,2021-07-27
693,ثشرق,سرمايه گذاري مسكن شمال شرق,5,49820,286963200,6060,5760,5760,-300,-4.95,6050,-10,-0.17,5760,5760,1400-5-5,2021-07-27
694,اخزا807,اسنادخزانه-م7بودجه98-000719,5,2908,2794764019,959808,961001,962600,2792,0.29,961060,1252,0.13,961000,962600,1400-5-5,2021-07-27
695,سكه0111پ05,تمام سكه طرح جديد0111آينده,5,1100,1202100000,1083976,1094000,1093000,9024,0.83,1092818,8842,0.82,1090000,1094000,1400-5-5,2021-07-27
696,اراد35,مرابحه عام دولت3-ش.خ 0103,5,11100,10739000100,999999,955004,964350,-35649,-3.56,967477,-32522,-3.25,955004,1000000,1400-5-5,2021-07-27
697,اخزا723,اسنادخزانه-م23بودجه97-000824,4,1826,1720985000,941018,942000,942500,1482,0.16,942489,1471,0.16,942000,942510,1400-5-5,2021-07-27
698,اراد36,مرابحه عام دولت3-ش.خ 0104,4,11100,10683495500,985000,950010,960500,-24500,-2.49,962477,-22523,-2.29,950010,984989,1400-5-5,2021-07-27
699,ضخوز7035,اختيارخ فخوز-8200-1400/07/14,4,4,34250000,8800,8850,8300,-500,-5.68,8562,-238,-2.7,8300,8850,1400-5-5,2021-07-27
700,داراب,پتروشيمي داراب,4,13800,31974600,2438,2317,2317,-121,-4.96,2438,0,0,2317,2317,1400-5-5,2021-07-27
701,ضپيك7042,اختيارخ تاپيكو-8070-00/07/18,4,36,129100000,4733,4400,4000,-733,-15.49,3586,-1147,-24.23,3100,4400,1400-5-5,2021-07-27
702,اخزا906,اسنادخزانه-م6بودجه99-020321,4,2650,1890860000,711491,710000,715100,3609,0.51,713532,2041,0.29,710000,718600,1400-5-5,2021-07-27
703,سجامح,ح.مجتمع سيمان غرب آسيا,4,56000,144180000,2650,2650,2570,-80,-3.02,2575,-75,-2.83,2570,2650,1400-5-5,2021-07-27
704,وسالت,بانك قرض الحسنه رسالت,4,24408,27922752,1111,1144,1144,33,2.97,1111,0,0,1144,1144,1400-5-5,2021-07-27
705,ثنام,س ساختماني ب نام آوران مهندسي,4,3000,48309000,16601,16103,16103,-498,-3,16599,-2,-0.01,16103,16103,1400-5-5,2021-07-27
706,ضپيك7039,اختيارخ تاپيكو-5070-00/07/18,4,5,32500000,7600,6400,6600,-1000,-13.16,6500,-1100,-14.47,6400,6600,1400-5-5,2021-07-27
707,اخزا818,اسنادخزانه-م18بودجه98-010614,4,3276,2630048766,803328,802203,803706,378,0.05,802823,-505,-0.06,802203,824986,1400-5-5,2021-07-27
708,اخزا810,اسنادخزانه-م10بودجه98-001006,4,2492,2293496852,918183,920344,920342,2159,0.24,920344,2161,0.24,920342,920344,1400-5-5,2021-07-27
709,تملي707,تسهيلات مسكن ب. ملي-مهر97,4,108,82283953,729500,729200,765975,36475,5,761888,32388,4.44,729200,765975,1400-5-5,2021-07-27
710,كرونا2,تامين مالي جمعي صرفا اهداي سود,4,2404,24040000,10000,10000,10000,0,0,10000,0,0,10000,10000,1400-5-5,2021-07-27
711,اخزا713,اسنادخزانه-م13بودجه97-000518,4,808,802492493,991847,993500,992971,1124,0.11,993184,1337,0.13,992971,993500,1400-5-5,2021-07-27
712,لخانه,لوازم‌ خانگي‌ پارس‌,3,3148,72426036,23718,23007,23007,-711,-3,23713,-5,-0.02,23007,23007,1400-5-5,2021-07-27
713,تملي805,تسهيلات مسكن ب. ملي-مرداد98,3,16,14715332,931350,884783,977917,46567,5,919708,-11642,-1.25,884783,977917,1400-5-5,2021-07-27
714,ضگل8072,اختيارخ كگل-8700-1400/08/23,3,3,42050000,12200,15000,12050,-150,-1.23,14017,1817,14.89,12050,15000,1400-5-5,2021-07-27
715,خفناور,مهندسي صنعتي روان فن آور,3,422,19012788,47425,45054,45054,-2371,-5,47420,-5,-0.01,45054,45054,1400-5-5,2021-07-27
716,افران2,صندوق س افرا نماد پايدار-ثابت,3,23000000,23000000,13857,1,1,-13856,-99.99,1,-13856,-99.99,1,1,1400-5-5,2021-07-27
717,غدام,خوراك‌  دام‌ پارس‌,3,180,65374200,382300,363190,363190,-19110,-5,382210,-90,-0.02,363190,363190,1400-5-5,2021-07-27
718,تصميم2,صندوق س با درآمد ثابت تصميم,3,3000000,3000000,16934,1,1,-16933,-99.99,1,-16933,-99.99,1,1,1400-5-5,2021-07-27
719,اراد364,مرابحه عام دولت3-ش.خ 0104,3,2889800,2775652900000,985000,960500,960500,-24500,-2.49,960500,-24500,-2.49,960500,960500,1400-5-5,2021-07-27
720,اخزا905,اسنادخزانه-م5بودجه99-020218,3,3900,2764888200,706966,708990,708900,1934,0.27,708946,1980,0.28,708900,708998,1400-5-5,2021-07-27
721,ضفلا7005,اختيارخ فولاد-11013-1400/07/25,3,12,24948590,1127,1445,1490,363,32.21,1483,356,31.59,1445,1490,1400-5-5,2021-07-27
722,زير0103پ01,زيره سبز0103كيميابذر(پ),3,90,69509520,730000,772328,772328,42328,5.8,772328,42328,5.8,772328,772328,1400-5-5,2021-07-27
723,گكيش,توريستي ورفاهي آبادگران كيش,3,560,25860800,47608,46180,46180,-1428,-3,47604,-4,-0.01,46180,46180,1400-5-5,2021-07-27
724,ثنظام,س. ساختماني نظام مهندسي ايران,2,350,15674400,47141,44784,44784,-2357,-5,47137,-4,-0.01,44784,44784,1400-5-5,2021-07-27
725,پا ه 19,بار پايه هفته 19,2,12970,7636000,345,800,526,181,52.46,589,244,70.72,526,800,1400-5-5,2021-07-27
726,ثاژن,سخت آژند,2,17184,158436480,9408,9220,9220,-188,-2,9402,-6,-0.06,9220,9220,1400-5-5,2021-07-27
727,ضپاس7027,اختيارخ وپارس-1800-1400/07/28,2,4,4180000,1450,1090,910,-540,-37.24,1045,-405,-27.93,910,1090,1400-5-5,2021-07-27
728,قشهد,شهد,2,800,14440000,18990,18050,18050,-940,-4.95,18990,0,0,18050,18050,1400-5-5,2021-07-27
729,ضفار8047,اختيارخ فارس-4400-1400/08/05,2,10,62250000,6397,6200,6250,-147,-2.3,6225,-172,-2.69,6200,6250,1400-5-5,2021-07-27
730,زعف0008پ18,زعفران0008نگين بهرامن(پ),2,1036,142550000,138622,137600,137500,-1122,-0.81,137597,-1025,-0.74,137500,137600,1400-5-5,2021-07-27
731,شلرد02,كود شيميايي اوره لردگان,2,13,13801365,1053485,1053485,1080000,26515,2.52,1061643,8158,0.77,1053485,1080000,1400-5-5,2021-07-27
732,پا ر 38,بار پايه روز 38,2,12970,7636000,350,800,526,176,50.29,589,239,68.29,526,800,1400-5-5,2021-07-27
733,همبين102,اختيارف ت مبين17952-01/02/10,2,22657,22657,1,1,1,0,0,1,0,0,1,1,1400-5-5,2021-07-27
734,اخزا0042,اسنادخزانه-م4بودجه00-030522,2,925000,499500000000,540459,540000,540000,-459,-0.08,540000,-459,-0.08,540000,540000,1400-5-5,2021-07-27
735,ثقزوي,شركت عمران و سازندگي قزوين,2,671,20635934,31705,30754,30754,-951,-3,31703,-2,-0.01,30754,30754,1400-5-5,2021-07-27
736,پا ر 37,بار پايه روز 37,2,12970,7636000,350,800,526,176,50.29,589,239,68.29,526,800,1400-5-5,2021-07-27
737,صفارس0372,صكوك اجاره فارس037- 3ماهه18%,2,994990,994990000000,1045000,1000000,1000000,-45000,-4.31,1000000,-45000,-4.31,1000000,1000000,1400-5-5,2021-07-27
738,كابگن,توليدي و صنعتي آبگينه‌,2,9505,51127395,5326,5379,5379,53,1,5327,1,0.02,5379,5379,1400-5-5,2021-07-27
739,وملت,سرمايه گذاري ملت,2,41200,171639200,4251,4166,4166,-85,-2,4248,-3,-0.07,4166,4166,1400-5-5,2021-07-27
740,اروند10,منفعت صبا اروند لوتوس 14001222,2,10505,10419900505,992500,980001,992500,0,0,991899,-601,-0.06,980001,992500,1400-5-5,2021-07-27
741,دمعيار2,صندوق س. توازن معيار-د,2,5000000,5000000,10021,1,1,-10020,-99.99,1,-10020,-99.99,1,1,1400-5-5,2021-07-27
742,ضمخا7077,اختيارخ اخابر-6700-1400/07/28,2,70,155500000,2319,2210,2250,-69,-2.98,2221,-98,-4.23,2210,2250,1400-5-5,2021-07-27
743,ومهان2,گروه توسعه مالي مهر آيندگان,2,14200000,196187200000,13816,13816,13816,0,0,13816,0,0,13816,13816,1400-5-5,2021-07-27
744,ضپاس7028,اختيارخ وپارس-2000-1400/07/28,2,5,3755000,1105,751,751,-354,-32.04,751,-354,-32.04,751,751,1400-5-5,2021-07-27
745,آوا2,صندوق س.سهام آواي معيار-س,2,2500000,2500000,7045,1,1,-7044,-99.99,1,-7044,-99.99,1,1,1400-5-5,2021-07-27
746,اخزا718,اسنادخزانه-م18بودجه97-000525,2,54,53554959,987771,991000,991999,4228,0.43,991758,3987,0.4,991000,991999,1400-5-5,2021-07-27
747,غگز,گز سكه,2,100000,1570000000,16500,15700,15700,-800,-4.85,15700,-800,-4.85,15700,15700,1400-5-5,2021-07-27
748,صفارس037,صكوك اجاره فارس037- 3ماهه18%,2,1800,1800000000,1045000,1000000,1000000,-45000,-4.31,1000000,-45000,-4.31,1000000,1000000,1400-5-5,2021-07-27
749,فولاد2,فولاد مباركه اصفهان,2,109400000,1158230000000,10790,10600,10450,-340,-3.15,10587,-203,-1.88,10450,10600,1400-5-5,2021-07-27
750,وهنر,گروه توسعه هنر ايران,1,840,6090840,7475,7251,7251,-224,-3,7475,0,0,7251,7251,1400-5-5,2021-07-27
751,تملي801,تسهيلات مسكن ب. ملي-فروردين98,1,7,5985000,900000,855000,855000,-45000,-5,855000,-45000,-5,855000,855000,1400-5-5,2021-07-27
752,رايان106,مشاركت رايان سايپا-3ماهه16%,1,100,101134000,991513,1011340,1011340,19827,2,1011340,19827,2,1011340,1011340,1400-5-5,2021-07-27
753,شكف,كف,1,408,39768984,99462,97473,97473,-1989,-2,99454,-8,-0.01,97473,97473,1400-5-5,2021-07-27
754,اراد354,مرابحه عام دولت3-ش.خ 0103,1,3490000,3365581500000,999999,964350,964350,-35649,-3.56,964350,-35649,-3.56,964350,964350,1400-5-5,2021-07-27
755,سخواف,سيمان مجد خواف,1,330,5144700,16072,15590,15590,-482,-3,16072,0,0,15590,15590,1400-5-5,2021-07-27
756,حاريا,كشتيراني آريا,1,1233,20194074,17060,16378,16378,-682,-4,17057,-3,-0.02,16378,16378,1400-5-5,2021-07-27
757,كمند4,صندوق س. با درآمد ثابت كمند,1,87000000,880005000000,10110,10115,10115,5,0.05,10115,5,0.05,10115,10115,1400-5-5,2021-07-27
758,مشهد0212,مشاركت ش مشهد0212-3ماهه18%,1,1700,1700000000,1000000,1000000,1000000,0,0,1000000,0,0,1000000,1000000,1400-5-5,2021-07-27
759,ضفار8050,اختيارخ فارس-7400-1400/08/05,1,10,35000000,3500,3500,3500,0,0,3500,0,0,3500,3500,1400-5-5,2021-07-27
760,اراد314,مرابحه عام دولت3-ش.خ 0208,1,25000000,22707750000000,950000,908310,908310,-41690,-4.39,908310,-41690,-4.39,908310,908310,1400-5-5,2021-07-27
761,سميعا002,سلف موازي استاندارد سميعا002,1,100,137113700,1345695,1371137,1371137,25442,1.89,1371137,25442,1.89,1371137,1371137,1400-5-5,2021-07-27
762,اراد324,مرابحه عام دولت3-ش.خ0211,1,45794392,41172364015440,1000000,899070,899070,-100930,-10.09,899070,-100930,-10.09,899070,899070,1400-5-5,2021-07-27
763,شتولي,تولي‌پرس‌,1,3000,92730000,31540,30910,30910,-630,-2,31528,-12,-0.04,30910,30910,1400-5-5,2021-07-27
764,سفارود,كارخانه فارسيت درود,1,300,5071500,17249,16905,16905,-344,-1.99,17249,0,0,16905,16905,1400-5-5,2021-07-27
765,سنفت102,سلف موازي استاندارد سنفت102,1,72000,101268576000,1236583,1406508,1406508,169925,13.74,1406508,169925,13.74,1406508,1406508,1400-5-5,2021-07-27
766,پا ه 20,بار پايه هفته 20,1,2970,2376000,385,800,800,415,107.79,800,415,107.79,800,800,1400-5-5,2021-07-27
767,پست0008پ08,پسته فندقي32-30مه ولات0008(پ),1,5,9000000,1838874,1800000,1800000,-38874,-2.11,1800000,-38874,-2.11,1800000,1800000,1400-5-5,2021-07-27
768,لپيام,گسترش صنايع پيام,1,110,5416950,51836,49245,49245,-2591,-5,51835,-1,0,49245,49245,1400-5-5,2021-07-27
769,فخوز2,فولاد  خوزستان,1,11000000,170500000000,15940,15500,15500,-440,-2.76,15500,-440,-2.76,15500,15500,1400-5-5,2021-07-27
770,نگين,ص.س. زمين و ساختمان نگين شهرري,1,849,40412400,47610,47600,47600,-10,-0.02,47600,-10,-0.02,47600,47600,1400-5-5,2021-07-27
771,دشيمي2,شيمي‌ داروئي‌ داروپخش‌,1,5530000,143780000000,26000,26000,26000,0,0,26000,0,0,26000,26000,1400-5-5,2021-07-27
772,ارفع2,شركت آهن و فولاد ارفع,1,10000000,140000000000,14170,14000,14000,-170,-1.2,14000,-170,-1.2,14000,14000,1400-5-5,2021-07-27
773,دتماد2,توليدمواداوليه‌داروپخش‌,1,1307000,60304980000,46140,46140,46140,0,0,46140,0,0,46140,46140,1400-5-5,2021-07-27
774,اشاد1,مشاركت دولتي1-شرايط خاص001026,1,200,198000000,984999,990000,990000,5001,0.51,990000,5001,0.51,990000,990000,1400-5-5,2021-07-27
775,اروند102,منفعت صبا اروند لوتوس 14001222,1,240000,238200000000,992500,992500,992500,0,0,992500,0,0,992500,992500,1400-5-5,2021-07-27
776,اخزا8112,اسنادخزانه-م11بودجه98-001013,1,325000,296660000000,915305,912800,912800,-2505,-0.27,912800,-2505,-0.27,912800,912800,1400-5-5,2021-07-27
777,ضپيك7040,اختيارخ تاپيكو-6070-00/07/18,1,10,50000000,5500,5000,5000,-500,-9.09,5000,-500,-9.09,5000,5000,1400-5-5,2021-07-27
778,نتوس,پشم‌ بافي‌ توس,1,290,5567420,19791,19198,19198,-593,-3,19791,0,0,19198,19198,1400-5-5,2021-07-27
779,افاد4,منفعت دولتي4-شرايط خاص14010729,1,1000,1017241000,1070781,1017241,1017241,-53540,-5,1017241,-53540,-5,1017241,1017241,1400-5-5,2021-07-27
780,اراد22,مرابحه عام دولت2-ش.خ لوتوس0212,1,4000,3880000000,964000,970000,970000,6000,0.62,970000,6000,0.62,970000,970000,1400-5-5,2021-07-27
781,پارسان2,گسترش نفت و گاز پارسيان,1,20000000,514000000000,25950,25700,25700,-250,-0.96,25700,-250,-0.96,25700,25700,1400-5-5,2021-07-27
782,افرا2,افرانت,1,19000000,549100000000,28421,28900,28900,479,1.69,28900,479,1.69,28900,28900,1400-5-5,2021-07-27
783,ضفار8048,اختيارخ فارس-5400-1400/08/05,1,1,5100000,5270,5100,5100,-170,-3.23,5100,-170,-3.23,5100,5100,1400-5-5,2021-07-27
784,پارتين,ص.ج.پارتيان,1,1000,418000000,407000,418000,418000,11000,2.7,418000,11000,2.7,418000,418000,1400-5-5,2021-07-27
785,شستان03,اجاره تجاري شستان14030915,1,4,4000000,1020000,1000000,1000000,-20000,-1.96,1000000,-20000,-1.96,1000000,1000000,1400-5-5,2021-07-27
786,گواهي ظرفيت,گواهي ظرفيت نقدي,1,100000,2105400000,20052,21054,21054,1002,5,20057,5,0.02,21054,21054,1400-5-5,2021-07-27
787,ضجار7039,اختيارخ وتجارت-1997-1400/07/21,1,15,11250000,865,750,750,-115,-13.29,750,-115,-13.29,750,750,1400-5-5,2021-07-27
788,صپا ر 19,بار پايه روز 19صنعتي,1,1300,1196000,385,920,920,535,138.96,920,535,138.96,920,920,1400-5-5,2021-07-27
789,حپترو,حمل و نقل پتروشيمي( سهامي عام,1,429,21664500,53150,50500,50500,-2650,-4.99,53150,0,0,50500,50500,1400-5-5,2021-07-27
790,ضخوز7039,اختيارخ فخوز-15200-1400/07/14,1,1,2650000,2760,2650,2650,-110,-3.99,2650,-110,-3.99,2650,2650,1400-5-5,2021-07-27
791,ضخوز7037,اختيارخ فخوز-11200-1400/07/14,1,1,5850000,5800,5850,5850,50,0.86,5850,50,0.86,5850,5850,1400-5-5,2021-07-27
792,كهرام,توليدي گرانيت بهسرام,1,50,5487600,113146,109752,109752,-3394,-3,113144,-2,0,109752,109752,1400-5-5,2021-07-27
793,ضخوز7036,اختيارخ فخوز-9200-1400/07/14,1,1,7850000,7830,7850,7850,20,0.26,7850,20,0.26,7850,7850,1400-5-5,2021-07-27
794,پست0008پ04,پسته فندقي32-30سبزدانه0008(پ),1,7,13160000,1880000,1880000,1880000,0,0,1880000,0,0,1880000,1880000,1400-5-5,2021-07-27
795,فراز2,صندوق س.سهام فراز داريك-س,1,500000,500000,12159,1,1,-12158,-99.99,1,-12158,-99.99,1,1,1400-5-5,2021-07-27
796,اراد764,مرابحه عام دولت76-ش.خ030406,1,300000,273900000000,919980,913000,913000,-6980,-0.76,913000,-6980,-0.76,913000,913000,1400-5-5,2021-07-27
797,صپا ر 18,بار پايه روز 18صنعتي,1,1300,1196000,385,920,920,535,138.96,920,535,138.96,920,920,1400-5-5,2021-07-27
798,ثزاگرس,سرمايه گذاري توسعه عمران زاگرس,1,132,6634056,52903,50258,50258,-2645,-5,52901,-2,0,50258,50258,1400-5-5,2021-07-27
799,زعف0008پ19,زعفران0008نگين تروند قاينات(پ),1,1000,137600000,138644,137600,137600,-1044,-0.75,137600,-1044,-0.75,137600,137600,1400-5-5,2021-07-27
800,ياقوت2,صندوق س ياقوت آگاه-ثابت,1,9638000,9638000,12734,1,1,-12733,-99.99,1,-12733,-99.99,1,1,1400-5-5,2021-07-27
801,ضغدر8056,اختيارخ وغدير-8000-1400/08/26,1,1,4950000,5067,4950,4950,-117,-2.31,4950,-117,-2.31,4950,4950,1400-5-5,2021-07-27
802,ضپيك7043,اختيارخ تاپيكو-10070-00/07/18,1,1,2000000,3861,2000,2000,-1861,-48.2,2000,-1861,-48.2,2000,2000,1400-5-5,2021-07-27
803,اراد76,مرابحه عام دولت76-ش.خ030406,1,25000,22825000000,919980,913000,913000,-6980,-0.76,913000,-6980,-0.76,913000,913000,1400-5-5,2021-07-27
804,صپا ر 17,بار پايه روز 17صنعتي,1,1300,1196000,385,920,920,535,138.96,920,535,138.96,920,920,1400-5-5,2021-07-27
805,سرو2,صندوق س سروسودمند مدبران-سهام,1,100000,100000,70240,1,1,-70239,-100,1,-70239,-100,1,1,1400-5-5,2021-07-27
806,نيرو,نيرو سرمايه,1,2050,99621800,50098,48596,48596,-1502,-3,50083,-15,-0.03,48596,48596,1400-5-5,2021-07-27
807,صپا ر 16,بار پايه روز 16صنعتي,1,1300,1196000,385,920,920,535,138.96,920,535,138.96,920,920,1400-5-5,2021-07-27
808,زير0103پ02,زيره سبز0103 دانش(پ),1,1,772000,759274,772000,772000,12726,1.68,772000,12726,1.68,772000,772000,1400-5-5,2021-07-27
809,پا ه 21,بار پايه هفته 21,1,2970,2376000,385,800,800,415,107.79,800,415,107.79,800,800,1400-5-5,2021-07-27
810,دارو2,كارخانجات‌داروپخش‌,1,2617510,64128995000,24500,24500,24500,0,0,24500,0,0,24500,24500,1400-5-5,2021-07-27
811,اراد46,مرابحه عام دولت4-ش.خ 0302,1,10000,10000000000,1000000,1000000,1000000,0,0,1000000,0,0,1000000,1000000,1400-5-5,2021-07-27
812,تملي709,تسهيلات مسكن ب. ملي-آذر97,1,7,5214832,784185,744976,744976,-39209,-5,744976,-39209,-5,744976,744976,1400-5-5,2021-07-27
813,وآذر2,سرمايه‌گذاري‌توسعه‌آذربايجان‌,1,9900000,623700000000,65030,63000,63000,-2030,-3.12,63000,-2030,-3.12,63000,63000,1400-5-5,2021-07-27
