,نماد,نام,تعداد,حجم,ارزش,دیروز,اولین,آخرین معامله - مقدار,آخرین معامله - تغییر,آخرین معامله - درصد,قیمت پایانی - مقدار,قیمت پایانی - تغییر,قیمت پایانی - درصد,کمترین,بیشترین,تاریخ,gregorian_date
0,پالايش,صندوق پالايشي يكم-سهام,107228,131055138,12304253990170,92480,96250,89400,-3080,-3.33,93890,1410,1.52,87800,98880,1400-6-7,2021-08-29
1,سپيد,سپيد ماكيان,73163,17828141,1021786921880,57510,58000,56000,-1510,-2.63,57310,-200,-0.35,55000,59260,1400-6-7,2021-08-29
2,وهامون,سرمايه گذاري هامون صبا,65646,149763300,603454079217,3839,4030,4030,191,4.98,4029,190,4.95,3960,4030,1400-6-7,2021-08-29
3,دارا يكم,صندوق واسطه گري مالي يكم-سهام,57138,37765048,5827099584860,157670,162800,147410,-10260,-6.51,154300,-3370,-2.14,146110,162800,1400-6-7,2021-08-29
4,شستا,سرمايه گذاري تامين اجتماعي,47189,243207823,3556004699380,14610,14790,14110,-500,-3.42,14620,10,0.07,14010,15170,1400-6-7,2021-08-29
5,دي,بانك دي,43141,1906836786,2461400393815,1259,1318,1245,-14,-1.11,1291,32,2.54,1225,1321,1400-6-7,2021-08-29
6,خودرو,ايران‌ خودرو,34878,1031487572,2512199215103,2474,2519,2351,-123,-4.97,2436,-38,-1.54,2351,2540,1400-6-7,2021-08-29
7,شپنا,پالايش نفت اصفهان,34737,222505171,3423654326240,15610,15860,14830,-780,-5,15390,-220,-1.41,14830,15900,1400-6-7,2021-08-29
8,مديريت,س. و خدمات مديريت صند. ب كشوري,33693,12570366,89953539096,6816,7156,7156,340,4.99,7156,340,4.99,7156,7156,1400-6-7,2021-08-29
9,فولاد,فولاد مباركه اصفهان,32565,270492020,3416681016610,12510,12680,12450,-60,-0.48,12630,120,0.96,12350,13100,1400-6-7,2021-08-29
10,فملي,ملي‌ صنايع‌ مس‌ ايران‌,32043,195511121,2863181898910,14480,14600,14220,-260,-1.8,14640,160,1.1,14000,15110,1400-6-7,2021-08-29
11,بركت,گروه دارويي بركت,30433,75289702,2941734613690,37690,38000,38420,730,1.94,39070,1380,3.66,37690,39570,1400-6-7,2021-08-29
12,خساپا,سايپا,29563,988781360,2216296372072,2273,2290,2160,-113,-4.97,2241,-32,-1.41,2160,2310,1400-6-7,2021-08-29
13,خگستر,گسترش‌سرمايه‌گذاري‌ايران‌خودرو,24563,571393709,1818919381978,3176,3325,3040,-136,-4.28,3183,7,0.22,3018,3325,1400-6-7,2021-08-29
14,شتران,پالايش نفت تهران,24336,207989811,2497553986650,11960,12300,11620,-340,-2.84,12010,50,0.42,11500,12390,1400-6-7,2021-08-29
15,خپارس,پارس‌ خودرو,21655,1183088033,1666900735488,1371,1439,1342,-29,-2.12,1409,38,2.77,1313,1439,1400-6-7,2021-08-29
16,وتجارت,بانك تجارت,21251,492540688,1423958315529,2987,2985,2838,-149,-4.99,2891,-96,-3.21,2838,2985,1400-6-7,2021-08-29
17,وهنر,گروه توسعه هنر ايران,21031,209360354,1441287956278,7048,6842,6837,-211,-2.99,6884,-164,-2.33,6837,7040,1400-6-7,2021-08-29
18,كرمان,س. توسعه و عمران استان كرمان,19937,604780182,904977543622,1547,1520,1470,-77,-4.98,1496,-51,-3.3,1470,1539,1400-6-7,2021-08-29
19,نوري,پتروشيمي نوري,17790,11805733,1247154659490,108400,108710,103400,-5000,-4.61,105640,-2760,-2.55,102980,109900,1400-6-7,2021-08-29
20,كاما,باما,16953,96495684,1358184125360,13760,13990,13710,-50,-0.36,14080,320,2.33,13480,14440,1400-6-7,2021-08-29
21,ومدير,گ.مديريت ارزش سرمايه ص ب كشوري,16740,120251103,706407383560,5760,6030,5610,-150,-2.6,5870,110,1.91,5510,6030,1400-6-7,2021-08-29
22,پترول,گ.س.وت.ص.پتروشيمي خليج فارس,16375,133957806,596706126983,4542,4596,4317,-225,-4.95,4454,-88,-1.94,4315,4596,1400-6-7,2021-08-29
23,وبملت,بانك ملت,16034,317792768,1418871645173,4594,4650,4365,-229,-4.98,4465,-129,-2.81,4365,4677,1400-6-7,2021-08-29
24,ولكار,ليزينگ كارآفرين,15949,32947235,183742289520,5600,5800,5370,-230,-4.11,5580,-20,-0.36,5320,5810,1400-6-7,2021-08-29
25,گدنا,تهيه توزيع غذاي دنا آفرين فدك,15637,14111726,341104003175,23433,24400,23050,-383,-1.63,24172,739,3.15,22551,24604,1400-6-7,2021-08-29
26,لطيف,محصولات كاغذي لطيف,14463,2632427,154570405759,59341,60832,57201,-2140,-3.61,58718,-623,-1.05,56381,60832,1400-6-7,2021-08-29
27,سيتا,سرمايه گذاري سيمان تامين,13702,22231812,370093727040,16620,17000,15980,-640,-3.85,16650,30,0.18,15900,17400,1400-6-7,2021-08-29
28,ذوب,سهامي ذوب آهن  اصفهان,13680,323789804,1573351097123,4698,4800,4750,52,1.11,4859,161,3.43,4671,4932,1400-6-7,2021-08-29
29,وسپهر,سرمايه گذاري مالي سپهرصادرات,13669,27974855,284548526870,10462,10550,9939,-523,-5,10172,-290,-2.77,9939,10550,1400-6-7,2021-08-29
30,وبصادر,بانك صادرات ايران,12877,271506321,734957975873,2783,2800,2644,-139,-4.99,2707,-76,-2.73,2644,2802,1400-6-7,2021-08-29
31,فگستر,گسترش صنايع روي ايرانيان,12563,19653311,346336888817,17201,17570,16800,-401,-2.33,17622,421,2.45,16600,18061,1400-6-7,2021-08-29
32,آريا,پليمر آريا ساسول,12474,5444931,628856009155,118216,116850,113020,-5196,-4.4,115494,-2722,-2.3,112306,118222,1400-6-7,2021-08-29
33,خبهمن,گروه‌بهمن‌,12451,490552780,893680939849,1861,1865,1768,-93,-5,1822,-39,-2.1,1768,1870,1400-6-7,2021-08-29
34,غكورش,صنعت غذايي كورش,12079,10845541,532897976920,50990,50500,48450,-2540,-4.98,49140,-1850,-3.63,48450,50890,1400-6-7,2021-08-29
35,ثبهساز,بهساز كاشانه تهران,12005,107913747,276902609720,2682,2649,2548,-134,-5,2566,-116,-4.33,2548,2649,1400-6-7,2021-08-29
36,غدام,خوراك‌  دام‌ پارس‌,11907,2726305,815729481930,303830,318000,288640,-15190,-5,299210,-4620,-1.52,288640,318000,1400-6-7,2021-08-29
37,شصدف,صنعتي دوده فام,11829,10891056,477356128375,45473,45740,43200,-2273,-5,43830,-1643,-3.61,43200,45740,1400-6-7,2021-08-29
38,وپارس,بانك‌پارسيان‌,11373,392877210,1325837755794,3267,3400,3221,-46,-1.41,3375,108,3.31,3209,3430,1400-6-7,2021-08-29
39,ماديرا,صنايع ماديران,11179,153379942,1556796637575,9860,10353,9651,-209,-2.12,10150,290,2.94,9455,10353,1400-6-7,2021-08-29
40,بوعلي,پتروشيمي بوعلي سينا,11153,7269056,471451135670,66530,66500,63210,-3320,-4.99,64860,-1670,-2.51,63210,66500,1400-6-7,2021-08-29
41,وخارزم,سرمايه گذاري خوارزمي,10966,95932827,669194347100,7240,7250,6880,-360,-4.97,6980,-260,-3.59,6880,7290,1400-6-7,2021-08-29
42,ثالوند,سرمايه گذاري مسكن الوند,10925,27604397,755051766191,26430,27751,27000,570,2.16,27353,923,3.49,25550,27751,1400-6-7,2021-08-29
43,غزر,صنعتي زر ماكارون,10723,10634429,297061251820,28440,29000,27050,-1390,-4.89,27930,-510,-1.79,27020,29000,1400-6-7,2021-08-29
44,فخوز,فولاد  خوزستان,10461,83164454,1611629288720,18690,19430,19050,360,1.93,19380,690,3.69,18600,19620,1400-6-7,2021-08-29
45,ثاميد,توسعه و عمران اميد,10281,81136898,151929613898,1929,1947,1833,-96,-4.98,1873,-56,-2.9,1833,1947,1400-6-7,2021-08-29
46,كاوه,فولاد كاوه جنوب كيش,10258,55451315,1286829388250,22360,22930,22350,-10,-0.04,23210,850,3.8,22290,23470,1400-6-7,2021-08-29
47,فتوسا,توليد و توسعه سرب روي ايرانيان,10075,9227649,148179158139,16241,16590,15429,-812,-5,16058,-183,-1.13,15429,16690,1400-6-7,2021-08-29
48,ولپارس,ليزينگ پارسيان,9823,39120708,200879780810,5160,5050,4920,-240,-4.65,5130,-30,-0.58,4910,5350,1400-6-7,2021-08-29
49,شگويا,پتروشيمي تندگويان,9718,39477797,524536923231,13372,13600,12850,-522,-3.9,13287,-85,-0.64,12800,13830,1400-6-7,2021-08-29
50,شاروم,پتروشيمي اروميه,9688,10303467,203904555893,20466,20276,19443,-1023,-5,19790,-676,-3.3,19443,20349,1400-6-7,2021-08-29
51,بترانس,ايران‌ ترانسفو,9606,195252235,584519078435,2997,3146,2885,-112,-3.74,2994,-3,-0.1,2848,3146,1400-6-7,2021-08-29
52,چخزر,صنايع چوب خزر كاسپين,9588,5705122,251282237053,42353,44470,43009,656,1.55,44045,1692,3.99,42500,44470,1400-6-7,2021-08-29
53,امين,تامين سرمايه امين,9349,11537868,106515442470,8910,9320,9150,240,2.69,9230,320,3.59,8800,9350,1400-6-7,2021-08-29
54,چكاپا,گروه صنايع كاغذ پارس,9314,119099783,571817251698,4726,4960,4620,-106,-2.24,4801,75,1.59,4517,4962,1400-6-7,2021-08-29
55,حكشتي,كشتيراني جمهوري اسلامي ايران,9235,39778893,791099206250,20180,20800,19180,-1000,-4.96,19890,-290,-1.44,19180,20890,1400-6-7,2021-08-29
56,فجر,فولاد اميركبيركاشان,9171,23397452,787285261560,33560,35230,32200,-1360,-4.05,33650,90,0.27,31950,35230,1400-6-7,2021-08-29
57,وسديد,گروه ‌صنعتي‌سديد,8842,148373438,217698656646,1445,1473,1440,-5,-0.35,1467,22,1.52,1417,1473,1400-6-7,2021-08-29
58,بپيوند,برق و انرژي پيوندگستر پارس,8753,11851967,162768277864,13565,14000,13190,-375,-2.76,13733,168,1.24,12988,14240,1400-6-7,2021-08-29
59,صبا,سرمايه گذاري صبا تامين,8461,40239771,402543689741,10330,10389,9814,-516,-5,10004,-326,-3.16,9814,10389,1400-6-7,2021-08-29
60,كزغال,زغال سنگ پروده طبس,8431,5181537,214339809460,42253,42160,40141,-2112,-5,41366,-887,-2.1,40141,43000,1400-6-7,2021-08-29
61,ملت,بيمه ملت,7818,574496029,832225723528,1381,1450,1450,69,5,1449,68,4.92,1420,1450,1400-6-7,2021-08-29
62,هاي وب,داده گسترعصرنوين-هاي وب,7683,43564808,448647698220,10620,10620,10090,-530,-4.99,10300,-320,-3.01,10090,10720,1400-6-7,2021-08-29
63,كمند,صندوق س. با درآمد ثابت كمند,7653,327938398,3320935046908,10122,10126,10126,4,0.04,10127,5,0.05,10126,10130,1400-6-7,2021-08-29
64,تاپيكو,س. نفت و گاز و پتروشيمي تأمين,7648,79092034,1193426500760,15360,15350,14790,-570,-3.71,15090,-270,-1.76,14630,15450,1400-6-7,2021-08-29
65,زملارد,كشاورزي و دامپروري ملارد شير,7628,2863483,96611895740,34544,35400,32817,-1727,-5,33739,-805,-2.33,32817,35632,1400-6-7,2021-08-29
66,وتوصا,گروه س توسعه صنعتي ايران,7439,50839995,569965760940,11070,11620,10650,-420,-3.79,11210,140,1.26,10520,11620,1400-6-7,2021-08-29
67,غگيلا,شيرپاستوريزه پگاه گيلان,7406,7447972,219825672885,30716,30032,29181,-1535,-5,29515,-1201,-3.91,29181,30710,1400-6-7,2021-08-29
68,وغدير,سرمايه‌گذاري‌غدير(هلدينگ‌,7175,51936390,874568865980,16790,16830,16600,-190,-1.13,16840,50,0.3,16320,17320,1400-6-7,2021-08-29
69,زماهان,مجتمع توليد گوشت مرغ ماهان,7134,29546669,461891698704,16373,15610,15555,-818,-5,15633,-740,-4.52,15555,16100,1400-6-7,2021-08-29
70,سنير,سيمان‌ سفيد ني‌ريز,7090,4801056,728671457950,145290,152550,152550,7260,5,151770,6480,4.46,145290,152550,1400-6-7,2021-08-29
71,وكبهمن,مديريت سرمايه گذاري كوثربهمن,6832,8507698,121363080707,14545,14980,13818,-727,-5,14265,-280,-1.93,13818,15272,1400-6-7,2021-08-29
72,فروي,ذوب روي اصفهان,6705,9330654,348968483584,36748,38000,35900,-848,-2.31,37400,652,1.77,35600,38585,1400-6-7,2021-08-29
73,كپشير,پشم‌شيشه‌ايران‌,6704,23757729,547313121420,22120,23220,23000,880,3.98,23040,920,4.16,22120,23220,1400-6-7,2021-08-29
74,وپويا,سرمايه گذاري پويا,6642,27743666,165060831015,6068,6242,5850,-218,-3.59,5949,-119,-1.96,5765,6242,1400-6-7,2021-08-29
75,رافزا,رايان هم افزا,6641,2551852,232129618398,87037,91388,91388,4351,5,90965,3928,4.51,85321,91388,1400-6-7,2021-08-29
76,قثابت,قند ثابت‌ خراسان‌,6625,118329509,606483308437,4590,5300,5035,445,9.69,5125,535,11.66,5035,5300,1400-6-7,2021-08-29
77,غگل,گلوكوزان‌,6492,78453575,319287932578,4196,4240,3987,-209,-4.98,4070,-126,-3,3987,4240,1400-6-7,2021-08-29
78,كوير,توليدي فولاد سپيد فراب كوير,6443,42865186,690682858680,15640,16200,15700,60,0.38,16110,470,3.01,15060,16420,1400-6-7,2021-08-29
79,آبادا,توليد نيروي برق آبادان,6383,5926394,81159064490,14200,14200,13490,-710,-5,13690,-510,-3.59,13490,14400,1400-6-7,2021-08-29
80,خمحركه,نيرو محركه‌,6372,134099272,665513751365,4757,4994,4881,124,2.61,4963,206,4.33,4650,4994,1400-6-7,2021-08-29
81,ثشاهد,سرمايه‌ گذاري‌ شاهد,6304,21334482,368542611640,17970,18000,17080,-890,-4.95,17270,-700,-3.9,17080,18000,1400-6-7,2021-08-29
82,حريل,ريل پردازسير,6295,90906968,456011920461,4836,5077,4850,14,0.29,5016,180,3.72,4717,5077,1400-6-7,2021-08-29
83,اخابر,مخابرات ايران,6118,102370466,1215981574740,11480,11580,11610,130,1.13,11880,400,3.48,11350,12050,1400-6-7,2021-08-29
84,خزاميا,زامياد,6103,97705092,815825513870,8080,8480,8110,30,0.37,8350,270,3.34,7960,8480,1400-6-7,2021-08-29
85,لپيام,گسترش صنايع پيام,6080,9183114,433668077118,46561,46500,46990,429,0.92,47225,664,1.43,45200,47957,1400-6-7,2021-08-29
86,بگيلان,توسعه مسير برق گيلان,5923,2539486,55662286362,22583,22897,21454,-1129,-5,21919,-664,-2.94,21454,22897,1400-6-7,2021-08-29
87,وسكرشا,س.سهام عدالت استان كرمانشاه,5891,279701082,215038105533,786,774,751,-35,-4.45,769,-17,-2.16,747,788,1400-6-7,2021-08-29
88,شبريز,پالايش نفت تبريز,5881,13124833,583867995510,44040,44140,42770,-1270,-2.88,44490,450,1.02,42020,46240,1400-6-7,2021-08-29
89,سفاسي,شركت فارسيت اهواز,5808,29689685,211218791801,7287,7130,7069,-218,-2.99,7114,-173,-2.37,7069,7359,1400-6-7,2021-08-29
90,بالبر,كابل‌ البرز,5716,8757785,380220081300,43610,45790,41990,-1620,-3.71,43420,-190,-0.44,41430,45790,1400-6-7,2021-08-29
91,ستران,سيمان‌ تهران‌,5671,20451086,698819282120,34510,36220,32790,-1720,-4.98,34170,-340,-0.99,32790,36220,1400-6-7,2021-08-29
92,فارس,صنايع پتروشيمي خليج فارس,5649,36699971,493528460340,13570,13420,13170,-400,-2.95,13450,-120,-0.88,13160,13900,1400-6-7,2021-08-29
93,اپال,فرآوري معدني اپال كاني پارس,5477,7750116,189584668850,24440,24180,23550,-890,-3.64,24460,20,0.08,23350,25400,1400-6-7,2021-08-29
94,كتوكا,توليدي و خدمات صنايع نسوز توكا,5447,11014244,314379477363,29123,29000,27667,-1456,-5,28543,-580,-1.99,27667,29700,1400-6-7,2021-08-29
95,سرو,صندوق س سروسودمند مدبران-سهام,5390,5368161,474231891340,89780,89790,85530,-4250,-4.73,88340,-1440,-1.6,84000,90150,1400-6-7,2021-08-29
96,فاراك,ماشين‌ سازي‌ اراك‌,5381,124944177,275511828996,2275,2280,2162,-113,-4.97,2205,-70,-3.08,2162,2282,1400-6-7,2021-08-29
97,ثاخت,بين‌المللي‌توسعه‌ساختمان,5365,87487790,241554015143,2852,2849,2710,-142,-4.98,2761,-91,-3.19,2710,2849,1400-6-7,2021-08-29
98,حگردش,ريل گردش ايرانيان,5330,14477011,46065849002,3090,3182,3182,92,2.98,3182,92,2.98,3182,3182,1400-6-7,2021-08-29
99,دماوند,توليد نيروي برق دماوند,5271,15128017,446052555405,28668,29000,28800,132,0.46,29485,817,2.85,28360,30101,1400-6-7,2021-08-29
100,شاراك,پتروشيمي شازند,5187,15795860,707920599970,46180,46550,43880,-2300,-4.98,44820,-1360,-2.94,43880,46550,1400-6-7,2021-08-29
101,كگل,معدني و صنعتي گل گهر,5153,34556392,842870857050,25230,25100,24050,-1180,-4.68,24390,-840,-3.33,23970,25100,1400-6-7,2021-08-29
102,غشهداب,كشت و صنعت شهداب ناب خراسان,5150,68846630,281568807548,4062,4211,3919,-143,-3.52,4090,28,0.69,3859,4265,1400-6-7,2021-08-29
103,غنوش,نوش‌ مازندران‌,5148,7321166,298138960580,41720,42370,39640,-2080,-4.99,40720,-1000,-2.4,39640,42370,1400-6-7,2021-08-29
104,شيران,س. صنايع‌شيميايي‌ايران,5135,17431310,525923320730,30360,30990,30030,-330,-1.09,30170,-190,-0.63,29260,31150,1400-6-7,2021-08-29
105,حفاري,حفاري شمال,5022,52870079,404854721400,7940,7950,7550,-390,-4.91,7660,-280,-3.53,7550,7950,1400-6-7,2021-08-29
106,پتاير,ايران‌ تاير,4972,93982112,297752878990,3180,3200,3040,-140,-4.4,3168,-12,-0.38,3025,3249,1400-6-7,2021-08-29
107,شفارس,صنايع‌ شيميايي‌ فارس‌,4964,104675791,225167091664,2188,2220,2079,-109,-4.98,2151,-37,-1.69,2079,2229,1400-6-7,2021-08-29
108,وثخوز,سرمايه گذاري و توسعه خوزستان,4934,3668174,225189656503,59322,62288,60000,678,1.14,61390,2068,3.49,56406,62288,1400-6-7,2021-08-29
109,آگاس,صندوق س.هستي بخش آگاه-س,4867,3751184,336054853659,91366,91900,86890,-4476,-4.9,89586,-1780,-1.95,86000,91977,1400-6-7,2021-08-29
110,قرن,پديده شيمي قرن,4854,5345330,197768538390,37160,38000,37000,-160,-0.43,37000,-160,-0.43,35310,38500,1400-6-7,2021-08-29
111,گشان,توسعه بين المللي پديده شانديز,4803,10174937,236941863188,23296,23760,22831,-465,-2,23287,-9,-0.04,22831,23761,1400-6-7,2021-08-29
112,پارسان,گسترش نفت و گاز پارسيان,4802,33304623,1140206969640,33540,34000,33000,-540,-1.61,34240,700,2.09,32020,35210,1400-6-7,2021-08-29
113,كفپارس,فرآورده‌هاي‌ نسوز پارس‌,4718,112061882,456153374539,3928,4124,3920,-8,-0.2,4071,143,3.64,3750,4124,1400-6-7,2021-08-29
114,وهور,مديريت انرژي اميد  تابان هور,4695,188685696,359998595820,1825,1916,1872,47,2.58,1908,83,4.55,1830,1916,1400-6-7,2021-08-29
115,سخواف,سيمان مجد خواف,4694,36981664,514595304851,14314,13885,13885,-429,-3,13915,-399,-2.79,13885,14100,1400-6-7,2021-08-29
116,تملت,تامين سرمايه بانك ملت,4636,41282166,242447497730,6000,6180,5700,-300,-5,5870,-130,-2.17,5700,6250,1400-6-7,2021-08-29
117,پاكشو,گروه صنعتي پاكشو,4627,34119671,210258525130,6290,6290,5990,-300,-4.77,6160,-130,-2.07,5980,6330,1400-6-7,2021-08-29
118,سمگا,گروه سرمايه گذاري ميراث فرهنگي,4625,15181832,418826631373,28108,28300,26703,-1405,-5,27587,-521,-1.85,26703,28599,1400-6-7,2021-08-29
119,ومعادن,توسعه‌معادن‌وفلزات‌,4621,44792946,582424035120,12720,12970,12730,10,0.08,13000,280,2.2,12090,13350,1400-6-7,2021-08-29
120,همراه,شركت ارتباطات سيار ايران,4619,30657829,346038241910,10880,11400,10880,0,0,11290,410,3.77,10500,11420,1400-6-7,2021-08-29
121,خزر,فنرسازي‌زر,4615,13667778,270372842550,19980,20650,19000,-980,-4.9,19780,-200,-1,18990,20660,1400-6-7,2021-08-29
122,ختور,رادياتور ايران‌,4593,16779880,382113037850,22120,23000,21950,-170,-0.77,22770,650,2.94,21500,23220,1400-6-7,2021-08-29
123,تپمپي,پمپ‌ سازي‌ ايران‌,4572,20538563,415729097190,19770,20750,19400,-370,-1.87,20240,470,2.38,19060,20750,1400-6-7,2021-08-29
124,خنصير,مهندسي‌نصيرماشين‌,4520,33011222,462117120880,13430,14100,14100,670,4.99,14000,570,4.24,13430,14100,1400-6-7,2021-08-29
125,دتوليد,داروسازي توليد دارو,4467,23278637,376305150758,15649,16431,15490,-159,-1.02,16165,516,3.3,15000,16431,1400-6-7,2021-08-29
126,هرمز,فولاد هرمزگان جنوب,4427,31854684,614360422187,18649,19000,18750,101,0.54,19286,637,3.42,18500,19581,1400-6-7,2021-08-29
127,ختوقا,قطعات‌ اتومبيل‌ ايران‌,4388,97757263,280353660956,2812,2933,2760,-52,-1.85,2868,56,1.99,2730,2952,1400-6-7,2021-08-29
128,مدير,ص.س.مديريت ثروت ص.بازنشستگي-س,4360,25267776,303176084755,12300,12370,11471,-829,-6.74,11999,-301,-2.45,11454,12440,1400-6-7,2021-08-29
129,قنيشا,قند  نيشابور,4356,4715174,262621693160,56530,57990,53900,-2630,-4.65,55700,-830,-1.47,53710,58340,1400-6-7,2021-08-29
130,خكار,ايركا پارت صنعت,4325,17264449,321901775070,18100,18800,17980,-120,-0.66,18650,550,3.04,17620,19000,1400-6-7,2021-08-29
131,ارفع,شركت آهن و فولاد ارفع,4320,25998343,496796734691,18340,19257,18840,500,2.73,19109,769,4.19,18590,19257,1400-6-7,2021-08-29
132,چدن,توليدي چدن سازان,4315,39707789,194024559120,4997,5000,4748,-249,-4.98,4886,-111,-2.22,4748,5100,1400-6-7,2021-08-29
133,فزرين,زرين معدن آسيا,4276,17685790,331687044705,19372,19110,18404,-968,-5,18754,-618,-3.19,18404,19531,1400-6-7,2021-08-29
134,فاذر,صنايع‌ آذرآب‌,4265,161769044,233597714977,1478,1479,1405,-73,-4.94,1444,-34,-2.3,1405,1490,1400-6-7,2021-08-29
135,شپترو,پتروشيمي آبادان,4237,75638606,424179134257,5574,5741,5407,-167,-3,5608,34,0.61,5407,5741,1400-6-7,2021-08-29
136,بكاب,صنايع‌جوشكاب‌يزد,4222,2009743,340861058440,162870,161500,168000,5130,3.15,169600,6730,4.13,157000,171010,1400-6-7,2021-08-29
137,وآذر,سرمايه‌گذاري‌توسعه‌آذربايجان‌,4191,4891856,413202492530,81450,85520,81500,50,0.06,84470,3020,3.71,80000,85520,1400-6-7,2021-08-29
138,امين يكم,صندوق درآمد ثابت امين يكم فردا,4189,131501154,1317624019826,10014,10022,10020,6,0.06,10020,6,0.06,10014,10024,1400-6-7,2021-08-29
139,وصنعت,سرمايه گذاري توسعه صنعت وتجارت,4135,33470978,237996122580,7030,7320,6870,-160,-2.28,7110,80,1.14,6770,7340,1400-6-7,2021-08-29
140,بكام,كارخانجات توليدي شهيد قندي,4084,61354504,188813420576,3061,3200,3000,-61,-1.99,3077,16,0.52,2908,3200,1400-6-7,2021-08-29
141,آپ,آسان پرداخت پرشين,4056,38202228,595501218660,15030,14660,15780,750,4.99,15590,560,3.73,14660,15780,1400-6-7,2021-08-29
142,فاراكح,ح . ماشين‌ سازي‌ اراك‌,3987,105397083,102321816978,1018,1005,950,-68,-6.68,971,-47,-4.62,937,1018,1400-6-7,2021-08-29
143,وساپا,سرمايه‌گذاري‌ سايپا,3985,51794319,336509699220,6610,6780,6280,-330,-4.99,6500,-110,-1.66,6280,6780,1400-6-7,2021-08-29
144,وپاسار,بانك  پاسارگاد,3982,67211037,1011356562460,15000,15150,15050,50,0.33,15050,50,0.33,14980,15200,1400-6-7,2021-08-29
145,ولغدر,ليزينگ‌خودروغدير,3959,13287764,210676695690,16420,16350,15600,-820,-4.99,15850,-570,-3.47,15600,16750,1400-6-7,2021-08-29
146,وبانك,سرمايه گذاري گروه توسعه ملي,3933,36716155,383674518740,10530,10780,10180,-350,-3.32,10450,-80,-0.76,10010,10890,1400-6-7,2021-08-29
147,خاهن,آهنگري‌ تراكتورسازي‌ ايران‌,3925,35867796,320448415930,8610,9040,8600,-10,-0.12,8930,320,3.72,8550,9040,1400-6-7,2021-08-29
148,تليسه,دامداري تليسه نمونه,3921,42632057,171118252053,4164,4200,3956,-208,-5,4014,-150,-3.6,3956,4200,1400-6-7,2021-08-29
149,تسه0005,امتيازتسهيلات مسكن مرداد 1400,3920,103178,61776685933,598822,600000,594000,-4822,-0.81,598739,-83,-0.01,570000,609995,1400-6-7,2021-08-29
150,شغدير,پتروشيمي غدير,3906,3528444,335947192990,97940,98940,93050,-4890,-4.99,95210,-2730,-2.79,93050,98940,1400-6-7,2021-08-29
151,كلوند,كاشي‌ الوند,3905,11192959,287478394570,26400,25770,25140,-1260,-4.77,25680,-720,-2.73,25080,26930,1400-6-7,2021-08-29
152,حفارس,حمل و نقل بين المللي خليج فارس,3903,59480715,232160443552,3582,3997,3799,217,6.06,3903,321,8.96,3798,4090,1400-6-7,2021-08-29
153,ونوين,بانك‌اقتصادنوين‌,3867,77307494,407827168110,5350,5450,5090,-260,-4.86,5280,-70,-1.31,5090,5470,1400-6-7,2021-08-29
154,رانفور,خدمات‌انفورماتيك‌,3849,83871645,611501177820,7010,7360,7130,120,1.71,7290,280,3.99,7040,7360,1400-6-7,2021-08-29
155,ورنا,سرمايه‌گذاري‌ رنا(هلدينگ‌,3796,43639798,279379373180,6320,6630,6100,-220,-3.48,6400,80,1.27,6010,6630,1400-6-7,2021-08-29
156,غفارس,شير پاستوريزه پگاه فارس,3777,13288337,198281844680,14793,15105,14590,-203,-1.37,14921,128,0.87,14270,15400,1400-6-7,2021-08-29
157,وساخت,سرمايه‌ گذاري‌ ساختمان‌ايران‌,3777,4702036,266279742460,57010,59000,54160,-2850,-5,56630,-380,-0.67,54160,59000,1400-6-7,2021-08-29
158,تاصيكو,سرمايه گذاري صدرتامين,3706,56210836,700933232070,11980,12160,12160,180,1.5,12470,490,4.09,11980,12570,1400-6-7,2021-08-29
159,سكارون,سيمان كارون,3671,2013261,212326941910,103461,105000,104900,1439,1.39,105464,2003,1.94,101550,106564,1400-6-7,2021-08-29
160,غسالم,سالمين‌,3650,37707396,153429527990,4124,4299,3918,-206,-5,4069,-55,-1.33,3918,4299,1400-6-7,2021-08-29
161,سصفها,سيمان‌اصفهان‌,3622,3405373,221496609420,66270,69400,62960,-3310,-4.99,65040,-1230,-1.86,62960,69400,1400-6-7,2021-08-29
162,بجهرم,توسعه مولد نيروگاهي جهرم,3616,52761836,152334294580,2898,2911,2785,-113,-3.9,2887,-11,-0.38,2765,2974,1400-6-7,2021-08-29
163,كچاد,معدني‌وصنعتي‌چادرملو,3614,14342264,443835490860,30840,30810,30850,10,0.03,30950,110,0.36,30600,31510,1400-6-7,2021-08-29
164,آوا,صندوق س.سهام آواي معيار-س,3591,26898827,244999169523,8922,9300,8880,-42,-0.47,9108,186,2.08,8751,9330,1400-6-7,2021-08-29
165,وايران,ليزينگ ايرانيان,3585,24177219,172841336160,7250,7460,6890,-360,-4.97,7150,-100,-1.38,6890,7460,1400-6-7,2021-08-29
166,پيزد,مجتمع صنايع لاستيك يزد,3558,665356,49187355599,76045,76000,72243,-3802,-5,73926,-2119,-2.79,72243,76495,1400-6-7,2021-08-29
167,خودكفا,اقتصادي و خودكفايي آزادگان,3512,12968617,195534226486,15111,15110,14658,-453,-3,15077,-34,-0.23,14658,15410,1400-6-7,2021-08-29
168,ثنوسا,نوسازي‌وساختمان‌تهران‌,3491,25511024,248140137280,9910,10150,9420,-490,-4.94,9730,-180,-1.82,9420,10240,1400-6-7,2021-08-29
169,كيان,صندوق س. با درآمد ثابت كيان,3455,39022094,1180475630113,30234,30250,30257,23,0.08,30251,17,0.06,30246,30259,1400-6-7,2021-08-29
170,تنوين,تامين سرمايه نوين,3450,63694836,497667081680,7510,7800,7610,100,1.33,7810,300,3.99,7450,7880,1400-6-7,2021-08-29
171,وگستر,گسترش سرمايه گذاري ايرانيان,3433,12416039,159639925536,13378,13680,12710,-668,-4.99,12858,-520,-3.89,12710,13680,1400-6-7,2021-08-29
172,كيسون,شركت كيسون,3424,21757177,197865599711,9242,9199,9058,-184,-1.99,9094,-148,-1.6,9058,9349,1400-6-7,2021-08-29
173,زاگرس,پتروشيمي زاگرس,3392,1765346,456413027808,269006,271988,255556,-13450,-5,258540,-10466,-3.89,255556,271988,1400-6-7,2021-08-29
174,ونيرو,سرمايه‌گذاري‌نيرو,3387,56291961,187197103424,3249,3289,3258,9,0.28,3325,76,2.34,3200,3411,1400-6-7,2021-08-29
175,زكوثر,سرمايه گذاري كشاورزي كوثر,3349,8755119,186650913680,21680,22350,20600,-1080,-4.98,21320,-360,-1.66,20600,22350,1400-6-7,2021-08-29
176,طلا,صندوق س.پشتوانه طلاي لوتوس,3338,3551372,305666751211,88770,88687,85495,-3275,-3.69,86070,-2700,-3.04,84000,88687,1400-6-7,2021-08-29
177,تبرك,گروه كارخانجات صنعتي تبرك,3334,12275026,185689778320,15507,15510,14732,-775,-5,15127,-380,-2.45,14732,15555,1400-6-7,2021-08-29
178,خاور,ايران خودرو ديزل,3252,30032178,250377358591,8000,8400,8101,101,1.26,8337,337,4.21,8001,8400,1400-6-7,2021-08-29
179,سبزوا,سيمان لار سبزوار,3238,33005932,129305416440,4022,4020,3821,-201,-5,3918,-104,-2.59,3821,4060,1400-6-7,2021-08-29
180,شلعاب,لعابيران‌,3218,18143948,168866245070,9520,9600,9090,-430,-4.52,9310,-210,-2.21,9050,9770,1400-6-7,2021-08-29
181,ثعمرا,عمران و توسعه شاهد,3210,23655637,298573250092,12241,12853,11999,-242,-1.98,12622,381,3.11,11750,12853,1400-6-7,2021-08-29
182,بموتو,موتوژن‌,3199,6753497,602282884030,85520,89790,88250,2730,3.19,89180,3660,4.28,85520,89790,1400-6-7,2021-08-29
183,اعتماد,صندوق س.اعتماد آفرين پارسيان-د,3181,85377220,3278315462410,38375,38397,38398,23,0.06,38398,23,0.06,38397,38402,1400-6-7,2021-08-29
184,كبافق,معادن‌ بافق‌,3154,3661224,172559656960,45830,47000,45780,-50,-0.11,47130,1300,2.84,45000,48120,1400-6-7,2021-08-29
185,غديس,پاكديس,3103,16523063,273365419417,16730,16900,15894,-836,-5,16544,-186,-1.11,15894,17390,1400-6-7,2021-08-29
186,حآسا,آسيا سير ارس,3097,5576588,133048855914,24350,24800,23133,-1217,-5,23858,-492,-2.02,23133,24800,1400-6-7,2021-08-29
187,غالبر,لبنيات‌ كالبر,3088,11109264,150567449000,13340,13990,12990,-350,-2.62,13550,210,1.57,12860,13990,1400-6-7,2021-08-29
188,دانا,بيمه دانا,3087,41168924,264134632160,6230,6300,6290,60,0.96,6420,190,3.05,6170,6540,1400-6-7,2021-08-29
189,بهپاك,صنعتي بهپاك,3036,47466738,386472090281,7787,7830,7950,163,2.09,8142,355,4.56,7788,8176,1400-6-7,2021-08-29
190,گكوثر,هتل پارسيان كوثر اصفهان,3033,57995726,146998119721,2650,2600,2518,-132,-4.98,2535,-115,-4.34,2518,2648,1400-6-7,2021-08-29
191,تاپكيش,تجارت الكترونيك پارسيان كيش,3011,17941093,259365768212,13897,14290,14419,522,3.76,14457,560,4.03,14040,14591,1400-6-7,2021-08-29
192,ورازي,بيمه رازي,3011,148219258,265517094351,1721,1807,1807,86,5,1791,70,4.07,1635,1807,1400-6-7,2021-08-29
193,فاسمين,كالسيمين‌,2991,15893967,297116300850,18490,18780,18030,-460,-2.49,18690,200,1.08,18000,19340,1400-6-7,2021-08-29
194,فباهنر,مس‌ شهيدباهنر,2971,5597301,176568980030,32480,33600,30860,-1620,-4.99,31550,-930,-2.86,30860,33600,1400-6-7,2021-08-29
195,كلر,كلر پارس,2953,1864066,232486288613,127243,129110,120881,-6362,-5,124720,-2523,-1.98,120881,130999,1400-6-7,2021-08-29
196,وتوس,توسعه‌شهري‌توس‌گستر,2952,10818551,152205815710,13760,14440,13900,140,1.02,14070,310,2.25,13120,14440,1400-6-7,2021-08-29
197,البرز,بيمه البرز,2935,56141951,165392932487,2944,3055,2848,-96,-3.26,2946,2,0.07,2797,3055,1400-6-7,2021-08-29
198,ونيكي,سرمايه‌گذاري‌ ملي‌ايران‌,2931,14614796,182079677660,12800,12790,12160,-640,-5,12460,-340,-2.66,12160,12900,1400-6-7,2021-08-29
199,وپست,پست بانك ايران,2930,14419877,302792660860,21880,22000,20790,-1090,-4.98,21000,-880,-4.02,20790,22000,1400-6-7,2021-08-29
200,سفارس,سيمان فارس و خوزستان,2924,11256618,282219679100,25590,25790,24320,-1270,-4.96,25070,-520,-2.03,24320,26400,1400-6-7,2021-08-29
201,ولساپا,ليزينگ رايان‌ سايپا,2908,49552133,167441460391,3453,3500,3281,-172,-4.98,3379,-74,-2.14,3281,3500,1400-6-7,2021-08-29
202,بكهنوج,توليد برق ماهتاب كهنوج,2905,80823689,151114298313,1888,1872,1794,-94,-4.98,1870,-18,-0.95,1794,1980,1400-6-7,2021-08-29
203,حتوكا,حمل‌ونقل‌توكا,2854,7826856,166512320070,21960,22500,20870,-1090,-4.96,21270,-690,-3.14,20870,22700,1400-6-7,2021-08-29
204,ثشرق,سرمايه گذاري مسكن شمال شرق,2849,30162360,176732966450,6120,6120,5820,-300,-4.9,5860,-260,-4.25,5820,6120,1400-6-7,2021-08-29
205,افق,فروشگاههاي زنجيره اي افق كوروش,2845,2410126,159243797490,68800,67990,65360,-3440,-5,66070,-2730,-3.97,65360,68000,1400-6-7,2021-08-29
206,ثپرديس,سرمايه گذاري مسكن پرديس,2818,33464894,225043433255,6570,6595,6600,30,0.46,6725,155,2.36,6251,6898,1400-6-7,2021-08-29
207,فولاي,صنايع فولاد آلياژي يزد,2816,12361827,301623952510,23396,24565,24300,904,3.86,24400,1004,4.29,23401,24565,1400-6-7,2021-08-29
208,ولصنم,ليزينگ‌صنعت‌ومعدن‌,2756,19319490,165663307370,8160,8660,8420,260,3.19,8570,410,5.02,8230,8900,1400-6-7,2021-08-29
209,غپينو,پارس‌ مينو,2750,18415553,108731241670,5980,6180,5690,-290,-4.85,5900,-80,-1.34,5690,6180,1400-6-7,2021-08-29
210,چفيبر,فيبر ايران‌,2734,19061178,173165788950,9130,9000,9160,30,0.33,9080,-50,-0.55,8680,9550,1400-6-7,2021-08-29
211,سيمرغ,سيمرغ,2731,10492442,226458856430,21870,22750,20810,-1060,-4.85,21580,-290,-1.33,20780,22750,1400-6-7,2021-08-29
212,غچين,كشت‌ و صنعت‌ چين‌ چين,2701,7685652,159476240090,21080,21610,20030,-1050,-4.98,20750,-330,-1.57,20030,21700,1400-6-7,2021-08-29
213,سبهان,سيمان‌ بهبهان‌,2691,1813150,137374666180,75770,79350,73120,-2650,-3.5,75770,0,0,72210,79350,1400-6-7,2021-08-29
214,سامان,بانك سامان,2687,34101951,346959765363,10322,10201,10013,-309,-2.99,10174,-148,-1.43,10013,10399,1400-6-7,2021-08-29
215,وآوا,سرمايه گذاري آوا نوين,2681,19481691,114294741929,6015,6200,5715,-300,-4.99,5867,-148,-2.46,5715,6200,1400-6-7,2021-08-29
216,نوين,بيمه نوين,2666,30872336,191062941235,6078,6381,5953,-125,-2.06,6189,111,1.83,5850,6381,1400-6-7,2021-08-29
217,آسيا,بيمه آسيا,2660,72434832,170675270672,2344,2400,2285,-59,-2.52,2356,12,0.51,2235,2428,1400-6-7,2021-08-29
218,دلر,داروسازي‌ اكسير,2636,10063161,476611086160,46700,46760,49000,2300,4.93,47360,660,1.41,45470,49020,1400-6-7,2021-08-29
219,كترام,توليدي‌ كاشي‌ تكسرام‌,2634,5005314,168484978810,33690,34950,32250,-1440,-4.27,33660,-30,-0.09,32010,35000,1400-6-7,2021-08-29
220,وسينا,بانك سينا,2629,73007929,248878841873,3451,3539,3300,-151,-4.38,3409,-42,-1.22,3280,3539,1400-6-7,2021-08-29
221,سدور,سيمان‌ دورود,2628,13780527,147890567820,10450,10900,10440,-10,-0.1,10730,280,2.68,10120,10970,1400-6-7,2021-08-29
222,پارس,پتروشيمي پارس,2627,2244314,481795254180,218430,218600,213030,-5400,-2.47,214670,-3760,-1.72,211500,218600,1400-6-7,2021-08-29
223,زنگان,صنعت روي زنگان,2622,1973073,139763484423,68902,72345,68000,-902,-1.31,70835,1933,2.81,66500,72347,1400-6-7,2021-08-29
224,سرچشمه,سرمايه گذاري مس سرچشمه,2603,13496924,106830357019,7832,8200,7551,-281,-3.59,7915,83,1.06,7500,8200,1400-6-7,2021-08-29
225,ريشمك,توليد و صادرات ريشمك,2601,3921436,186809492681,46257,48200,45999,-258,-0.56,47638,1381,2.99,45510,48569,1400-6-7,2021-08-29
226,لكما,كارخانجات‌مخابراتي‌ايران‌,2599,52858785,82733390673,1527,1571,1572,45,2.95,1565,38,2.49,1523,1572,1400-6-7,2021-08-29
227,شلرد,كود شيميايي اوره لردگان,2552,27722604,268929984761,9941,9731,9643,-298,-3,9701,-240,-2.41,9643,9940,1400-6-7,2021-08-29
228,وسپه,سرمايه‌گذاري‌ سپه‌,2529,62249599,631896947880,9690,10170,10010,320,3.3,10150,460,4.75,9930,10170,1400-6-7,2021-08-29
229,ولراز,ليزينگ رازي,2525,3917815,119086812018,30774,31145,29851,-923,-3,30396,-378,-1.23,29851,31145,1400-6-7,2021-08-29
230,وتوكا,سرمايه‌گذاري‌توكافولاد(هلدينگ,2522,15064519,177932355210,12000,12400,11400,-600,-5,11810,-190,-1.58,11400,12420,1400-6-7,2021-08-29
231,خمهر,مهركام‌پارس‌,2504,78804500,201202802079,2462,2585,2502,40,1.62,2553,91,3.7,2427,2585,1400-6-7,2021-08-29
232,شفن,پتروشيمي فناوران,2497,471231,182276914280,388350,388500,377990,-10360,-2.67,386810,-1540,-0.4,373900,398400,1400-6-7,2021-08-29
233,ددام,داروسازي زاگرس فارمد پارس,2491,10272001,146398408180,14240,14950,13530,-710,-4.99,14250,10,0.07,13530,14950,1400-6-7,2021-08-29
234,كسرام,پارس‌ سرام‌,2487,29577008,213055948390,6960,7240,7010,50,0.72,7200,240,3.45,6910,7300,1400-6-7,2021-08-29
235,مرقام,ايران‌ارقام‌,2487,8897417,163431473490,18640,19000,17710,-930,-4.99,18370,-270,-1.45,17710,19200,1400-6-7,2021-08-29
236,خشرق,الكتريك‌ خودرو شرق‌,2477,17227122,339028238280,18960,19900,18980,20,0.11,19680,720,3.8,18020,19900,1400-6-7,2021-08-29
237,ثتران,سرمايه گذاري مسكن تهران,2476,55542537,229178496378,3967,4165,4070,103,2.6,4126,159,4.01,3800,4165,1400-6-7,2021-08-29
238,شپديس,پتروشيمي پرديس,2468,1843132,291900757920,162430,162420,156210,-6220,-3.83,158370,-4060,-2.5,156000,162420,1400-6-7,2021-08-29
239,حپترو,حمل و نقل پتروشيمي( سهامي عام,2467,2805821,104637625800,36860,36890,37000,140,0.38,37290,430,1.17,36020,38490,1400-6-7,2021-08-29
240,چافست,افست‌,2439,8609758,140075000520,16900,16400,16060,-840,-4.97,16270,-630,-3.73,16060,16870,1400-6-7,2021-08-29
241,قرنح,ح . پديده شيمي قرن,2437,4859514,146027899640,30620,29800,29500,-1120,-3.66,30050,-570,-1.86,28500,31100,1400-6-7,2021-08-29
242,فايرا,آلومينيوم‌ايران‌,2424,11127305,202697116700,18160,18250,17950,-210,-1.16,18220,60,0.33,17640,18840,1400-6-7,2021-08-29
243,تيپيكو,سرمايه گذاري دارويي تامين,2422,11727238,276646214390,22790,23690,22800,10,0.04,23590,800,3.51,22030,23920,1400-6-7,2021-08-29
244,وبوعلي,سرمايه‌گذاري‌بوعلي‌,2418,22655391,117225663380,5050,5220,5060,10,0.2,5170,120,2.38,4910,5300,1400-6-7,2021-08-29
245,وملل,اعتباري ملل,2415,18203654,247558137865,13033,13684,13100,67,0.51,13599,566,4.34,13080,13684,1400-6-7,2021-08-29
246,شاوان,پالايش نفت لاوان,2412,7839365,919535896053,112027,117628,117628,5601,5,117297,5270,4.7,113100,117628,1400-6-7,2021-08-29
247,فروس,فروسيليس‌ ايران‌,2382,21986344,146149831750,6840,6860,6540,-300,-4.39,6650,-190,-2.78,6500,6910,1400-6-7,2021-08-29
248,تكشا,گسترش‌صنايع‌وخدمات‌كشاورزي‌,2376,7164598,265131356420,35700,37400,35200,-500,-1.4,37010,1310,3.67,34500,37480,1400-6-7,2021-08-29
249,غگلستا,شير پاستوريزه پگاه گلستان,2372,6176458,118414075784,19494,19390,18525,-969,-4.97,19172,-322,-1.65,18520,19796,1400-6-7,2021-08-29
250,خرينگ,رينگ‌سازي‌مشهد,2364,4362023,181651100860,40040,42040,42040,2000,5,41640,1600,4,39970,42040,1400-6-7,2021-08-29
251,خاذين,سايپاآذين‌,2361,31402144,124191889415,4004,4059,3804,-200,-5,3955,-49,-1.22,3804,4100,1400-6-7,2021-08-29
252,ثرود,سرمايه‌گذاري مسكن زاينده رود,2359,11346637,180413463051,15333,15499,15503,170,1.11,15900,567,3.7,15200,16099,1400-6-7,2021-08-29
253,كهمدا,شيشه‌ همدان‌,2342,10526338,124809875200,12090,12500,11550,-540,-4.47,11860,-230,-1.9,11490,12500,1400-6-7,2021-08-29
254,دامين,داروسازي‌ امين‌,2338,23670979,104466258877,4277,4470,4279,2,0.05,4413,136,3.18,4112,4490,1400-6-7,2021-08-29
255,فرآور,فرآوري‌موادمعدني‌ايران‌,2333,5158235,176873607630,35350,34500,33590,-1760,-4.98,34290,-1060,-3,33590,35300,1400-6-7,2021-08-29
256,ثاصفا,شركت‌ ساختمان‌ اصفهان‌,2333,3647394,87717865494,23811,24245,23746,-65,-0.27,24049,238,1,23200,24455,1400-6-7,2021-08-29
257,وبيمه,سرمايه‌ گذاري‌ صنعت‌ بيمه‌,2324,56383708,122526315642,2169,2201,2087,-82,-3.78,2173,4,0.18,2080,2237,1400-6-7,2021-08-29
258,ساوه,سيمان ساوه,2306,1073004,70443441600,67568,68600,64300,-3268,-4.84,65651,-1917,-2.84,64190,68600,1400-6-7,2021-08-29
259,پلاسك,پلاسكوكار,2305,15810442,127174754670,7930,8300,7730,-200,-2.52,8040,110,1.39,7600,8320,1400-6-7,2021-08-29
260,والبر,سرمايه‌ گذاري‌ البرز(هلدينگ‌,2303,12176155,133719858480,11110,11400,10590,-520,-4.68,10980,-130,-1.17,10560,11400,1400-6-7,2021-08-29
261,شبصير,توليدات پتروشيمي قائد بصير,2303,3106526,346683627919,111245,116800,109000,-2245,-2.02,111598,353,0.32,107000,116806,1400-6-7,2021-08-29
262,فسپا,گروه‌صنعتي‌سپاهان‌,2289,3084786,151219274930,49100,51000,47300,-1800,-3.67,49020,-80,-0.16,47010,51000,1400-6-7,2021-08-29
263,زمگسا,كشاورزي‌ ودامپروي‌ مگسال‌,2284,4155969,132785809960,32900,32750,31260,-1640,-4.98,31950,-950,-2.89,31260,33490,1400-6-7,2021-08-29
264,فلامي,لاميران‌,2267,6428673,174658742240,26610,27940,25580,-1030,-3.87,27170,560,2.1,25410,27940,1400-6-7,2021-08-29
265,وصنا,گروه‌صنايع‌بهشهرايران‌,2267,26310301,205639424870,8130,8000,7740,-390,-4.8,7820,-310,-3.81,7730,8080,1400-6-7,2021-08-29
266,ميهن,بيمه ميهن,2264,27901145,113471498805,3956,4149,3977,21,0.53,4067,111,2.81,3800,4153,1400-6-7,2021-08-29
267,كسرا,سراميك‌هاي‌صنعتي‌اردكان‌,2264,17515870,373415893910,20530,21550,21070,540,2.63,21320,790,3.85,20780,21550,1400-6-7,2021-08-29
268,دزهراوي,داروسازي‌زهراوي‌,2258,11322094,84680141020,7510,7800,7300,-210,-2.8,7480,-30,-0.4,7140,7800,1400-6-7,2021-08-29
269,كروي,توسعه‌ معادن‌ روي‌ ايران‌,2242,15028486,457403340590,29170,30500,30160,990,3.39,30440,1270,4.35,29180,30620,1400-6-7,2021-08-29
270,كساوه,صنايع‌ كاشي‌ و سراميك‌ سينا,2237,4028872,237893853670,57080,59930,57900,820,1.44,59050,1970,3.45,54230,59930,1400-6-7,2021-08-29
271,بزاگرس,نيروگاه زاگرس كوثر,2234,25582860,150209774937,5705,5950,5601,-104,-1.82,5872,167,2.93,5510,5990,1400-6-7,2021-08-29
272,شپارس,بين‌ المللي‌ محصولات‌  پارس‌,2220,7354144,114127551410,16030,15960,15230,-800,-4.99,15520,-510,-3.18,15230,16040,1400-6-7,2021-08-29
273,بپاس,بيمه پاسارگاد,2219,3353117,223113035438,63610,66790,66790,3180,5,66539,2929,4.6,64564,66790,1400-6-7,2021-08-29
274,رمپنا,گروه مپنا (سهامي عام),2219,12519724,239597357200,19700,20140,18720,-980,-4.97,19140,-560,-2.84,18720,20140,1400-6-7,2021-08-29
275,پارند,صندوق س. پارند پايدار سپهر,2178,185718765,1881212336947,10124,10130,10130,6,0.06,10129,5,0.05,10129,10135,1400-6-7,2021-08-29
276,خكمك,كمك‌فنرايندامين‌,2155,6025419,138294790000,22550,23490,21920,-630,-2.79,22950,400,1.77,21430,23670,1400-6-7,2021-08-29
277,نطرين,عطرين نخ قم,2150,8740809,78288275930,9001,9370,8591,-410,-4.56,8957,-44,-0.49,8551,9370,1400-6-7,2021-08-29
278,اميد,تامين سرمايه اميد,2130,27120653,182656579470,6450,6770,6770,320,4.96,6730,280,4.34,6480,6770,1400-6-7,2021-08-29
279,كسعدي,كاشي‌ سعدي‌,2122,8310709,110070272080,13710,13550,13030,-680,-4.96,13240,-470,-3.43,13030,13550,1400-6-7,2021-08-29
280,قشهد,شهد,2117,8067081,143424866930,18610,18000,17680,-930,-5,17780,-830,-4.46,17680,18580,1400-6-7,2021-08-29
281,آ س پ,آ.س.پ,2094,12433973,129035663617,9955,10410,10238,283,2.84,10378,423,4.25,9999,10452,1400-6-7,2021-08-29
282,شكربن,كربن‌ ايران‌,2088,2354268,290199871820,122510,127000,123000,490,0.4,123270,760,0.62,116390,128000,1400-6-7,2021-08-29
283,حاريا,كشتيراني آريا,2086,8267036,134115633476,16447,16300,16119,-328,-1.99,16223,-224,-1.36,16119,16580,1400-6-7,2021-08-29
284,غاذر,كشت‌وصنعت‌پياذر,2073,3995864,115411174110,28000,28780,28550,550,1.96,28880,880,3.14,27500,29400,1400-6-7,2021-08-29
285,غويتا,ويتانا,2069,13218912,131128549332,9678,10161,9520,-158,-1.63,9920,242,2.5,9195,10161,1400-6-7,2021-08-29
286,حتايد,تايدواترخاورميانه,2050,6503210,177744679840,27320,27600,26040,-1280,-4.69,27330,10,0.04,25960,28200,1400-6-7,2021-08-29
287,وپخش,داروپخش‌ (هلدينگ‌,2047,4543946,173495827850,37190,39040,36250,-940,-2.53,38180,990,2.66,35340,39040,1400-6-7,2021-08-29
288,شسينا,صنايع‌شيميايي‌سينا,2032,1848696,149711500220,80580,84600,77670,-2910,-3.61,80980,400,0.5,76560,84600,1400-6-7,2021-08-29
289,ديران,ايران‌دارو,2026,6721176,162113627020,23240,24180,22900,-340,-1.46,24120,880,3.79,22100,24400,1400-6-7,2021-08-29
290,ارزش,صندوق س ارزش آفرين بيدار-سهام,2016,10032064,124173430860,12500,12740,11990,-510,-4.08,12380,-120,-0.96,11870,12800,1400-6-7,2021-08-29
291,لخزر,پارس‌ خزر,2009,802314,138600321030,178920,180520,176500,-2420,-1.35,172750,-6170,-3.45,169980,183500,1400-6-7,2021-08-29
292,شزنگ,تجهيزنيروي‌زنگان‌,2009,1451616,196519237316,133873,137889,130013,-3860,-2.88,135380,1507,1.13,129857,137889,1400-6-7,2021-08-29
293,بشهاب,لامپ‌  پارس‌ شهاب‌,2002,1282034,174834450430,138350,140000,134500,-3850,-2.78,136370,-1980,-1.43,131440,143500,1400-6-7,2021-08-29
294,قلرست,قند لرستان‌,1994,3278673,95370957080,30150,30000,28650,-1500,-4.98,29090,-1060,-3.52,28650,30000,1400-6-7,2021-08-29
295,هماي,صندوق س هماي آگاه-ثابت,1993,8066927,83270586406,10000,10322,10323,323,3.23,10322,322,3.22,10322,10326,1400-6-7,2021-08-29
296,ثاباد,توريستي ورفاهي آبادگران ايران,1991,3809698,193505830800,48570,50990,49020,450,0.93,50790,2220,4.57,48570,50990,1400-6-7,2021-08-29
297,خكاوه,سايپا ديزل,1987,28688296,133397563368,4533,4759,4436,-97,-2.14,4650,117,2.58,4307,4759,1400-6-7,2021-08-29
298,سخاش,سيمان‌خاش‌,1969,1156565,149891410740,125050,130000,131300,6250,5,129600,4550,3.64,121080,131300,1400-6-7,2021-08-29
299,كوثر,بيمه كوثر,1966,7705860,114353311668,15145,15100,14388,-757,-5,14840,-305,-2.01,14388,15495,1400-6-7,2021-08-29
300,آريان,سرمايه گذاري پارس آريان,1964,34219642,585787012830,17373,17380,16852,-521,-3,17118,-255,-1.47,16852,17380,1400-6-7,2021-08-29
301,ونفت,سرمايه‌گذاري‌ صنعت‌ نفت‌,1959,10124123,189055674930,19090,19090,18140,-950,-4.98,18670,-420,-2.2,18140,19300,1400-6-7,2021-08-29
302,داوه,داروسازي آوه سينا,1950,6139130,120785377123,19174,20132,19100,-74,-0.39,19675,501,2.61,18216,20132,1400-6-7,2021-08-29
303,قشكر,شكرشاهرود,1943,29861454,109094482777,3781,3710,3592,-189,-5,3653,-128,-3.39,3592,3800,1400-6-7,2021-08-29
304,قاسم,قاسم ايران,1939,8297918,86112115783,10139,10645,10027,-112,-1.1,10378,239,2.36,9783,10645,1400-6-7,2021-08-29
305,ودي,بيمه  دي,1939,12821824,110066865958,8783,8880,8390,-393,-4.47,8584,-199,-2.27,8345,8890,1400-6-7,2021-08-29
306,قصفها,قنداصفهان‌,1931,1300419,154287429600,116570,122390,116000,-570,-0.49,118640,2070,1.78,110750,122390,1400-6-7,2021-08-29
307,ثمسكن,سرمايه‌گذاري‌ مسكن‌,1914,27776811,167885196680,5930,5950,5860,-70,-1.18,6040,110,1.85,5730,6220,1400-6-7,2021-08-29
308,غپاك,لبنيات‌ پاك‌,1912,12219876,227488399950,17670,17900,18790,1120,6.34,18620,950,5.38,17900,18790,1400-6-7,2021-08-29
309,توريل,توكاريل,1911,9158418,148943889115,16775,16470,15937,-838,-5,16263,-512,-3.05,15937,16862,1400-6-7,2021-08-29
310,پكوير,كوير تاير,1910,9081255,149930939310,16700,16940,15970,-730,-4.37,16510,-190,-1.14,15900,17090,1400-6-7,2021-08-29
311,ومهان,گروه توسعه مالي مهر آيندگان,1891,10412542,179931569419,17630,17898,16800,-830,-4.71,17280,-350,-1.99,16749,17950,1400-6-7,2021-08-29
312,كيميا,معدني كيمياي زنجان گستران,1886,7377260,120332711102,16501,16680,15757,-744,-4.51,16311,-190,-1.15,15676,16750,1400-6-7,2021-08-29
313,فنوال,نورد آلومينيوم‌,1871,3975071,120587770500,31110,31150,29560,-1550,-4.98,30340,-770,-2.48,29560,31450,1400-6-7,2021-08-29
314,پارسيان,بيمه پارسيان,1865,21797053,267901062530,11840,11360,12010,170,1.44,12290,450,3.8,11360,12430,1400-6-7,2021-08-29
315,شتوكا,توكا رنگ فولاد سپاهان,1842,3034460,109187249925,37243,37800,35381,-1862,-5,35982,-1261,-3.39,35381,37800,1400-6-7,2021-08-29
316,ميدكو,توسعه معادن وص.معدني خاورميانه,1841,7960655,335169647160,41050,42200,42560,1510,3.68,42100,1050,2.56,41050,42640,1400-6-7,2021-08-29
317,فولاژ,فولاد آلياژي ايران,1840,6941489,131754322750,18990,19030,18450,-540,-2.84,18980,-10,-0.05,18100,19700,1400-6-7,2021-08-29
318,ثغرب,شركت سرمايه گذاري مسكن شمالغرب,1836,12184688,79793464994,6624,6710,6293,-331,-5,6549,-75,-1.13,6293,6900,1400-6-7,2021-08-29
319,غبهنوش,بهنوش‌ ايران‌,1830,3327697,260569312270,74980,78720,78720,3740,4.99,78300,3320,4.43,75260,78720,1400-6-7,2021-08-29
320,ساروم,سيمان‌اروميه‌,1830,3588286,166245602340,44620,46850,44400,-220,-0.49,46330,1710,3.83,44010,46850,1400-6-7,2021-08-29
321,كپارس,كاشي‌ پارس‌,1829,1293378,166111411620,129210,131800,124690,-4520,-3.5,128430,-780,-0.6,122750,133380,1400-6-7,2021-08-29
322,هجرت,پخش هجرت,1820,14977573,521402611085,33369,35037,33026,-343,-1.03,34812,1443,4.32,33025,35037,1400-6-7,2021-08-29
323,تكمبا,كمباين‌ سازي‌ ايران‌,1818,11820103,94260079520,8050,8050,7650,-400,-4.97,7970,-80,-0.99,7650,8310,1400-6-7,2021-08-29
324,شخارك,پتروشيمي‌ خارك‌,1816,3451437,182069264900,54250,54990,53000,-1250,-2.3,52750,-1500,-2.76,51540,54990,1400-6-7,2021-08-29
325,دلقما,دارويي‌ لقمان‌,1814,2529898,99810280740,38860,39000,38110,-750,-1.93,39450,590,1.52,37750,40750,1400-6-7,2021-08-29
326,ضخود7075,اختيارخ خودرو-2000-1400/07/07,1813,70325,32998107000,485,520,400,-85,-17.53,469,-16,-3.3,400,533,1400-6-7,2021-08-29
327,زشگزا,شير و گوشت زاگرس شهركرد,1810,12144056,83592061021,7126,7200,6770,-356,-5,6883,-243,-3.41,6770,7200,1400-6-7,2021-08-29
328,سفار,سيمان‌فارس‌,1804,759625,72929199400,96750,98410,93390,-3360,-3.47,96010,-740,-0.76,91990,98410,1400-6-7,2021-08-29
329,سشرق,سيمان‌ شرق‌,1803,14545857,140807893060,9950,10000,9460,-490,-4.92,9680,-270,-2.71,9460,10130,1400-6-7,2021-08-29
330,واميد,گروه مديريت سرمايه گذاري اميد,1798,15644922,220318946600,14220,14360,13770,-450,-3.16,14080,-140,-0.98,13600,14390,1400-6-7,2021-08-29
331,كساپا,سايپاشيشه‌,1788,4215506,98231905340,22800,23850,22950,150,0.66,23300,500,2.19,22300,23940,1400-6-7,2021-08-29
332,وملت,سرمايه گذاري ملت,1781,21618795,83857478209,3843,3919,3870,27,0.7,3879,36,0.94,3767,3919,1400-6-7,2021-08-29
333,سمازن,سيمان‌مازندران‌,1765,14386136,247248184640,16960,17000,17010,50,0.29,17190,230,1.36,16670,17550,1400-6-7,2021-08-29
334,شپاس,نفت پاسارگاد,1762,9802720,225536137829,22801,22260,22940,139,0.61,23008,207,0.91,21810,23870,1400-6-7,2021-08-29
335,فسرب,ملي‌ سرب‌وروي‌ ايران‌,1762,1391564,120144776690,86130,86000,84900,-1230,-1.43,86340,210,0.24,84000,89000,1400-6-7,2021-08-29
336,ثباغ,شهر سازي و خانه سازي باغميشه,1760,11352268,162925249794,14917,14500,14172,-745,-4.99,14352,-565,-3.79,14172,14900,1400-6-7,2021-08-29
337,حشكوه,دليجان طلايي شكوه پارس,1756,7865724,25028733768,3090,3182,3182,92,2.98,3182,92,2.98,3182,3182,1400-6-7,2021-08-29
338,خكرمان,گروه اقتصادي كرمان خودرو,1755,23443737,98627617530,4309,4270,4180,-129,-2.99,4207,-102,-2.37,4180,4317,1400-6-7,2021-08-29
339,ولشرق,ليزينگ ايران و شرق,1748,11521194,76906433945,6912,6900,6567,-345,-4.99,6675,-237,-3.43,6567,6900,1400-6-7,2021-08-29
340,دجابر,داروسازي‌ جابرابن‌حيان‌,1729,15646272,261505478490,16100,16900,16310,210,1.3,16710,610,3.79,16000,16900,1400-6-7,2021-08-29
341,فنورد,نوردوقطعات‌ فولادي‌,1720,794748,172456324250,221040,227330,209990,-11050,-5,216990,-4050,-1.83,209990,227330,1400-6-7,2021-08-29
342,سصوفي,سيمان‌ صوفيان‌,1719,3996214,92693211540,23670,24140,22540,-1130,-4.77,23200,-470,-1.99,22500,24200,1400-6-7,2021-08-29
343,تايرا,تراكتورسازي‌ايران‌,1719,8170092,242634017620,28670,28700,30090,1420,4.95,29700,1030,3.59,27910,30100,1400-6-7,2021-08-29
344,غمارگ,مارگارين‌,1718,7799393,257823725960,33460,32620,32130,-1330,-3.97,33060,-400,-1.2,31790,34000,1400-6-7,2021-08-29
345,فجام,جام‌دارو,1701,11868699,94281230130,7790,8090,7650,-140,-1.8,7940,150,1.93,7620,8170,1400-6-7,2021-08-29
346,سپاها,سيمان‌سپاهان‌,1700,17888839,197523326490,11050,11150,11060,10,0.09,11040,-10,-0.09,10670,11390,1400-6-7,2021-08-29
347,فپنتا,سپنتا,1700,332129,197999780220,590140,579900,566500,-23640,-4.01,596150,6010,1.02,566030,615000,1400-6-7,2021-08-29
348,سدبير,س. تدبيرگران فارس وخوزستان,1696,2174246,101171947591,48011,46140,45611,-2400,-5,46532,-1479,-3.08,45611,47990,1400-6-7,2021-08-29
349,خچرخش,چرخشگر,1694,10082937,123362725720,11810,12400,11800,-10,-0.08,12230,420,3.56,11630,12400,1400-6-7,2021-08-29
350,وسكاب,س.ص.بازنشستگي كاركنان بانكها,1667,27274867,92065842819,3402,3470,3330,-72,-2.12,3375,-27,-0.79,3234,3490,1400-6-7,2021-08-29
351,افرا,افرانت,1663,2339201,66893956929,29074,29500,27621,-1453,-5,28597,-477,-1.64,27621,29860,1400-6-7,2021-08-29
352,فلات,گروه صنايع معادن فلات ايرانيان,1662,5538167,76050446104,14017,14390,13597,-420,-3,13732,-285,-2.03,13597,14390,1400-6-7,2021-08-29
353,اطلس,صندوق س.توسعه اندوخته آينده-س,1648,593547,165431176508,281401,283100,271001,-10400,-3.7,278716,-2685,-0.95,271001,283100,1400-6-7,2021-08-29
354,پاسا,ايران‌ياساتايرورابر,1646,5109387,122574977970,24700,24730,23470,-1230,-4.98,23990,-710,-2.87,23470,24840,1400-6-7,2021-08-29
355,پدرخش,درخشان‌ تهران‌,1639,2790209,73545196810,26750,27220,25420,-1330,-4.97,26360,-390,-1.46,25420,27680,1400-6-7,2021-08-29
356,قجام,فرآوردههاي غذايي وقندتربت‌جام‌,1635,9479152,61651328476,6496,6625,6367,-129,-1.99,6504,8,0.12,6367,6625,1400-6-7,2021-08-29
357,رنيك,جنرال مكانيك,1626,4873277,90090934436,19279,19220,18316,-963,-5,18487,-792,-4.11,18316,19220,1400-6-7,2021-08-29
358,درهآور,دارويي ره آورد تامين,1620,4713684,148855013946,30299,31813,30900,601,1.98,31579,1280,4.22,30310,31813,1400-6-7,2021-08-29
359,شبهرن,نفت‌ بهران‌,1616,6976217,99933355090,14330,14640,14000,-330,-2.3,14320,-10,-0.07,13900,14640,1400-6-7,2021-08-29
360,زدشت,كشت و صنعت دشت خرم دره,1616,3638619,86449397614,24427,24960,23206,-1221,-5,23759,-668,-2.73,23206,24960,1400-6-7,2021-08-29
361,زشريف,كشت وصنعت شريف آباد,1614,12616837,74104864149,5931,6110,5680,-251,-4.23,5873,-58,-0.98,5635,6120,1400-6-7,2021-08-29
362,كي بي سي,شركت كي بي سي,1611,3704085,106502466276,28662,29900,27500,-1162,-4.05,28753,91,0.32,27229,30095,1400-6-7,2021-08-29
363,زبينا,كشاورزي و دامپروري بينالود,1601,22292941,75118544587,3410,3444,3263,-147,-4.31,3370,-40,-1.17,3241,3530,1400-6-7,2021-08-29
364,غمينو,شركت صنايع غذايي مينو شرق,1581,5974649,54461711502,9273,9300,8810,-463,-4.99,9115,-158,-1.7,8810,9650,1400-6-7,2021-08-29
365,وآرين,شركت توسعه اقتصادي آرين,1580,24819792,81373689782,3280,3360,3182,-98,-2.99,3279,-1,-0.03,3182,3378,1400-6-7,2021-08-29
366,سيلام,سيمان‌ ايلام‌,1568,6385972,57602444340,9180,9350,8730,-450,-4.9,9020,-160,-1.74,8730,9380,1400-6-7,2021-08-29
367,كگاز,شيشه‌ و گاز,1562,8327755,184314817490,21290,22350,21550,260,1.22,22130,840,3.95,20860,22350,1400-6-7,2021-08-29
368,كاذر,فرآورده‌هاي‌نسوزآذر,1557,5558050,103619189650,18840,18840,18110,-730,-3.87,18640,-200,-1.06,17900,19350,1400-6-7,2021-08-29
369,زفكا,كشت و دامداري فكا,1554,8205488,102883671829,12067,12650,12000,-67,-0.56,12538,471,3.9,11900,12670,1400-6-7,2021-08-29
370,لابسا,آبسال‌,1518,2591171,109177985620,43410,44700,41240,-2170,-5,42130,-1280,-2.95,41240,45370,1400-6-7,2021-08-29
371,غگلپا,شير پاستوريزه پگاه گلپايگان,1515,1280823,95189231033,75036,73620,72220,-2816,-3.75,74319,-717,-0.96,72001,76500,1400-6-7,2021-08-29
372,تابا,تابان نيرو سپاهان,1514,2462307,80156770372,32816,33500,31832,-984,-3,32554,-262,-0.8,31832,33500,1400-6-7,2021-08-29
373,شدوص,دوده‌ صنعتي‌ پارس‌,1500,4302661,106461807880,25770,26000,24490,-1280,-4.97,24740,-1030,-4,24490,26000,1400-6-7,2021-08-29
374,فوكا,فولاد كاويان,1499,7959177,136631755463,17646,17750,17117,-529,-3,17167,-479,-2.71,17117,17750,1400-6-7,2021-08-29
375,ختراك,ريخته‌گري‌ تراكتورسازي‌ ايران‌,1494,7573938,108732163370,14480,14500,13760,-720,-4.97,14360,-120,-0.83,13760,15190,1400-6-7,2021-08-29
376,سمايه,بانك سرمايه,1493,12526863,59152942610,4744,4799,4609,-135,-2.85,4722,-22,-0.46,4602,4876,1400-6-7,2021-08-29
377,خموتور,موتورسازان‌تراكتورسازي‌ايران‌,1490,8998034,106549762260,11830,12420,11460,-370,-3.13,11840,10,0.08,11240,12420,1400-6-7,2021-08-29
378,كمنگنز,معادن‌منگنزايران‌,1475,984717,86994892060,91440,92000,86870,-4570,-5,88350,-3090,-3.38,86870,92000,1400-6-7,2021-08-29
379,بسويچ,پارس‌سويچ‌,1470,4183167,121960675320,27920,28010,29310,1390,4.98,29160,1240,4.44,28010,29310,1400-6-7,2021-08-29
380,بالاس,مهندسي ساختمان تاسيسات راه آهن,1465,2063841,80373771136,39747,41240,37760,-1987,-5,38944,-803,-2.02,37760,41240,1400-6-7,2021-08-29
381,تپولا,مهندسي مرآت پولاد,1460,3673862,91643311922,24496,25230,24420,-76,-0.31,24945,449,1.83,24003,25230,1400-6-7,2021-08-29
382,دعبيد,لابراتوارداروسازي‌  دكترعبيدي‌,1459,3026029,85825389300,27700,29080,27020,-680,-2.45,28360,660,2.38,26800,29080,1400-6-7,2021-08-29
383,دبالك,مواد اوليه دارويي البرز بالك,1459,8241002,154070617766,17950,18847,18640,690,3.84,18696,746,4.16,17960,18847,1400-6-7,2021-08-29
384,غشهد,شهد ايران ‌,1452,10586971,58382044250,5520,5790,5280,-240,-4.35,5510,-10,-0.18,5250,5790,1400-6-7,2021-08-29
385,شپلي,پلي اكريل ايران,1449,9981240,123489504819,12729,12410,12348,-381,-2.99,12372,-357,-2.8,12348,12700,1400-6-7,2021-08-29
386,زقيام,كشت و دام قيام اصفهان,1448,2641515,61398333467,23278,24000,22670,-608,-2.61,23244,-34,-0.15,22120,24250,1400-6-7,2021-08-29
387,فسازان,غلتك سازان سپاهان,1431,2723108,95971373320,35600,35500,34340,-1260,-3.54,35240,-360,-1.01,34000,36360,1400-6-7,2021-08-29
388,دسبحان,سبحان دارو,1428,5084373,110631888520,21090,21700,21810,720,3.41,21760,670,3.18,20390,22140,1400-6-7,2021-08-29
389,اعتلا,شركت سرمايه گذاري اعتلاء البرز,1428,7295748,59715691163,8349,8350,8140,-209,-2.5,8185,-164,-1.96,7951,8500,1400-6-7,2021-08-29
390,كطبس,ذغال‌سنگ‌ نگين‌ ط‌بس‌,1417,2063706,139240970770,68350,69950,64940,-3410,-4.99,67470,-880,-1.29,64940,70670,1400-6-7,2021-08-29
391,كاردان,صندوق س تجارت شاخصي كاردان,1401,1476554,352854875420,234430,240100,233500,-930,-0.4,238970,4540,1.94,232190,244000,1400-6-7,2021-08-29
392,ركيش,كارت اعتباري ايران كيش,1395,15012148,116798924700,7650,7800,7560,-90,-1.18,7780,130,1.7,7410,8020,1400-6-7,2021-08-29
393,خريخت,صنايع‌ريخته‌گري‌ايران‌,1392,28130899,98389177116,3627,3599,3446,-181,-4.99,3498,-129,-3.56,3446,3639,1400-6-7,2021-08-29
394,ومعلم,بيمه معلم,1391,14086386,63618275728,4501,4504,4500,-1,-0.02,4516,15,0.33,4391,4726,1400-6-7,2021-08-29
395,كگهر,سنگ آهن گهرزمين,1381,5844157,303023203598,51504,52200,51500,-4,-0.01,51851,347,0.67,51020,52980,1400-6-7,2021-08-29
396,خوساز,محورسازان‌ايران‌خودرو,1381,11628098,94875097790,8390,8450,7980,-410,-4.89,8160,-230,-2.74,7980,8610,1400-6-7,2021-08-29
397,لسرما,سرما آفرين‌,1378,3791074,95561467100,25340,26600,24820,-520,-2.05,25210,-130,-0.51,24080,26600,1400-6-7,2021-08-29
398,ولانا,شركت ليزينگ آريا دانا,1353,2930332,74748592057,26081,26660,25299,-782,-3,25509,-572,-2.19,25299,26660,1400-6-7,2021-08-29
399,جهرم,پتروشيمي جهرم,1348,29735345,47658607556,1609,1601,1564,-45,-2.8,1603,-6,-0.37,1561,1642,1400-6-7,2021-08-29
400,شرانل,نفت ايرانول,1338,1271581,67581560364,52126,54590,51500,-626,-1.2,53148,1022,1.96,50500,54590,1400-6-7,2021-08-29
401,حسينا,توسعه خدمات دريايي وبندري سينا,1329,961996,61180275510,65006,66350,61800,-3206,-4.93,63597,-1409,-2.17,61756,67400,1400-6-7,2021-08-29
402,غشاذر,پگاه‌آذربايجان‌غربي‌,1323,8417016,67563474150,8270,8360,7890,-380,-4.59,8030,-240,-2.9,7860,8370,1400-6-7,2021-08-29
403,رتاپ,تجارت الكترونيك  پارسيان,1316,7485156,51229552850,6990,7150,6650,-340,-4.86,6840,-150,-2.15,6650,7160,1400-6-7,2021-08-29
404,واحيا,م .صنايع و معادن احياء سپاهان,1312,1735271,369239291937,214620,210500,208182,-6438,-3,212785,-1835,-0.85,208182,216500,1400-6-7,2021-08-29
405,نمرينو,ايران‌ مرينوس‌,1308,861042,101029043100,118800,121320,112860,-5940,-5,117330,-1470,-1.24,112860,122000,1400-6-7,2021-08-29
406,شراز,پالايش نفت شيراز,1292,1493838,195893792584,129915,134690,127300,-2615,-2.01,131135,1220,0.94,126100,135990,1400-6-7,2021-08-29
407,جم پيلن,پلي پروپيلن جم - جم پيلن,1281,1896884,215969417560,114920,114350,112800,-2120,-1.84,113850,-1070,-0.93,112070,116000,1400-6-7,2021-08-29
408,غشان,شيرپاستوريزه‌پگاه‌خراسان‌,1274,16216834,110078734170,6510,6700,6700,190,2.92,6790,280,4.3,6520,6830,1400-6-7,2021-08-29
409,قچار,فراوردههاي غذايي وقند چهارمحال,1273,3174473,54419131679,17560,17850,16682,-878,-5,17143,-417,-2.37,16682,17880,1400-6-7,2021-08-29
410,شيراز,پتروشيمي‌شيراز,1264,1500779,114737624630,79220,78170,75260,-3960,-5,76450,-2770,-3.5,75260,78700,1400-6-7,2021-08-29
411,زكشت,كشاورزي مكانيزه اصفهان كشت,1245,2337927,69714199495,29372,30576,29150,-222,-0.76,29819,447,1.52,28000,30840,1400-6-7,2021-08-29
412,شپاكسا,پاكسان‌,1243,3967203,94962455870,24160,23870,23020,-1140,-4.72,23940,-220,-0.91,22960,24600,1400-6-7,2021-08-29
413,جم,پتروشيمي جم,1242,6455336,309292988220,49150,49510,47110,-2040,-4.15,47910,-1240,-2.52,47100,49690,1400-6-7,2021-08-29
414,شفا,سرمايه گذاري شفادارو,1233,2388179,117892752120,47850,48500,47470,-380,-0.79,49370,1520,3.18,46050,50240,1400-6-7,2021-08-29
415,لازما,كارخانه هاي صنعتي آزمايش,1217,2724000,63606750304,23590,24200,22883,-707,-3,23350,-240,-1.02,22883,24200,1400-6-7,2021-08-29
416,سخوز,سيمان خوزستان,1214,2542751,73502781180,28540,29480,27950,-590,-2.07,28910,370,1.3,27400,29780,1400-6-7,2021-08-29
417,سهرمز,سيمان‌هرمزگان‌,1209,2643279,50492583970,19600,20130,19160,-440,-2.24,19100,-500,-2.55,18620,20130,1400-6-7,2021-08-29
418,تيپيكوح,ح . سرمايه گذاري دارويي تامين,1191,3300953,68441615790,20860,21000,19880,-980,-4.7,20730,-130,-0.62,19060,21250,1400-6-7,2021-08-29
419,دفارا,داروسازي‌ فارابي‌,1187,2618060,56956931090,21570,22000,21020,-550,-2.55,21760,190,0.88,20500,22500,1400-6-7,2021-08-29
420,درازك,دارويي‌ رازك‌,1178,3531077,159021585470,45640,46990,43360,-2280,-5,45030,-610,-1.34,43360,46990,1400-6-7,2021-08-29
421,وسهمدا,شركت س استان همدان,1172,56990090,38418352305,674,699,659,-15,-2.23,674,0,0,641,699,1400-6-7,2021-08-29
422,ساربيل,سيمان آرتا اردبيل,1172,1247902,50410227160,40750,41670,39300,-1450,-3.56,40400,-350,-0.86,39000,41670,1400-6-7,2021-08-29
423,كصدف,كاشي صدف سرام استقلال آباده,1171,4696243,95486460360,20598,21178,20880,282,1.37,20333,-265,-1.29,19981,21178,1400-6-7,2021-08-29
424,فبيرا,بسته‌ بندي‌ ايران‌,1160,24453993,57429260797,2304,2373,2284,-20,-0.87,2348,44,1.91,2235,2373,1400-6-7,2021-08-29
425,واعتبار,سرمايه گذاري اعتبار ايران,1158,5994729,54223154570,9130,9420,8850,-280,-3.07,9050,-80,-0.88,8680,9420,1400-6-7,2021-08-29
426,غبهار,كشت وصنعت بهاران گلبهار خراسان,1158,2013409,38682706646,19630,19830,19042,-588,-3,19213,-417,-2.12,19042,19830,1400-6-7,2021-08-29
427,سغرب,سيمان‌غرب‌,1155,2518608,63560303260,26190,27070,24890,-1300,-4.96,25240,-950,-3.63,24890,27070,1400-6-7,2021-08-29
428,داسوه,داروسازي‌ اسوه‌,1150,1659587,52484695070,32010,33300,30410,-1600,-5,31630,-380,-1.19,30410,33300,1400-6-7,2021-08-29
429,دشيمي,شيمي‌ داروئي‌ داروپخش‌,1144,2526156,76362640990,29850,30660,28900,-950,-3.18,30230,380,1.27,28560,31340,1400-6-7,2021-08-29
430,خفولا,خدمات فني فولاد يزد,1144,3059230,89397043770,28462,29200,29315,853,3,29222,760,2.67,28462,29315,1400-6-7,2021-08-29
431,تسه0004,امتيازتسهيلات مسكن تير1400,1139,19058,11348336657,598653,592000,590000,-8653,-1.45,595463,-3190,-0.53,580022,620000,1400-6-7,2021-08-29
432,سيدكو,سرمايه گذاري توسعه صنايع سيمان,1138,7062956,58566649220,8410,8630,8030,-380,-4.52,8290,-120,-1.43,7990,8630,1400-6-7,2021-08-29
433,كاريس,صندوق س.سپهر كاريزما-س,1135,5286633,81814481249,15667,15730,15010,-657,-4.19,15476,-191,-1.22,15010,15880,1400-6-7,2021-08-29
434,پرداخت,به پرداخت ملت,1132,2233604,49049869910,22540,22900,21420,-1120,-4.97,21960,-580,-2.57,21420,23090,1400-6-7,2021-08-29
435,ثزاگرس,سرمايه گذاري توسعه عمران زاگرس,1130,859762,45543150240,52662,54880,51210,-1452,-2.76,52972,310,0.59,50300,54880,1400-6-7,2021-08-29
436,خلنت,لنت‌ ترمزايران‌,1129,949614,66290444450,68010,71400,67410,-600,-0.88,69810,1800,2.65,65110,71410,1400-6-7,2021-08-29
437,غمهرا,توليدي‌مهرام‌,1121,664190,46591110200,70540,72990,70000,-540,-0.77,70150,-390,-0.55,67130,72990,1400-6-7,2021-08-29
438,افران,صندوق س افرا نماد پايدار-ثابت,1119,37761662,533234656725,14119,14128,14119,0,0,14121,2,0.01,14119,14160,1400-6-7,2021-08-29
439,پخش,پخش البرز,1110,3045214,82565362366,26304,27619,26000,-304,-1.16,27113,809,3.08,25390,27619,1400-6-7,2021-08-29
440,كرماشا,صنايع پتروشيمي كرمانشاه,1106,3176033,148499269160,47540,47520,46000,-1540,-3.24,46760,-780,-1.64,45170,47550,1400-6-7,2021-08-29
441,تماوند,تامين سرمايه دماوند,1105,78985636,505149639073,6340,6440,6448,108,1.7,6395,55,0.87,6250,6509,1400-6-7,2021-08-29
442,فاهواز,نورد و لوله اهواز,1095,6241457,45786004744,7385,7450,7312,-73,-0.99,7336,-49,-0.66,7312,7455,1400-6-7,2021-08-29
443,وپترو,سرمايه‌گذاري صنايع پتروشيمي‌,1084,7140386,114084465050,16290,16600,15480,-810,-4.97,15980,-310,-1.9,15480,16700,1400-6-7,2021-08-29
444,سخزر,سيمان‌ خزر,1083,2696380,77059234940,29780,29850,28300,-1480,-4.97,28580,-1200,-4.03,28300,29850,1400-6-7,2021-08-29
445,ثامان,سامان‌ گستراصفهان‌,1079,3120808,45983916720,15190,15360,14440,-750,-4.94,14730,-460,-3.03,14440,15770,1400-6-7,2021-08-29
446,وصندوق,سرمايه‌گذاري‌صندوق‌بازنشستگي‌,1078,12830205,250533604060,19690,19700,19670,-20,-0.1,19530,-160,-0.81,19200,19880,1400-6-7,2021-08-29
447,نتوس,پشم‌ بافي‌ توس,1077,4606313,70002240559,15590,15855,15123,-467,-3,15197,-393,-2.52,15123,15855,1400-6-7,2021-08-29
448,دكوثر,داروسازي‌ كوثر,1071,13832283,75437465990,5270,5510,5290,20,0.38,5450,180,3.42,5110,5530,1400-6-7,2021-08-29
449,پكرمان,گروه‌ صنعتي‌ بارز,1070,2015963,59668008690,30180,30550,29000,-1180,-3.91,29600,-580,-1.92,28680,30600,1400-6-7,2021-08-29
450,فخاس,فولاد خراسان,1070,4499402,138231850450,29340,30800,30500,1160,3.95,30720,1380,4.7,29400,30800,1400-6-7,2021-08-29
451,واتي,سرمايه‌ گذاري‌ آتيه‌ دماوند,1069,9586666,131087660930,14060,14000,13360,-700,-4.98,13670,-390,-2.77,13360,14160,1400-6-7,2021-08-29
452,اپرداز,آتيه داده پرداز,1067,2201237,50424760616,23449,24590,22277,-1172,-5,22907,-542,-2.31,22277,24590,1400-6-7,2021-08-29
453,چكاوه,صنايع‌كاغذسازي‌كاوه‌,1064,4571644,64337647840,14570,14700,13850,-720,-4.94,14070,-500,-3.43,13850,15010,1400-6-7,2021-08-29
454,وكادو,تكادو,1058,7614446,156443667353,19968,20567,20567,599,3,20546,578,2.89,19950,20567,1400-6-7,2021-08-29
455,شوينده,مديريت صنعت شوينده ت.ص.بهشهر,1056,2272068,62108891530,28230,28880,26820,-1410,-4.99,27340,-890,-3.15,26820,28880,1400-6-7,2021-08-29
456,ما,بيمه  ما,1054,5819532,49549616120,8870,8790,8450,-420,-4.74,8510,-360,-4.06,8430,8790,1400-6-7,2021-08-29
457,قشير,قند شيروان قوچان و بجنورد,1048,6102406,130975321510,20611,21641,21030,419,2.03,21463,852,4.13,20592,21641,1400-6-7,2021-08-29
458,وسبحان,سرمايه گذاري سبحان,1046,16044965,55264187030,3531,3531,3355,-176,-4.98,3444,-87,-2.46,3355,3540,1400-6-7,2021-08-29
459,ساراب,سيمان‌ داراب‌,1039,3660318,71561232570,19900,20390,19430,-470,-2.36,19550,-350,-1.76,19000,20390,1400-6-7,2021-08-29
460,غپآذر,شير پگاه آذربايجان شرقي,1031,1814139,97626542964,52111,52905,52650,539,1.03,53814,1703,3.27,51002,54716,1400-6-7,2021-08-29
461,دفاراح,ح . داروسازي‌ فارابي‌,1028,2945620,48859899800,16270,16570,16000,-270,-1.66,16590,320,1.97,15610,17310,1400-6-7,2021-08-29
462,وثوق,سرمايه گذاري وثوق امين,1024,2859734,50213226026,17863,18390,17328,-535,-3,17559,-304,-1.7,17328,18390,1400-6-7,2021-08-29
463,بنو,بيمه تجارت نو,1015,8932115,130804517774,14582,15100,14201,-381,-2.61,14644,62,0.43,14000,15100,1400-6-7,2021-08-29
464,شكلر,نيروكلر,1009,1476984,64722485420,44740,45500,42510,-2230,-4.98,43820,-920,-2.06,42510,45980,1400-6-7,2021-08-29
465,سكه0012پ01,تمام سكه طرح جديد0012رفاه,1009,230400,277358999100,1244461,1236000,1196360,-48101,-3.87,1203815,-40646,-3.27,1190610,1236000,1400-6-7,2021-08-29
466,آبين,كشت و صنعت آبشيرين,999,12429539,33147614170,2695,2742,2642,-53,-1.97,2667,-28,-1.04,2642,2742,1400-6-7,2021-08-29
467,حپارسا,توسعه حمل و نقل ريلي پارسيان,999,3089881,125806556498,39247,38625,40700,1453,3.7,40716,1469,3.74,38625,41209,1400-6-7,2021-08-29
468,خفنر,فنرسازي‌خاور,993,7503072,58892630330,8060,8190,7660,-400,-4.96,7850,-210,-2.61,7660,8190,1400-6-7,2021-08-29
469,كشرق,صنعتي و معدني شمال شرق شاهرود,990,821871,59876360600,70790,72130,70180,-610,-0.86,72854,2064,2.92,70000,74329,1400-6-7,2021-08-29
470,وساشرقي,شركت س استان آذربايجان شرقي,983,49837215,36370913283,740,735,733,-7,-0.95,734,-6,-0.81,712,746,1400-6-7,2021-08-29
471,پرديس,سرمايه گذاري پرديس,977,8069818,52078434330,6510,6560,6260,-250,-3.84,6450,-60,-0.92,6190,6790,1400-6-7,2021-08-29
472,سشمال,سيمان‌ شمال‌,959,3644622,40650100310,11150,11350,11120,-30,-0.27,11150,0,0,10930,11350,1400-6-7,2021-08-29
473,ضخود7076,اختيارخ خودرو-2500-1400/07/07,953,50392,7743407000,158,161,128,-30,-18.99,154,-4,-2.53,124,170,1400-6-7,2021-08-29
474,سكرد,سيمان كردستان,941,7205022,54746942560,7680,7910,7330,-350,-4.56,7600,-80,-1.04,7300,7910,1400-6-7,2021-08-29
475,دارو,كارخانجات‌داروپخش‌,941,4415945,144550463140,31340,32900,32170,830,2.65,32730,1390,4.44,31010,32900,1400-6-7,2021-08-29
476,غشصفا,شيرپاستوريزه‌پگاه‌اصفهان‌,940,3564845,118229985490,31610,33190,33180,1570,4.97,33170,1560,4.94,32500,33190,1400-6-7,2021-08-29
477,لوتوس,تامين سرمايه لوتوس پارسيان,937,5505808,53503041540,9430,9750,9620,190,2.01,9720,290,3.08,9250,9900,1400-6-7,2021-08-29
478,وپسا,س. پتروشيمي ساختمان  خليج فارس,936,21206886,44002632923,2092,2133,2051,-41,-1.96,2075,-17,-0.81,2051,2133,1400-6-7,2021-08-29
479,اوان,مبين وان كيش,933,1340531,48625994251,37645,37650,35763,-1882,-5,36274,-1371,-3.64,35763,37900,1400-6-7,2021-08-29
480,وجامي,سرمايه گذاري جامي,925,3215446,40961656236,12954,13200,12566,-388,-3,12739,-215,-1.66,12566,13200,1400-6-7,2021-08-29
481,مبين,مبين انرژي خليج فارس,920,6538681,145262301000,22540,22400,21450,-1090,-4.84,22220,-320,-1.42,21420,22800,1400-6-7,2021-08-29
482,كفرا,فراورده‌ هاي‌ نسوزايران‌,920,1793340,51808348810,28680,29540,27700,-980,-3.42,28890,210,0.73,27250,30000,1400-6-7,2021-08-29
483,شجم,صنايع پتروشيمي تخت جمشيد,915,6207091,89225569566,14598,14700,14161,-437,-2.99,14375,-223,-1.53,14161,14720,1400-6-7,2021-08-29
484,كاسپين,داروسازي كاسپين تامين,913,2082551,50007756741,23550,24700,22900,-650,-2.76,24013,463,1.97,22500,24727,1400-6-7,2021-08-29
485,معيار ,سرمايه گذاري معيار صنعت پارس,904,666666,32738289737,50082,48710,48580,-1502,-3,49107,-975,-1.95,48580,51000,1400-6-7,2021-08-29
486,وتوسم,سرمايه‌گذاري‌توسعه‌ملي‌,895,4955943,44956624520,9240,9300,8800,-440,-4.76,9070,-170,-1.84,8800,9440,1400-6-7,2021-08-29
487,دتماد,توليدمواداوليه‌داروپخش‌,894,1784521,94786074440,53740,54480,51600,-2140,-3.98,53120,-620,-1.15,51080,54500,1400-6-7,2021-08-29
488,وسصفا,شركت س استان اصفهان,892,30962847,25366388836,849,830,813,-36,-4.24,839,-10,-1.18,808,841,1400-6-7,2021-08-29
489,ولملت,واسپاري ملت,885,11334880,72523022080,6210,6470,6410,200,3.22,6400,190,3.06,6000,6520,1400-6-7,2021-08-29
490,ولبهمن,شركت بهمن ليزينگ,878,7297563,60402584237,8466,8559,8065,-401,-4.74,8277,-189,-2.23,8061,8739,1400-6-7,2021-08-29
491,لخانه,لوازم‌ خانگي‌ پارس‌,877,1104830,25310710744,23322,23990,22623,-699,-3,22909,-413,-1.77,22623,23990,1400-6-7,2021-08-29
492,بساما,بيمه سامان,876,1839332,45458415188,25345,25940,24690,-655,-2.58,24715,-630,-2.49,24078,25940,1400-6-7,2021-08-29
493,جوين,كشت و صنعت جوين,870,17322464,68713759639,3856,3870,3971,115,2.98,3967,111,2.88,3870,3971,1400-6-7,2021-08-29
494,سقاين,سيمان‌ قائن‌,864,867444,61332813980,73630,72000,69950,-3680,-5,70710,-2920,-3.97,69950,73620,1400-6-7,2021-08-29
495,ومشان,س. فني و مهندسي مشانير,863,461419,31444228062,69252,71000,67175,-2077,-3,68147,-1105,-1.6,67175,71000,1400-6-7,2021-08-29
496,وخاور,بانك خاورميانه,844,6261752,43913261560,7100,7380,6810,-290,-4.08,7050,-50,-0.7,6790,7400,1400-6-7,2021-08-29
497,وسگيلا,شركت س استان گيلان,843,39959745,27887662503,698,721,680,-18,-2.58,698,0,0,670,723,1400-6-7,2021-08-29
498,فردا,صندوق س آواي فرداي زاگرس-ثابت,829,39191493,443720495013,11315,11322,11322,7,0.06,11322,7,0.06,11321,11323,1400-6-7,2021-08-29
499,غبشهر,صنعتي‌ بهشهر,826,2617552,75593673550,29830,29850,28340,-1490,-4.99,28880,-950,-3.18,28340,29950,1400-6-7,2021-08-29
500,ركيشح,ح. كارت اعتباري ايران كيش,820,16001123,80834460480,4980,5170,4880,-100,-2.01,5050,70,1.41,4830,5300,1400-6-7,2021-08-29
501,حبندر,دريايي و کشتيراني خط دريابندر,811,1381436,45766137295,34073,34000,33051,-1022,-3,33129,-944,-2.77,33051,34236,1400-6-7,2021-08-29
502,وسين,بيمه سينا,807,15132702,56993929352,3799,3867,3730,-69,-1.82,3766,-33,-0.87,3691,3867,1400-6-7,2021-08-29
503,بفجر,فجر انرژي خليج فارس,807,5595102,168377953330,30650,29700,29200,-1450,-4.73,30090,-560,-1.83,29200,30650,1400-6-7,2021-08-29
504,دتوزيع,توزيع دارو پخش,806,5475230,197655803000,34381,36100,36100,1719,5,36100,1719,5,36100,36100,1400-6-7,2021-08-29
505,دسبحا,گروه دارويي سبحان,797,3047064,56575562290,18210,17920,17850,-360,-1.98,18570,360,1.98,17400,19120,1400-6-7,2021-08-29
506,سلار,شركت سيمان لارستان,794,1102578,42457963715,39252,38110,38075,-1177,-3,38508,-744,-1.9,38075,39469,1400-6-7,2021-08-29
507,كفرآور,فرآورده هاي سيمان شرق,786,3245278,70221830286,22107,22270,21444,-663,-3,21638,-469,-2.12,21444,22270,1400-6-7,2021-08-29
508,عيار,صندوق سكه طلاي مفيد,786,1121745,34370674203,31573,31570,30256,-1317,-4.17,30640,-933,-2.96,30100,31570,1400-6-7,2021-08-29
509,بميلا,توسعه بازرگاني آهن وفولادميلاد,786,4602522,64683250001,13825,14150,13870,45,0.33,14054,229,1.66,13700,14239,1400-6-7,2021-08-29
510,لبوتان,گروه‌صنعتي‌بوتان‌,784,667188,43456804530,64790,67000,62200,-2590,-4,65130,340,0.52,62000,67480,1400-6-7,2021-08-29
511,والبرح,ح . سرمايه گذاري‌البرز(هلدينگ‌,781,2315846,21123039264,9195,9190,8690,-505,-5.49,9121,-74,-0.8,8650,9390,1400-6-7,2021-08-29
512,سكرما,سيمان‌ كرمان‌,781,5145574,94277838180,18870,18870,18170,-700,-3.71,18320,-550,-2.91,17930,19140,1400-6-7,2021-08-29
513,وبشهر,توسعه‌ صنايع‌ بهشهر(هلدينگ,757,4809884,69887973920,14970,15000,14230,-740,-4.94,14530,-440,-2.94,14230,15000,1400-6-7,2021-08-29
514,تشتاد,صنايع توليدي اشتاد ايران‌,757,4619067,34010317568,7534,7567,7308,-226,-3,7363,-171,-2.27,7308,7609,1400-6-7,2021-08-29
515,قمرو,قند مرودشت‌,756,2960186,92087318790,30070,31570,29760,-310,-1.03,31110,1040,3.46,28770,31570,1400-6-7,2021-08-29
516,خراسان,پتروشيمي خراسان,755,877789,76379830440,87890,89050,84060,-3830,-4.36,87010,-880,-1,84000,89050,1400-6-7,2021-08-29
517,ضخود7077,اختيارخ خودرو-3000-1400/07/07,747,42285,1303602000,33,36,25,-8,-24.24,31,-2,-6.06,24,38,1400-6-7,2021-08-29
518,مداران,داده‌پردازي‌ايران‌,741,1903569,43271074270,22950,22610,22510,-440,-1.92,22730,-220,-0.96,21820,23500,1400-6-7,2021-08-29
519,وتوشه,سرمايه‌ گذاري‌ پارس‌ توشه‌,739,4112495,32127703620,8030,8360,7750,-280,-3.49,7810,-220,-2.74,7630,8360,1400-6-7,2021-08-29
520,سفانو,سيمان فارس نو,739,1005000,32400050120,32480,32290,30930,-1550,-4.77,32240,-240,-0.74,30860,33690,1400-6-7,2021-08-29
521,بخاور,بيمه زندگي خاورميانه,735,7660790,49147877140,6180,6487,6280,100,1.62,6416,236,3.82,6194,6489,1400-6-7,2021-08-29
522,شگل,گلتاش‌,733,2692988,25363788580,9610,9900,9130,-480,-4.99,9420,-190,-1.98,9130,9900,1400-6-7,2021-08-29
523,رتكو,كنترل‌خوردگي‌تكين‌كو,729,2511616,31053739830,12620,12650,11990,-630,-4.99,12360,-260,-2.06,11990,12890,1400-6-7,2021-08-29
524,فسا,پتروشيمي فسا,728,17667390,27188941431,1501,1546,1546,45,3,1539,38,2.53,1500,1546,1400-6-7,2021-08-29
525,فيروزه,صندوق شاخص30 شركت فيروزه- سهام,728,340486,63600150050,188120,190100,183000,-5120,-2.72,186790,-1330,-0.71,181060,190100,1400-6-7,2021-08-29
526,تكنو,تكنوتار,722,3151587,48277968240,15230,15480,15100,-130,-0.85,15320,90,0.59,15010,15800,1400-6-7,2021-08-29
527,دسينا,داروسازي‌ سينا,719,2124346,51549399420,24320,24330,23500,-820,-3.37,24270,-50,-0.21,23110,24980,1400-6-7,2021-08-29
528,قنقش,قند نقش جهان,717,740211,48162540915,64243,65527,65527,1284,2,65066,823,1.28,62959,65527,1400-6-7,2021-08-29
529,زگلدشت,كشت و دام گلدشت نمونه اصفهان,702,2311716,28696806380,12598,12900,11969,-629,-4.99,12414,-184,-1.46,11969,12900,1400-6-7,2021-08-29
530,قزوين,كارخانجات‌ قند قزوين‌,700,2329219,86701555230,36390,38200,36300,-90,-0.25,37220,830,2.28,35160,38200,1400-6-7,2021-08-29
531,دپارس,پارس‌ دارو,699,1023221,41302641750,40990,42050,39500,-1490,-3.64,40370,-620,-1.51,38950,42280,1400-6-7,2021-08-29
532,فافزا,فولاد افزا سپاهان,694,545372,25701854129,47192,47800,47300,108,0.23,47127,-65,-0.14,45780,48500,1400-6-7,2021-08-29
533,تسه0003,امتيازتسهيلات مسكن خرداد1400,692,11020,6581131744,600299,601100,590000,-10299,-1.72,597199,-3100,-0.52,571000,619207,1400-6-7,2021-08-29
534,حخزر,كشتيراني درياي خزر,687,2625196,66396838285,24339,25301,24360,21,0.09,25292,953,3.92,24001,25555,1400-6-7,2021-08-29
535,پسهند,صنايع‌ لاستيكي‌  سهند,678,761148,27089542450,35990,36830,34230,-1760,-4.89,35590,-400,-1.11,34200,37000,1400-6-7,2021-08-29
536,خديزل,بهمن  ديزل,675,1004915,53573624698,54225,55400,54000,-225,-0.41,53312,-913,-1.68,51514,55400,1400-6-7,2021-08-29
537,سپ,پرداخت الكترونيك سامان كيش,675,1186159,34884465800,29780,30270,29170,-610,-2.05,29560,-220,-0.74,28390,30270,1400-6-7,2021-08-29
538,وگردش,بانك گردشگري,673,1506019,20535937411,13681,13534,13412,-269,-1.97,13670,-11,-0.08,13410,13839,1400-6-7,2021-08-29
539,وسرمد,بيمه  سرمد,669,6133459,31462739421,5027,5177,4950,-77,-1.53,5130,103,2.05,4903,5177,1400-6-7,2021-08-29
540,زپارس,ملي كشت و صنعت و دامپروري پارس,665,933836,114771817000,127690,130000,121310,-6380,-5,122900,-4790,-3.75,121310,130000,1400-6-7,2021-08-29
541,كخاك,صنايع‌خاك‌چيني‌ايران‌,654,1247266,48651375910,39930,39810,38280,-1650,-4.13,39010,-920,-2.3,37940,40890,1400-6-7,2021-08-29
542,فاما,صنعتي‌ آما,652,1581661,30076269590,19390,20270,18450,-940,-4.85,19020,-370,-1.91,18430,20270,1400-6-7,2021-08-29
543,تكنار,مجتمع معادن مس تكنار,634,405481,38943274409,98545,98250,95589,-2956,-3,96042,-2503,-2.54,95589,98262,1400-6-7,2021-08-29
544,سرود,سيمان‌شاهرود,631,1522171,43150441810,28070,28610,27700,-370,-1.32,28350,280,1,27470,29340,1400-6-7,2021-08-29
545,دابور,داروسازي‌ ابوريحان‌,628,1036487,28522176190,27630,28280,26620,-1010,-3.66,27520,-110,-0.4,26500,28380,1400-6-7,2021-08-29
546,اتكام,بيمه اتكايي امين,616,5871385,32442135460,5730,5710,5450,-280,-4.89,5530,-200,-3.49,5450,5710,1400-6-7,2021-08-29
547,كپرور,فرآوري زغال سنگ پروده طبس,613,1257147,47456532484,38504,38450,36600,-1904,-4.94,37749,-755,-1.96,36579,39230,1400-6-7,2021-08-29
548,واحصا,احياء صنايع خراسان,613,596755,26891869277,44000,45320,45000,1000,2.27,45063,1063,2.42,44320,45320,1400-6-7,2021-08-29
549,آساس,صندوق س.آسمان آرماني سهام-س,612,294644,58372189253,200821,202399,195998,-4823,-2.4,198111,-2710,-1.35,194000,203900,1400-6-7,2021-08-29
550,آسام,صندوق س.آرمان سپهر آشنا-م,605,645410,83916643000,129929,130000,129952,23,0.02,130021,92,0.07,127000,130500,1400-6-7,2021-08-29
551,گوهران,سرمايه گذاري توسعه گوهران اميد,602,3564593,21357686500,5989,6200,5960,-29,-0.48,5992,3,0.05,5690,6270,1400-6-7,2021-08-29
552,شفارا,پتروشيمي فارابي,601,6784522,40148937771,6051,6150,5870,-181,-2.99,5918,-133,-2.2,5870,6150,1400-6-7,2021-08-29
553,دفرا,فرآورده‌هاي‌ تزريقي‌ ايران‌,601,1548726,51411128500,32150,32550,33680,1530,4.76,33200,1050,3.27,31500,33750,1400-6-7,2021-08-29
554,سبجنو,سيمان‌ بجنورد,595,1012166,50536467040,48510,49520,48660,150,0.31,49930,1420,2.93,46500,50930,1400-6-7,2021-08-29
555,سپاس,صندوق س. پاداش سهامداري-ثابت,594,24554522,248675915424,10120,10127,10126,6,0.06,10127,7,0.07,10126,10130,1400-6-7,2021-08-29
556,زر,صندوق س.پشتوانه سكه طلاي زر,582,1086185,57289475659,54752,53855,52500,-2252,-4.11,52744,-2008,-3.67,52391,54999,1400-6-7,2021-08-29
557,غشوكو,شوكو پارس,575,1841834,60900855231,32738,33599,31756,-982,-3,33065,327,1,31756,33720,1400-6-7,2021-08-29
558,وارس,سرمايه گذاري ارس صبا,561,2064000,28656255645,14084,14450,13663,-421,-2.99,13884,-200,-1.42,13662,14450,1400-6-7,2021-08-29
559,وبهمن,سرمايه‌گذاري‌بهمن‌,561,1859524,32036222070,17370,17800,17400,30,0.17,17230,-140,-0.81,16800,17800,1400-6-7,2021-08-29
560,وحكمت,بيمه حكمت صبا,561,6813591,28669422484,4242,4300,4115,-127,-2.99,4208,-34,-0.8,4115,4349,1400-6-7,2021-08-29
561,تسه0002,امتيازتسهيلاتمسكن ارديبهشت1400,559,8149,4875625180,602182,600000,585001,-17181,-2.85,598310,-3872,-0.64,580000,615000,1400-6-7,2021-08-29
562,غپونه,نوش پونه مشهد,554,1590480,26680185937,16420,16880,16599,179,1.09,16775,355,2.16,16420,16912,1400-6-7,2021-08-29
563,دالبر,البرزدارو,551,1721957,26294008500,15000,15740,15000,0,0,15270,270,1.8,14680,15740,1400-6-7,2021-08-29
564,فكمند,گسترش قطعه سازي كمند,551,1365439,43490069622,32454,31481,31481,-973,-3,31851,-603,-1.86,31481,33150,1400-6-7,2021-08-29
565,شكبير,پتروشيمي اميركبير,549,1225381,122636589867,103054,102010,99963,-3091,-3,100080,-2974,-2.89,99963,103489,1400-6-7,2021-08-29
566,ميدكوح,ح.توسعه م وص.معدني خاورميانه,546,1166388,45814805930,38140,38990,39000,860,2.25,39280,1140,2.99,38150,39890,1400-6-7,2021-08-29
567,وايرا,سرمايه گذاري صنايع ايران,542,2380459,18979725968,7919,8156,7682,-237,-2.99,7973,54,0.68,7682,8156,1400-6-7,2021-08-29
568,ولتجار,واسپاري تجارت وسرمايه ايرانيان,536,5400181,19544486390,3727,3616,3616,-111,-2.98,3619,-108,-2.9,3616,3724,1400-6-7,2021-08-29
569,ياقوت,صندوق س ياقوت آگاه-ثابت,531,6029896,78277242993,12977,12981,12982,5,0.04,12982,5,0.04,12977,12996,1400-6-7,2021-08-29
570,آساميد,صندوق س.مشترك آسمان اميد -د,518,23233001,297866017480,12720,12728,12857,137,1.08,12821,101,0.79,12723,12979,1400-6-7,2021-08-29
571,سنوين,سرمايه گذاري اقتصاد نوين,499,2988290,24982401465,8188,8433,8220,32,0.39,8360,172,2.1,8002,8433,1400-6-7,2021-08-29
572,زرين,صندوق س. سهام زرين كوروش-س,497,10125324,144823028525,14215,14215,13890,-325,-2.29,14303,88,0.62,13780,14500,1400-6-7,2021-08-29
573,پارتا,مجتمع‌صنعتي‌آرتاويل‌تاير,497,1015096,29402535503,29531,29000,28646,-885,-3,28965,-566,-1.92,28646,29998,1400-6-7,2021-08-29
574,دروز,داروسازي‌ روزدارو,496,809431,26519469480,33150,34000,31500,-1650,-4.98,32760,-390,-1.18,31500,34000,1400-6-7,2021-08-29
575,كقزوي,شيشه‌ قزوين‌,491,2401423,21288169225,8953,9040,8685,-268,-2.99,8865,-88,-0.98,8685,9200,1400-6-7,2021-08-29
576,ولتجارح,ح.واسپا تجارت وسرمايه ايرانيان,489,15642775,33445204601,2203,2193,2137,-66,-3,2138,-65,-2.95,2137,2193,1400-6-7,2021-08-29
577,سهگمت,سيمان‌هگمتان‌,488,1044562,30548833040,29220,29890,28220,-1000,-3.42,29250,30,0.1,28210,29990,1400-6-7,2021-08-29
578,تسه0001,امتيازتسهيلات مسكن فروردين1400,486,10690,6372018099,606019,585719,590000,-16019,-2.64,596073,-9946,-1.64,585000,614999,1400-6-7,2021-08-29
579,قپيرا,فرآورده‌هاي‌غدايي‌وقندپيرانشهر,483,2630029,21567568690,8510,8450,8110,-400,-4.7,8200,-310,-3.64,8090,8450,1400-6-7,2021-08-29
580,گوهر,صندوق سكه طلاي كيان,480,308595,18651645806,62261,62329,59700,-2561,-4.11,60441,-1820,-2.92,59505,62329,1400-6-7,2021-08-29
581,ضخود7078,اختيارخ خودرو-3500-1400/07/07,471,24955,219529000,8,6,7,-1,-12.5,9,1,12.5,6,10,1400-6-7,2021-08-29
582,دقاضي,داروسازي شهيد قاضي,467,686795,25611133522,36757,37859,35655,-1102,-3,37291,534,1.45,35655,37859,1400-6-7,2021-08-29
583,دكيمي,كيميدارو,466,5134767,128882651700,23910,25100,25100,1190,4.98,25100,1190,4.98,25100,25100,1400-6-7,2021-08-29
584,گكيش,توريستي ورفاهي آبادگران كيش,463,1054953,48410605478,44601,45939,45790,1189,2.67,45889,1288,2.89,44601,45939,1400-6-7,2021-08-29
585,مفاخر,توسعه فناوري اطلاعات خوارزمي,459,443429,22856743415,51050,52000,50990,-60,-0.12,51545,495,0.97,49026,53200,1400-6-7,2021-08-29
586,آساميد2,صندوق س.مشترك آسمان اميد -د,458,45800000,45800000,12720,1,1,-12719,-99.99,1,-12719,-99.99,1,1,1400-6-7,2021-08-29
587,كارين,صندوق س نگين سامان-ثابت,450,15716491,157744522840,10030,10036,10036,6,0.06,10037,7,0.07,10036,10041,1400-6-7,2021-08-29
588,خاتم,صندوق س خاتم ايساتيس پويا-ثابت,445,13224655,157527266668,11901,11911,11919,18,0.15,11912,11,0.09,11910,11920,1400-6-7,2021-08-29
589,چكارن,كارتن‌ ايران‌,442,16778667,57601163811,3270,3433,3433,163,4.98,3433,163,4.98,3433,3433,1400-6-7,2021-08-29
590,شاملا,معدني‌ املاح‌  ايران‌,441,408251,18334646440,44580,45210,42540,-2040,-4.58,44910,330,0.74,42500,46000,1400-6-7,2021-08-29
591,ساروج,بين المللي ساروج بوشهر,440,1521118,30645724856,20215,20820,19659,-556,-2.75,20147,-68,-0.34,19609,20820,1400-6-7,2021-08-29
592,آكورد,صندوق س. آرمان آتي كوثر-د,434,6287008,212667514909,33807,33827,33827,20,0.06,33827,20,0.06,33826,33836,1400-6-7,2021-08-29
593,سمتاز,سيمان ممتازان كرمان,432,704551,18865115427,27412,26590,26590,-822,-3,26776,-636,-2.32,26590,27540,1400-6-7,2021-08-29
594,تسه9912,امتياز تسهيلات مسكن اسفند99,429,7441,4447388747,605724,590001,590000,-15724,-2.6,597687,-8037,-1.33,575438,619600,1400-6-7,2021-08-29
595,وآفري,بيمه كارآفرين,427,17074028,53128685808,3028,3118,3118,90,2.97,3112,84,2.77,3028,3118,1400-6-7,2021-08-29
596,مارون,پتروشيمي مارون,421,164103,31562238250,193243,195264,192900,-343,-0.18,192956,-287,-0.15,190642,195990,1400-6-7,2021-08-29
597,وپخشح,ح . داروپخش‌ (هلدينگ‌,412,577035,19567539660,33840,35500,32000,-1840,-5.44,33910,70,0.21,30460,36800,1400-6-7,2021-08-29
598,فالوم,آلومتك‌,405,1505344,39921766603,25957,26735,26735,778,3,26520,563,2.17,25179,26735,1400-6-7,2021-08-29
599,وشهر,بانك شهر,404,11800832,76611001344,6243,6492,6492,249,3.99,6492,249,3.99,6492,6492,1400-6-7,2021-08-29
600,گنگين,اقتصادي نگين گردشگري ايرانيان,390,1771807,46104962005,26228,25500,25442,-786,-3,26021,-207,-0.79,25442,26300,1400-6-7,2021-08-29
601,ثجوان,تامين مسكن جوانان,381,2313193,21472487531,9098,9210,9113,15,0.16,9283,185,2.03,8930,9370,1400-6-7,2021-08-29
602,وفتخار,سرمايه گذاري افتخار سهام,381,671591,4781727920,6913,7120,7120,207,2.99,7120,207,2.99,7120,7120,1400-6-7,2021-08-29
603,دسانكو,داروسازي سبحان انكولوژي,380,3409176,45918191544,12828,13469,13469,641,5,13469,641,5,13469,13469,1400-6-7,2021-08-29
604,سجام,مجتمع سيمان غرب آسيا,376,6853573,34952908983,4921,5167,5000,79,1.61,5100,179,3.64,4800,5167,1400-6-7,2021-08-29
605,وآتوس,س.آرين توسكا قيمت اسمي 350ريال,375,972308,31474822808,33136,32450,32142,-994,-3,32371,-765,-2.31,32142,34000,1400-6-7,2021-08-29
606,تسه9908,امتياز تسهيلات مسكن آبان99,369,6780,4039538679,595097,620000,581000,-14097,-2.37,595802,705,0.12,578699,620000,1400-6-7,2021-08-29
607,دابورح,ح . داروسازي‌ ابوريحان‌,369,591090,14421701750,24500,24600,23600,-900,-3.67,24400,-100,-0.41,23500,25340,1400-6-7,2021-08-29
608,فراز,صندوق س.سهام فراز داريك-س,355,1715650,23883955754,13877,13960,13878,1,0.01,13921,44,0.32,13877,14030,1400-6-7,2021-08-29
609,وزمين,بانك ايران زمين,354,1968055,25352229050,13111,13169,12590,-521,-3.97,12882,-229,-1.75,12587,13200,1400-6-7,2021-08-29
610,زنجان,صنايع كشاورزي وكود زنجان,350,8416199,51338813900,8146,6100,6100,-2046,-25.12,6100,-2046,-25.12,6100,6100,1400-6-7,2021-08-29
611,كمرجان,بازرگاني و توليدي مرجان كار,348,163620,20331748440,130802,124262,124262,-6540,-5,124262,-6540,-5,124262,124262,1400-6-7,2021-08-29
612,تصميم,صندوق س با درآمد ثابت تصميم,324,1897616,32706067974,17230,17240,17234,4,0.02,17235,5,0.03,17230,17240,1400-6-7,2021-08-29
613,فن آوا,گروه فن آوا,324,3555900,79786283536,21804,22458,22458,654,3,22438,634,2.91,21600,22458,1400-6-7,2021-08-29
614,تسه9911,امتياز تسهيلات مسكن بهمن99,317,3805,2263762907,597389,585100,571000,-26389,-4.42,594944,-2445,-0.41,567520,609900,1400-6-7,2021-08-29
615,پلوله,گازلوله‌,306,437388,12396948184,27948,27456,28150,202,0.72,28343,395,1.41,27120,28710,1400-6-7,2021-08-29
616,گوهرانح,ح . س. توسعه گوهران اميد,305,1759487,7724660343,4408,4266,4310,-98,-2.22,4390,-18,-0.41,4222,4499,1400-6-7,2021-08-29
617,حرهشا,رهشاد سپاهان (سهامي عام,298,201619,16490993682,84136,82000,81612,-2524,-3,81793,-2343,-2.78,81612,85500,1400-6-7,2021-08-29
618,سدشت,صنايع سيمان دشتستان,294,156529,8634011920,55550,55100,54900,-650,-1.17,55420,-130,-0.23,52850,57490,1400-6-7,2021-08-29
619,دكپسول,توليد ژلاتين كپسول ايران,292,837967,32493846359,36931,38777,38777,1846,5,38777,1846,5,38777,38777,1400-6-7,2021-08-29
620,ضخود7074,اختيارخ خودرو-1800-1400/07/07,292,8422,5591402000,686,680,561,-125,-18.22,664,-22,-3.21,561,720,1400-6-7,2021-08-29
621,وبازار,صندوق س شاخصي بازارآشنا,291,1020134,14020092320,13800,13880,13410,-390,-2.83,13740,-60,-0.43,13400,13990,1400-6-7,2021-08-29
622,فردا2,صندوق س آواي فرداي زاگرس-ثابت,290,29000000,29000000,11315,1,1,-11314,-99.99,1,-11314,-99.99,1,1,1400-6-7,2021-08-29
623,افق ملت,صندوق س در سهام افق ملت,288,175271,29108632990,167110,169900,163200,-3910,-2.34,166080,-1030,-0.62,163000,170000,1400-6-7,2021-08-29
624,دشيري,شيرين دارو,288,146939,28490278165,188274,193922,193922,5648,3,193892,5618,2.98,189580,193922,1400-6-7,2021-08-29
625,آتيمس,صندوق س.آرمان آتيه درخشان مس-س,278,71968,16099040619,223267,225000,216116,-7151,-3.2,223697,430,0.19,215581,228000,1400-6-7,2021-08-29
626,وامين,س. امين توان آفرين ساز,274,1903583,24538491821,12774,12849,12904,130,1.02,12830,56,0.44,12849,12950,1400-6-7,2021-08-29
627,تسه9910,امتياز تسهيلات مسكن دي99,267,3628,2161311559,599333,583000,592000,-7333,-1.22,595731,-3602,-0.6,570000,620000,1400-6-7,2021-08-29
628,صنوين,صندوق سرمايه‌گذاري صنوين-مختلط,267,207586,23583342190,113010,113490,111010,-2000,-1.77,113610,600,0.53,110000,114750,1400-6-7,2021-08-29
629,تسه9909,امتياز تسهيلات مسكن آذر99,262,3416,2034788188,598548,582000,590000,-8548,-1.43,595664,-2884,-0.48,570009,615000,1400-6-7,2021-08-29
630,اخزا910,اسنادخزانه-م10بودجه99-020807,259,641459,413631865332,642468,642551,644550,2082,0.32,644830,2362,0.37,635000,647000,1400-6-7,2021-08-29
631,ضسپا8044,اختيارخ خساپا-2500-1400/08/26,255,11382,2478506000,207,220,199,-8,-3.86,218,11,5.31,190,249,1400-6-7,2021-08-29
632,كرازي,كارخانجات‌توليدي‌شيشه‌رازي‌,241,20689110,30164722380,1389,1458,1458,69,4.97,1458,69,4.97,1458,1458,1400-6-7,2021-08-29
633,سحرخيز,صندوق س. گروه زعفران سحرخيز,224,876249,9079720322,10505,10510,10300,-205,-1.95,10362,-143,-1.36,10023,10510,1400-6-7,2021-08-29
634,اخزا902,اسنادخزانه-م2بودجه99-011019,224,377801,289556119350,763728,769000,767000,3272,0.43,766425,2697,0.35,761241,769000,1400-6-7,2021-08-29
635,نهال,صندوق س. طلاي سرخ نوويرا,219,242267,2462317056,10363,10310,10028,-335,-3.23,10164,-199,-1.92,10000,10310,1400-6-7,2021-08-29
636,آرمان,بيمه آرمان,218,2066225,13891846131,6529,6670,6724,195,2.99,6723,194,2.97,6601,6724,1400-6-7,2021-08-29
637,شسپا,نفت سپاهان,218,10883478,31801522716,2783,2922,2922,139,4.99,2851,68,2.44,2922,2922,1400-6-7,2021-08-29
638,دسانكوح,ح . داروسازي سبحان انكولوژي,210,1421108,13919752860,9329,9795,9795,466,5,9795,466,5,9795,9795,1400-6-7,2021-08-29
639,خپويش,سازه‌ پويش‌,206,557904,32057163840,54730,57460,57460,2730,4.99,57460,2730,4.99,57460,57460,1400-6-7,2021-08-29
640,فيروزا,صندوق بادرآمد ثابت فيروزه آسيا,205,670606,16553119121,24699,24710,24700,1,0,24684,-15,-0.06,24610,24720,1400-6-7,2021-08-29
641,تسه9907,امتياز تسهيلات مسكن مهر99,204,3259,1924411742,597997,581001,579001,-18996,-3.18,590491,-7506,-1.26,579001,619990,1400-6-7,2021-08-29
642,تسه9810,امتياز تسهيلات مسكن دي98,203,3268,1939582784,593777,591100,599895,6118,1.03,593508,-269,-0.05,585006,615000,1400-6-7,2021-08-29
643,سكه0011پ02,تمام سكه طرح جديد0011ملت,202,46800,56188885200,1241721,1222000,1194000,-47721,-3.84,1200617,-41104,-3.31,1185557,1238999,1400-6-7,2021-08-29
644,سپر,صندوق س سپر سرمايه بيدار- ثابت,202,4850309,61248136117,12622,11450,12634,12,0.1,12628,6,0.05,11450,12640,1400-6-7,2021-08-29
645,اخزا901,اسنادخزانه-م1بودجه99-010621,192,304331,248281982648,813997,806002,817101,3104,0.38,815829,1832,0.23,806002,818500,1400-6-7,2021-08-29
646,شساخت,مهندسي و ساختمان صنايع نفت,191,928143,43168308004,45158,46512,46512,1354,3,46404,1246,2.76,45168,46512,1400-6-7,2021-08-29
647,وثنو,سرمايه گذاري ساختماني نوين,191,2827345,14305837345,4919,5066,5066,147,2.99,5060,141,2.87,5001,5066,1400-6-7,2021-08-29
648,ضسپا8043,اختيارخ خساپا-2000-1400/08/26,187,5802,2418518000,437,416,371,-66,-15.1,417,-20,-4.58,303,455,1400-6-7,2021-08-29
649,سكه0012پ04,تمام سكه طرح جديد0012صادرات,187,81200,97044641900,1240418,1227000,1190700,-49718,-4.01,1195131,-45287,-3.65,1185000,1227800,1400-6-7,2021-08-29
650,شستان,پتروشيمي گلستان,182,2194860,7222659989,3228,3292,3292,64,1.98,3291,63,1.95,3240,3292,1400-6-7,2021-08-29
651,ارمغان,ص سرمايه گذاري ارمغان ايرانيان,178,2881459,29157776506,10114,10133,10128,14,0.14,10119,5,0.05,10117,10133,1400-6-7,2021-08-29
652,بنيرو,نيروترانس‌,174,4324707,13475787012,2968,3116,3116,148,4.99,3089,121,4.08,3116,3116,1400-6-7,2021-08-29
653,ساينا,صنايع بهداشتي ساينا,174,96107,10119202137,100278,105291,105291,5013,5,103379,3101,3.09,105291,105291,1400-6-7,2021-08-29
654,كميناح,ح . شيشه سازي مينا,161,1755842,15579586066,8615,8873,8873,258,2.99,8873,258,2.99,8873,8873,1400-6-7,2021-08-29
655,ثنور,سرمايه گذاري كوه نور,160,1984388,15559586308,7613,7841,7841,228,2.99,7841,228,2.99,7841,7841,1400-6-7,2021-08-29
656,ثتوسا,س.توسعه و عمران استان اردبيل,160,526041,16833312000,37503,32000,32000,-5503,-14.67,32000,-5503,-14.67,32000,32000,1400-6-7,2021-08-29
657,اخزا903,اسنادخزانه-م3بودجه99-011110,156,283262,214827387587,755478,758000,756415,937,0.12,758405,2927,0.39,754001,760000,1400-6-7,2021-08-29
658,تسه9902,امتياز تسهيلات مسكن ارديبهشت99,154,2318,1377957419,594734,600000,586115,-8619,-1.45,594460,-274,-0.05,571000,600000,1400-6-7,2021-08-29
659,ثروتم,صندوق س. ثروت آفرين پارسيان-س,152,297250,28802157610,97588,98688,95001,-2587,-2.65,96895,-693,-0.71,95000,98688,1400-6-7,2021-08-29
660,كامياب,صندوق س. كامياب آشنا-د,150,819608,8457155624,10314,10320,10319,5,0.05,10319,5,0.05,10310,10350,1400-6-7,2021-08-29
661,اخزا914,اسنادخزانه-م14بودجه99-021025,150,443880,274002915967,618736,613000,617350,-1386,-0.22,617290,-1446,-0.23,612500,621000,1400-6-7,2021-08-29
662,ضسپا8041,اختيارخ خساپا-1600-1400/08/26,146,4770,3371909000,750,700,620,-130,-17.33,707,-43,-5.73,620,780,1400-6-7,2021-08-29
663,تسه9906,امتياز تسهيلات مسكن شهريور99,140,1223,722670162,596198,586050,570000,-26198,-4.39,590900,-5298,-0.89,570000,600000,1400-6-7,2021-08-29
664,تسه9904,امتياز تسهيلات مسكن تير99,139,1336,788107392,597847,581059,599300,1453,0.24,589901,-7946,-1.33,567955,607650,1400-6-7,2021-08-29
665,الماس,صندوق س.امين تدبيرگران فردا-س,138,42614,5813041079,136289,135520,133100,-3189,-2.34,136412,123,0.09,133000,138000,1400-6-7,2021-08-29
666,ضذوب905,اختيارخ ذوب-5000-14000917,131,6002,4151451000,680,790,634,-46,-6.76,692,12,1.76,630,790,1400-6-7,2021-08-29
667,دارا,صندوق س. دارا الگوريتم-د,129,1982858,19763261166,9975,9984,9960,-15,-0.15,9967,-8,-0.08,9956,9993,1400-6-7,2021-08-29
668,سكه0112پ03,تمام سكه طرح جديد0112سامان,128,23300,28036398000,1241018,1224000,1192001,-49017,-3.95,1203279,-37739,-3.04,1191269,1227899,1400-6-7,2021-08-29
669,ضصاد8033,اختيارخ وبصادر-2489-1400/08/12,126,3384,1452457000,458,425,392,-66,-14.41,429,-29,-6.33,350,485,1400-6-7,2021-08-29
670,ثعتما,س. ساختماني اعتماد گستر,125,613142,18681823598,29582,30469,30469,887,3,30469,887,3,30469,30469,1400-6-7,2021-08-29
671,ضملي7004,اختيارخ فملي-13720-1400/07/11,125,2337,3655530000,1608,1600,1381,-227,-14.12,1564,-44,-2.74,1300,2098,1400-6-7,2021-08-29
672,ضملي7003,اختيارخ فملي-11720-1400/07/11,125,1554,5034954000,3119,3200,3001,-118,-3.78,3240,121,3.88,2999,3500,1400-6-7,2021-08-29
673,ضپاس7029,اختيارخ وپارس-2500-1400/07/28,125,2784,2495128000,829,980,780,-49,-5.91,896,67,8.08,752,1200,1400-6-7,2021-08-29
674,اخزا908,اسنادخزانه-م8بودجه99-020606,122,447385,298949391668,666958,666011,668260,1302,0.2,668215,1257,0.19,664010,671000,1400-6-7,2021-08-29
675,ضملت8042,اختيارخ وبملت-3934-1400/08/19,117,2392,2057020000,921,881,749,-172,-18.68,860,-61,-6.62,722,970,1400-6-7,2021-08-29
676,ثفارس,عمران‌وتوسعه‌فارس‌,115,1363192,14908747730,10560,11000,10880,320,3.03,10910,350,3.31,10750,11000,1400-6-7,2021-08-29
677,كمينا,شيشه سازي مينا,115,1037466,11457774504,10723,11044,11044,321,2.99,11044,321,2.99,11044,11044,1400-6-7,2021-08-29
678,تپكو,توليدتجهيزات‌سنگين‌هپكو,115,527791,2704401084,5337,5124,5124,-213,-3.99,5324,-13,-0.24,5124,5124,1400-6-7,2021-08-29
679,صايند,صندوق س. گنجينه آينده روشن-د,114,571090,5790932890,10148,10169,10149,1,0.01,10140,-8,-0.08,10125,10169,1400-6-7,2021-08-29
680,ثنام,س ساختماني ب نام آوران مهندسي,113,388905,6102697260,16177,15692,15692,-485,-3,15868,-309,-1.91,15692,15692,1400-6-7,2021-08-29
681,اخزا006,اسنادخزانه-م6بودجه00-030723,112,95367,50106413675,528458,523520,528000,-458,-0.09,525406,-3052,-0.58,522500,529900,1400-6-7,2021-08-29
682,شصفها,پتروشيمي‌ اصفهان‌,110,810343,123745858844,149714,152708,152708,2994,2,152708,2994,2,152708,152708,1400-6-7,2021-08-29
683,تسه9905,امتياز تسهيلات مسكن مرداد99,107,1297,771148799,596582,590520,599000,2418,0.41,594563,-2019,-0.34,580002,626411,1400-6-7,2021-08-29
684,پلاست,كارخانجات توليدي پلاستيران,107,155224,7728292512,48338,49788,49788,1450,3,49414,1076,2.23,49788,49788,1400-6-7,2021-08-29
685,اخزا909,اسنادخزانه-م9بودجه99-020316,106,501183,350705497257,697311,697500,700007,2696,0.39,699755,2444,0.35,695419,702999,1400-6-7,2021-08-29
686,تسه9903,امتياز تسهيلات مسكن خرداد99,106,1140,681096257,599551,575100,572000,-27551,-4.6,597453,-2098,-0.35,570023,616000,1400-6-7,2021-08-29
687,ضملت8043,اختيارخ وبملت-4434-1400/08/19,105,4652,2735993000,610,680,500,-110,-18.03,588,-22,-3.61,500,699,1400-6-7,2021-08-29
688,تسه9811,امتياز تسهيلات مسكن بهمن98,100,888,523788107,592262,590000,580000,-12262,-2.07,589851,-2411,-0.41,580000,599970,1400-6-7,2021-08-29
689,سباقر,سيمان باقران,97,791908,14053991276,17231,17747,17747,516,2.99,17747,516,2.99,17747,17747,1400-6-7,2021-08-29
690,تسه9806,امتياز تسهيلات مسكن شهريور98,94,1731,1026831991,590766,590000,580001,-10765,-1.82,593202,2436,0.41,580001,599000,1400-6-7,2021-08-29
691,تسه9809,امتياز تسهيلات مسكن آذر98,94,901,539093007,599501,592300,596030,-3471,-0.58,598327,-1174,-0.2,592300,604000,1400-6-7,2021-08-29
692,تسه9812,امتياز تسهيلات مسكن اسفند98,92,765,454503295,589989,573339,596000,6011,1.02,594122,4133,0.7,573339,600000,1400-6-7,2021-08-29
693,ضشنا8004,اختيارخ شپنا-10800-1400/08/16,88,855,4255406000,5059,5190,4250,-809,-15.99,4977,-82,-1.62,4200,5250,1400-6-7,2021-08-29
694,سپيدما,صندوق س. سپيد دماوند-د,87,2644799,28975552930,10940,10946,10956,16,0.15,10956,16,0.15,10946,10961,1400-6-7,2021-08-29
695,تسه9807,امتياز تسهيلات مسكن مهر98,86,970,578461320,605854,596000,589500,-16354,-2.7,596352,-9502,-1.57,581188,614998,1400-6-7,2021-08-29
696,اوصتا,صندوق انديشه ورزان صباتامين -د,86,4257251,83788566393,19666,19680,19679,13,0.07,19681,15,0.08,19679,19686,1400-6-7,2021-08-29
697,ضپال2007,اختيارخ اپال-32000-1401/02/12,84,1657,2292945000,1339,1302,1261,-78,-5.83,1384,45,3.36,1251,1587,1400-6-7,2021-08-29
698,كهربا,صندوق س.پشتوانه سكه طلا كهربا,84,473278,4975497589,10570,10750,10543,-27,-0.26,10513,-57,-0.54,10457,10750,1400-6-7,2021-08-29
699,سكه0111پ05,تمام سكه طرح جديد0111آينده,83,29400,35262546300,1241458,1222600,1196000,-45458,-3.66,1199406,-42052,-3.39,1193000,1226700,1400-6-7,2021-08-29
700,اخزا911,اسنادخزانه-م11بودجه99-020906,83,481997,305639307299,634057,643900,636000,1943,0.31,634110,53,0.01,630579,643900,1400-6-7,2021-08-29
701,ضجار7040,اختيارخ وتجارت-2497-1400/07/21,80,1832,924449000,574,492,420,-154,-26.83,505,-69,-12.02,420,559,1400-6-7,2021-08-29
702,تسه9808,امتياز تسهيلات مسكن آبان98,80,904,545011101,601082,593520,596070,-5012,-0.83,602888,1806,0.3,593520,608488,1400-6-7,2021-08-29
703,تسه9901,امتياز تسهيلات مسكن فروردين99,79,642,375259500,597455,585000,570000,-27455,-4.6,584516,-12939,-2.17,567583,600000,1400-6-7,2021-08-29
704,پادا,صندوق س.پاداش سرمايه پارس-س,77,28080,3660372415,129690,131750,125060,-4630,-3.57,130355,665,0.51,125050,132300,1400-6-7,2021-08-29
705,وسقم,شركت س استان قم,75,1961050,2582702850,1386,1317,1317,-69,-4.98,1380,-6,-0.43,1317,1317,1400-6-7,2021-08-29
706,گپارس,امور رفاهي كارگزاران پارس,73,32706,4364255934,129553,133439,133439,3886,3,131214,1661,1.28,133439,133439,1400-6-7,2021-08-29
707,ضخود7072,اختيارخ خودرو-1400-1400/07/07,72,3437,3731589000,1077,820,1021,-56,-5.2,1086,9,0.84,1020,1110,1400-6-7,2021-08-29
708,بذر,صندوق س بذر اميد آفرين-سهام,69,26969,3183031020,119140,119100,114020,-5120,-4.3,118030,-1110,-0.93,113960,120990,1400-6-7,2021-08-29
709,خبازرس,بازرسي مهندسي و صنعتي ايران,66,218193,5736293970,25525,26290,26290,765,3,25951,426,1.67,26290,26290,1400-6-7,2021-08-29
710,داريك,صندوق س.اعتماد داريك-د,64,1308405,14867020767,11353,11363,11362,9,0.08,11363,10,0.09,11360,11363,1400-6-7,2021-08-29
711,ضسپا8042,اختيارخ خساپا-1800-1400/08/26,63,2525,1334809000,576,572,471,-105,-18.23,529,-47,-8.16,456,577,1400-6-7,2021-08-29
712,ضملت8044,اختيارخ وبملت-4934-1400/08/19,62,2059,689847000,335,335,281,-54,-16.12,335,0,0,281,363,1400-6-7,2021-08-29
713,تدبير04,اجاره اقتصادي تدبير14040606,59,4999905,4799908800000,960000,960000,960000,0,0,960000,0,0,960000,960000,1400-6-7,2021-08-29
714,ضشنا8005,اختيارخ شپنا-12800-1400/08/16,58,655,2092072000,3295,3300,2802,-493,-14.96,3194,-101,-3.07,2802,3400,1400-6-7,2021-08-29
715,ثهام,صندوق س ثروت هامرز-سهام,56,116770,1437472659,12286,12600,12200,-86,-0.7,12310,24,0.2,12200,12600,1400-6-7,2021-08-29
716,ضسپا8039,اختيارخ خساپا-1200-1400/08/26,56,1238,1333118000,1147,1087,930,-217,-18.92,1077,-70,-6.1,889,1200,1400-6-7,2021-08-29
717,اخزا004,اسنادخزانه-م4بودجه00-030522,53,67494,36914564274,551196,551196,550000,-1196,-0.22,546931,-4265,-0.77,540002,552000,1400-6-7,2021-08-29
718,ضپاس7030,اختيارخ وپارس-3000-1400/07/28,53,1620,832537000,507,550,430,-77,-15.19,514,7,1.38,400,590,1400-6-7,2021-08-29
719,اخزا907,اسنادخزانه-م7بودجه99-020704,48,222674,145901850492,652696,651000,657000,4304,0.66,655226,2530,0.39,648050,657000,1400-6-7,2021-08-29
720,نگين,ص.س. زمين و ساختمان نگين شهرري,47,2117068,110756493330,49860,51190,51150,1290,2.59,52320,2460,4.93,51140,52570,1400-6-7,2021-08-29
721,عيار2,صندوق سكه طلاي مفيد,46,460000,460000,31573,1,1,-31572,-100,1,-31572,-100,1,1,1400-6-7,2021-08-29
722,آكورد2,صندوق س. آرمان آتي كوثر-د,45,4500000,4500000,33807,1,1,-33806,-100,1,-33806,-100,1,1,1400-6-7,2021-08-29
723,داراب,پتروشيمي داراب,43,360525,825602250,2360,2290,2290,-70,-2.97,2354,-6,-0.25,2290,2290,1400-6-7,2021-08-29
724,ضفلا7004,اختيارخ فولاد-9586-1400/07/25,35,267,1264033386,3345,3000,3200,-145,-4.33,3377,32,0.96,3000,3700,1400-6-7,2021-08-29
725,ثنظام,س. ساختماني نظام مهندسي ايران,34,12555,564912225,46386,44995,44995,-1391,-3,46305,-81,-0.17,44995,44995,1400-6-7,2021-08-29
726,ضپال2006,اختيارخ اپال-28000-1401/02/12,33,179,456488000,3500,3001,2300,-1200,-34.29,2550,-950,-27.14,2004,3700,1400-6-7,2021-08-29
727,ضخود7073,اختيارخ خودرو-1600-1400/07/07,32,1085,962444000,883,900,700,-183,-20.72,887,4,0.45,700,910,1400-6-7,2021-08-29
728,وشمال,س. چشم انداز توسعه شمال,32,9009,744765021,85225,82669,82669,-2556,-3,85027,-198,-0.23,82669,82669,1400-6-7,2021-08-29
729,ضذوب904,اختيارخ ذوب-4500-14000917,31,899,948700000,996,1000,900,-96,-9.64,1055,59,5.92,900,1100,1400-6-7,2021-08-29
730,ضذوب906,اختيارخ ذوب-6000-14000917,30,1707,812025000,450,400,420,-30,-6.67,476,26,5.78,400,501,1400-6-7,2021-08-29
731,افاد4,منفعت دولتي4-شرايط خاص14010729,30,413300,399079723900,980000,967000,968000,-12000,-1.22,965593,-14407,-1.47,964033,1000000,1400-6-7,2021-08-29
732,ضمخا7076,اختيارخ اخابر-9700-1400/07/28,28,356,761559000,2127,2200,2089,-38,-1.79,2139,12,0.56,1530,2600,1400-6-7,2021-08-29
733,ضمخا7066,اختيارخ اخابر-11700-1400/07/28,28,420,479360000,995,900,1102,107,10.75,1141,146,14.67,900,1333,1400-6-7,2021-08-29
734,ضجار7041,اختيارخ وتجارت-2997-1400/07/21,27,929,217449000,261,241,204,-57,-21.84,234,-27,-10.34,200,258,1400-6-7,2021-08-29
735,وحافظ,بيمه حافظ,27,72808,855930848,11995,11756,11756,-239,-1.99,11953,-42,-0.35,11756,11756,1400-6-7,2021-08-29
736,ضملت8041,اختيارخ وبملت-3434-1400/08/19,25,410,472482000,1286,1111,1018,-268,-20.84,1152,-134,-10.42,1014,1280,1400-6-7,2021-08-29
737,گنجين,صندوق س. گنجينه يكم آويد-د,24,171108,2321296122,13561,13566,13568,7,0.05,13566,5,0.04,13564,13574,1400-6-7,2021-08-29
738,امين يكم2,صندوق درآمد ثابت امين يكم فردا,24,24000000,24000000,10014,1,1,-10013,-99.99,1,-10013,-99.99,1,1,1400-6-7,2021-08-29
739,اگ001254,گام بانك پارسيان0012,23,200006,178205382000,1000000,891000,897000,-103000,-10.3,891000,-109000,-10.9,891000,897000,1400-6-7,2021-08-29
740,هنوري102,اختيارف ت نوري59561-01/02/15,21,300000,300000,1,1,1,0,0,1,0,0,1,1,1400-6-7,2021-08-29
741,ضمخا7071,اختيارخ اخابر-23700-1400/07/28,21,636,34177000,43,47,50,7,16.28,54,11,25.58,30,67,1400-6-7,2021-08-29
742,اخزا812,اسنادخزانه-م12بودجه98-001111,20,112628,103817115606,919250,920502,923000,3750,0.41,921770,2520,0.27,920500,924000,1400-6-7,2021-08-29
743,صنفت0312,صكوك منفعت نفت0312-6ماهه 18/5%,20,200000,200000000000,1000000,1000000,1000000,0,0,1000000,0,0,1000000,1000000,1400-6-7,2021-08-29
744,دارا2,صندوق س. دارا الگوريتم-د,20,2000000,2000000,9975,1,1,-9974,-99.99,1,-9974,-99.99,1,1,1400-6-7,2021-08-29
745,ضملي7002,اختيارخ فملي-9720-1400/07/11,20,322,1643992000,4926,5000,4650,-276,-5.6,5106,180,3.65,4510,5300,1400-6-7,2021-08-29
746,ضشنا8006,اختيارخ شپنا-14800-1400/08/16,19,117,242416000,2051,2000,1900,-151,-7.36,2072,21,1.02,1900,2290,1400-6-7,2021-08-29
747,زعف0008پ12,زعفران0008پوشالمعمول سحرخيز(پ),19,4334,493099486,113361,116000,110007,-3354,-2.96,113775,414,0.37,110000,116000,1400-6-7,2021-08-29
748,ضسپا8040,اختيارخ خساپا-1400-1400/08/26,19,557,497169000,955,1077,800,-155,-16.23,893,-62,-6.49,800,1077,1400-6-7,2021-08-29
749,سخند,صندوق س.سپهرخبرگان نفت-د,18,31500,315799500,10025,10012,10037,12,0.12,10025,0,0,10012,10037,1400-6-7,2021-08-29
750,ضجار7038,اختيارخ وتجارت-1797-1400/07/21,18,362,394169000,1217,1151,1040,-177,-14.54,1089,-128,-10.52,970,1151,1400-6-7,2021-08-29
751,شتولي,تولي‌پرس‌,18,12129,321927918,27083,26542,26542,-541,-2,27047,-36,-0.13,26542,26542,1400-6-7,2021-08-29
752,ضفلا7005,اختيارخ فولاد-11013-1400/07/25,18,166,522294070,2315,2200,2110,-205,-8.86,2244,-71,-3.07,2110,2650,1400-6-7,2021-08-29
753,ضملي7005,اختيارخ فملي-15720-1400/07/11,18,173,159839000,819,900,700,-119,-14.53,924,105,12.82,700,1099,1400-6-7,2021-08-29
754,ضخود7080,اختيارخ خودرو-4500-1400/07/07,17,41,225000,8,7,5,-3,-37.5,5,-3,-37.5,4,9,1400-6-7,2021-08-29
755,اخزا821,اسنادخزانه-م21بودجه98-020906,17,30253,19203228300,635000,631520,635000,0,0,634754,-246,-0.04,631470,635000,1400-6-7,2021-08-29
756,اخزا815,اسنادخزانه-م15بودجه98-010406,16,26382,22438563264,851370,851200,850007,-1363,-0.16,850525,-845,-0.1,850000,851200,1400-6-7,2021-08-29
757,ضمخا7075,اختيارخ اخابر-8700-1400/07/28,16,197,619652000,2982,3000,2851,-131,-4.39,3145,163,5.47,2801,3550,1400-6-7,2021-08-29
758,اخزا811,اسنادخزانه-م11بودجه98-001013,16,110899,103454156701,929160,933150,931008,1848,0.2,932868,3708,0.4,931008,938000,1400-6-7,2021-08-29
759,زرين2,صندوق س. سهام زرين كوروش-س,15,10900000,10900000,14215,1,1,-14214,-99.99,1,-14214,-99.99,1,1,1400-6-7,2021-08-29
760,اخزا813,اسنادخزانه-م13بودجه98-010219,15,56683,49555955587,872669,874001,874002,1333,0.15,874265,1596,0.18,874001,874300,1400-6-7,2021-08-29
761,ضپاس7031,اختيارخ وپارس-3500-1400/07/28,15,463,127427000,300,250,250,-50,-16.67,275,-25,-8.33,245,330,1400-6-7,2021-08-29
762,اخزا904,اسنادخزانه-م4بودجه99-011215,15,17976,13399383483,745802,745504,746500,698,0.09,745404,-398,-0.05,742003,746500,1400-6-7,2021-08-29
763,ضصاد8036,اختيارخ وبصادر-3989-1400/08/12,14,1353,54550000,40,39,40,0,0,40,0,0,38,50,1400-6-7,2021-08-29
764,دمعيار,صندوق س. توازن معيار-د,14,266924,2678605950,10030,10035,10036,6,0.06,10035,5,0.05,10035,10036,1400-6-7,2021-08-29
765,ساذري,آذريت‌,14,554780,4124789300,7219,7435,7435,216,2.99,7324,105,1.45,7435,7435,1400-6-7,2021-08-29
766,اطلس2,صندوق س.توسعه اندوخته آينده-س,14,140000,140000,281401,1,1,-281400,-100,1,-281400,-100,1,1,1400-6-7,2021-08-29
767,اخزا721,اسنادخزانه-م21بودجه97-000728,13,2647,2573619666,971531,972000,972400,869,0.09,972278,747,0.08,972000,972500,1400-6-7,2021-08-29
768,ددامح,ح . داروسازي زاگرس فارمد پارس,13,9173,143098800,15600,15600,15600,0,0,15600,0,0,15600,15600,1400-6-7,2021-08-29
769,اراد50,مرابحه عام دولت5-ش.خ0302,13,243000,243000230000,1000000,1000000,1000001,1,0,1000001,1,0,1000000,1000001,1400-6-7,2021-08-29
770,ضصاد8031,اختيارخ وبصادر-1789-1400/08/12,13,163,148700000,934,934,930,-4,-0.43,912,-22,-2.36,809,950,1400-6-7,2021-08-29
771,ضمخا7077,اختيارخ اخابر-6700-1400/07/28,12,61,311499000,2509,4999,4500,1991,79.35,5107,2598,103.55,4500,5300,1400-6-7,2021-08-29
772,وحافظح,ح . بيمه حافظ,12,30465,204816195,6860,6723,6723,-137,-2,6723,-137,-2,6723,6723,1400-6-7,2021-08-29
773,اخزا808,اسنادخزانه-م8بودجه98-000817,12,3813,3667332928,960723,960300,962058,1335,0.14,961797,1074,0.11,960200,962999,1400-6-7,2021-08-29
774,زعف0008پ11,زعفران0008نگين سحرخيز(پ),11,1101,164295364,154728,148000,146100,-8628,-5.58,149224,-5504,-3.56,146100,152000,1400-6-7,2021-08-29
775,زعف0008پ09,زعفران0008نگين نوين(پ),11,6546,1030922000,154701,157800,157000,2299,1.49,157489,2788,1.8,157000,157800,1400-6-7,2021-08-29
776,اخزا809,اسنادخزانه-م9بودجه98-000923,11,3062,2892745031,942719,945000,945501,2782,0.3,944724,2005,0.21,943375,947000,1400-6-7,2021-08-29
777,ضجار7039,اختيارخ وتجارت-1997-1400/07/21,10,210,194719000,1173,1000,909,-264,-22.51,927,-246,-20.97,909,1000,1400-6-7,2021-08-29
778,كيان2,صندوق س. با درآمد ثابت كيان,10,1000000,1000000,30234,1,1,-30233,-100,1,-30233,-100,1,1,1400-6-7,2021-08-29
779,صعبيد312,صكوك اجاره دعبيد-3ماهه18%,10,100000,100100000000,996000,1001000,1001000,5000,0.5,1001000,5000,0.5,1001000,1001000,1400-6-7,2021-08-29
780,تملي705,تسهيلات مسكن ب. ملي-مرداد97,9,217,138821984,622218,640000,653328,31110,5,639733,17515,2.81,637000,653328,1400-6-7,2021-08-29
781,زير0103پ04,زيره سبز0103شركت مينوبذر(پ),9,69,56199426,784037,790000,790000,5963,0.76,814484,30447,3.88,790000,851571,1400-6-7,2021-08-29
782,ضپيك7042,اختيارخ تاپيكو-8070-00/07/18,9,71,477500000,7463,6600,6200,-1263,-16.92,6725,-738,-9.89,6200,7000,1400-6-7,2021-08-29
783,اخزا906,اسنادخزانه-م6بودجه99-020321,9,21955,15405066750,703796,702000,701610,-2186,-0.31,701666,-2130,-0.3,701310,702000,1400-6-7,2021-08-29
784,اخزا905,اسنادخزانه-م5بودجه99-020218,9,38164,27410730722,718375,716001,718000,-375,-0.05,718235,-140,-0.02,716001,719000,1400-6-7,2021-08-29
785,ضفلا7006,اختيارخ فولاد-12440-1400/07/25,9,112,268454960,1503,1700,1800,297,19.76,1710,207,13.77,1700,1800,1400-6-7,2021-08-29
786,اخزا723,اسنادخزانه-م23بودجه97-000824,9,50016,47929306862,957874,958397,958250,376,0.04,958279,405,0.04,958250,958999,1400-6-7,2021-08-29
787,زعف0008پ18,زعفران0008نگين بهرامن(پ),9,6280,948864000,150875,153000,150000,-875,-0.58,151093,218,0.14,150000,153000,1400-6-7,2021-08-29
788,زعف0008پ19,زعفران0008نگين تروند قاينات(پ),9,5883,892443500,151311,153500,150000,-1311,-0.87,151699,388,0.26,150000,153500,1400-6-7,2021-08-29
789,زير0103پ01,زيره سبز0103كيميابذر(پ),8,120,98233310,817606,820000,793333,-24273,-2.97,818611,1005,0.12,793333,829998,1400-6-7,2021-08-29
790,اخزا807,اسنادخزانه-م7بودجه98-000719,8,1885,1841379252,976473,977500,976846,373,0.04,976859,386,0.04,976846,977500,1400-6-7,2021-08-29
791,ضخود7079,اختيارخ خودرو-4000-1400/07/07,8,294,1914000,13,6,10,-3,-23.08,7,-6,-46.15,6,16,1400-6-7,2021-08-29
792,ضشنا8002,اختيارخ شپنا-7800-1400/08/16,8,75,570555000,7600,7600,7600,0,0,7607,7,0.09,7000,7700,1400-6-7,2021-08-29
793,افران2,صندوق س افرا نماد پايدار-ثابت,7,35200000,35200000,14119,1,1,-14118,-99.99,1,-14118,-99.99,1,1,1400-6-7,2021-08-29
794,تملي711,تسهيلات مسكن ب. ملي-بهمن97,7,88,55956897,606232,636543,636543,30311,5,635874,29642,4.89,630000,636543,1400-6-7,2021-08-29
795,ثقزوي,شركت عمران و سازندگي قزوين,7,5130,154643850,31077,30145,30145,-932,-3,31062,-15,-0.05,30145,30145,1400-6-7,2021-08-29
796,زعف0008پ15,زعفران0008پوشالمعمول طلاسرخ(پ),7,5789,683217350,114000,118000,117000,3000,2.63,118020,4020,3.53,117000,119029,1400-6-7,2021-08-29
797,ضخوز7039,اختيارخ فخوز-15200-1400/07/14,7,80,416900000,4392,5190,5200,808,18.4,5211,819,18.65,5190,5300,1400-6-7,2021-08-29
798,زعف0008پ10,زعفران0008نگين طلاي سرخ(پ),6,2600,394200000,151460,153500,150000,-1460,-0.96,151615,155,0.1,150000,153500,1400-6-7,2021-08-29
799,هفارس104,اختيارف ت فارس-11832-01/04/12,6,33539,33539,1,1,1,0,0,1,0,0,1,1,1400-6-7,2021-08-29
800,سرو2,صندوق س سروسودمند مدبران-سهام,6,600000,600000,89780,1,1,-89779,-100,1,-89779,-100,1,1,1400-6-7,2021-08-29
801,اشاد10,مشاركت دولتي10-شرايط خاص001226,6,73400,71451000000,974900,975000,972000,-2900,-0.3,973447,-1453,-0.15,972000,975500,1400-6-7,2021-08-29
802,ضفلا7003,اختيارخ فولاد-8160-1400/07/25,6,26,177116062,4461,4950,4555,94,2.11,4859,398,8.92,4555,4950,1400-6-7,2021-08-29
803,سفارود,كارخانه فارسيت درود,6,8860,147802520,17022,16682,16682,-340,-2,17012,-10,-0.06,16682,16682,1400-6-7,2021-08-29
804,اخزا814,اسنادخزانه-م14بودجه98-010318,6,684,589584024,860466,862000,861001,535,0.06,861965,1499,0.17,861001,862000,1400-6-7,2021-08-29
805,شسم,توليد سموم‌ علف‌ كش,6,2150,215664350,98343,100309,100309,1966,2,98428,85,0.09,100309,100309,1400-6-7,2021-08-29
806,ضسان7077,اختيارخ پارسان-16000-00/07/14,6,18,333000000,10117,18500,16000,5883,58.15,18500,8383,82.86,16000,19000,1400-6-7,2021-08-29
807,هماي2,صندوق س هماي آگاه-ثابت,6,24644000,24644000,10000,1,1,-9999,-99.99,1,-9999,-99.99,1,1,1400-6-7,2021-08-29
808,اخزا816,اسنادخزانه-م16بودجه98-010503,6,5227,4374751940,838794,836700,837012,-1782,-0.21,836953,-1841,-0.22,836502,837050,1400-6-7,2021-08-29
809,طلا2,صندوق س.پشتوانه طلاي لوتوس,6,600000,600000,88770,1,1,-88769,-100,1,-88769,-100,1,1,1400-6-7,2021-08-29
810,تملي702,تسهيلات مسكن ب. ملي-ارديبهشت97,5,190,102295960,520080,536959,546084,26004,5,538400,18320,3.52,536959,546084,1400-6-7,2021-08-29
811,خفناور,مهندسي صنعتي روان فن آور,5,2586,116080368,46276,44888,44888,-1388,-3,46259,-17,-0.04,44888,44888,1400-6-7,2021-08-29
812,ضصاد8030,اختيارخ وبصادر-1589-1400/08/12,5,36,38582000,1229,1150,932,-297,-24.17,1072,-157,-12.77,932,1150,1400-6-7,2021-08-29
813,صايپا112,صكوك مرابحه سايپا112-3ماهه 16%,5,50000,47595400000,951908,951908,951908,0,0,951908,0,0,951908,951908,1400-6-7,2021-08-29
814,اخزا820,اسنادخزانه-م20بودجه98-020806,5,523,336470770,649990,643250,643255,-6735,-1.04,643348,-6642,-1.02,643250,644001,1400-6-7,2021-08-29
815,ضملي7006,اختيارخ فملي-17720-1400/07/11,5,12,3000000,317,250,250,-67,-21.14,250,-67,-21.14,250,250,1400-6-7,2021-08-29
816,ضسان7081,اختيارخ پارسان-28000-00/07/14,5,37,250700000,5020,6500,6000,980,19.52,6776,1756,34.98,6000,7400,1400-6-7,2021-08-29
817,تملي802,تسهيلات مسكن ب. ملي-ارديبهشت98,5,46,40680404,898124,853218,920000,21876,2.44,884357,-13767,-1.53,853218,943030,1400-6-7,2021-08-29
818,تملي804,تسهيلات مسكن ب. ملي-تير98,5,46,42345438,969003,920553,920553,-48450,-5,920553,-48450,-5,920553,920553,1400-6-7,2021-08-29
819,ضپيك7040,اختيارخ تاپيكو-6070-00/07/18,4,132,1207800000,8350,8999,8801,451,5.4,9150,800,9.58,8801,9200,1400-6-7,2021-08-29
820,مشير112,مشاركت شهرداري شيراز-3ماهه18%,4,40000,40000000000,990000,1000000,1000000,10000,1.01,1000000,10000,1.01,1000000,1000000,1400-6-7,2021-08-29
821,تملي712,تسهيلات مسكن ب. ملي-اسفند97,4,32,26242065,797994,837800,758095,-39899,-5,820064,22070,2.77,758095,837800,1400-6-7,2021-08-29
822,ضشنا8003,اختيارخ شپنا-8800-1400/08/16,4,23,161181000,7101,7181,7000,-101,-1.42,7008,-93,-1.31,7000,7181,1400-6-7,2021-08-29
823,اخزا817,اسنادخزانه-م17بودجه98-010512,4,6586,5473552072,830962,830962,831601,639,0.08,831089,127,0.02,830962,831601,1400-6-7,2021-08-29
824,سايرا,ايرانيت‌,4,634,23675462,38105,37343,37343,-762,-2,38101,-4,-0.01,37343,37343,1400-6-7,2021-08-29
825,ضجار7042,اختيارخ وتجارت-3497-1400/07/21,4,70,6290000,125,129,83,-42,-33.6,90,-35,-28,83,129,1400-6-7,2021-08-29
826,اراد46,مرابحه عام دولت4-ش.خ 0302,4,100000,100000000000,1000000,1000000,1000000,0,0,1000000,0,0,1000000,1000000,1400-6-7,2021-08-29
827,اخزا818,اسنادخزانه-م18بودجه98-010614,4,10764,8837364000,821000,821000,821000,0,0,821011,11,0,821000,823000,1400-6-7,2021-08-29
828,سپيدما2,صندوق س. سپيد دماوند-د,4,40000000,40000000,10940,1,1,-10939,-99.99,1,-10939,-99.99,1,1,1400-6-7,2021-08-29
829,ضپيك7039,اختيارخ تاپيكو-5070-00/07/18,3,10,95005000,9300,9500,9501,201,2.16,9500,200,2.15,9500,9501,1400-6-7,2021-08-29
830,ضمخا7078,اختيارخ اخابر-7700-1400/07/28,3,10,42076000,2400,4222,4300,1900,79.17,4208,1808,75.33,4000,4300,1400-6-7,2021-08-29
831,اراد49,مرابحه عام دولت4-ش.خ 0206,3,50000,46835000000,929159,938000,936000,6841,0.74,936700,7541,0.81,936000,938000,1400-6-7,2021-08-29
832,اخزا810,اسنادخزانه-م10بودجه98-001006,3,5596,5260239000,935284,939999,940000,4716,0.5,940000,4716,0.5,939999,940000,1400-6-7,2021-08-29
833,ضپيك7041,اختيارخ تاپيكو-7070-00/07/18,3,56,447994000,7619,7999,8000,381,5,8000,381,5,7999,8000,1400-6-7,2021-08-29
834,تملي803,تسهيلات مسكن ب. ملي-خرداد98,3,23,15276482,665393,698662,632600,-32793,-4.93,664195,-1198,-0.18,632600,698662,1400-6-7,2021-08-29
835,تملي704,تسهيلات مسكن ب. ملي-تير97,3,235,189575205,849161,806703,806703,-42458,-5,806703,-42458,-5,806703,806703,1400-6-7,2021-08-29
836,ضترا8057,اختيارخ شتران-3000-1400/08/09,3,3,14400000,5134,5100,5100,-34,-0.66,4800,-334,-6.51,4200,5100,1400-6-7,2021-08-29
837,سپرمي,پرميت‌,3,7500,70200000,9177,9360,9360,183,1.99,9185,8,0.09,9360,9360,1400-6-7,2021-08-29
838,هفجر102,اختيارف ت بفجر8626-01/02/11,3,154918,154918,1,1,1,0,0,1,0,0,1,1,1400-6-7,2021-08-29
839,زير0103پ02,زيره سبز0103 دانش(پ),3,63,51840000,786019,820000,850000,63981,8.14,822857,36838,4.69,820000,850000,1400-6-7,2021-08-29
840,ثاژن,سخت آژند,3,2750,25069000,9302,9116,9116,-186,-2,9301,-1,-0.01,9116,9116,1400-6-7,2021-08-29
841,ضپيك7043,اختيارخ تاپيكو-10070-00/07/18,3,11,57280000,4500,5100,5690,1190,26.44,5207,707,15.71,5100,5690,1400-6-7,2021-08-29
842,زعف0008پ05,زعفران0008نگين زرين(پ),3,200,29140400,144045,145702,145702,1657,1.15,145702,1657,1.15,145702,145702,1400-6-7,2021-08-29
843,اراد76,مرابحه عام دولت76-ش.خ030406,2,2500,2290000000,912000,900000,920000,8000,0.88,916000,4000,0.44,900000,920000,1400-6-7,2021-08-29
844,سپيدما4,صندوق س. سپيد دماوند-د,2,155000000,1698180000000,10940,10956,10956,16,0.15,10956,16,0.15,10956,10956,1400-6-7,2021-08-29
845,صپا ه 24,بار پايه هفته 24صنعتي,2,3500,2625000,750,750,750,0,0,750,0,0,750,750,1400-6-7,2021-08-29
846,ضچاد7031,اختيارخ كچاد-13870-1400/07/04,2,2,32000000,15000,16000,16000,1000,6.67,16000,1000,6.67,16000,16000,1400-6-7,2021-08-29
847,ضشنا8001,اختيارخ شپنا-6800-1400/08/16,2,6,51965000,8977,8910,8611,-366,-4.08,8661,-316,-3.52,8611,8910,1400-6-7,2021-08-29
848,پست0008پ08,پسته فندقي32-30مه ولات0008(پ),2,13,24169991,1860134,1889997,1850000,-10134,-0.54,1859230,-904,-0.05,1850000,1889997,1400-6-7,2021-08-29
849,ضپاس7028,اختيارخ وپارس-2000-1400/07/28,2,20,28000000,1246,1400,1400,154,12.36,1400,154,12.36,1400,1400,1400-6-7,2021-08-29
850,ضچاد7033,اختيارخ كچاد-17870-1400/07/04,2,18,232400000,12000,12800,13000,1000,8.33,12911,911,7.59,12800,13000,1400-6-7,2021-08-29
851,فبستم,صنايع ‌بسته‌بندي‌ مشهد,2,4597,3755749,794,817,817,23,2.9,794,0,0,817,817,1400-6-7,2021-08-29
852,تملي706,تسهيلات مسكن ب. ملي-شهريور97,2,23,20359798,893101,933000,848446,-44655,-5,885209,-7892,-0.88,848446,933000,1400-6-7,2021-08-29
853,طخود7076,اختيارف خودرو-2500-1400/07/07,2,55,10765000,250,200,153,-97,-38.8,196,-54,-21.6,153,200,1400-6-7,2021-08-29
854,آسام2,صندوق س.آرمان سپهر آشنا-م,2,200000,200000,129929,1,1,-129928,-100,1,-129928,-100,1,1,1400-6-7,2021-08-29
855,ضترا8060,اختيارخ شتران-4323-1400/08/09,2,2,5380000,2816,2500,2880,64,2.27,2690,-126,-4.47,2500,2880,1400-6-7,2021-08-29
856,اراد704,مرابحه عام دولت70-ش.خ0112,2,34228000,32373081996000,943750,945864,945750,2000,0.21,945807,2057,0.22,945750,945864,1400-6-7,2021-08-29
857,ضملت8040,اختيارخ وبملت-2934-1400/08/19,2,3,4850000,1730,1600,1650,-80,-4.62,1617,-113,-6.53,1600,1650,1400-6-7,2021-08-29
858,اراد494,مرابحه عام دولت4-ش.خ 0206,2,5715000,5388595000000,929159,943000,940500,11341,1.22,942886,13727,1.48,940500,943000,1400-6-7,2021-08-29
859,ضملت8039,اختيارخ وبملت-2434-1400/08/19,2,2,4300000,2100,2200,2100,0,0,2150,50,2.38,2100,2200,1400-6-7,2021-08-29
860,ضغدر8057,اختيارخ وغدير-9000-1400/08/26,2,13,104000000,7400,8000,8000,600,8.11,8000,600,8.11,8000,8000,1400-6-7,2021-08-29
861,هپارس102,اختيارف ت پارس-157010-01/02/05,2,16400,16400,1,1,1,0,0,1,0,0,1,1,1400-6-7,2021-08-29
862,شكف,كف,2,200,19424600,99105,97123,97123,-1982,-2,99101,-4,0,97123,97123,1400-6-7,2021-08-29
863,ضغدر8058,اختيارخ وغدير-10000-1400/08/26,2,2,15050000,7418,7550,7500,82,1.11,7525,107,1.44,7500,7550,1400-6-7,2021-08-29
864,هاميد104,اختيارف ت ثاميد-2050-01/04/20,2,100000,100000,1,1,1,0,0,1,0,0,1,1,1400-6-7,2021-08-29
865,اراد834,مرابحه عام دولت83-ش.خ041220,2,20000000,18344480000000,1000000,917253,917195,-82805,-8.28,917224,-82776,-8.28,917195,917253,1400-6-7,2021-08-29
866,تفيرو,مهندسي فيروزا,2,488,9530152,19147,19529,19529,382,2,19150,3,0.02,19529,19529,1400-6-7,2021-08-29
867,كايتا,ايتالران‌,2,9113,87667060,9340,9620,9620,280,3,9343,3,0.03,9620,9620,1400-6-7,2021-08-29
868,شگويات.ف0104,اختيارف.تبعي شگويا010408,2,10750,10750,1,1,1,0,0,1,0,0,1,1,1400-6-7,2021-08-29
869,كمند2,صندوق س. با درآمد ثابت كمند,2,150000000,150000000,10122,1,1,-10121,-99.99,1,-10121,-99.99,1,1,1400-6-7,2021-08-29
870,ضذوب903,اختيارخ ذوب-4000-14000917,2,11,14400000,1300,1400,1300,0,0,1309,9,0.69,1300,1400,1400-6-7,2021-08-29
871,ضترا8059,اختيارخ شتران-3882-1400/08/09,1,1,3500000,3383,3500,3500,117,3.46,3500,117,3.46,3500,3500,1400-6-7,2021-08-29
872,ضترا8061,اختيارخ شتران-5205-1400/08/09,1,20,44000000,1889,2200,2200,311,16.46,2200,311,16.46,2200,2200,1400-6-7,2021-08-29
873,طخود7075,اختيارف خودرو-2000-1400/07/07,1,26,676000,7,26,26,19,271.43,26,19,271.43,26,26,1400-6-7,2021-08-29
874,طمخا7071,اختيارف اخابر-23700-1400/07/28,1,3,37050000,15587,12350,12350,-3237,-20.77,12350,-3237,-20.77,12350,12350,1400-6-7,2021-08-29
875,ميدكوح2,ح.توسعه م وص.معدني خاورميانه,1,21000000,798000000000,38140,38000,38000,-140,-0.37,38000,-140,-0.37,38000,38000,1400-6-7,2021-08-29
876,وغدير2,سرمايه‌گذاري‌غدير(هلدينگ‌,1,29500000,501500000000,16790,17000,17000,210,1.25,17000,210,1.25,17000,17000,1400-6-7,2021-08-29
877,دارا4,صندوق س. دارا الگوريتم-د,1,2000000,20066000000,9975,10033,10033,58,0.58,10033,58,0.58,10033,10033,1400-6-7,2021-08-29
878,اراد82,مرابحه عام دولت82-ش.خ010912,1,1000,880000000,888000,880000,880000,-8000,-0.9,880000,-8000,-0.9,880000,880000,1400-6-7,2021-08-29
879,عكاوه2,اوراق سلف شمش فولاد كاوه كيش,1,2,9092366,4329000,4546183,4546183,217183,5.02,4546183,217183,5.02,4546183,4546183,1400-6-7,2021-08-29
880,ضترا8055,اختيارخ شتران-2118-1400/08/09,1,10,72000000,7100,7200,7200,100,1.41,7200,100,1.41,7200,7200,1400-6-7,2021-08-29
881,ضغدر8059,اختيارخ وغدير-12000-1400/08/26,1,1,5800000,5700,5800,5800,100,1.75,5800,100,1.75,5800,5800,1400-6-7,2021-08-29
882,ضمخا7067,اختيارخ اخابر-13700-1400/07/28,1,1,601000,665,601,601,-64,-9.62,601,-64,-9.62,601,601,1400-6-7,2021-08-29
883,ضپنا8004,اختيارخ رمپنا-17850-1400/08/05,1,20,50000000,3800,2500,2500,-1300,-34.21,2500,-1300,-34.21,2500,2500,1400-6-7,2021-08-29
884,تملي708,تسهيلات مسكن ب. ملي-آبان97,1,6,4916280,862505,819380,819380,-43125,-5,819380,-43125,-5,819380,819380,1400-6-7,2021-08-29
885,كگل2,معدني و صنعتي گل گهر,1,3500000,84595000000,25230,24170,24170,-1060,-4.2,24170,-1060,-4.2,24170,24170,1400-6-7,2021-08-29
886,تملي703,تسهيلات مسكن ب. ملي-خرداد97,1,14,11886000,877713,849000,849000,-28713,-3.27,849000,-28713,-3.27,849000,849000,1400-6-7,2021-08-29
887,تملي707,تسهيلات مسكن ب. ملي-مهر97,1,10,6640100,698886,664010,664010,-34876,-4.99,664010,-34876,-4.99,664010,664010,1400-6-7,2021-08-29
888,ثعمرا2,عمران و توسعه شاهد,1,12900000,162540000000,12241,12600,12600,359,2.93,12600,359,2.93,12600,12600,1400-6-7,2021-08-29
889,صيدك404,صكوك مرابحه صيدك404-3ماهه18%,1,10000,9350000000,935000,935000,935000,0,0,935000,0,0,935000,935000,1400-6-7,2021-08-29
890,اراد51,مرابحه عام دولت5-ش.خ 0010,1,3000,2999997000,1000000,999999,999999,-1,0,999999,-1,0,999999,999999,1400-6-7,2021-08-29
891,اراد214,مرابحه عام دولت2ش.خ صادرات0212,1,5000000,4757660000000,1000000,951532,951532,-48468,-4.85,951532,-48468,-4.85,951532,951532,1400-6-7,2021-08-29
892,اراد73,مرابحه عام دولت73-ش.خ0402,1,1000,920000000,960000,920000,920000,-40000,-4.17,920000,-40000,-4.17,920000,920000,1400-6-7,2021-08-29
893,ضجار7037,اختيارخ وتجارت-1597-1400/07/21,1,1,1370000,1370,1370,1370,0,0,1370,0,0,1370,1370,1400-6-7,2021-08-29
894,ضمخا7069,اختيارخ اخابر-17700-1400/07/28,1,1,400000,200,400,400,200,100,400,200,100,400,400,1400-6-7,2021-08-29
895,آتيمس2,صندوق س.آرمان آتيه درخشان مس-س,1,400000,400000,223267,1,1,-223266,-100,1,-223266,-100,1,1,1400-6-7,2021-08-29
896,زعف0008پ16,زعفران0008نگين بيرجند(پ),1,68,9907736,143914,145702,145702,1788,1.24,145702,1788,1.24,145702,145702,1400-6-7,2021-08-29
897,افاد53,منفعت دولت5-ش.خاص كاريزما0108,1,1000,963000000,972000,963000,963000,-9000,-0.93,963000,-9000,-0.93,963000,963000,1400-6-7,2021-08-29
898,ضصاد8032,اختيارخ وبصادر-1989-1400/08/12,1,1,910000,826,910,910,84,10.17,910,84,10.17,910,910,1400-6-7,2021-08-29
899,ضغدر8060,اختيارخ وغدير-14000-1400/08/26,1,11,60500000,3800,5500,5500,1700,44.74,5500,1700,44.74,5500,5500,1400-6-7,2021-08-29
900,همبين102,اختيارف ت مبين17952-01/02/10,1,100000,100000,1,1,1,0,0,1,0,0,1,1,1400-6-7,2021-08-29
901,ضترا8058,اختيارخ شتران-3442-1400/08/09,1,1,4401000,4401,4401,4401,0,0,4401,0,0,4401,4401,1400-6-7,2021-08-29
902,ارمغان2,ص سرمايه گذاري ارمغان ايرانيان,1,69067588,69067588,10114,1,1,-10113,-99.99,1,-10113,-99.99,1,1,1400-6-7,2021-08-29
903,شرق1400,مشاركت ليزينگ ايران وشرق140010,1,10,10070000,999771,1007000,1007000,7229,0.72,1007000,7229,0.72,1007000,1007000,1400-6-7,2021-08-29
904,صخود0412,ص مرابحه خودرو041- 3ماهه 18%,1,800000,784000000000,1010000,980000,980000,-30000,-2.97,980000,-30000,-2.97,980000,980000,1400-6-7,2021-08-29
905,ضجار7043,اختيارخ وتجارت-3997-1400/07/21,1,20,400000,15,20,20,5,33.33,20,5,33.33,20,20,1400-6-7,2021-08-29
906,پادا2,صندوق س.پاداش سرمايه پارس-س,1,10000,10000,129690,1,1,-129689,-100,1,-129689,-100,1,1,1400-6-7,2021-08-29
907,ضملي7000,اختيارخ فملي-7720-1400/07/11,1,4,28000000,6600,7000,7000,400,6.06,7000,400,6.06,7000,7000,1400-6-7,2021-08-29
908,ضچاد7035,اختيارخ كچاد-25870-1400/07/04,1,2,10000000,5000,5000,5000,0,0,5000,0,0,5000,5000,1400-6-7,2021-08-29
909,دمعيار2,صندوق س. توازن معيار-د,1,500000,500000,10030,1,1,-10029,-99.99,1,-10029,-99.99,1,1,1400-6-7,2021-08-29
910,صنفت312,صكوك منفعت نفت312-6ماهه 18/5%,1,1000,990000000,999900,990000,990000,-9900,-0.99,990000,-9900,-0.99,990000,990000,1400-6-7,2021-08-29
911,ومعادن2,توسعه‌معادن‌وفلزات‌,1,40000000,530000000000,12720,13250,13250,530,4.17,13250,530,4.17,13250,13250,1400-6-7,2021-08-29
912,سنفت009,سلف موازي استاندارد سنفت009,1,23600,37865964000,1597000,1604490,1604490,7490,0.47,1604490,7490,0.47,1604490,1604490,1400-6-7,2021-08-29
913,ضسان7078,اختيارخ پارسان-18000-00/07/14,1,3,45000000,10216,15000,15000,4784,46.83,15000,4784,46.83,15000,15000,1400-6-7,2021-08-29
914,اعتماد2,صندوق س.اعتماد آفرين پارسيان-د,1,4200000,4200000,38375,1,1,-38374,-100,1,-38374,-100,1,1,1400-6-7,2021-08-29
915,ياقوت2,صندوق س ياقوت آگاه-ثابت,1,4848000,4848000,12977,1,1,-12976,-99.99,1,-12976,-99.99,1,1,1400-6-7,2021-08-29
916,ضسان7080,اختيارخ پارسان-24000-00/07/14,1,1,9000000,4755,9000,9000,4245,89.27,9000,4245,89.27,9000,9000,1400-6-7,2021-08-29
917,وسالت,بانك قرض الحسنه رسالت,1,62106,72477702,1112,1167,1167,55,4.95,1112,0,0,1167,1167,1400-6-7,2021-08-29
918,فراز2,صندوق س.سهام فراز داريك-س,1,500000,500000,13877,1,1,-13876,-99.99,1,-13876,-99.99,1,1,1400-6-7,2021-08-29
919,افاد54,منفعت دولت5-ش.خاص لوتوس0108,1,1000,840000000,835000,840000,840000,5000,0.6,840000,5000,0.6,840000,840000,1400-6-7,2021-08-29
920,صنفت3122,صكوك منفعت نفت312-6ماهه 18/5%,1,1000000,984736000000,999900,984736,984736,-15164,-1.52,984736,-15164,-1.52,984736,984736,1400-6-7,2021-08-29
921,كقزوي4,شيشه‌ قزوين‌,1,6283528,55703475720,8953,8865,8865,-88,-0.98,8865,-88,-0.98,8865,8865,1400-6-7,2021-08-29
