,نماد,نام,تعداد,حجم,ارزش,دیروز,اولین,آخرین معامله - مقدار,آخرین معامله - تغییر,آخرین معامله - درصد,قیمت پایانی - مقدار,قیمت پایانی - تغییر,قیمت پایانی - درصد,کمترین,بیشترین,تاریخ,gregorian_date
0,پالايش,صندوق پالايشي يكم-سهام,36256,46776347,3232047753050,67220,66800,71000,3780,5.62,69100,1880,2.8,66200,71000,1400-2-20,2021-05-10
1,دارا يكم,صندوق واسطه گري مالي يكم-سهام,24850,22748682,3017083385030,131790,129000,134830,3040,2.31,132630,840,0.64,128700,135400,1400-2-20,2021-05-10
2,خودرو,ايران‌ خودرو,20074,784428921,1457236504544,1894,1838,1898,4,0.21,1858,-36,-1.9,1838,1924,1400-2-20,2021-05-10
3,شپنا,پالايش نفت اصفهان,19858,167829919,1617709057840,9700,9410,9970,270,2.78,9640,-60,-0.62,9410,10080,1400-2-20,2021-05-10
4,فملي,ملي‌ صنايع‌ مس‌ ايران‌,17164,143950159,1777142839040,11850,11790,12560,710,5.99,12350,500,4.22,11670,12560,1400-2-20,2021-05-10
5,خساپا,سايپا,17061,772516419,1402537390322,1859,1804,1836,-23,-1.24,1816,-43,-2.31,1804,1877,1400-2-20,2021-05-10
6,شستا,سرمايه گذاري تامين اجتماعي,15059,77986157,832199862030,10270,10110,10880,610,5.94,10670,400,3.89,10110,10880,1400-2-20,2021-05-10
7,فولاد,فولاد مباركه اصفهان,12821,106481412,1279381849560,11580,11410,12270,690,5.96,12020,440,3.8,11400,12270,1400-2-20,2021-05-10
8,اپال,فرآوري معدني اپال كاني پارس,12815,9887790,171972986260,17220,17220,17540,320,1.86,17390,170,0.99,17210,17680,1400-2-20,2021-05-10
9,بركت,گروه دارويي بركت,12226,50645615,1371777909620,27850,27020,27050,-800,-2.87,27090,-760,-2.73,27020,27670,1400-2-20,2021-05-10
10,وكارح,ح . بانك‌ كارآفرين‌,12057,2755771057,3698573776431,1427,1342,1342,-85,-5.96,1342,-85,-5.96,1342,1598,1400-2-20,2021-05-10
11,شتران,پالايش نفت تهران,11030,93952787,713492492990,7670,7440,7820,150,1.96,7590,-80,-1.04,7440,8000,1400-2-20,2021-05-10
12,خگستر,گسترش‌سرمايه‌گذاري‌ايران‌خودرو,9447,298129559,671086464067,2316,2247,2265,-51,-2.2,2251,-65,-2.81,2247,2278,1400-2-20,2021-05-10
13,شبندر,پالايش نفت بندرعباس,8062,33529450,641888241920,19180,18610,19740,560,2.92,19140,-40,-0.21,18610,20220,1400-2-20,2021-05-10
14,ذوب,سهامي ذوب آهن  اصفهان,7716,154168653,481737173030,2996,2970,3175,179,5.97,3125,129,4.31,2934,3175,1400-2-20,2021-05-10
15,وتجارت,بانك تجارت,7544,202415077,496532763497,2435,2435,2468,33,1.36,2453,18,0.74,2435,2516,1400-2-20,2021-05-10
16,كمند,صندوق س. با درآمد ثابت كمند,7133,353752401,3547148866733,10023,10029,10027,4,0.04,10027,4,0.04,10026,10029,1400-2-20,2021-05-10
17,امينح,ح . تامين سرمايه امين,6828,4195081,19912104427,4727,4600,4705,-22,-0.47,4747,20,0.42,4600,4847,1400-2-20,2021-05-10
18,خبهمن,گروه‌بهمن‌,6303,389576223,520995789337,1363,1323,1365,2,0.15,1337,-26,-1.91,1323,1380,1400-2-20,2021-05-10
19,وبصادر,بانك صادرات ايران,6031,196001379,437551805953,2215,2215,2231,16,0.72,2232,17,0.77,2215,2278,1400-2-20,2021-05-10
20,پترول,گ.س.وت.ص.پتروشيمي خليج فارس,5989,58451505,476306863210,7750,7660,8210,460,5.94,8150,400,5.16,7660,8210,1400-2-20,2021-05-10
21,بترانس,ايران‌ ترانسفو,5942,206109849,565489396460,2814,2730,2732,-82,-2.91,2744,-70,-2.49,2730,2880,1400-2-20,2021-05-10
22,وپاسار,بانك  پاسارگاد,5722,67556665,1118702532680,16390,16510,16700,310,1.89,16560,170,1.04,16470,16900,1400-2-20,2021-05-10
23,بوعلي,پتروشيمي بوعلي سينا,5686,4335246,183070574480,42410,42020,42050,-360,-0.85,42230,-180,-0.42,41570,42980,1400-2-20,2021-05-10
24,آريا,پليمر آريا ساسول,5612,2094484,183265118580,84704,84100,88970,4266,5.04,87499,2795,3.3,84100,89206,1400-2-20,2021-05-10
25,دماوند,توليد نيروي برق دماوند,5485,8205540,252273529896,29760,30000,31040,1280,4.3,30744,984,3.31,29800,31399,1400-2-20,2021-05-10
26,وكبهمن,مديريت سرمايه گذاري كوثربهمن,5476,1470838,14833278176,10055,9831,10130,75,0.75,10064,9,0.09,9831,10210,1400-2-20,2021-05-10
27,شگويا,پتروشيمي تندگويان,5206,28363973,238914674141,8143,7990,8631,488,5.99,8423,280,3.44,7990,8631,1400-2-20,2021-05-10
28,فارس,صنايع پتروشيمي خليج فارس,4239,50274556,416594067050,8180,7990,8490,310,3.79,8290,110,1.34,7950,8610,1400-2-20,2021-05-10
29,غگل,گلوكوزان‌,4199,47970319,131721400612,2705,2700,2850,145,5.36,2746,41,1.52,2632,2860,1400-2-20,2021-05-10
30,ثاميد,توسعه و عمران اميد,4116,42551397,56684627614,1373,1332,1336,-37,-2.69,1332,-41,-2.99,1332,1349,1400-2-20,2021-05-10
31,بپيوند,برق و انرژي پيوندگستر پارس,4114,2942480,31641655499,10970,10641,10803,-167,-1.52,10828,-142,-1.29,10641,10967,1400-2-20,2021-05-10
32,وغدير,سرمايه‌گذاري‌غدير(هلدينگ‌,4056,35502398,343665160500,9300,9110,9850,550,5.91,9680,380,4.09,9110,9850,1400-2-20,2021-05-10
33,سيتا,سرمايه گذاري سيمان تامين,3743,6255902,93846274310,15000,15000,15000,0,0,15000,0,0,15000,15010,1400-2-20,2021-05-10
34,امين,تامين سرمايه امين,3670,2933967,20513411950,6990,6990,6990,0,0,6990,0,0,6990,7010,1400-2-20,2021-05-10
35,هصادر108,اختيارف ت وبصادر-3189-01/08/10,3426,550000000,160600000000,1,292,292,291,29100,292,291,29100,292,292,1400-2-20,2021-05-10
36,بگيلان,توسعه مسير برق گيلان,3382,476668,9360119741,19981,19395,19710,-271,-1.36,19915,-66,-0.33,19391,20090,1400-2-20,2021-05-10
37,صبا,سرمايه گذاري صبا تامين,3000,16500364,122555668233,7323,7120,7540,217,2.96,7427,104,1.42,7110,7660,1400-2-20,2021-05-10
38,امين يكم,صندوق درآمد ثابت امين يكم فردا,2952,91076684,921283210136,10112,10115,10115,3,0.03,10115,3,0.03,10111,10120,1400-2-20,2021-05-10
39,وخارزمح,ح.سرمايه گذاري خوارزمي,2768,20777312,56306968465,2689,2570,2832,143,5.32,2710,21,0.78,2570,2859,1400-2-20,2021-05-10
40,بجهرم,توسعه مولد نيروگاهي جهرم,2491,34039366,73112246039,2128,2065,2219,91,4.28,2148,20,0.94,2065,2223,1400-2-20,2021-05-10
41,وپارس,بانك‌پارسيان‌,2432,66484995,160649933992,2388,2393,2410,22,0.92,2416,28,1.17,2393,2449,1400-2-20,2021-05-10
42,شپلي,پلي اكريل ايران,2413,35039463,282600377735,8073,8234,7912,-161,-1.99,8065,-8,-0.1,7912,8234,1400-2-20,2021-05-10
43,ماديرا,صنايع ماديران,2413,19692241,141205413186,7264,7047,7300,36,0.5,7171,-93,-1.28,7047,7686,1400-2-20,2021-05-10
44,وساپا,سرمايه‌گذاري‌ سايپا,2355,27846379,123458866048,4286,4175,4543,257,6,4434,148,3.45,4175,4543,1400-2-20,2021-05-10
45,ومعادنح,ح . توسعه‌معادن‌وفلزات‌,2343,13379452,65362559730,4670,4600,5010,340,7.28,4890,220,4.71,4570,5070,1400-2-20,2021-05-10
46,شبريز,پالايش نفت تبريز,2341,7702074,188629552170,24870,24130,25000,130,0.52,24490,-380,-1.53,24130,25540,1400-2-20,2021-05-10
47,شيران,س. صنايع‌شيميايي‌ايران,2132,7965045,153753774560,19650,19070,19740,90,0.46,19300,-350,-1.78,19070,20300,1400-2-20,2021-05-10
48,فخوز,فولاد  خوزستان,2100,16384345,236768721330,14090,13770,14760,670,4.76,14450,360,2.56,13770,14860,1400-2-20,2021-05-10
49,وبوعلي,سرمايه‌گذاري‌بوعلي‌,2059,27288919,154547869550,5750,5600,5780,30,0.52,5660,-90,-1.57,5580,5850,1400-2-20,2021-05-10
50,ونوين,بانك‌اقتصادنوين‌,2025,35222278,149038603624,4232,4120,4310,78,1.84,4231,-1,-0.02,4110,4340,1400-2-20,2021-05-10
51,ضسپا3002,اختيارخ خساپا-1800-1400/03/26,1993,101476,7894723000,73,75,84,11,15.07,78,5,6.85,65,99,1400-2-20,2021-05-10
52,وخارزم,سرمايه گذاري خوارزمي,1984,29758457,133637425074,4624,4486,4486,-138,-2.98,4491,-133,-2.88,4486,4550,1400-2-20,2021-05-10
53,نوري,پتروشيمي نوري,1966,1905960,105628058790,54540,53010,56800,2260,4.14,55420,880,1.61,53010,56850,1400-2-20,2021-05-10
54,كلوند,كاشي‌ الوند,1902,8696612,177030207090,46490,20000,21200,-25290,-54.4,20360,-26130,-56.21,19400,21200,1400-2-20,2021-05-10
55,كيان,صندوق س. با درآمد ثابت كيان,1854,21656478,614227348581,28349,28363,28362,13,0.05,28362,13,0.05,28358,28365,1400-2-20,2021-05-10
56,فاسمين,كالسيمين‌,1786,7287957,98035785110,13410,13030,13730,320,2.39,13450,40,0.3,13020,13990,1400-2-20,2021-05-10
57,كرمان,س. توسعه و عمران استان كرمان,1585,54184536,60795049392,1156,1122,1122,-34,-2.94,1122,-34,-2.94,1122,1122,1400-2-20,2021-05-10
58,خصدرا,صنعتي‌ دريايي‌ ايران‌,1562,38813655,94668130089,2487,2438,2438,-49,-1.97,2439,-48,-1.93,2438,2478,1400-2-20,2021-05-10
59,اعتماد,صندوق س.اعتماد آفرين پارسيان-د,1542,27753900,1008459047340,36321,36337,36337,16,0.04,36336,15,0.04,36335,36339,1400-2-20,2021-05-10
60,بپاس,بيمه پاسارگاد,1537,1864742,161985897944,86867,86867,86900,33,0.04,86868,1,0,84261,86999,1400-2-20,2021-05-10
61,سرو,صندوق س سروسودمند مدبران-سهام,1514,2011592,122373570920,59720,59340,61880,2160,3.62,60830,1110,1.86,59340,61940,1400-2-20,2021-05-10
62,ومعادن,توسعه‌معادن‌وفلزات‌,1505,15202952,106522990620,6950,6750,7200,250,3.6,7000,50,0.72,6750,7220,1400-2-20,2021-05-10
63,تاپيكو,س. نفت و گاز و پتروشيمي تأمين,1374,9532518,93839640610,9750,9800,9940,190,1.95,9830,80,0.82,9470,10020,1400-2-20,2021-05-10
64,فجر,فولاد اميركبيركاشان,1362,1668841,93747017380,56370,54700,57800,1430,2.54,56170,-200,-0.35,54700,58590,1400-2-20,2021-05-10
65,كاوه,فولاد كاوه جنوب كيش,1362,10470173,201937984050,19230,18850,19620,390,2.03,19290,60,0.31,18660,19790,1400-2-20,2021-05-10
66,آگاس,صندوق س.هستي بخش آگاه-س,1360,1245375,77601242033,61132,61000,63389,2257,3.69,62312,1180,1.93,60790,63399,1400-2-20,2021-05-10
67,فنوال,نورد آلومينيوم‌,1345,2071973,56318741430,26960,27210,26930,-30,-0.11,27180,220,0.82,26550,27700,1400-2-20,2021-05-10
68,رمپنا,گروه مپنا (سهامي عام),1341,14706188,215652406320,15090,14640,14800,-290,-1.92,14660,-430,-2.85,14640,14910,1400-2-20,2021-05-10
69,كارين,صندوق س نگين سامان-ثابت,1293,61757967,624591375206,10111,10115,10114,3,0.03,10114,3,0.03,10113,10119,1400-2-20,2021-05-10
70,تاصيكو,سرمايه گذاري صدرتامين,1291,13669053,133223116610,9840,9870,9880,40,0.41,9750,-90,-0.91,9550,9970,1400-2-20,2021-05-10
71,تسه0001,امتيازتسهيلات مسكن فروردين1400,1290,43331,23400174419,547581,555337,530000,-17581,-3.21,540033,-7548,-1.38,522600,565000,1400-2-20,2021-05-10
72,آسيا,بيمه آسيا,1284,45503747,81277353471,1839,1784,1800,-39,-2.12,1786,-53,-2.88,1784,1832,1400-2-20,2021-05-10
73,تملت,تامين سرمايه بانك ملت,1280,8280307,39870176647,4934,4786,4850,-84,-1.7,4836,-98,-1.99,4786,4904,1400-2-20,2021-05-10
74,حفاري,حفاري شمال,1242,9240842,58537335000,6520,6330,6330,-190,-2.91,6330,-190,-2.91,6330,6450,1400-2-20,2021-05-10
75,آوا,صندوق س.سهام آواي معيار-س,1238,8301333,53393114369,6300,6300,6551,251,3.98,6432,132,2.1,6300,6589,1400-2-20,2021-05-10
76,فباهنرح,ح . مس‌ شهيدباهنر,1232,4279587,69703848540,15880,15700,16510,630,3.97,16290,410,2.58,15700,16800,1400-2-20,2021-05-10
77,البرز,بيمه البرز,1231,31084824,106297398320,3355,3261,3556,201,5.99,3420,65,1.94,3261,3556,1400-2-20,2021-05-10
78,سفارس,سيمان فارس و خوزستان,1206,6210486,88643947650,14020,13900,14500,480,3.42,14270,250,1.78,13750,14600,1400-2-20,2021-05-10
79,فباهنر,مس‌ شهيدباهنر,1155,2993258,68397604840,23270,22580,23350,80,0.34,22850,-420,-1.8,22580,23620,1400-2-20,2021-05-10
80,ارفع,شركت آهن و فولاد ارفع,1122,6251625,83455339275,13448,13045,13550,102,0.76,13349,-99,-0.74,13045,13940,1400-2-20,2021-05-10
81,ونيكي,سرمايه‌گذاري‌ ملي‌ايران‌,1049,5787222,45086250210,7970,7740,7900,-70,-0.88,7820,-150,-1.88,7740,8000,1400-2-20,2021-05-10
82,طلا,صندوق س.پشتوانه طلاي لوتوس,1043,1182012,82533277079,68270,69500,70848,2578,3.78,69824,1554,2.28,69000,71000,1400-2-20,2021-05-10
83,فايرا,آلومينيوم‌ايران‌,1036,4796956,86706864900,17680,17500,18100,420,2.38,18080,400,2.26,17500,18400,1400-2-20,2021-05-10
84,وصنعت,سرمايه گذاري توسعه صنعت وتجارت,974,8352941,46610374400,5550,5390,5700,150,2.7,5580,30,0.54,5390,5730,1400-2-20,2021-05-10
85,هرمز,فولاد هرمزگان جنوب,960,9611814,141151905850,14643,14230,14960,317,2.16,14685,42,0.29,14204,15188,1400-2-20,2021-05-10
86,كچاد,معدني‌وصنعتي‌چادرملو,938,4445539,90344896440,20120,20000,20770,650,3.23,20270,150,0.75,19870,20900,1400-2-20,2021-05-10
87,شبهرن,نفت‌ بهران‌,937,5553982,58113342360,10750,10430,10600,-150,-1.4,10460,-290,-2.7,10430,10740,1400-2-20,2021-05-10
88,خكرمان,گروه اقتصادي كرمان خودرو,936,12037793,39524042104,3335,3269,3300,-35,-1.05,3283,-52,-1.56,3269,3386,1400-2-20,2021-05-10
89,كگل,معدني و صنعتي گل گهر,913,9779543,129294573640,13180,12830,13410,230,1.75,13220,40,0.3,12830,13490,1400-2-20,2021-05-10
90,ومهان,گروه توسعه مالي مهر آيندگان,901,2425192,29298192683,12002,11700,12202,200,1.67,12049,47,0.39,11700,12488,1400-2-20,2021-05-10
91,دعبيد,لابراتوارداروسازي‌  دكترعبيدي‌,872,1611947,40722829010,25360,24650,25050,-310,-1.22,25280,-80,-0.32,24600,25800,1400-2-20,2021-05-10
92,هساپا108,اختيارف ت سايپا-2750-01/08/16,850,85000000,24565000000,282,289,289,7,2.48,289,7,2.48,289,289,1400-2-20,2021-05-10
93,كگلح,ح . معدني و صنعتي گل گهر,822,2219535,22369266970,9770,9580,10260,490,5.02,10080,310,3.17,9550,10400,1400-2-20,2021-05-10
94,تصميم,صندوق س با درآمد ثابت تصميم,811,12007497,195419840345,16282,16282,16243,-39,-0.24,16275,-7,-0.04,16000,16284,1400-2-20,2021-05-10
95,هخود108,اختيارف ت خودرو-2850-01/08/03,810,81000000,27783000000,286,343,343,57,19.93,343,57,19.93,343,343,1400-2-20,2021-05-10
96,ضخود7075,اختيارخ خودرو-2000-1400/07/07,801,37882,6932341000,163,200,189,26,15.95,183,20,12.27,163,218,1400-2-20,2021-05-10
97,مدير,ص.س.مديريت ثروت ص.بازنشستگي-س,794,3458806,26501630374,7518,7450,7798,280,3.72,7662,144,1.92,7450,7800,1400-2-20,2021-05-10
98,سمازن,سيمان‌مازندران‌,767,3301935,39808292960,12300,11970,12070,-230,-1.87,12100,-200,-1.63,11950,12230,1400-2-20,2021-05-10
99,ورازي,بيمه رازي,759,10901559,84049828751,7940,7543,7733,-207,-2.61,7710,-230,-2.9,7543,8050,1400-2-20,2021-05-10
100,پارند,صندوق س. پارند پايدار سپهر,742,15685851,175649933046,11195,11203,11198,3,0.03,11198,3,0.03,11185,11203,1400-2-20,2021-05-10
101,پارسان,گسترش نفت و گاز پارسيان,711,5337410,92237398110,17150,16640,17430,280,1.63,17250,100,0.58,16640,17520,1400-2-20,2021-05-10
102,زگلدشتح,ح.كشت و دام گلدشت نمونه اصفهان,700,4003501,23605335128,6045,5864,5866,-179,-2.96,5896,-149,-2.46,5864,6050,1400-2-20,2021-05-10
103,ما,بيمه  ما,693,4720572,35874898190,7380,7650,7750,370,5.01,7530,150,2.03,7350,7780,1400-2-20,2021-05-10
104,ارزش,صندوق س ارزش آفرين بيدار-سهام,685,4480844,39919878250,8840,8600,9070,230,2.6,8910,70,0.79,8600,9070,1400-2-20,2021-05-10
105,واحيا,م .صنايع و معادن احياء سپاهان,681,2738573,394497744235,139964,139000,144162,4198,3,144052,4088,2.92,139000,144162,1400-2-20,2021-05-10
106,اطلس,صندوق س.توسعه اندوخته آينده-س,680,928344,177483187021,192219,190510,192210,-9,0,191183,-1036,-0.54,189500,193001,1400-2-20,2021-05-10
107,تسه9912,امتياز تسهيلات مسكن اسفند99,679,12596,6886872284,553282,545600,535000,-18282,-3.3,546751,-6531,-1.18,525619,560000,1400-2-20,2021-05-10
108,همراه,شركت ارتباطات سيار ايران,677,2410211,53886104760,23000,22310,22650,-350,-1.52,22640,-360,-1.57,22310,23000,1400-2-20,2021-05-10
109,زاگرس,پتروشيمي زاگرس,673,499299,97912963381,195496,189910,198000,2504,1.28,196092,596,0.3,189910,199490,1400-2-20,2021-05-10
110,شصدف,صنعتي دوده فام,666,98542,3252280168,31136,33004,33004,1868,6,31250,114,0.37,33004,33004,1400-2-20,2021-05-10
111,وسكاب,س.ص.بازنشستگي كاركنان بانكها,654,6482250,30768670342,4718,4632,4822,104,2.2,4736,18,0.38,4630,4830,1400-2-20,2021-05-10
112,وسينا,بانك سينا,653,17782291,46333389572,2682,2602,2620,-62,-2.31,2608,-74,-2.76,2602,2644,1400-2-20,2021-05-10
113,وساخت,سرمايه‌ گذاري‌ ساختمان‌ايران‌,645,2774272,119283750670,44230,42910,42980,-1250,-2.83,43000,-1230,-2.78,42910,43980,1400-2-20,2021-05-10
114,شساخت,مهندسي و ساختمان صنايع نفت,628,594163,24774840124,41429,41405,40601,-828,-2,41587,158,0.38,40601,42540,1400-2-20,2021-05-10
115,شفن,پتروشيمي فناوران,628,116832,35051786450,307280,298080,299990,-7290,-2.37,304630,-2650,-0.86,298070,304900,1400-2-20,2021-05-10
116,شپديس,پتروشيمي پرديس,623,758212,68181368590,90250,88610,91300,1050,1.16,90020,-230,-0.25,88610,91960,1400-2-20,2021-05-10
117,افق,فروشگاههاي زنجيره اي افق كوروش,610,549043,36908246260,67680,65650,67400,-280,-0.41,67470,-210,-0.31,65650,68370,1400-2-20,2021-05-10
118,هتجار108,اختيارف ت تجارت-3597-01/08/17,600,60000000,22560000000,340,376,376,36,10.59,376,36,10.59,376,376,1400-2-20,2021-05-10
119,ضسپا3003,اختيارخ خساپا-2000-1400/03/26,598,33250,1276071000,34,12,43,9,26.47,38,4,11.76,12,50,1400-2-20,2021-05-10
120,دالبرح,ح . البرزدارو,596,606803,4967686160,8250,8230,8150,-100,-1.21,8190,-60,-0.73,8100,8300,1400-2-20,2021-05-10
121,وبانك,سرمايه گذاري گروه توسعه ملي,592,3147470,23155889630,7410,7200,7400,-10,-0.13,7390,-20,-0.27,7200,7540,1400-2-20,2021-05-10
122,سامان,بانك سامان,566,7216082,60122778861,8469,8300,8382,-87,-1.03,8332,-137,-1.62,8300,8639,1400-2-20,2021-05-10
123,كاريس,صندوق س.سپهر كاريزما-س,565,8491160,87668212818,10169,10200,10500,331,3.25,10325,156,1.53,10107,10500,1400-2-20,2021-05-10
124,ضسپا3004,اختيارخ خساپا-2500-1400/03/26,563,33809,400401000,7,7,16,9,128.57,12,5,71.43,6,17,1400-2-20,2021-05-10
125,شسپا,نفت سپاهان,560,1644304,23129070350,13970,13920,14260,290,2.08,14010,40,0.29,13820,14390,1400-2-20,2021-05-10
126,تيپيكو,سرمايه گذاري دارويي تامين,557,1121597,38172541700,33940,32940,34630,690,2.03,34000,60,0.18,32930,34990,1400-2-20,2021-05-10
127,وثوق,سرمايه گذاري وثوق امين,556,1683447,27803468687,16836,16500,16500,-336,-2,16516,-320,-1.9,16500,16836,1400-2-20,2021-05-10
128,هفارس108,اختيارف ت فارس-11400-01/08/09,550,55000000,67100000000,1000,1220,1220,220,22,1220,220,22,1220,1220,1400-2-20,2021-05-10
129,ساراب,سيمان‌ داراب‌,545,3977748,89141332680,23100,22410,22410,-690,-2.99,22410,-690,-2.99,22410,22410,1400-2-20,2021-05-10
130,شغدير,پتروشيمي غدير,535,624062,37186973470,59440,57670,60600,1160,1.95,59550,110,0.19,57670,61000,1400-2-20,2021-05-10
131,افران,صندوق س افرا نماد پايدار-ثابت,533,9907592,131642202723,13285,13286,13291,6,0.05,13287,2,0.02,13285,13292,1400-2-20,2021-05-10
132,فسازان,غلتك سازان سپاهان,509,1465488,46510527660,32530,31560,32000,-530,-1.63,31770,-760,-2.34,31560,32470,1400-2-20,2021-05-10
133,هشپنا108,اختيارف ت شپنا-7247-01/08/14,500,50000000,81700000000,1124,1634,1634,510,45.37,1634,510,45.37,1634,1634,1400-2-20,2021-05-10
134,هخابر108,اختيارف ت اخابر-12900-01/08/18,500,50000000,45300000000,1,906,906,905,90500,906,905,90500,906,906,1400-2-20,2021-05-10
135,پاكشو,گروه صنعتي پاكشو,492,10870429,67916036320,6320,6140,6600,280,4.43,6280,-40,-0.63,6140,6640,1400-2-20,2021-05-10
136,وتوس,توسعه‌شهري‌توس‌گستر,487,1600408,21215969230,13540,13160,13200,-340,-2.51,13410,-130,-0.96,13140,13900,1400-2-20,2021-05-10
137,سمتاز,سيمان ممتازان كرمان,468,788286,18795182548,23562,24240,23931,369,1.57,23817,255,1.08,23100,24268,1400-2-20,2021-05-10
138,وكار,بانك‌ كارآفرين‌,467,6393793,18140759726,2913,2826,2826,-87,-2.99,2884,-29,-1,2826,2949,1400-2-20,2021-05-10
139,سيدكو,سرمايه گذاري توسعه صنايع سيمان,461,1914318,11051436370,5690,5530,5800,110,1.93,5710,20,0.35,5530,5970,1400-2-20,2021-05-10
140,ميدكو,هلدينگ صنايع  معدني خاورميانه,461,4738847,155751893764,32857,32858,32900,43,0.13,32867,10,0.03,32856,32980,1400-2-20,2021-05-10
141,ونفت,سرمايه‌گذاري‌ صنعت‌ نفت‌,442,2255304,30008056400,13300,12910,13640,340,2.56,13300,0,0,12910,13890,1400-2-20,2021-05-10
142,شرانل,نفت ايرانول,439,1087968,41229677172,38357,37500,37800,-557,-1.45,37962,-395,-1.03,37500,38500,1400-2-20,2021-05-10
143,ضخود4002,اختيارخ خودرو-1800-1400/04/02,436,25321,3272758000,1,144,130,129,12900,129,128,12800,100,144,1400-2-20,2021-05-10
144,سكه0012پ01,تمام سكه طرح جديد0012رفاه,427,137300,133743405400,937997,969111,980500,42503,4.53,974096,36099,3.85,967000,981998,1400-2-20,2021-05-10
145,وخاور,بانك خاورميانه,425,12542974,104088079180,8490,8270,8400,-90,-1.06,8300,-190,-2.24,8240,8490,1400-2-20,2021-05-10
146,شاراك,پتروشيمي شازند,420,1653747,41460051730,25160,24480,25300,140,0.56,25110,-50,-0.2,24410,25480,1400-2-20,2021-05-10
147,شفارا,پتروشيمي فارابي,408,9173701,34842514087,3703,3629,3814,111,3,3798,95,2.57,3629,3814,1400-2-20,2021-05-10
148,جم,پتروشيمي جم,406,1027244,35644183250,35270,34260,34700,-570,-1.62,35060,-210,-0.6,34220,35150,1400-2-20,2021-05-10
149,ضخود7074,اختيارخ خودرو-1800-1400/07/07,406,24340,5690539000,218,191,269,51,23.39,234,16,7.34,190,280,1400-2-20,2021-05-10
150,فنورد,نوردوقطعات‌ فولادي‌,405,161748,23660958120,150160,145660,150490,330,0.22,148250,-1910,-1.27,145660,152000,1400-2-20,2021-05-10
151,لوتوس,تامين سرمايه لوتوس پارسيان,399,10824553,94405074760,8980,8730,8720,-260,-2.9,8720,-260,-2.9,8720,9000,1400-2-20,2021-05-10
152,سپ,پرداخت الكترونيك سامان كيش,399,868786,18884395260,21630,21290,22100,470,2.17,21670,40,0.18,21150,22130,1400-2-20,2021-05-10
153,تسه9908,امتياز تسهيلات مسكن آبان99,398,9986,5388298659,546663,540000,519330,-27333,-5,539585,-7078,-1.29,519330,556800,1400-2-20,2021-05-10
154,داروح,ح . كارخانجات‌داروپخش,397,8216042,134632395500,17410,18600,16800,-610,-3.5,16390,-1020,-5.86,16370,18600,1400-2-20,2021-05-10
155,وبشهر,توسعه‌ صنايع‌ بهشهر(هلدينگ,389,5859990,58374044700,10120,9820,10680,560,5.53,9960,-160,-1.58,9820,10680,1400-2-20,2021-05-10
156,سخوز,سيمان خوزستان,388,1365751,27665323490,20860,20270,20250,-610,-2.92,20510,-350,-1.68,20240,20600,1400-2-20,2021-05-10
157,سپاها,سيمان‌سپاهان‌,387,3359941,26636065770,8150,7910,7910,-240,-2.94,8030,-120,-1.47,7910,8160,1400-2-20,2021-05-10
158,وتوسم,سرمايه‌گذاري‌توسعه‌ملي‌,381,2126045,16065441160,7750,7520,7650,-100,-1.29,7690,-60,-0.77,7520,7920,1400-2-20,2021-05-10
159,تماوند,تامين سرمايه دماوند,378,8922139,48952014676,5527,5417,5417,-110,-1.99,5487,-40,-0.72,5417,5670,1400-2-20,2021-05-10
160,كروي,توسعه‌ معادن‌ روي‌ ايران‌,374,1119316,27546576760,25370,24610,24820,-550,-2.17,24930,-440,-1.73,24610,24820,1400-2-20,2021-05-10
161,وتوكا,سرمايه‌گذاري‌توكافولاد(هلدينگ,370,2699928,25608183560,11940,9160,9700,-2240,-18.76,10360,-1580,-13.23,9160,9700,1400-2-20,2021-05-10
162,تسه9911,امتياز تسهيلات مسكن بهمن99,365,6045,3269889580,548292,541522,545000,-3292,-0.6,540925,-7367,-1.34,521000,559000,1400-2-20,2021-05-10
163,كنور,توسعه معدني و صنعتي صبانور,364,721055,34611586470,47730,46540,47900,170,0.36,47900,170,0.36,46540,49500,1400-2-20,2021-05-10
164,حكشتي,كشتيراني جمهوري اسلامي ايران,358,2322075,37129979250,16480,15990,15990,-490,-2.97,16320,-160,-0.97,15990,15990,1400-2-20,2021-05-10
165,شخارك,پتروشيمي‌ خارك‌,356,755489,31846620550,43210,41920,42540,-670,-1.55,42860,-350,-0.81,41920,43180,1400-2-20,2021-05-10
166,حسينا,توسعه خدمات دريايي وبندري سينا,355,347987,19807671819,56250,55300,57700,1450,2.58,56521,271,0.48,55300,58700,1400-2-20,2021-05-10
167,پارس,پتروشيمي پارس,349,652014,92020391980,141250,138250,141600,350,0.25,141140,-110,-0.08,138250,141710,1400-2-20,2021-05-10
168,كرماشا,صنايع پتروشيمي كرمانشاه,344,1009798,32331698640,32810,31830,32400,-410,-1.25,32270,-540,-1.65,31830,32650,1400-2-20,2021-05-10
169,كاردان,صندوق س تجارت شاخصي كاردان,340,73443,10402978840,138890,137130,143970,5080,3.66,141650,2760,1.99,137130,144320,1400-2-20,2021-05-10
170,ياقوت,صندوق س ياقوت آگاه-ثابت,313,2631627,32500303489,12350,12350,12352,2,0.02,12350,0,0,12349,12357,1400-2-20,2021-05-10
171,بموتو,موتوژن‌,313,617097,31779304490,53070,51480,51500,-1570,-2.96,52040,-1030,-1.94,51480,53000,1400-2-20,2021-05-10
172,وسپه,سرمايه‌گذاري‌ سپه‌,311,3492975,21659509590,6370,6180,6290,-80,-1.26,6290,-80,-1.26,6180,6350,1400-2-20,2021-05-10
173,گوهران,سرمايه گذاري توسعه گوهران اميد,303,1342014,9124551008,6909,6703,6840,-69,-1,6889,-20,-0.29,6703,6930,1400-2-20,2021-05-10
174,سشمال,سيمان‌ شمال‌,299,1651497,15635623600,9750,9460,9460,-290,-2.97,9660,-90,-0.92,9460,9590,1400-2-20,2021-05-10
175,پكرمان,گروه‌ صنعتي‌ بارز,299,1117715,26452662830,24380,23650,23950,-430,-1.76,23990,-390,-1.6,23650,24380,1400-2-20,2021-05-10
176,بفجر,فجر انرژي خليج فارس,297,568239,12018218970,20930,21130,21330,400,1.91,20980,50,0.24,20880,21610,1400-2-20,2021-05-10
177,تسه9910,امتياز تسهيلات مسكن دي99,297,4636,2514083775,552223,527122,546000,-6223,-1.13,542296,-9927,-1.8,527122,565000,1400-2-20,2021-05-10
178,آكورد,صندوق س. آرمان آتي كوثر-د,294,3118755,99792951662,31982,31997,31999,17,0.05,31998,16,0.05,31997,32002,1400-2-20,2021-05-10
179,مبين,مبين انرژي خليج فارس,293,1200538,18479729060,15460,15530,15480,20,0.13,15450,-10,-0.06,15060,15590,1400-2-20,2021-05-10
180,تسه9909,امتياز تسهيلات مسكن آذر99,287,5141,2788443479,550237,543000,530100,-20137,-3.66,542393,-7844,-1.43,527000,569000,1400-2-20,2021-05-10
181,خبازرس,بازرسي مهندسي و صنعتي ايران,286,944083,24532942410,31056,26430,25902,-5154,-16.6,25986,-5070,-16.33,25902,26430,1400-2-20,2021-05-10
182,دسبحانح,ح. سبحان دارو,284,307401,3395770260,11560,12000,11400,-160,-1.38,11050,-510,-4.41,10880,12000,1400-2-20,2021-05-10
183,شلعابح,ح . لعابيران‌,282,2451454,20880450330,9010,9500,8470,-540,-5.99,8520,-490,-5.44,8470,9500,1400-2-20,2021-05-10
184,آساس,صندوق س.آسمان آرماني سهام-س,277,114467,18156411546,158065,157010,160000,1935,1.22,158617,552,0.35,157010,160000,1400-2-20,2021-05-10
185,شبصير,توليدات پتروشيمي قائد بصير,275,540887,35085552352,66806,64802,64802,-2004,-3,65402,-1404,-2.1,64802,68700,1400-2-20,2021-05-10
186,ارمغان,ص سرمايه گذاري ارمغان ايرانيان,243,4910071,49210559357,10024,10029,10032,8,0.08,10022,-2,-0.02,10009,10032,1400-2-20,2021-05-10
187,كگهر,سنگ آهن گهرزمين,236,1205568,49911077145,42383,41112,43500,1117,2.64,41960,-423,-1,41112,43500,1400-2-20,2021-05-10
188,زر,صندوق س.پشتوانه سكه طلاي زر,234,228112,9482923083,39648,41000,41800,2152,5.43,41571,1923,4.85,41000,41870,1400-2-20,2021-05-10
189,فخاس,فولاد خراسان,234,1485178,37444314540,25980,25210,25210,-770,-2.96,25680,-300,-1.15,25210,25440,1400-2-20,2021-05-10
190,تنوين,تامين سرمايه نوين,232,2401222,17340948060,7200,7210,7270,70,0.97,7210,10,0.14,7190,7280,1400-2-20,2021-05-10
191,شنفت,نفت‌ پارس‌,219,378522,17462317300,46850,45640,46650,-200,-0.43,46590,-260,-0.55,45450,47300,1400-2-20,2021-05-10
192,فيروزه,صندوق شاخص30 شركت فيروزه- سهام,216,196404,24780801440,125020,124050,128010,2990,2.39,126170,1150,0.92,124050,128900,1400-2-20,2021-05-10
193,تسه9803,امتياز تسهيلات مسكن خرداد98,214,3181,1706867316,536339,523800,534000,-2339,-0.44,536582,243,0.05,523800,544987,1400-2-20,2021-05-10
194,وصندوق,سرمايه‌گذاري‌صندوق‌بازنشستگي‌,212,2568017,35135519690,14010,13590,13780,-230,-1.64,13910,-100,-0.71,13590,14000,1400-2-20,2021-05-10
195,خديزل,بهمن  ديزل,212,539918,20513690737,39122,37949,37949,-1173,-3,38641,-481,-1.23,37949,38999,1400-2-20,2021-05-10
196,سحرخيز,صندوق س. گروه زعفران سحرخيز,208,872127,7535704911,8699,8557,8650,-49,-0.56,8641,-58,-0.67,8557,8699,1400-2-20,2021-05-10
197,سرود,سيمان‌شاهرود,203,1339934,22006971040,16920,16420,16420,-500,-2.96,16690,-230,-1.36,16420,16580,1400-2-20,2021-05-10
198,اخابر,مخابرات ايران,203,6161151,56251308630,9410,9130,9130,-280,-2.98,9270,-140,-1.49,9130,9130,1400-2-20,2021-05-10
199,حآسا,آسيا سير ارس,200,742843,28063856900,44797,38000,36860,-7937,-17.72,40126,-4671,-10.43,36860,38000,1400-2-20,2021-05-10
200,هتران108,اختيارف ت شتران-5206-01/08/11,200,20000000,34240000000,1477,1712,1712,235,15.91,1712,235,15.91,1712,1712,1400-2-20,2021-05-10
201,عيار,صندوق سكه طلاي مفيد,189,170506,4264923332,23984,24971,25152,1168,4.87,25013,1029,4.29,24710,25198,1400-2-20,2021-05-10
202,ضخود7076,اختيارخ خودرو-2500-1400/07/07,188,5124,563076000,104,55,134,30,28.85,110,6,5.77,55,137,1400-2-20,2021-05-10
203,كخاك,صنايع‌خاك‌چيني‌ايران‌,188,331037,12980580410,40320,39120,39140,-1180,-2.93,40020,-300,-0.74,39120,40190,1400-2-20,2021-05-10
204,آساميد,صندوق س.مشترك آسمان اميد -د,185,9335752,111973165323,12011,11998,11991,-20,-0.17,11994,-17,-0.14,11991,11998,1400-2-20,2021-05-10
205,وحكمت,بيمه حكمت صبا,183,1825805,6085813930,3397,3330,3330,-67,-1.97,3377,-20,-0.59,3330,3360,1400-2-20,2021-05-10
206,هجرتح,ح . پخش هجرت,179,7418872,125027939444,17361,18000,16841,-520,-3,16853,-508,-2.93,16841,18000,1400-2-20,2021-05-10
207,ضخود7077,اختيارخ خودرو-3000-1400/07/07,177,12334,576195000,33,77,52,19,57.58,47,14,42.42,28,77,1400-2-20,2021-05-10
208,كاما,باما,175,658707,7482911520,11710,11360,11360,-350,-2.99,11660,-50,-0.43,11360,11360,1400-2-20,2021-05-10
209,تسه9810,امتياز تسهيلات مسكن دي98,172,3607,1925403866,548054,526711,520652,-27402,-5,533796,-14258,-2.6,520652,557600,1400-2-20,2021-05-10
210,شصفها,پتروشيمي‌ اصفهان‌,171,201191,25069491055,123527,121057,125997,2470,2,124605,1078,0.87,121057,125997,1400-2-20,2021-05-10
211,تسه9907,امتياز تسهيلات مسكن مهر99,170,2598,1402351260,549571,526000,522093,-27478,-5,539781,-9790,-1.78,522093,577049,1400-2-20,2021-05-10
212,خراسان,پتروشيمي خراسان,170,130581,8691219850,68220,66180,68000,-220,-0.32,67920,-300,-0.44,66180,68400,1400-2-20,2021-05-10
213,خمحركه,نيرو محركه‌,163,1098301,4747955223,4598,4323,4323,-275,-5.98,4570,-28,-0.61,4323,4323,1400-2-20,2021-05-10
214,شيراز,پتروشيمي‌شيراز,161,556113,28021429850,51760,50210,51200,-560,-1.08,51360,-400,-0.77,50210,51680,1400-2-20,2021-05-10
215,تسه9902,امتياز تسهيلات مسكن ارديبهشت99,154,2542,1381665818,547331,574697,519965,-27366,-5,543535,-3796,-0.69,519965,574697,1400-2-20,2021-05-10
216,پتاير,ايران‌ تاير,153,985716,3397763052,3667,3447,3447,-220,-6,3651,-16,-0.44,3447,3447,1400-2-20,2021-05-10
217,سشرق,سيمان‌ شرق‌,151,3228089,18787477980,6000,5820,5820,-180,-3,5930,-70,-1.17,5820,5820,1400-2-20,2021-05-10
218,هفولا108,اختيارف ت فولاد-11512-01/08/07,150,15000000,22770000000,1173,1518,1518,345,29.41,1518,345,29.41,1518,1518,1400-2-20,2021-05-10
219,شراز,پالايش نفت شيراز,149,88973,9291729355,107339,104119,104119,-3220,-3,106766,-573,-0.53,104119,107350,1400-2-20,2021-05-10
220,واعتبار,سرمايه گذاري اعتبار ايران,149,2567859,24959589480,9170,9720,9720,550,6,9410,240,2.62,9720,9720,1400-2-20,2021-05-10
221,گوهر,صندوق سكه طلاي كيان,149,85670,4123775237,46462,47597,48344,1882,4.05,48136,1674,3.6,47370,48697,1400-2-20,2021-05-10
222,ضجار2002,اختيارخ وتجارت-2500-1400/02/22,142,8590,200041000,20,10,24,4,20,23,3,15,10,49,1400-2-20,2021-05-10
223,لبوتان,گروه‌صنعتي‌بوتان‌,140,168927,9756886010,59530,57750,57750,-1780,-2.99,59170,-360,-0.6,57750,58660,1400-2-20,2021-05-10
224,دارا,صندوق س. دارا الگوريتم-د,139,3382270,33959849149,10052,10065,10039,-13,-0.13,10041,-11,-0.11,10000,10065,1400-2-20,2021-05-10
225,نهال,صندوق س. طلاي سرخ نوويرا,135,214203,1907339123,8833,8761,9096,263,2.98,8904,71,0.8,8750,9441,1400-2-20,2021-05-10
226,دلر,داروسازي‌ اكسير,133,185454,6326741760,35130,34080,34100,-1030,-2.93,35000,-130,-0.37,34080,34870,1400-2-20,2021-05-10
227,فسپا,گروه‌صنعتي‌سپاهان‌,129,549081,18690717240,35090,34040,34040,-1050,-2.99,34680,-410,-1.17,34040,34040,1400-2-20,2021-05-10
228,ضخود7072,اختيارخ خودرو-1400-1400/07/07,128,4468,2612714000,581,400,620,39,6.71,585,4,0.69,399,700,1400-2-20,2021-05-10
229,تسه9904,امتياز تسهيلات مسكن تير99,128,1556,840598595,552453,525000,575000,22547,4.08,540230,-12223,-2.21,524831,575000,1400-2-20,2021-05-10
230,ضملي3003,اختيارخ فملي-12000-1400/03/02,126,2637,1397307000,223,459,739,516,231.39,530,307,137.67,300,739,1400-2-20,2021-05-10
231,دمعيار,صندوق س. توازن معيار-د,115,4673583,47204144558,10096,10100,10101,5,0.05,10100,4,0.04,10100,10106,1400-2-20,2021-05-10
232,آبادا,توليد نيروي برق آبادان,114,155082,1892000400,12570,12200,12200,-370,-2.94,12560,-10,-0.08,12200,12200,1400-2-20,2021-05-10
233,سكرما,سيمان‌ كرمان‌,114,479113,7149045530,15380,14920,14920,-460,-2.99,15310,-70,-0.46,14920,15000,1400-2-20,2021-05-10
234,اخزا901,اسنادخزانه-م1بودجه99-010621,112,83834,63754053440,760796,760571,760500,-296,-0.04,760480,-316,-0.04,759135,761650,1400-2-20,2021-05-10
235,تسه9906,امتياز تسهيلات مسكن شهريور99,110,1190,648759700,556023,528286,530000,-26023,-4.68,545176,-10847,-1.95,528222,583823,1400-2-20,2021-05-10
236,مارون,پتروشيمي مارون,110,22100,3180336287,147890,143454,143511,-4379,-2.96,147758,-132,-0.09,143454,144470,1400-2-20,2021-05-10
237,شكبير,پتروشيمي اميركبير,110,430752,35137958942,83203,81539,83900,697,0.84,82617,-586,-0.7,81539,84493,1400-2-20,2021-05-10
238,اخزا910,اسنادخزانه-م10بودجه99-020807,109,225214,136728235145,607069,606169,606601,-468,-0.08,607104,35,0.01,605202,608500,1400-2-20,2021-05-10
239,سپاس,صندوق س. پاداش سهامداري-ثابت,105,1829526,18348513635,10024,10028,10030,6,0.06,10029,5,0.05,10028,10031,1400-2-20,2021-05-10
240,فروي,ذوب روي اصفهان,104,43900,2425431100,56957,55249,55249,-1708,-3,56871,-86,-0.15,55249,55249,1400-2-20,2021-05-10
241,آريان,سرمايه گذاري پارس آريان,104,2718669,26708204256,9538,9824,9824,286,3,9636,98,1.03,9824,9824,1400-2-20,2021-05-10
242,اتكاي,بيمه اتكايي ايرانيان,103,747579,11897845602,16403,15911,15999,-404,-2.46,16282,-121,-0.74,15911,16398,1400-2-20,2021-05-10
243,تسه9905,امتياز تسهيلات مسكن مرداد99,103,1660,903603841,543813,525000,534444,-9369,-1.72,544340,527,0.1,525000,554999,1400-2-20,2021-05-10
244,تسه9804,امتياز تسهيلات مسكن تير98,102,1145,623223986,547425,537000,537170,-10255,-1.87,544300,-3125,-0.57,525600,552519,1400-2-20,2021-05-10
245,زعف0008پ16,زعفران0008نگين بيرجند(پ),101,40316,4801453078,120648,118006,116105,-4543,-3.77,119095,-1553,-1.29,116105,120000,1400-2-20,2021-05-10
246,وهور,مديريت انرژي اميد  تابان هور,100,4267385,8419550605,2033,1973,1973,-60,-2.95,2023,-10,-0.49,1973,1973,1400-2-20,2021-05-10
247,همراه108,اختيارف ت همراه-12578-01/08/21,100,10000000,27470000000,1,2747,2747,2746,274600,2747,2746,274600,2747,2747,1400-2-20,2021-05-10
248,گشان,توسعه بين المللي پديده شانديز,99,109689,2411073909,22429,21981,21981,-448,-2,22346,-83,-0.37,21981,21981,1400-2-20,2021-05-10
249,اخزا902,اسنادخزانه-م2بودجه99-011019,99,114053,81360335850,713868,713155,715000,1132,0.16,713355,-513,-0.07,712000,715000,1400-2-20,2021-05-10
250,تسه9903,امتياز تسهيلات مسكن خرداد99,99,1027,559673986,546943,540000,530678,-16265,-2.97,544960,-1983,-0.36,520522,574290,1400-2-20,2021-05-10
251,فردا,صندوق س آواي فرداي زاگرس-ثابت,98,2711939,28904961754,10653,10658,10659,6,0.06,10658,5,0.05,10658,10660,1400-2-20,2021-05-10
252,تسه9806,امتياز تسهيلات مسكن شهريور98,94,1234,678507165,551215,533000,541043,-10172,-1.85,549844,-1371,-0.25,528020,559497,1400-2-20,2021-05-10
253,خاتم,صندوق س خاتم ايساتيس پويا-ثابت,93,723282,8016750539,11075,11078,11088,13,0.12,11084,9,0.08,11078,11090,1400-2-20,2021-05-10
254,تسه9901,امتياز تسهيلات مسكن فروردين99,88,1127,621312346,561127,540000,570000,8873,1.58,551298,-9829,-1.75,533071,572820,1400-2-20,2021-05-10
255,تسه9805,امتياز تسهيلات مسكن مرداد98,81,785,431569397,551720,534033,536010,-15710,-2.85,549770,-1950,-0.35,534033,559000,1400-2-20,2021-05-10
256,دقاضيح,ح . داروسازي شهيد قاضي,80,317139,8189924210,26447,27400,25390,-1057,-4,25824,-623,-2.36,25390,27400,1400-2-20,2021-05-10
257,وبازار,صندوق س شاخصي بازارآشنا,80,195302,1769986290,9000,9000,9070,70,0.78,9060,60,0.67,9000,9180,1400-2-20,2021-05-10
258,غسالم,سالمين‌,80,795438,3062436300,3969,3850,3850,-119,-3,3961,-8,-0.2,3850,3850,1400-2-20,2021-05-10
259,زعف0008پ05,زعفران0008نگين زرين(پ),77,40556,4869598338,121801,119016,119750,-2051,-1.68,120071,-1730,-1.42,119000,120999,1400-2-20,2021-05-10
260,اخزا903,اسنادخزانه-م3بودجه99-011110,75,159959,112698390415,704348,704003,704545,197,0.03,704545,197,0.03,704003,705000,1400-2-20,2021-05-10
261,تسه9809,امتياز تسهيلات مسكن آذر98,75,906,501296137,548117,521111,537823,-10294,-1.88,553307,5190,0.95,521111,568999,1400-2-20,2021-05-10
262,سكه0011پ02,تمام سكه طرح جديد0011ملت,74,14400,14053421100,936270,966999,982000,45730,4.88,975932,39662,4.24,966999,982000,1400-2-20,2021-05-10
263,بكهنوج,توليد برق ماهتاب كهنوج,71,2604633,4141366470,1639,1590,1590,-49,-2.99,1635,-4,-0.24,1590,1590,1400-2-20,2021-05-10
264,تسه9808,امتياز تسهيلات مسكن آبان98,70,563,306799836,548938,540000,540001,-8937,-1.63,544938,-4000,-0.73,523788,570000,1400-2-20,2021-05-10
265,آتيمس,صندوق س.آرمان آتيه درخشان مس-س,70,16720,2878399613,172017,171105,172800,783,0.46,172153,136,0.08,171000,174500,1400-2-20,2021-05-10
266,ضجار2000,اختيارخ وتجارت-1800-1400/02/22,69,3644,2601991000,477,500,563,86,18.03,714,237,49.69,417,1000,1400-2-20,2021-05-10
267,زرين,صندوق س. سهام زرين كوروش-س,68,249444,2323150629,9222,9161,9350,128,1.39,9313,91,0.99,9150,9500,1400-2-20,2021-05-10
268,ضملي3004,اختيارخ فملي-14000-1400/03/02,66,3035,313226000,39,54,150,111,284.62,103,64,164.1,35,187,1400-2-20,2021-05-10
269,تسه9812,امتياز تسهيلات مسكن اسفند98,66,280,151878260,543603,540000,535000,-8603,-1.58,542422,-1181,-0.22,520000,550000,1400-2-20,2021-05-10
270,تسه9811,امتياز تسهيلات مسكن بهمن98,66,636,343382573,547067,522601,565000,17933,3.28,539910,-7157,-1.31,519714,565000,1400-2-20,2021-05-10
271,اخزا909,اسنادخزانه-م9بودجه99-020316,64,214482,140954657426,657857,656159,659000,1143,0.17,657186,-671,-0.1,656159,659000,1400-2-20,2021-05-10
272,ثمسكن,سرمايه‌گذاري‌ مسكن‌,60,417842,2000627496,4936,4788,4788,-148,-3,4930,-6,-0.12,4788,4788,1400-2-20,2021-05-10
273,وسبحان,سرمايه گذاري سبحان,60,3040628,8328280092,2823,2739,2739,-84,-2.98,2808,-15,-0.53,2739,2739,1400-2-20,2021-05-10
274,خزاميا,زامياد,59,212568,1804702320,8750,8490,8490,-260,-2.97,8740,-10,-0.11,8490,8490,1400-2-20,2021-05-10
275,فيروزا,صندوق بادرآمد ثابت فيروزه آسيا,59,431942,9847192546,22796,22812,22801,5,0.02,22797,1,0,22700,22812,1400-2-20,2021-05-10
276,والبر,سرمايه‌ گذاري‌ البرز(هلدينگ‌,59,1032559,16190525120,16160,15680,15680,-480,-2.97,16000,-160,-0.99,15680,15680,1400-2-20,2021-05-10
277,فاراك,ماشين‌ سازي‌ اراك‌,58,455733,1057300560,2391,2320,2320,-71,-2.97,2389,-2,-0.08,2320,2320,1400-2-20,2021-05-10
278,كدما,معدني‌ دماوند,57,102684,9781677840,98200,95260,95260,-2940,-2.99,97600,-600,-0.61,95260,95260,1400-2-20,2021-05-10
279,ضملي3002,اختيارخ فملي-10000-1400/03/02,57,493,1105987000,1774,1998,2600,826,46.56,2243,469,26.44,1777,2600,1400-2-20,2021-05-10
280,ضخود7073,اختيارخ خودرو-1600-1400/07/07,56,3255,1274210000,349,355,440,91,26.07,391,42,12.03,315,440,1400-2-20,2021-05-10
281,سبزوا,سيمان لار سبزوار,56,342956,1103975364,3318,3219,3219,-99,-2.98,3316,-2,-0.06,3219,3219,1400-2-20,2021-05-10
282,كفپارس,فرآورده‌هاي‌ نسوز پارس‌,56,724230,2297257560,3270,3172,3172,-98,-3,3265,-5,-0.15,3172,3172,1400-2-20,2021-05-10
283,سكه0112پ03,تمام سكه طرح جديد0112سامان,56,20700,20200505500,938385,957901,980500,42115,4.49,975870,37485,3.99,957901,984799,1400-2-20,2021-05-10
284,وپويا,سرمايه گذاري پويا,55,812772,5068446192,6428,6236,6236,-192,-2.99,6408,-20,-0.31,6236,6236,1400-2-20,2021-05-10
285,دلرح,ح . داروسازي‌ اكسير,55,163964,4062716320,26300,26000,24730,-1570,-5.97,24780,-1520,-5.78,24730,26000,1400-2-20,2021-05-10
286,اوصتا,صندوق انديشه ورزان صباتامين -د,53,2469578,45929356079,18570,18580,18580,10,0.05,18598,28,0.15,18572,18690,1400-2-20,2021-05-10
287,تسه9807,امتياز تسهيلات مسكن مهر98,51,469,254076683,549127,540000,521671,-27456,-5,541741,-7386,-1.35,521671,545030,1400-2-20,2021-05-10
288,اخزا908,اسنادخزانه-م8بودجه99-020606,48,330698,207873910302,628915,629000,629400,485,0.08,628591,-324,-0.05,627201,629400,1400-2-20,2021-05-10
289,سيمرغ,سيمرغ,47,33181,570049580,18270,17180,17180,-1090,-5.97,18260,-10,-0.05,17180,17180,1400-2-20,2021-05-10
290,ضملي7004,اختيارخ فملي-13720-1400/07/11,47,424,431571000,600,700,1201,601,100.17,1018,418,69.67,700,1201,1400-2-20,2021-05-10
291,ساروج,بين المللي ساروج بوشهر,46,281400,4818810866,17473,17128,17124,-349,-2,17385,-88,-0.5,17124,17140,1400-2-20,2021-05-10
292,ثاخت,بين‌المللي‌توسعه‌ساختمان,46,307764,735555960,2463,2390,2390,-73,-2.96,2462,-1,-0.04,2390,2390,1400-2-20,2021-05-10
293,افق ملت,صندوق س در سهام افق ملت,46,12201,1487016390,120620,120300,122850,2230,1.85,121880,1260,1.04,120300,122900,1400-2-20,2021-05-10
294,فراز,صندوق س.سهام فراز داريك-س,44,67307,693880269,10300,10304,10310,10,0.1,10309,9,0.09,10304,10312,1400-2-20,2021-05-10
295,گكوثر,هتل پارسيان كوثر اصفهان,44,268095,595438995,2289,2221,2221,-68,-2.97,2288,-1,-0.04,2221,2221,1400-2-20,2021-05-10
296,سپر,صندوق س سپر سرمايه بيدار- ثابت,42,641797,7561035471,11778,11781,11781,3,0.03,11781,3,0.03,11781,11783,1400-2-20,2021-05-10
297,قشرين,قند شيرين خراسان,42,794670,9024272520,11587,11356,11356,-231,-1.99,11476,-111,-0.96,11356,11356,1400-2-20,2021-05-10
298,ضپاس7028,اختيارخ وپارس-2000-1400/07/28,41,2540,1317024000,502,580,520,18,3.59,519,17,3.39,510,580,1400-2-20,2021-05-10
299,بورس,بورس اوراق بهادار تهران,41,383075,12698936250,34170,33150,33150,-1020,-2.99,33930,-240,-0.7,33150,33150,1400-2-20,2021-05-10
300,سكه0012پ04,تمام سكه طرح جديد0012صادرات,40,10700,10438932300,937848,971500,981000,43152,4.6,975601,37753,4.03,970000,981000,1400-2-20,2021-05-10
301,ضملي7002,اختيارخ فملي-9720-1400/07/11,39,538,1928069000,2884,3490,3700,816,28.29,3584,700,24.27,3200,4000,1400-2-20,2021-05-10
302,صايند,صندوق س. گنجينه آينده روشن-د,39,105120,1022513810,9756,9730,9720,-36,-0.37,9727,-29,-0.3,9720,9777,1400-2-20,2021-05-10
303,ختوقا,قطعات‌ اتومبيل‌ ايران‌,39,254003,618243302,2509,2434,2434,-75,-2.99,2508,-1,-0.04,2434,2434,1400-2-20,2021-05-10
304,شاوان,پالايش نفت لاوان,38,29435,2345057015,82132,79669,79669,-2463,-3,82011,-121,-0.15,79669,79669,1400-2-20,2021-05-10
305,ضفلا3003,اختيارخ فولاد-7133-1400/03/19,38,466,977326000,1689,1991,2500,811,48.02,2097,408,24.16,1924,2500,1400-2-20,2021-05-10
306,قرن,پديده شيمي قرن,38,59700,3584985000,61900,60050,60050,-1850,-2.99,61760,-140,-0.23,60050,60050,1400-2-20,2021-05-10
307,چكاپا,گروه صنايع كاغذ پارس,38,270787,1364766480,5190,5040,5040,-150,-2.89,5190,0,0,5040,5040,1400-2-20,2021-05-10
308,واميدح,ح.گروه مديريت سرمايه گذار اميد,38,359097,2337721470,6920,6510,6510,-410,-5.92,6510,-410,-5.92,6510,6510,1400-2-20,2021-05-10
309,زعف0008پ20,زعفران0008نگين وحدت جام(پ),35,20600,2414617800,120432,116400,116570,-3862,-3.21,117214,-3218,-2.67,116000,119500,1400-2-20,2021-05-10
310,ثروتم,صندوق س. ثروت آفرين پارسيان-س,34,80980,5773627250,70669,70900,72600,1931,2.73,71297,628,0.89,70696,72600,1400-2-20,2021-05-10
311,ضشنا8001,اختيارخ شپنا-6800-1400/08/16,34,512,1290129000,2368,2200,2500,132,5.57,2520,152,6.42,2055,2700,1400-2-20,2021-05-10
312,اخزا820,اسنادخزانه-م20بودجه98-020806,34,119385,72813660431,609867,602601,610000,133,0.02,609906,39,0.01,602601,610000,1400-2-20,2021-05-10
313,ضشنا8002,اختيارخ شپنا-7800-1400/08/16,33,698,1291832000,1689,1600,1890,201,11.9,1851,162,9.59,1520,1899,1400-2-20,2021-05-10
314,خودكفا,اقتصادي و خودكفايي آزادگان,32,88955,1571212165,18023,17663,17663,-360,-2,18008,-15,-0.08,17663,17663,1400-2-20,2021-05-10
315,واميد,گروه مديريت سرمايه گذاري اميد,31,1026684,12422876400,12470,12100,12100,-370,-2.97,12430,-40,-0.32,12100,12100,1400-2-20,2021-05-10
316,ونيرو,سرمايه‌گذاري‌نيرو,30,256494,640978506,2576,2499,2499,-77,-2.99,2575,-1,-0.04,2499,2499,1400-2-20,2021-05-10
317,ولانا,شركت ليزينگ آريا دانا,30,31459,1206987453,39149,38367,38367,-782,-2,39100,-49,-0.13,38367,38367,1400-2-20,2021-05-10
318,فسرب,ملي‌ سرب‌وروي‌ ايران‌,29,5345,408411450,78770,76410,76410,-2360,-3,78750,-20,-0.03,76410,76410,1400-2-20,2021-05-10
319,بكام,كارخانجات توليدي شهيد قندي,29,272324,1039460708,3935,3817,3817,-118,-3,3932,-3,-0.08,3817,3817,1400-2-20,2021-05-10
320,اخزا815,اسنادخزانه-م15بودجه98-010406,28,45721,36381233901,796282,795001,798000,1718,0.22,795723,-559,-0.07,795000,798000,1400-2-20,2021-05-10
321,پارسيان,بيمه پارسيان,28,1017313,9522049680,9640,9360,9360,-280,-2.9,9580,-60,-0.62,9360,9360,1400-2-20,2021-05-10
322,ضشنا2001,اختيارخ شپنا-10000-1400/02/27,28,597,94747000,72,55,350,278,386.11,159,87,120.83,55,390,1400-2-20,2021-05-10
323,گنجين,صندوق س. گنجينه يكم آويد-د,28,339642,4342780801,12782,12785,12790,8,0.06,12786,4,0.03,12784,12798,1400-2-20,2021-05-10
324,شپترو,پتروشيمي آبادان,28,430000,1919950000,4556,4465,4465,-91,-2,4547,-9,-0.2,4465,4465,1400-2-20,2021-05-10
325,صنوين,صندوق سرمايه‌گذاري صنوين-مختلط,27,9959,1019255740,102290,102290,103500,1210,1.18,102350,60,0.06,101510,103500,1400-2-20,2021-05-10
326,انرژي3,سايراشخاص بورس انرژي,27,1490,360922700,249720,242230,242230,-7490,-3,249670,-50,-0.02,242230,242230,1400-2-20,2021-05-10
327,غزر,صنعتي زر ماكارون,27,18611,463227790,25650,24890,24890,-760,-2.96,25640,-10,-0.04,24890,24890,1400-2-20,2021-05-10
328,وتوصا,گروه س توسعه صنعتي ايران,26,57192,621677040,11200,10870,10870,-330,-2.95,11200,0,0,10870,10870,1400-2-20,2021-05-10
329,كالا,بورس كالاي ايران,26,67390,2085046600,31890,30940,30940,-950,-2.98,31850,-40,-0.13,30940,30940,1400-2-20,2021-05-10
330,ضشنا2002,اختيارخ شپنا-12000-1400/02/27,26,925,12869000,6,3,17,11,183.33,14,8,133.33,3,39,1400-2-20,2021-05-10
331,اخزا911,اسنادخزانه-م11بودجه99-020906,26,76586,45691364469,595964,596100,596889,925,0.16,596602,638,0.11,595000,597000,1400-2-20,2021-05-10
332,ختور,رادياتور ايران‌,25,49712,945522240,19600,19020,19020,-580,-2.96,19590,-10,-0.05,19020,19020,1400-2-20,2021-05-10
333,غشهداب,كشت و صنعت شهداب ناب خراسان,25,176751,679254093,3961,3843,3843,-118,-2.98,3959,-2,-0.05,3843,3843,1400-2-20,2021-05-10
334,دانا,بيمه دانا,24,611419,3925309980,6610,6420,6420,-190,-2.87,6590,-20,-0.3,6420,6420,1400-2-20,2021-05-10
335,وصنا,گروه‌صنايع‌بهشهرايران‌,24,52948,289625560,5630,5470,5470,-160,-2.84,5630,0,0,5470,5470,1400-2-20,2021-05-10
336,سهگمت,سيمان‌هگمتان‌,24,22096,514836800,24780,23300,23300,-1480,-5.97,24760,-20,-0.08,23300,23300,1400-2-20,2021-05-10
337,ملت,بيمه ملت,24,28246,426797060,15570,15110,15110,-460,-2.95,15570,0,0,15110,15110,1400-2-20,2021-05-10
338,زعف0008پ08,زعفران0008نگين روستا(پ),24,7272,856781101,121029,120000,119490,-1539,-1.27,117819,-3210,-2.65,115006,120698,1400-2-20,2021-05-10
339,چكارن,كارتن‌ ايران‌,23,138898,448779438,3330,3231,3231,-99,-2.97,3329,-1,-0.03,3231,3231,1400-2-20,2021-05-10
340,ثبهساز,بهساز كاشانه تهران,23,446214,985240512,2276,2208,2208,-68,-2.99,2275,-1,-0.04,2208,2208,1400-2-20,2021-05-10
341,ضسپا3001,اختيارخ خساپا-1600-1400/03/26,23,514,116935000,219,219,240,21,9.59,227,8,3.65,220,250,1400-2-20,2021-05-10
342,خريخت,صنايع‌ريخته‌گري‌ايران‌,23,230394,654088566,2926,2839,2839,-87,-2.97,2925,-1,-0.03,2839,2839,1400-2-20,2021-05-10
343,دزهراوي,داروسازي‌زهراوي‌,23,26345,222615250,8710,8450,8450,-260,-2.99,8710,0,0,8450,8450,1400-2-20,2021-05-10
344,ضشنا8003,اختيارخ شپنا-8800-1400/08/16,22,423,593758000,1296,1269,1470,174,13.43,1404,108,8.33,1269,1501,1400-2-20,2021-05-10
345,ستران,سيمان‌ تهران‌,22,14833,336709100,23400,22700,22700,-700,-2.99,23400,0,0,22700,22700,1400-2-20,2021-05-10
346,كزغال,زغال سنگ پروده طبس,22,130807,3978364098,31354,30414,30414,-940,-3,31276,-78,-0.25,30414,30414,1400-2-20,2021-05-10
347,نوين,بيمه نوين,22,184408,1059055144,5920,5743,5743,-177,-2.99,5916,-4,-0.07,5743,5743,1400-2-20,2021-05-10
348,دالبر,البرزدارو,21,60832,869289280,14730,14290,14290,-440,-2.99,14720,-10,-0.07,14290,14290,1400-2-20,2021-05-10
349,كيان2,صندوق س. با درآمد ثابت كيان,21,2100000,2100000,28349,1,1,-28348,-100,1,-28348,-100,1,1,1400-2-20,2021-05-10
350,شپاكسا,پاكسان‌,21,305951,8052630320,27130,26320,26320,-810,-2.99,26990,-140,-0.52,26320,26320,1400-2-20,2021-05-10
351,حتايد,تايدواترخاورميانه,21,118837,2931708790,25430,24670,24670,-760,-2.99,25380,-50,-0.2,24670,24670,1400-2-20,2021-05-10
352,سپيدار,سپيدار سيستم آسيا,20,5947,339169304,58795,57032,57032,-1763,-3,58783,-12,-0.02,57032,57032,1400-2-20,2021-05-10
353,واتي,سرمايه‌ گذاري‌ آتيه‌ دماوند,20,265201,2612229850,10150,9850,9850,-300,-2.96,10130,-20,-0.2,9850,9850,1400-2-20,2021-05-10
354,كبافق,معادن‌ بافق‌,20,17278,809992640,48320,46880,46880,-1440,-2.98,48300,-20,-0.04,46880,46880,1400-2-20,2021-05-10
355,ولساپا,ليزينگ رايان‌ سايپا,20,178191,571102155,3304,3205,3205,-99,-3,3303,-1,-0.03,3205,3205,1400-2-20,2021-05-10
356,زپارس,ملي كشت و صنعت و دامپروري پارس,19,211536,27533525760,134180,130160,130160,-4020,-3,131810,-2370,-1.77,130160,130160,1400-2-20,2021-05-10
357,پيزد,مجتمع صنايع لاستيك يزد,19,5000,297770000,61395,59554,59554,-1841,-3,61384,-11,-0.02,59554,59554,1400-2-20,2021-05-10
358,شاروم,پتروشيمي اروميه,19,17701,331769843,19322,18743,18743,-579,-3,19318,-4,-0.02,18743,18743,1400-2-20,2021-05-10
359,سپيدما,صندوق س. سپيد دماوند-د,19,287435,2957078526,10282,10285,10286,4,0.04,10288,6,0.06,10285,10289,1400-2-20,2021-05-10
360,درازك,دارويي‌ رازك‌,19,13856,406812160,30260,29360,29360,-900,-2.97,30250,-10,-0.03,29360,29360,1400-2-20,2021-05-10
361,وپترو,سرمايه‌گذاري صنايع پتروشيمي‌,19,84335,1118282100,13670,13260,13260,-410,-3,13660,-10,-0.07,13260,13260,1400-2-20,2021-05-10
362,فرابورس,فرابورس ايران,19,11641,353199581,31279,30341,30341,-938,-3,31272,-7,-0.02,30341,30341,1400-2-20,2021-05-10
363,ضپاس2001,اختيارخ وپارس-2500-1400/02/29,18,515,29902000,51,45,60,9,17.65,58,7,13.73,45,90,1400-2-20,2021-05-10
364,اتكام,شركت بيمه اتكايي امين,18,122155,562523775,4747,4605,4605,-142,-2.99,4745,-2,-0.04,4605,4605,1400-2-20,2021-05-10
365,هاي وب,داده گسترعصرنوين-هاي وب,18,66501,675650160,10470,10160,10160,-310,-2.96,10470,0,0,10160,10160,1400-2-20,2021-05-10
366,سبهان,سيمان‌ بهبهان‌,17,892,119206880,142160,133640,133640,-8520,-5.99,142140,-20,-0.01,133640,133640,1400-2-20,2021-05-10
367,اخزا914,اسنادخزانه-م14بودجه99-021025,17,19630,11385185612,580788,579100,580611,-177,-0.03,579989,-799,-0.14,579100,581000,1400-2-20,2021-05-10
368,شوينده,مديريت صنعت شوينده ت.ص.بهشهر,17,23382,584550000,25770,25000,25000,-770,-2.99,25760,-10,-0.04,25000,25000,1400-2-20,2021-05-10
369,حريل,ريل پردازسير,17,45577,243700219,5512,5347,5347,-165,-2.99,5511,-1,-0.02,5347,5347,1400-2-20,2021-05-10
370,ضشنا2003,اختيارخ شپنا-14000-1400/02/27,17,707,707000,1,1,1,0,0,1,0,0,1,1,1400-2-20,2021-05-10
371,اخزا814,اسنادخزانه-م14بودجه98-010318,17,5889,4730001266,802840,803023,803105,265,0.03,803193,353,0.04,803023,804000,1400-2-20,2021-05-10
372,ثشاهد,سرمايه‌ گذاري‌ شاهد,16,10345,174520150,17390,16870,16870,-520,-2.99,17390,0,0,16870,16870,1400-2-20,2021-05-10
373,ثباغ,شهر سازي و خانه سازي باغميشه,16,52651,772600774,15127,14674,14674,-453,-2.99,15120,-7,-0.05,14674,14674,1400-2-20,2021-05-10
374,زقيام,كشت و دام قيام اصفهان,16,169305,4752222045,28937,28069,28069,-868,-3,28852,-85,-0.29,28069,28069,1400-2-20,2021-05-10
375,لپارس,پارس‌ الكتريك‌,16,1482,130890240,91050,88320,88320,-2730,-3,91040,-10,-0.01,88320,88320,1400-2-20,2021-05-10
376,تايرا,تراكتورسازي‌ايران‌,16,51005,1333270700,26940,26140,26140,-800,-2.97,26920,-20,-0.07,26140,26140,1400-2-20,2021-05-10
377,دتوليد,داروسازي توليد دارو,16,44747,1153174937,26568,25771,25771,-797,-3,26549,-19,-0.07,25771,25771,1400-2-20,2021-05-10
378,تكمبا,كمباين‌ سازي‌ ايران‌,16,136109,1035789490,7840,7610,7610,-230,-2.93,7840,0,0,7610,7610,1400-2-20,2021-05-10
379,ضشنا2000,اختيارخ شپنا-9000-1400/02/27,16,369,213820000,380,140,885,505,132.89,579,199,52.37,140,888,1400-2-20,2021-05-10
380,تليسه,دامداري تليسه نمونه,16,65395,275901505,4349,4219,4219,-130,-2.99,4348,-1,-0.02,4219,4219,1400-2-20,2021-05-10
381,رتاپ,تجارت الكترونيك  پارسيان,16,181495,1210571650,6870,6670,6670,-200,-2.91,6860,-10,-0.15,6670,6670,1400-2-20,2021-05-10
382,اخزا808,اسنادخزانه-م8بودجه98-000817,16,5868,5303778314,903842,903186,903901,59,0.01,903848,6,0,903186,904600,1400-2-20,2021-05-10
383,دامين,داروسازي‌ امين‌,15,40586,206176880,5230,5080,5080,-150,-2.87,5230,0,0,5080,5080,1400-2-20,2021-05-10
384,اخزا907,اسنادخزانه-م7بودجه99-020704,15,73575,45622623752,618524,621490,617019,-1505,-0.24,620083,1559,0.25,617019,621490,1400-2-20,2021-05-10
385,بساما,بيمه سامان,15,600633,12633113889,21683,21033,21033,-650,-3,21514,-169,-0.78,21033,21033,1400-2-20,2021-05-10
386,پرديس,سرمايه گذاري پرديس,15,65027,342692290,5430,5270,5270,-160,-2.95,5430,0,0,5270,5270,1400-2-20,2021-05-10
387,اخزا809,اسنادخزانه-م9بودجه98-000923,15,11861,10536771472,887183,886203,886202,-981,-0.11,888354,1171,0.13,886202,892000,1400-2-20,2021-05-10
388,غمينو,شركت صنايع غذايي مينو شرق,15,13428,148768812,11421,11079,11079,-342,-2.99,11420,-1,-0.01,11079,11079,1400-2-20,2021-05-10
389,ضپيك7041,اختيارخ تاپيكو-7070-00/07/18,15,866,1400800000,1600,1600,1800,200,12.5,1618,18,1.13,1600,1800,1400-2-20,2021-05-10
390,دپارس,پارس‌ دارو,15,4018,185551240,47600,46180,46180,-1420,-2.98,47590,-10,-0.02,46180,46180,1400-2-20,2021-05-10
391,اخزا818,اسنادخزانه-م18بودجه98-010614,15,5722,4377178520,765227,763500,764800,-427,-0.06,764973,-254,-0.03,762002,766690,1400-2-20,2021-05-10
392,كرازي,كارخانجات‌توليدي‌شيشه‌رازي‌,15,27085,589911300,22450,21780,21780,-670,-2.98,22440,-10,-0.04,21780,21780,1400-2-20,2021-05-10
393,اخزا821,اسنادخزانه-م21بودجه98-020906,14,10689,6402719800,599377,598000,600000,623,0.1,599001,-376,-0.06,598000,601990,1400-2-20,2021-05-10
394,زگلدشت,كشت و دام گلدشت نمونه اصفهان,14,110598,1496612136,13950,13532,13532,-418,-3,13937,-13,-0.09,13532,13532,1400-2-20,2021-05-10
395,ولپارس,ليزينگ پارسيان,14,169024,816723968,4981,4832,4832,-149,-2.99,4978,-3,-0.06,4832,4832,1400-2-20,2021-05-10
396,بذر,صندوق س بذر اميد آفرين-سهام,14,10209,925008660,90210,89330,90060,-150,-0.17,90610,400,0.44,89330,92000,1400-2-20,2021-05-10
397,رطب0002پ01,رطب مضافتي0002افشارتعاون بم(پ),13,1017,156682810,155981,154400,154400,-1581,-1.01,154064,-1917,-1.23,148182,154400,1400-2-20,2021-05-10
398,وآيند,بانك  آينده,13,180561,2895656757,16364,16037,16037,-327,-2,16354,-10,-0.06,16037,16037,1400-2-20,2021-05-10
399,وثنو,سرمايه گذاري ساختماني نوين,13,147815,683940005,4721,4627,4627,-94,-1.99,4718,-3,-0.06,4627,4627,1400-2-20,2021-05-10
400,ورنا,سرمايه‌گذاري‌ رنا(هلدينگ‌,13,122626,651144060,5470,5310,5310,-160,-2.93,5470,0,0,5310,5310,1400-2-20,2021-05-10
401,وپخش,داروپخش‌ (هلدينگ‌,13,5121,503957610,101450,98410,98410,-3040,-3,101420,-30,-0.03,98410,98410,1400-2-20,2021-05-10
402,اخزا904,اسنادخزانه-م4بودجه99-011215,13,20185,14007109008,696072,695900,694186,-1886,-0.27,693937,-2135,-0.31,692700,695900,1400-2-20,2021-05-10
403,فروس,فروسيليس‌ ايران‌,13,97681,500126720,5270,5120,5120,-150,-2.85,5270,0,0,5120,5120,1400-2-20,2021-05-10
404,اخزا817,اسنادخزانه-م17بودجه98-010512,12,10964,8520497165,779502,776546,777300,-2202,-0.28,777134,-2368,-0.3,776546,777301,1400-2-20,2021-05-10
405,غپينو,پارس‌ مينو,12,32680,200982000,6340,6150,6150,-190,-3,6340,0,0,6150,6150,1400-2-20,2021-05-10
406,ضترا8056,اختيارخ شتران-2558-1400/08/09,12,140,293700000,2200,2000,2500,300,13.64,2098,-102,-4.64,2000,2500,1400-2-20,2021-05-10
407,وپست,پست بانك ايران,12,27201,535587690,20290,19690,19690,-600,-2.96,20280,-10,-0.05,19690,19690,1400-2-20,2021-05-10
408,خعمرا,توسعه و عمران شهرستان نائين,12,28560,669189360,22749,23431,23431,682,3,22771,22,0.1,23431,23431,1400-2-20,2021-05-10
409,سيستم,همكاران سيستم,12,10741,267128670,25630,24870,24870,-760,-2.97,25630,0,0,24870,24870,1400-2-20,2021-05-10
410,وملي,گروه‌ صنعتي‌ ملي‌ (هلدينگ‌,12,1306,215934040,170450,165340,165340,-5110,-3,170430,-20,-0.01,165340,165340,1400-2-20,2021-05-10
411,ودي,بيمه  دي,12,63298,1282164288,20882,20256,20256,-626,-3,20865,-17,-0.08,20256,20256,1400-2-20,2021-05-10
412,باران,بيمه زندگي باران50%تاديه,12,144980,560637660,3755,3867,3867,112,2.98,3758,3,0.08,3867,3867,1400-2-20,2021-05-10
413,الماس,صندوق س.امين تدبيرگران فردا-س,12,2007,212982632,106000,106000,106430,430,0.41,106120,120,0.11,103615,107620,1400-2-20,2021-05-10
414,قجام,فرآوردههاي غذايي وقندتربت‌جام‌,12,620118,9607488174,16138,15493,15493,-645,-4,15493,-645,-4,15493,15493,1400-2-20,2021-05-10
415,ساوه,سيمان ساوه,12,5077,274833241,55807,54133,54133,-1674,-3,55798,-9,-0.02,54133,54133,1400-2-20,2021-05-10
416,حفارس,حمل و نقل بين المللي خليج فارس,11,31956,149554080,4824,4680,4680,-144,-2.99,4824,0,0,4680,4680,1400-2-20,2021-05-10
417,ضسپا3000,اختيارخ خساپا-1400-1400/03/26,11,118,48807000,400,421,400,0,0,414,14,3.5,400,450,1400-2-20,2021-05-10
418,فزرين,زرين معدن آسيا,11,26264,686593488,26950,26142,26142,-808,-3,26939,-11,-0.04,26142,26142,1400-2-20,2021-05-10
419,لكما,كارخانجات‌مخابراتي‌ايران‌,11,71279,426533536,6106,5984,5984,-122,-2,6103,-3,-0.05,5984,5984,1400-2-20,2021-05-10
420,وآرين,شركت توسعه اقتصادي آرين,11,47676,163099596,3490,3421,3421,-69,-1.98,3489,-1,-0.03,3421,3421,1400-2-20,2021-05-10
421,سقاين,سيمان‌ قائن‌,11,1700,108409000,65740,63770,63770,-1970,-3,65740,0,0,63770,63770,1400-2-20,2021-05-10
422,غشصفا,شيرپاستوريزه‌پگاه‌اصفهان‌,11,101300,2751308000,28000,27160,27160,-840,-3,27950,-50,-0.18,27160,27160,1400-2-20,2021-05-10
423,سخند,صندوق س.سپهرخبرگان نفت-د,11,73760,739555840,10021,10025,10026,5,0.05,10027,6,0.06,10025,10030,1400-2-20,2021-05-10
424,تپكو,توليدتجهيزات‌سنگين‌هپكو,11,73194,380389218,5413,5197,5197,-216,-3.99,5411,-2,-0.04,5197,5197,1400-2-20,2021-05-10
425,دارو,كارخانجات‌داروپخش‌,11,1812,58763160,33430,32430,32430,-1000,-2.99,33430,0,0,32430,32430,1400-2-20,2021-05-10
426,ضپاس2002,اختيارخ وپارس-3000-1400/02/29,11,522,1044000,2,2,2,0,0,2,0,0,2,2,1400-2-20,2021-05-10
427,اطلس2,صندوق س.توسعه اندوخته آينده-س,11,110000,110000,192219,1,1,-192218,-100,1,-192218,-100,1,1,1400-2-20,2021-05-10
428,كهمدا,شيشه‌ همدان‌,10,10202,100387680,10140,9840,9840,-300,-2.96,10140,0,0,9840,9840,1400-2-20,2021-05-10
429,اخزا813,اسنادخزانه-م13بودجه98-010219,10,11877,9712848062,817384,817501,818011,627,0.08,817786,402,0.05,817500,818011,1400-2-20,2021-05-10
430,اخزا806,اسنادخزانه-م6بودجه98-000519,10,21069,20016193024,950005,950000,949052,-953,-0.1,950030,25,0,949023,952500,1400-2-20,2021-05-10
431,خشرق,الكتريك‌ خودرو شرق‌,10,23544,341388000,14940,14500,14500,-440,-2.95,14940,0,0,14500,14500,1400-2-20,2021-05-10
432,ضشنا8000,اختيارخ شپنا-5800-1400/08/16,10,155,471895000,2651,3100,3200,549,20.71,3044,393,14.82,2999,3200,1400-2-20,2021-05-10
433,كوثر,بيمه كوثر,10,14750,209877750,14669,14229,14229,-440,-3,14667,-2,-0.01,14229,14229,1400-2-20,2021-05-10
434,سجام,مجتمع سيمان غرب آسيا,10,19378,79372288,4266,4096,4096,-170,-3.98,4265,-1,-0.02,4096,4096,1400-2-20,2021-05-10
435,بميلا,توسعه بازرگاني آهن وفولادميلاد,10,12150,163368900,14006,13446,13446,-560,-4,14001,-5,-0.04,13446,13446,1400-2-20,2021-05-10
436,غبهنوش,بهنوش‌ ايران‌,10,5941,412186580,71520,69380,69380,-2140,-2.99,71500,-20,-0.03,69380,69380,1400-2-20,2021-05-10
437,شستان,پتروشيمي گلستان,10,156560,578958880,3852,3698,3698,-154,-4,3843,-9,-0.23,3698,3698,1400-2-20,2021-05-10
438,ضترا3004,اختيارخ شتران-10000-1400/03/09,10,87,3548000,75,41,30,-45,-60,41,-34,-45.33,30,50,1400-2-20,2021-05-10
439,ضترا8055,اختيارخ شتران-2118-1400/08/09,10,44,132100000,3150,2900,3400,250,7.94,3002,-148,-4.7,2900,3400,1400-2-20,2021-05-10
440,غبشهر,صنعتي‌ بهشهر,10,9960,244617600,25310,24560,24560,-750,-2.96,25310,0,0,24560,24560,1400-2-20,2021-05-10
441,اراد50,مرابحه عام دولت5-ش.خ0302,10,109000,109000000000,1000000,1000000,1000000,0,0,1000000,0,0,1000000,1000000,1400-2-20,2021-05-10
442,اعتلا,شركت سرمايه گذاري اعتلاء البرز,10,22840,160862120,7260,7043,7043,-217,-2.99,7259,-1,-0.01,7043,7043,1400-2-20,2021-05-10
443,وتعاون,بيمه  تعاون,10,15258,92341416,6304,6052,6052,-252,-4,6303,-1,-0.02,6052,6052,1400-2-20,2021-05-10
444,چخزر,صنايع چوب خزر كاسپين,9,3399,176533863,53543,51937,51937,-1606,-3,53537,-6,-0.01,51937,51937,1400-2-20,2021-05-10
445,كمنگنز,معادن‌منگنزايران‌,9,3344,284975680,87850,85220,85220,-2630,-2.99,87830,-20,-0.02,85220,85220,1400-2-20,2021-05-10
446,خرينگ,رينگ‌سازي‌مشهد,9,14191,721470440,52410,50840,50840,-1570,-3,52390,-20,-0.04,50840,50840,1400-2-20,2021-05-10
447,مفاخر,توسعه فناوري اطلاعات خوارزمي,9,260100,15600017700,61831,59977,59977,-1854,-3,61223,-608,-0.98,59977,59977,1400-2-20,2021-05-10
448,دسبحان,سبحان دارو,8,20154,367608960,18800,18240,18240,-560,-2.98,18800,0,0,18240,18240,1400-2-20,2021-05-10
449,وملت,سرمايه گذاري ملت,8,214673,922664554,4385,4298,4298,-87,-1.98,4377,-8,-0.18,4298,4298,1400-2-20,2021-05-10
450,وبيمه,سرمايه‌ گذاري‌ صنعت‌ بيمه‌,8,16625,45153500,2799,2716,2716,-83,-2.97,2799,0,0,2716,2716,1400-2-20,2021-05-10
451,وآفري,بيمه كارآفرين,8,31818,103631226,3323,3257,3257,-66,-1.99,3323,0,0,3257,3257,1400-2-20,2021-05-10
452,بنيرو,نيروترانس‌,8,16208,236312640,15030,14580,14580,-450,-2.99,15030,0,0,14580,14580,1400-2-20,2021-05-10
453,قثابت,قند ثابت‌ خراسان‌,8,3103,203432680,67580,65560,65560,-2020,-2.99,67570,-10,-0.01,65560,65560,1400-2-20,2021-05-10
454,وسديد,گروه ‌صنعتي‌سديد,8,47294,134504136,2902,2844,2844,-58,-2,2902,0,0,2844,2844,1400-2-20,2021-05-10
455,هپارس102,اختيارف ت پارس-157010-01/02/05,8,17982,88525386,4301,4923,4923,622,14.46,4923,622,14.46,4923,4923,1400-2-20,2021-05-10
456,كي بي سي,شركت كي بي سي,8,7973,200321625,25902,25125,25125,-777,-3,25899,-3,-0.01,25125,25125,1400-2-20,2021-05-10
457,اخزا713,اسنادخزانه-م13بودجه97-000518,8,2183,2076902500,950395,950200,952500,2105,0.22,951398,1003,0.11,949601,952500,1400-2-20,2021-05-10
458,ضصاد3002,اختيارخ وبصادر-2500-1400/03/12,8,236,17848000,90,70,70,-20,-22.22,76,-14,-15.56,70,90,1400-2-20,2021-05-10
459,اخزا811,اسنادخزانه-م11بودجه98-001013,7,35314,30997612207,878852,877999,877040,-1812,-0.21,877771,-1081,-0.12,877040,878000,1400-2-20,2021-05-10
460,خفناور,مهندسي صنعتي روان فن آور,7,8378,397460698,48409,47441,47441,-968,-2,48389,-20,-0.04,47441,47441,1400-2-20,2021-05-10
461,سمگا,گروه سرمايه گذاري ميراث فرهنگي,7,5223,145230738,28665,27806,27806,-859,-3,28663,-2,-0.01,27806,27806,1400-2-20,2021-05-10
462,اخزا721,اسنادخزانه-م21بودجه97-000728,7,803,733684627,913125,914425,912410,-715,-0.08,913679,554,0.06,912401,914426,1400-2-20,2021-05-10
463,شجم,صنايع پتروشيمي تخت جمشيد,7,5178,52054434,10258,10053,10053,-205,-2,10258,0,0,10053,10053,1400-2-20,2021-05-10
464,شكربن,كربن‌ ايران‌,7,1200,100956000,86730,84130,84130,-2600,-3,86720,-10,-0.01,84130,84130,1400-2-20,2021-05-10
465,ضمخا7075,اختيارخ اخابر-8700-1400/07/28,7,62,74110000,1092,1200,1200,108,9.89,1195,103,9.43,1010,1200,1400-2-20,2021-05-10
466,جوين,كشت و صنعت جوين,7,21950,107028200,4975,4876,4876,-99,-1.99,4974,-1,-0.02,4876,4876,1400-2-20,2021-05-10
467,اراد33,مرابحه عام دولت3-ش.خ 0303,7,29800,25983155800,916549,872032,871721,-44828,-4.89,871918,-44631,-4.87,871721,872032,1400-2-20,2021-05-10
468,اخزا905,اسنادخزانه-م5بودجه99-020218,7,13060,8731065627,667532,668000,665110,-2422,-0.36,668535,1003,0.15,665069,669500,1400-2-20,2021-05-10
469,ضترا8058,اختيارخ شتران-3442-1400/08/09,7,270,326000000,1256,1200,1200,-56,-4.46,1207,-49,-3.9,1200,1300,1400-2-20,2021-05-10
470,برن0003پ01,برنج طارم0003تجارت مازندران(پ),7,501,141382000,281046,280000,282000,954,0.34,282200,1154,0.41,280000,285000,1400-2-20,2021-05-10
471,ضپاس2000,اختيارخ وپارس-2000-1400/02/29,7,7,3542000,372,550,313,-59,-15.86,506,134,36.02,313,550,1400-2-20,2021-05-10
472,پكوير,كوير تاير,7,10608,132387840,12860,12480,12480,-380,-2.95,12860,0,0,12480,12480,1400-2-20,2021-05-10
473,كپارس,كاشي‌ پارس‌,7,1660,247423000,153650,149050,149050,-4600,-2.99,153630,-20,-0.01,149050,149050,1400-2-20,2021-05-10
474,تكنو,تكنوتار,7,40000,852000000,21950,21300,21300,-650,-2.96,21940,-10,-0.05,21300,21300,1400-2-20,2021-05-10
475,بخاور,بيمه زندگي خاورميانه,7,38000,249394000,6765,6563,6563,-202,-2.99,6764,-1,-0.01,6563,6563,1400-2-20,2021-05-10
476,تملي612,تسهيلات مسكن بانك ملي-اسفند96,7,135,81120924,572309,600924,600924,28615,5,600896,28587,5,600500,600924,1400-2-20,2021-05-10
477,اخزا812,اسنادخزانه-م12بودجه98-001111,6,6138,5327335329,867094,867501,867500,406,0.05,867927,833,0.1,867500,871999,1400-2-20,2021-05-10
478,هجرت,پخش هجرت,6,3200,87148800,28076,27234,27234,-842,-3,28074,-2,-0.01,27234,27234,1400-2-20,2021-05-10
479,كسرا,سراميك‌هاي‌صنعتي‌اردكان‌,6,28100,567058000,20800,20180,20180,-620,-2.98,20790,-10,-0.05,20180,20180,1400-2-20,2021-05-10
480,قيستو,شركت قند بيستون,6,4780,90284640,19273,18888,18888,-385,-2,19269,-4,-0.02,18888,18888,1400-2-20,2021-05-10
481,وگردش,بانك گردشگري,6,11420,181463800,16214,15890,15890,-324,-2,16213,-1,-0.01,15890,15890,1400-2-20,2021-05-10
482,ضفلا3005,اختيارخ فولاد-9986-1400/03/19,6,210,26363000,75,155,150,75,100,126,51,68,98,155,1400-2-20,2021-05-10
483,هنوري102,اختيارف ت نوري59561-01/02/15,6,38556,234034920,4400,6070,6070,1670,37.95,6070,1670,37.95,6070,6070,1400-2-20,2021-05-10
484,ضپاس2004,اختيارخ وپارس-4000-1400/02/29,6,114,264000,5,5,1,-4,-80,2,-3,-60,1,5,1400-2-20,2021-05-10
485,اخزا906,اسنادخزانه-م6بودجه99-020321,6,7078,5379817252,748609,786039,759999,11390,1.52,760076,11467,1.53,759998,786039,1400-2-20,2021-05-10
486,ضفلا3004,اختيارخ فولاد-8560-1400/03/19,6,21,21279000,300,289,1100,800,266.67,1013,713,237.67,289,1100,1400-2-20,2021-05-10
487,سباقر,سيمان باقران,6,15653,244249412,15922,15604,15604,-318,-2,15918,-4,-0.03,15604,15604,1400-2-20,2021-05-10
488,ضجار2005,اختيارخ وتجارت-4000-1400/02/22,6,297,359000,7,1,3,-4,-57.14,1,-6,-85.71,1,7,1400-2-20,2021-05-10
489,فالوم,آلومتك‌,6,2997,104394501,36284,34833,34833,-1451,-4,36276,-8,-0.02,34833,34833,1400-2-20,2021-05-10
490,وآوا,سرمايه گذاري آوا نوين,6,5900,50899300,8893,8627,8627,-266,-2.99,8893,0,0,8627,8627,1400-2-20,2021-05-10
491,كحافظ,كاشي‌ وسراميك‌ حافظ‌,6,7739,90004570,11980,11630,11630,-350,-2.92,11980,0,0,11630,11630,1400-2-20,2021-05-10
492,ثفارس,عمران‌وتوسعه‌فارس‌,6,17524,169982800,10000,9700,9700,-300,-3,10000,0,0,9700,9700,1400-2-20,2021-05-10
493,رنيك,جنرال مكانيك,6,7638,165286320,22309,21640,21640,-669,-3,22307,-2,-0.01,21640,21640,1400-2-20,2021-05-10
494,دشيمي,شيمي‌ داروئي‌ داروپخش‌,6,15430,457190900,30540,29630,29630,-910,-2.98,30530,-10,-0.03,29630,29630,1400-2-20,2021-05-10
495,غنوش,نوش‌ مازندران‌,6,3182,175519120,56860,55160,55160,-1700,-2.99,56850,-10,-0.02,55160,55160,1400-2-20,2021-05-10
496,تملي709,تسهيلات مسكن ب. ملي-آذر97,6,45,37207980,787471,826844,826844,39373,5,826844,39373,5,826844,826844,1400-2-20,2021-05-10
497,صگل039,صكوك اجاره گل گهر039-3ماهه20%,6,55000,55000000000,1000000,1000000,1000000,0,0,1000000,0,0,1000000,1000000,1400-2-20,2021-05-10
498,زكوثر,سرمايه گذاري كشاورزي كوثر,6,4523,94937770,21630,20990,20990,-640,-2.96,21630,0,0,20990,20990,1400-2-20,2021-05-10
499,ضمخا7066,اختيارخ اخابر-11700-1400/07/28,6,88,52972000,610,602,850,240,39.34,602,-8,-1.31,599,850,1400-2-20,2021-05-10
500,قنيشا,قند  نيشابور,6,1851,115650480,64410,62480,62480,-1930,-3,64410,0,0,62480,62480,1400-2-20,2021-05-10
501,آپ,آسان پرداخت پرشين,6,3530,59621700,17410,16890,16890,-520,-2.99,17410,0,0,16890,16890,1400-2-20,2021-05-10
502,غگز,گز سكه,6,300000,6060000000,20200,20200,20200,0,0,20200,0,0,20200,20200,1400-2-20,2021-05-10
503,وجامي,سرمايه گذاري جامي,6,21950,324399050,15080,14779,14779,-301,-2,15075,-5,-0.03,14779,14779,1400-2-20,2021-05-10
504,دتوزيع,توزيع دارو پخش,6,2217,108264978,50344,48834,48834,-1510,-3,50341,-3,-0.01,48834,48834,1400-2-20,2021-05-10
505,لخزر,پارس‌ خزر,5,177,32019300,186490,180900,180900,-5590,-3,186490,0,0,180900,180900,1400-2-20,2021-05-10
506,فپنتا,سپنتا,5,281,110635320,405890,393720,393720,-12170,-3,405860,-30,-0.01,393720,393720,1400-2-20,2021-05-10
507,طلا2,صندوق س.پشتوانه طلاي لوتوس,5,500000,500000,68270,1,1,-68269,-100,1,-68269,-100,1,1,1400-2-20,2021-05-10
508,رافزا,رايان هم افزا,5,365,37763630,106661,103462,103462,-3199,-3,106659,-2,0,103462,103462,1400-2-20,2021-05-10
509,وسگيلا,شركت س استان گيلان,5,116735,87201045,770,747,747,-23,-2.99,770,0,0,747,747,1400-2-20,2021-05-10
510,زبينا,كشاورزي و دامپروري بينالود,5,12893,48864470,3907,3790,3790,-117,-2.99,3907,0,0,3790,3790,1400-2-20,2021-05-10
511,بنو,بيمه تجارت نو,5,1605,49612155,31866,30911,30911,-955,-3,31865,-1,0,30911,30911,1400-2-20,2021-05-10
512,تملي702,تسهيلات مسكن ب. ملي-ارديبهشت97,5,116,52376500,445000,467250,467250,22250,5,451522,6522,1.47,422750,467250,1400-2-20,2021-05-10
513,آكورد2,صندوق س. آرمان آتي كوثر-د,5,500000,500000,31982,1,1,-31981,-100,1,-31981,-100,1,1,1400-2-20,2021-05-10
514,تملي708,تسهيلات مسكن ب. ملي-آبان97,5,44,33586344,726978,763326,763326,36348,5,763326,36348,5,763326,763326,1400-2-20,2021-05-10
515,شكف,كف,5,3668,380808092,105937,103819,103819,-2118,-2,105859,-78,-0.07,103819,103819,1400-2-20,2021-05-10
516,غپاك,لبنيات‌ پاك‌,5,2243,66818970,30710,29790,29790,-920,-3,30710,0,0,29790,29790,1400-2-20,2021-05-10
517,قاسم,قاسم ايران,5,78345,992161080,13055,12664,12664,-391,-3,13047,-8,-0.06,12664,12664,1400-2-20,2021-05-10
518,ضفلا7003,اختيارخ فولاد-8160-1400/07/25,5,31,68400000,1,2400,2200,2199,219900,2206,2205,220500,2000,2400,1400-2-20,2021-05-10
519,شسينا,صنايع‌شيميايي‌سينا,5,341,43780990,132360,128390,128390,-3970,-3,132360,0,0,128390,128390,1400-2-20,2021-05-10
520,زشگزا,شير و گوشت زاگرس شهركرد,5,3642,29088654,8233,7987,7987,-246,-2.99,8233,0,0,7987,7987,1400-2-20,2021-05-10
521,زشريف,كشت وصنعت شريف آباد,5,14503,73298162,5210,5054,5054,-156,-2.99,5210,0,0,5054,5054,1400-2-20,2021-05-10
522,كيميا,معدني كيمياي زنجان گستران,5,19148,328579680,17690,17160,17160,-530,-3,17686,-4,-0.02,17160,17160,1400-2-20,2021-05-10
523,ختراك,ريخته‌گري‌ تراكتورسازي‌ ايران‌,5,32969,497502210,15550,15090,15090,-460,-2.96,15550,0,0,15090,15090,1400-2-20,2021-05-10
524,كفرا,فراورده‌ هاي‌ نسوزايران‌,5,4971,228566580,47400,45980,45980,-1420,-3,47390,-10,-0.02,45980,45980,1400-2-20,2021-05-10
525,دفرا,فرآورده‌هاي‌ تزريقي‌ ايران‌,5,70000,1771700000,26090,25310,25310,-780,-2.99,26060,-30,-0.11,25310,25310,1400-2-20,2021-05-10
526,زعف0008پ12,زعفران0008پوشالمعمول سحرخيز(پ),5,844,75317140,85415,83000,89685,4270,5,89238,3823,4.48,83000,89685,1400-2-20,2021-05-10
527,فولاي,صنايع فولاد آلياژي يزد,5,2000,98048000,50540,49024,49024,-1516,-3,50537,-3,-0.01,49024,49024,1400-2-20,2021-05-10
528,همبين102,اختيارف ت مبين17952-01/02/10,5,120006,97324866,732,811,811,79,10.79,811,79,10.79,811,811,1400-2-20,2021-05-10
529,اخزا722,اسنادخزانه-م22بودجه97-000428,5,6294,6058013200,961523,962400,963000,1477,0.15,962506,983,0.1,962400,963000,1400-2-20,2021-05-10
530,ضترا3001,اختيارخ شتران-7000-1400/03/09,5,32,32000000,700,1000,1000,300,42.86,1000,300,42.86,1000,1000,1400-2-20,2021-05-10
531,فرآور,فرآوري‌موادمعدني‌ايران‌,5,2259,76580100,34940,33900,33900,-1040,-2.98,34940,0,0,33900,33900,1400-2-20,2021-05-10
532,زعف0008پ15,زعفران0008پوشالمعمول طلاسرخ(پ),4,660,58726890,87700,83146,89685,1985,2.26,88980,1280,1.46,83146,89685,1400-2-20,2021-05-10
533,ضجار2001,اختيارخ وتجارت-2000-1400/02/22,4,133,55942000,379,444,409,30,7.92,421,42,11.08,409,444,1400-2-20,2021-05-10
534,اخزا819,اسنادخزانه-م19بودجه98-020322,4,678,492183799,730500,693975,730900,400,0.05,725935,-4565,-0.62,693975,730900,1400-2-20,2021-05-10
535,زماهان,مجتمع توليد گوشت مرغ ماهان,4,2247,44899554,20600,19982,19982,-618,-3,20599,-1,0,19982,19982,1400-2-20,2021-05-10
536,زنجان,صنايع كشاورزي وكود زنجان,4,5601,50274576,9349,8976,8976,-373,-3.99,9348,-1,-0.01,8976,8976,1400-2-20,2021-05-10
537,خمحور,توليدمحورخودرو,4,1198,73784820,63490,61590,61590,-1900,-2.99,63490,0,0,61590,61590,1400-2-20,2021-05-10
538,ثاصفا,شركت‌ ساختمان‌ اصفهان‌,4,2807,74857076,27779,26668,26668,-1111,-4,27775,-4,-0.01,26668,26668,1400-2-20,2021-05-10
539,ريشمك,توليد و صادرات ريشمك,4,557,30562033,56565,54869,54869,-1696,-3,56564,-1,0,54869,54869,1400-2-20,2021-05-10
540,سنير,سيمان‌ سفيد ني‌ريز,4,125,30233750,249350,241870,241870,-7480,-3,249350,0,0,241870,241870,1400-2-20,2021-05-10
541,غگلپا,شير پاستوريزه پگاه گلپايگان,4,2162,137929114,65770,63797,63797,-1973,-3,65764,-6,-0.01,63797,63797,1400-2-20,2021-05-10
542,ضجار7039,اختيارخ وتجارت-1997-1400/07/21,4,74,50090000,610,690,680,70,11.48,677,67,10.98,670,690,1400-2-20,2021-05-10
543,خمهر,مهركام‌پارس‌,4,28931,68219298,2430,2358,2358,-72,-2.96,2430,0,0,2358,2358,1400-2-20,2021-05-10
544,كپرور,فرآوري زغال سنگ پروده طبس,4,984,34797192,36456,35363,35363,-1093,-3,36455,-1,0,35363,35363,1400-2-20,2021-05-10
545,وزمين,بانك ايران زمين,4,12328,153557568,12975,12456,12456,-519,-4,12971,-4,-0.03,12456,12456,1400-2-20,2021-05-10
546,كاسپين,داروسازي كاسپين تامين,4,40956,1026521184,25839,25064,25064,-775,-3,25823,-16,-0.06,25064,25064,1400-2-20,2021-05-10
547,سدور,سيمان‌ دورود,4,2278,42803620,19370,18790,18790,-580,-2.99,19370,0,0,18790,18790,1400-2-20,2021-05-10
548,غگرجي,بيسكويت‌  گرجي‌,4,31000,547460000,18200,17660,17660,-540,-2.97,18190,-10,-0.05,17660,17660,1400-2-20,2021-05-10
549,بزاگرس,نيروگاه زاگرس كوثر,4,3289,22825660,7154,6940,6940,-214,-2.99,7154,0,0,6940,6940,1400-2-20,2021-05-10
550,شپاس,نفت پاسارگاد,4,2313,47844405,21324,20685,20685,-639,-3,21323,-1,0,20685,20685,1400-2-20,2021-05-10
551,شفا,سرمايه گذاري شفادارو,4,1018,45972880,46550,45160,45160,-1390,-2.99,46550,0,0,45160,45160,1400-2-20,2021-05-10
552,ضفار8047,اختيارخ فارس-4400-1400/08/05,4,40,152000000,3700,3800,3800,100,2.7,3800,100,2.7,3800,3800,1400-2-20,2021-05-10
553,ضصاد3001,اختيارخ وبصادر-2000-1400/03/12,4,35,10952000,307,315,319,12,3.91,313,6,1.95,300,319,1400-2-20,2021-05-10
554,دتماد,توليدمواداوليه‌داروپخش‌,4,3599,154721010,44310,42990,42990,-1320,-2.98,44310,0,0,42990,42990,1400-2-20,2021-05-10
555,ضپنا8001,اختيارخ رمپنا-11850-1400/08/05,4,16,64200000,4300,3600,4200,-100,-2.33,4012,-288,-6.7,3600,4200,1400-2-20,2021-05-10
556,خاذين,سايپاآذين‌,4,25548,117725184,4750,4608,4608,-142,-2.99,4750,0,0,4608,4608,1400-2-20,2021-05-10
557,سمايه,بانك سرمايه,4,17450,85016400,4971,4872,4872,-99,-1.99,4971,0,0,4872,4872,1400-2-20,2021-05-10
558,وگستر,گسترش سرمايه گذاري ايرانيان,4,2061,37932705,18974,18405,18405,-569,-3,18974,0,0,18405,18405,1400-2-20,2021-05-10
559,قصفها,قنداصفهان‌,4,214,32515160,156630,151940,151940,-4690,-2.99,156630,0,0,151940,151940,1400-2-20,2021-05-10
560,شلعاب,لعابيران‌,4,34794,739720440,21910,21260,21260,-650,-2.97,21900,-10,-0.05,21260,21260,1400-2-20,2021-05-10
561,فلوله,لوله‌وماشين‌سازي‌ايران‌,4,22697,487758530,22150,21490,21490,-660,-2.98,22140,-10,-0.05,21490,21490,1400-2-20,2021-05-10
562,فلات,گروه صنايع معادن فلات ايرانيان,4,2017,30293323,15644,15019,15019,-625,-4,15643,-1,-0.01,15019,15019,1400-2-20,2021-05-10
563,تكشا,گسترش‌صنايع‌وخدمات‌كشاورزي‌,4,9461,426312660,46450,45060,45060,-1390,-2.99,46440,-10,-0.02,45060,45060,1400-2-20,2021-05-10
564,اپرداز,آتيه داده پرداز,4,3905,80774925,21324,20685,20685,-639,-3,21323,-1,0,20685,20685,1400-2-20,2021-05-10
565,لابسا,آبسال‌,4,2115,108499500,52880,51300,51300,-1580,-2.99,52880,0,0,51300,51300,1400-2-20,2021-05-10
566,چفيبر,فيبر ايران‌,4,5193,69845850,13860,13450,13450,-410,-2.96,13860,0,0,13450,13450,1400-2-20,2021-05-10
567,سخواف,سيمان مجد خواف,4,2000,33010000,16841,16505,16505,-336,-2,16840,-1,-0.01,16505,16505,1400-2-20,2021-05-10
568,كباده,توليد خاك نسوزاستقلال آباده,4,15060,135796020,8755,9017,9017,262,2.99,8757,2,0.02,9017,9017,1400-2-20,2021-05-10
569,سحرا022,سلف موازي نيروي برق حرارتي022,4,700000,207989600000,292155,297128,297128,4973,1.7,297128,4973,1.7,297128,297128,1400-2-20,2021-05-10
570,مداران,داده‌پردازي‌ايران‌,4,11786,287224820,25120,24370,24370,-750,-2.99,25120,0,0,24370,24370,1400-2-20,2021-05-10
571,شتولي,تولي‌پرس‌,4,2298,80802276,35879,35162,35162,-717,-2,35873,-6,-0.02,35162,35162,1400-2-20,2021-05-10
572,فافزا,فولاد افزا سپاهان,3,649,31695862,49834,48838,48838,-996,-2,49832,-2,0,48838,48838,1400-2-20,2021-05-10
573,شزنگ,تجهيزنيروي‌زنگان‌,3,85,19136815,234519,225139,225139,-9380,-4,234510,-9,0,225139,225139,1400-2-20,2021-05-10
574,سكرد,سيمان كردستان,3,2434,23123000,9790,9500,9500,-290,-2.96,9790,0,0,9500,9500,1400-2-20,2021-05-10
575,ضترا3003,اختيارخ شتران-9000-1400/03/09,3,100,10000000,100,100,100,0,0,100,0,0,100,100,1400-2-20,2021-05-10
576,غصينو,صنعتي مينو,3,553,35939470,66999,64990,64990,-2009,-3,66998,-1,0,64990,64990,1400-2-20,2021-05-10
577,اخزا718,اسنادخزانه-م18بودجه97-000525,3,368,348335427,950687,946151,946990,-3697,-0.39,946564,-4123,-0.43,946151,946990,1400-2-20,2021-05-10
578,خموتور,موتورسازان‌تراكتورسازي‌ايران‌,3,2284,33186520,14970,14530,14530,-440,-2.94,14970,0,0,14530,14530,1400-2-20,2021-05-10
579,دفارا,داروسازي‌ فارابي‌,3,4371,273274920,64450,62520,62520,-1930,-2.99,64440,-10,-0.02,62520,62520,1400-2-20,2021-05-10
580,تاپكيش,تجارت الكترونيك پارسيان كيش,3,1216,21470912,18203,17657,17657,-546,-3,18203,0,0,17657,17657,1400-2-20,2021-05-10
581,تكنار,مجتمع معادن مس تكنار,3,199,22925994,117557,115206,115206,-2351,-2,117554,-3,0,115206,115206,1400-2-20,2021-05-10
582,ساينا,صنايع بهداشتي ساينا,3,140,20316520,149606,145118,145118,-4488,-3,149604,-2,0,145118,145118,1400-2-20,2021-05-10
583,كگاز,شيشه‌ و گاز,3,1138,20734360,18780,18220,18220,-560,-2.98,18780,0,0,18220,18220,1400-2-20,2021-05-10
584,دابور,داروسازي‌ ابوريحان‌,3,674,24850380,38010,36870,36870,-1140,-3,38010,0,0,36870,36870,1400-2-20,2021-05-10
585,ولبهمن,شركت بهمن ليزينگ,3,6709,49572801,7617,7389,7389,-228,-2.99,7617,0,0,7389,7389,1400-2-20,2021-05-10
586,ضفلا7001,اختيارخ فولاد-6020-1400/07/25,3,29,116950000,3391,4000,4050,659,19.43,4033,642,18.93,4000,4050,1400-2-20,2021-05-10
587,ضغدر3003,اختيارخ وغدير-9200-1400/03/26,3,80,95500000,1180,1150,1200,20,1.69,1194,14,1.19,1150,1200,1400-2-20,2021-05-10
588,دسبحا,گروه دارويي سبحان,3,960,17769600,19080,18510,18510,-570,-2.99,19080,0,0,18510,18510,1400-2-20,2021-05-10
589,آسام,صندوق س.آرمان سپهر آشنا-م,3,8060,826144780,102390,102000,102413,23,0.02,102499,109,0.11,102000,103000,1400-2-20,2021-05-10
590,غاذر,كشت‌وصنعت‌پياذر,3,724,39262520,55900,54230,54230,-1670,-2.99,55900,0,0,54230,54230,1400-2-20,2021-05-10
591,قشكر,شكرشاهرود,3,7400,27565000,3840,3725,3725,-115,-2.99,3840,0,0,3725,3725,1400-2-20,2021-05-10
592,ضترا3002,اختيارخ شتران-8000-1400/03/09,3,7,1800000,200,250,300,100,50,257,57,28.5,250,300,1400-2-20,2021-05-10
593,زعف0008پ10,زعفران0008نگين طلاي سرخ(پ),3,266,32503660,122866,122500,122010,-856,-0.7,122194,-672,-0.55,122010,122500,1400-2-20,2021-05-10
594,غشان,شيرپاستوريزه‌پگاه‌خراسان‌,3,6414,47848440,7690,7460,7460,-230,-2.99,7690,0,0,7460,7460,1400-2-20,2021-05-10
595,شستا004,اجاره تامين اجتماعي-نوين000523,3,18,18058900,990000,983000,1019490,29490,2.98,1003272,13272,1.34,983000,1019490,1400-2-20,2021-05-10
596,زدشت,كشت و صنعت دشت خرم دره,3,1479,42213618,29424,28542,28542,-882,-3,29423,-1,0,28542,28542,1400-2-20,2021-05-10
597,اخزا804,اسنادخزانه-م4بودجه98-000421,3,126,121629648,964010,964013,966498,2488,0.26,965315,1305,0.14,964013,966498,1400-2-20,2021-05-10
598,كسرام,پارس‌ سرام‌,3,7620,61569600,8320,8080,8080,-240,-2.88,8320,0,0,8080,8080,1400-2-20,2021-05-10
599,مرقام,ايران‌ارقام‌,3,1126,21326440,19520,18940,18940,-580,-2.97,19520,0,0,18940,18940,1400-2-20,2021-05-10
600,چافست,افست‌,3,1670,26903700,16600,16110,16110,-490,-2.95,16600,0,0,16110,16110,1400-2-20,2021-05-10
601,كترام,توليدي‌ كاشي‌ تكسرام‌,3,740,34839200,48530,47080,47080,-1450,-2.99,48530,0,0,47080,47080,1400-2-20,2021-05-10
602,خفولا,خدمات فني فولاد يزد,3,750,31968000,43493,42624,42624,-869,-2,43492,-1,0,42624,42624,1400-2-20,2021-05-10
603,كساوه,صنايع‌ كاشي‌ و سراميك‌ سينا,3,325,22246250,70560,68450,68450,-2110,-2.99,70560,0,0,68450,68450,1400-2-20,2021-05-10
604,وبهمن,سرمايه‌گذاري‌بهمن‌,3,2971,41148350,14270,13850,13850,-420,-2.94,14270,0,0,13850,13850,1400-2-20,2021-05-10
605,خنصير,مهندسي‌نصيرماشين‌,3,1262,132787640,108470,105220,105220,-3250,-3,108460,-10,-0.01,105220,105220,1400-2-20,2021-05-10
606,اميد,تامين سرمايه اميد,3,3199,24056480,7750,7520,7520,-230,-2.97,7750,0,0,7520,7520,1400-2-20,2021-05-10
607,ساروم,سيمان‌اروميه‌,3,1935,66544650,35450,34390,34390,-1060,-2.99,35450,0,0,34390,34390,1400-2-20,2021-05-10
608,ومعلم,بيمه معلم,3,5300,25636100,4986,4837,4837,-149,-2.99,4986,0,0,4837,4837,1400-2-20,2021-05-10
609,كطبس,ذغال‌سنگ‌ نگين‌ ط‌بس‌,3,1100,87153000,81680,79230,79230,-2450,-3,81680,0,0,79230,79230,1400-2-20,2021-05-10
610,وايرا,سرمايه گذاري صنايع ايران,3,5850,69954300,12202,11958,11958,-244,-2,12201,-1,-0.01,11958,11958,1400-2-20,2021-05-10
611,زفكا,كشت و دامداري فكا,3,3030,37317480,12696,12316,12316,-380,-2.99,12696,0,0,12316,12316,1400-2-20,2021-05-10
612,كلر,كلر پارس,3,276,34772688,129884,125988,125988,-3896,-3,129881,-3,0,125988,125988,1400-2-20,2021-05-10
613,زعف0008پ11,زعفران0008نگين سحرخيز(پ),3,1048,126080788,121178,121255,120206,-972,-0.8,120306,-872,-0.72,120206,121255,1400-2-20,2021-05-10
614,غدشت,دشت‌ مرغاب‌,2,162,45269280,288080,279440,279440,-8640,-3,288070,-10,0,279440,279440,1400-2-20,2021-05-10
615,اراد604,مرابحه عام دولتي6-ش.خ0210,2,6600000,6132944400000,947000,929234,929234,-17766,-1.88,929234,-17766,-1.88,929234,929234,1400-2-20,2021-05-10
616,ضجار7044,اختيارخ وتجارت-4497-1400/07/21,2,6,60000,1,10,10,9,900,10,9,900,10,10,1400-2-20,2021-05-10
617,پست0008پ08,پسته فندقي32-30مه ولات0008(پ),2,8,13120000,1641000,1650000,1630000,-11000,-0.67,1640000,-1000,-0.06,1630000,1650000,1400-2-20,2021-05-10
618,فملي2,ملي‌ صنايع‌ مس‌ ايران‌,2,44815000,541399440000,11850,12080,12090,240,2.03,12081,231,1.95,12080,12090,1400-2-20,2021-05-10
619,وآذر,سرمايه‌گذاري‌توسعه‌آذربايجان‌,2,1318,107786040,84300,81780,81780,-2520,-2.99,84290,-10,-0.01,81780,81780,1400-2-20,2021-05-10
620,سفانو,سيمان فارس نو,2,1148,39020520,35040,33990,33990,-1050,-3,35040,0,0,33990,33990,1400-2-20,2021-05-10
621,اراد704,مرابحه عام دولت70-ش.خ0112,2,23114000,21719126400000,943750,939802,939600,-4150,-0.44,939652,-4098,-0.43,939600,939802,1400-2-20,2021-05-10
622,ضجار7041,اختيارخ وتجارت-2997-1400/07/21,2,2,200000,40,190,100,60,150,100,60,150,100,100,1400-2-20,2021-05-10
623,پخش,پخش البرز,2,327,10074216,31760,30808,30808,-952,-3,31760,0,0,30808,30808,1400-2-20,2021-05-10
624,گدنا,تهيه توزيع غذاي دنا آفرين فدك,2,800,26325600,33924,32907,32907,-1017,-3,33923,-1,0,32907,32907,1400-2-20,2021-05-10
625,نگين,ص.س. زمين و ساختمان نگين شهرري,2,950,45172500,48150,47550,47550,-600,-1.25,47550,-600,-1.25,47550,47550,1400-2-20,2021-05-10
626,سصفها,سيمان‌اصفهان‌,2,240,29556000,126950,123150,123150,-3800,-2.99,126950,0,0,123150,123150,1400-2-20,2021-05-10
627,صبا1404,اجاصبابدون ضامن بارتبه اعتباري,2,100000,100000000000,1000000,1000000,1000000,0,0,1000000,0,0,1000000,1000000,1400-2-20,2021-05-10
628,ثعمرا,عمران و توسعه شاهد,2,5402,68383918,13050,12659,12659,-391,-3,13049,-1,-0.01,12659,12659,1400-2-20,2021-05-10
629,زملارد,كشاورزي و دامپروري ملارد شير,2,4129,150411212,37554,36428,36428,-1126,-3,37551,-3,-0.01,36428,36428,1400-2-20,2021-05-10
630,سيلام,سيمان‌ ايلام‌,2,1000,10870000,11200,10870,10870,-330,-2.95,11200,0,0,10870,10870,1400-2-20,2021-05-10
631,ثرود,سرمايه‌گذاري مسكن زاينده رود,2,5245,107213045,21073,20441,20441,-632,-3,21072,-1,0,20441,20441,1400-2-20,2021-05-10
632,وسيستا,شركت س استان سيستان وبلوچستان,2,16940,12501720,760,738,738,-22,-2.89,760,0,0,738,738,1400-2-20,2021-05-10
633,گواهي ظرفيت,گواهي ظرفيت نقدي,2,1300000,22519900000,17323,17323,17323,0,0,17323,0,0,17323,17323,1400-2-20,2021-05-10
634,ضخوز7037,اختيارخ فخوز-11200-1400/07/14,2,27,100500000,3001,3500,3800,799,26.62,3722,721,24.03,3500,3800,1400-2-20,2021-05-10
635,زير0003پ01,زيره سبز0003كيميابذر(پ),2,250,155870500,587723,623482,623482,35759,6.08,623482,35759,6.08,623482,623482,1400-2-20,2021-05-10
636,غالبر,لبنيات‌ كالبر,2,518,10157980,20210,19610,19610,-600,-2.97,20210,0,0,19610,19610,1400-2-20,2021-05-10
637,ولغدر,ليزينگ‌خودروغدير,2,3215,76742050,24600,23870,23870,-730,-2.97,24600,0,0,23870,23870,1400-2-20,2021-05-10
638,بايكا,كارخانجات كابلسازي ‌ايران‌,2,10500,423297000,41993,40314,40314,-1679,-4,41956,-37,-0.09,40314,40314,1400-2-20,2021-05-10
639,شپنا2,پالايش نفت اصفهان,2,50000000,470500000000,9700,9410,9410,-290,-2.99,9410,-290,-2.99,9410,9410,1400-2-20,2021-05-10
640,فسديد,لوله‌وتجهيزات‌ سديد - ورشكسته,2,935,104421735,112809,111681,111681,-1128,-1,112785,-24,-0.02,111681,111681,1400-2-20,2021-05-10
641,ضشنا8004,اختيارخ شپنا-10800-1400/08/16,2,8,12000000,996,1500,1500,504,50.6,1500,504,50.6,1500,1500,1400-2-20,2021-05-10
642,ركيش,كارت اعتباري ايران كيش,2,1301,29988050,23760,23050,23050,-710,-2.99,23760,0,0,23050,23050,1400-2-20,2021-05-10
643,ضفلا7002,اختيارخ فولاد-6733-1400/07/25,2,30,84995000,2450,2800,2999,549,22.41,2833,383,15.63,2800,2999,1400-2-20,2021-05-10
644,اراد594,مرابحه عام دولتي5-ش.خ 0309,2,19000000,17760240500000,1000000,934792,934707,-65293,-6.53,934749,-65251,-6.53,934707,934792,1400-2-20,2021-05-10
645,خوساز,محورسازان‌ايران‌خودرو,2,3396,26420880,8020,7780,7780,-240,-2.99,8020,0,0,7780,7780,1400-2-20,2021-05-10
646,اراد644,مرابحه عام دولتي64-ش.خ0111,2,15940000,15011959470000,944500,941649,942000,-2500,-0.26,941779,-2721,-0.29,941649,942000,1400-2-20,2021-05-10
647,سهرمز,سيمان‌هرمزگان‌,2,581,13990480,24820,24080,24080,-740,-2.98,24820,0,0,24080,24080,1400-2-20,2021-05-10
648,ضبدر3001,اختيارخ شبندر-3416-1400/03/30,2,12,42000000,4050,3500,3500,-550,-13.58,3500,-550,-13.58,3500,3500,1400-2-20,2021-05-10
649,سرو2,صندوق س سروسودمند مدبران-سهام,2,200000,200000,59720,1,1,-59719,-100,1,-59719,-100,1,1,1400-2-20,2021-05-10
650,اخزا805,اسنادخزانه-م5بودجه98-000422,2,50,48400000,969573,968000,968000,-1573,-0.16,968000,-1573,-0.16,968000,968000,1400-2-20,2021-05-10
651,غويتا,ويتانا,2,1787,31134901,17961,17423,17423,-538,-3,17961,0,0,17423,17423,1400-2-20,2021-05-10
652,فاما,صنعتي‌ آما,2,562,10116000,18550,18000,18000,-550,-2.96,18550,0,0,18000,18000,1400-2-20,2021-05-10
653,ضملي3000,اختيارخ فملي-8000-1400/03/02,2,5,21644000,3958,4300,4444,486,12.28,4329,371,9.37,4300,4444,1400-2-20,2021-05-10
654,شگل,گلتاش‌,2,3692,36144680,10090,9790,9790,-300,-2.97,10090,0,0,9790,9790,1400-2-20,2021-05-10
655,اراد35,مرابحه عام دولت3-ش.خ 0103,2,2000,1956000000,948748,960000,996000,47252,4.98,978000,29252,3.08,960000,996000,1400-2-20,2021-05-10
656,كشرق,صنعتي و معدني شمال شرق شاهرود,2,300,26775000,92010,89250,89250,-2760,-3,92008,-2,0,89250,89250,1400-2-20,2021-05-10
657,ضفلا3008,اختيارخ فولاد-14266-1400/03/19,2,10,100000,20,10,10,-10,-50,10,-10,-50,10,10,1400-2-20,2021-05-10
658,ضپاس7027,اختيارخ وپارس-1800-1400/07/28,2,200,140000000,695,700,700,5,0.72,700,5,0.72,700,700,1400-2-20,2021-05-10
659,ضغدر3002,اختيارخ وغدير-8200-1400/03/26,2,27,58200000,1504,2600,2000,496,32.98,2156,652,43.35,2000,2600,1400-2-20,2021-05-10
660,بمپنا,توليد برق عسلويه  مپنا,2,174,11858622,70260,68153,68153,-2107,-3,70259,-1,0,68153,68153,1400-2-20,2021-05-10
661,سفار,سيمان‌فارس‌,2,40,5908800,152280,147720,147720,-4560,-2.99,152280,0,0,147720,147720,1400-2-20,2021-05-10
662,ضگل3001,اختيارخ كگل-10595-1400/03/23,2,19,75931080,5700,3000,3120,-2580,-45.26,3025,-2675,-46.93,3000,3120,1400-2-20,2021-05-10
663,اراد354,مرابحه عام دولت3-ش.خ 0103,2,1000000,947550000000,948748,948000,947100,-1648,-0.17,947550,-1198,-0.13,947100,948000,1400-2-20,2021-05-10
664,گكيش,توريستي ورفاهي آبادگران كيش,2,3110,147678350,48454,47485,47485,-969,-2,48447,-7,-0.01,47485,47485,1400-2-20,2021-05-10
665,غچين,كشت‌ و صنعت‌ چين‌ چين,2,1050,20223000,19850,19260,19260,-590,-2.97,19850,0,0,19260,19260,1400-2-20,2021-05-10
666,دسانكو,داروسازي سبحان انكولوژي,2,931,13354264,14787,14344,14344,-443,-3,14787,0,0,14344,14344,1400-2-20,2021-05-10
667,وهنر,گروه توسعه هنر ايران,2,80676,654524388,8278,8113,8113,-165,-1.99,8272,-6,-0.07,8113,8113,1400-2-20,2021-05-10
668,شپارس,بين‌ المللي‌ محصولات‌  پارس‌,2,15500,335110000,22280,21620,21620,-660,-2.96,22280,0,0,21620,21620,1400-2-20,2021-05-10
669,فولاد2,فولاد مباركه اصفهان,2,18575000,209998500000,11580,11240,11580,0,0,11305,-275,-2.37,11240,11580,1400-2-20,2021-05-10
670,سدبير,س. تدبيرگران فارس وخوزستان,2,122,10580328,89406,86724,86724,-2682,-3,89405,-1,0,86724,86724,1400-2-20,2021-05-10
671,ساذري,آذريت‌,2,383,2307192,5849,6024,6024,175,2.99,5849,0,0,6024,6024,1400-2-20,2021-05-10
672,كقزوي,شيشه‌ قزوين‌,2,16993,167075176,10241,9832,9832,-409,-3.99,10237,-4,-0.04,9832,9832,1400-2-20,2021-05-10
673,اراد214,مرابحه عام دولت2ش.خ صادرات0212,2,18300000,17306356500000,1000000,945738,945675,-54325,-5.43,945703,-54297,-5.43,945675,945738,1400-2-20,2021-05-10
674,ضمخا7067,اختيارخ اخابر-13700-1400/07/28,2,46,23000000,497,500,500,3,0.6,500,3,0.6,500,500,1400-2-20,2021-05-10
675,كمينا,شيشه سازي مينا,2,410,10083540,25095,24594,24594,-501,-2,25095,0,0,24594,24594,1400-2-20,2021-05-10
676,غشوكو,شوكو پارس,2,268,10474512,39881,39084,39084,-797,-2,39881,0,0,39084,39084,1400-2-20,2021-05-10
677,وكادو,تكادو,2,711,11244465,16137,15815,15815,-322,-2,16137,0,0,15815,15815,1400-2-20,2021-05-10
678,كپشير,پشم‌شيشه‌ايران‌,2,271,10509380,39970,38780,38780,-1190,-2.98,39970,0,0,38780,38780,1400-2-20,2021-05-10
679,ضمخا7068,اختيارخ اخابر-15700-1400/07/28,2,30,12020000,4000,401,400,-3600,-90,401,-3599,-89.98,400,401,1400-2-20,2021-05-10
680,پلاسك,پلاسكوكار,2,2025,14681250,7470,7250,7250,-220,-2.95,7470,0,0,7250,7250,1400-2-20,2021-05-10
681,فن آوا,گروه فن آوا,2,2000,35040000,18250,17520,17520,-730,-4,18249,-1,-0.01,17520,17520,1400-2-20,2021-05-10
682,داريك,صندوق س.اعتماد داريك-د,2,977,10322936,10561,10564,10568,7,0.07,10566,5,0.05,10564,10568,1400-2-20,2021-05-10
683,خكاوه,سايپا ديزل,2,3440,12153520,3605,3533,3533,-72,-2,3605,0,0,3533,3533,1400-2-20,2021-05-10
684,اخزا810,اسنادخزانه-م10بودجه98-001006,2,1472,1295523392,879668,880111,880111,443,0.05,880111,443,0.05,880111,880111,1400-2-20,2021-05-10
685,كتوكا,توليدي و خدمات صنايع نسوز توكا,2,745,28180370,38995,37826,37826,-1169,-3,38994,-1,0,37826,37826,1400-2-20,2021-05-10
686,فوكا,فولاد كاويان,2,45226,527154256,11893,11656,11656,-237,-1.99,11889,-4,-0.03,11656,11656,1400-2-20,2021-05-10
687,ضپنا8000,اختيارخ رمپنا-9850-1400/08/05,2,20,121000000,6650,6000,6100,-550,-8.27,6050,-600,-9.02,6000,6100,1400-2-20,2021-05-10
688,ضملي7001,اختيارخ فملي-8720-1400/07/11,2,2,8500000,3600,4000,4500,900,25,4250,650,18.06,4000,4500,1400-2-20,2021-05-10
689,زنگان,صنعت روي زنگان,2,166,16820780,104463,101330,101330,-3133,-3,104462,-1,0,101330,101330,1400-2-20,2021-05-10
690,ضجار7040,اختيارخ وتجارت-2497-1400/07/21,1,10,3500000,345,350,350,5,1.45,350,5,1.45,350,350,1400-2-20,2021-05-10
691,ضپيك7039,اختيارخ تاپيكو-5070-00/07/18,1,20,71000000,3300,3550,3550,250,7.58,3550,250,7.58,3550,3550,1400-2-20,2021-05-10
692,بكاب,صنايع‌جوشكاب‌يزد,1,171,59690970,359860,349070,349070,-10790,-3,359850,-10,0,349070,349070,1400-2-20,2021-05-10
693,فكمند,گسترش قطعه سازي كمند,1,3000,37374000,12335,12458,12458,123,1,12336,1,0.01,12458,12458,1400-2-20,2021-05-10
694,ضجار7038,اختيارخ وتجارت-1797-1400/07/21,1,50,40000000,720,800,800,80,11.11,800,80,11.11,800,800,1400-2-20,2021-05-10
695,مي ه 8,ميان باري هفته 8,1,18500,10119500,350,547,547,197,56.29,547,197,56.29,547,547,1400-2-20,2021-05-10
696,نطرين,عطرين نخ قم,1,775,9117100,12127,11764,11764,-363,-2.99,12127,0,0,11764,11764,1400-2-20,2021-05-10
697,صايپا203,صكوك مرابحه سايپا203-3ماهه 16%,1,5000,4825000000,952200,965000,965000,12800,1.34,965000,12800,1.34,965000,965000,1400-2-20,2021-05-10
698,ضپنا8002,اختيارخ رمپنا-13850-1400/08/05,1,20,45000000,2450,2250,2250,-200,-8.16,2250,-200,-8.16,2250,2250,1400-2-20,2021-05-10
699,اراد65,مرابحه عام دولتي65-ش.خ0210,1,1400,1358000000,967274,970000,970000,2726,0.28,970000,2726,0.28,970000,970000,1400-2-20,2021-05-10
700,دبالك,مواد اوليه دارويي البرز بالك,1,10000,201920000,20816,20192,20192,-624,-3,20813,-3,-0.01,20192,20192,1400-2-20,2021-05-10
701,كمند2,صندوق س. با درآمد ثابت كمند,1,103000000,103000000,10023,1,1,-10022,-99.99,1,-10022,-99.99,1,1,1400-2-20,2021-05-10
702,اعتماد4,صندوق س.اعتماد آفرين پارسيان-د,1,28000000,1017380000000,36321,36335,36335,14,0.04,36335,14,0.04,36335,36335,1400-2-20,2021-05-10
703,غبهار,كشت وصنعت بهاران گلبهار خراسان,1,167,5479604,34179,32812,32812,-1367,-4,34179,0,0,32812,32812,1400-2-20,2021-05-10
704,کم ه 8,کم باري هفته 8,1,8000,3704000,253,463,463,210,83,463,210,83,463,463,1400-2-20,2021-05-10
705,ولصنم,ليزينگ‌صنعت‌ومعدن‌,1,500,5385000,11100,10770,10770,-330,-2.97,11100,0,0,10770,10770,1400-2-20,2021-05-10
706,ضسپا3008,اختيارخ خساپا-4500-1400/03/26,1,5,50000,39,10,10,-29,-74.36,10,-29,-74.36,10,10,1400-2-20,2021-05-10
707,هرمز2,فولاد هرمزگان جنوب,1,6880000,100104000000,14643,14550,14550,-93,-0.64,14550,-93,-0.64,14550,14550,1400-2-20,2021-05-10
708,لخانه,لوازم‌ خانگي‌ پارس‌,1,1000,27406000,27965,27406,27406,-559,-2,27964,-1,0,27406,27406,1400-2-20,2021-05-10
709,قلرست,قند لرستان‌,1,2000,69480000,35810,34740,34740,-1070,-2.99,35810,0,0,34740,34740,1400-2-20,2021-05-10
710,تملي703,تسهيلات مسكن ب. ملي-خرداد97,1,10,5242780,551871,524278,524278,-27593,-5,524278,-27593,-5,524278,524278,1400-2-20,2021-05-10
711,وارس,سرمايه گذاري ارس صبا,1,300,5066100,17231,16887,16887,-344,-2,17231,0,0,16887,16887,1400-2-20,2021-05-10
712,ضمخا7076,اختيارخ اخابر-9700-1400/07/28,1,6,5400000,990,900,900,-90,-9.09,900,-90,-9.09,900,900,1400-2-20,2021-05-10
713,اراد314,مرابحه عام دولت3-ش.خ 0208,1,10000000,8981100000000,950000,898110,898110,-51890,-5.46,898110,-51890,-5.46,898110,898110,1400-2-20,2021-05-10
714,ثپرديس,سرمايه گذاري مسكن پرديس,1,1000,9855000,10159,9855,9855,-304,-2.99,10159,0,0,9855,9855,1400-2-20,2021-05-10
715,تملي807,تسهيلات مسكن ب. ملي-مهر98,1,10,5190270,546344,519027,519027,-27317,-5,519027,-27317,-5,519027,519027,1400-2-20,2021-05-10
716,شبندر2,پالايش نفت بندرعباس,1,13404000,249984600000,19180,18650,18650,-530,-2.76,18650,-530,-2.76,18650,18650,1400-2-20,2021-05-10
717,اخزا8214,اسنادخزانه-م21بودجه98-020906,1,3400000,2043702600000,599377,601089,601089,1712,0.29,601089,1712,0.29,601089,601089,1400-2-20,2021-05-10
718,تبرك,گروه كارخانجات صنعتي تبرك,1,283,5436147,19803,19209,19209,-594,-3,19803,0,0,19209,19209,1400-2-20,2021-05-10
719,افرا,افرانت,1,4492,149435364,34295,33267,33267,-1028,-3,34292,-3,-0.01,33267,33267,1400-2-20,2021-05-10
720,قيستو4,شركت قند بيستون,1,5000000,96345000000,19273,19269,19269,-4,-0.02,19269,-4,-0.02,19269,19269,1400-2-20,2021-05-10
721,فنفت,صنايع تجهيزات نفت,1,167,5408963,33050,32389,32389,-661,-2,33050,0,0,32389,32389,1400-2-20,2021-05-10
722,ثاباد,توريستي ورفاهي آبادگران ايران,1,1200,63060000,54170,52550,52550,-1620,-2.99,54170,0,0,52550,52550,1400-2-20,2021-05-10
723,شسم,توليد سموم‌ علف‌ كش,1,67,6151940,90020,91820,91820,1800,2,90021,1,0,91820,91820,1400-2-20,2021-05-10
724,غشاذر,پگاه‌آذربايجان‌غربي‌,1,11900,115430000,9990,9700,9700,-290,-2.9,9990,0,0,9700,9700,1400-2-20,2021-05-10
725,گپارس,امور رفاهي كارگزاران پارس,1,30,6133770,208631,204459,204459,-4172,-2,208630,-1,0,204459,204459,1400-2-20,2021-05-10
726,پاسا,ايران‌ياساتايرورابر,1,419,10843720,26680,25880,25880,-800,-3,26680,0,0,25880,25880,1400-2-20,2021-05-10
727,ضجار2003,اختيارخ وتجارت-3000-1400/02/22,1,1,1000,1,1,1,0,0,1,0,0,1,1,1400-2-20,2021-05-10
728,فنرژي,گسترش صنايع انرژي آذرآب,1,300,5467500,18984,18225,18225,-759,-4,18984,0,0,18225,18225,1400-2-20,2021-05-10
729,خساپا2,سايپا,1,85000000,153340000000,1859,1804,1804,-55,-2.96,1804,-55,-2.96,1804,1804,1400-2-20,2021-05-10
730,ضشنا2007,اختيارخ شپنا-24000-1400/02/27,1,1,10000,44,10,10,-34,-77.27,10,-34,-77.27,10,10,1400-2-20,2021-05-10
731,ثنور,سرمايه گذاري كوه نور,1,600,5693400,9682,9489,9489,-193,-1.99,9682,0,0,9489,9489,1400-2-20,2021-05-10
732,اخزا9092,اسنادخزانه-م9بودجه99-020316,1,105000,68985000000,657857,657000,657000,-857,-0.13,657000,-857,-0.13,657000,657000,1400-2-20,2021-05-10
733,ضمخا7071,اختيارخ اخابر-23700-1400/07/28,1,20,2000000,104,100,100,-4,-3.85,100,-4,-3.85,100,100,1400-2-20,2021-05-10
734,اخزا816,اسنادخزانه-م16بودجه98-010503,1,333,260079660,783108,781020,781020,-2088,-0.27,781020,-2088,-0.27,781020,781020,1400-2-20,2021-05-10
735,همراه2,شركت ارتباطات سيار ايران,1,10000000,223100000000,23000,22310,22310,-690,-3,22310,-690,-3,22310,22310,1400-2-20,2021-05-10
736,ثنظام,س. ساختماني نظام مهندسي ايران,1,136,6322232,47435,46487,46487,-948,-2,47435,0,0,46487,46487,1400-2-20,2021-05-10
737,جهرم,پتروشيمي جهرم,1,2950,5130050,1774,1739,1739,-35,-1.97,1774,0,0,1739,1739,1400-2-20,2021-05-10
738,وغدير2,سرمايه‌گذاري‌غدير(هلدينگ‌,1,25987000,249994940000,9300,9620,9620,320,3.44,9620,320,3.44,9620,9620,1400-2-20,2021-05-10
739,اراد58,مرابحه عام دولت5-ش.خ 0110,1,3000,2970000000,972287,990000,990000,17713,1.82,990000,17713,1.82,990000,990000,1400-2-20,2021-05-10
740,اراد834,مرابحه عام دولت83-ش.خ041220,1,10524000,9613568760000,1000000,913490,913490,-86510,-8.65,913490,-86510,-8.65,913490,913490,1400-2-20,2021-05-10
741,كيسون,شركت كيسون,1,1000,11237000,11466,11237,11237,-229,-2,11466,0,0,11237,11237,1400-2-20,2021-05-10
742,كاذر,فرآورده‌هاي‌نسوزآذر,1,2229,70793040,32740,31760,31760,-980,-2.99,32740,0,0,31760,31760,1400-2-20,2021-05-10
743,اراد43,مرابحه عام دولت4-ش.خ 0205,1,5000,4987500000,950000,997500,997500,47500,5,997500,47500,5,997500,997500,1400-2-20,2021-05-10
744,صخابر102,صكوك اجاره مخابرات-3 ماهه 16%,1,500,495000000,999652,990000,990000,-9652,-0.97,990000,-9652,-0.97,990000,990000,1400-2-20,2021-05-10
745,ثاژن,سخت آژند,1,5000,47375000,9668,9475,9475,-193,-2,9667,-1,-0.01,9475,9475,1400-2-20,2021-05-10
746,فارس2,صنايع پتروشيمي خليج فارس,1,55000000,436700000000,8180,7940,7940,-240,-2.93,7940,-240,-2.93,7940,7940,1400-2-20,2021-05-10
747,دروز,داروسازي‌ روزدارو,1,14447,498132560,35540,34480,34480,-1060,-2.98,35530,-10,-0.03,34480,34480,1400-2-20,2021-05-10
748,اراد79,مرابحه عام دولت79-ش.خ010612,1,1000,980000000,949100,980000,980000,30900,3.26,980000,30900,3.26,980000,980000,1400-2-20,2021-05-10
749,شتوكا,توكا رنگ فولاد سپاهان,1,199,9954179,51568,50021,50021,-1547,-3,51568,0,0,50021,50021,1400-2-20,2021-05-10
750,تپمپي,پمپ‌ سازي‌ ايران‌,1,1500,28245000,19410,18830,18830,-580,-2.99,19410,0,0,18830,18830,1400-2-20,2021-05-10
751,كصدف,كاشي صدف سرام استقلال آباده,1,210,5197920,25257,24752,24752,-505,-2,25257,0,0,24752,24752,1400-2-20,2021-05-10
752,اراد61,مرابحه عام دولت61-ش.خ0309,1,13000,13000000000,1000000,1000000,1000000,0,0,1000000,0,0,1000000,1000000,1400-2-20,2021-05-10
753,اراد71,مرابحه عام دولت71-ش.خ0311,1,20000,20604000000,1010000,1030200,1030200,20200,2,1030200,20200,2,1030200,1030200,1400-2-20,2021-05-10
754,عيار2,صندوق سكه طلاي مفيد,1,10000,10000,23984,1,1,-23983,-100,1,-23983,-100,1,1,1400-2-20,2021-05-10
755,وسرمد,بيمه  سرمد,1,824,5030520,6229,6105,6105,-124,-1.99,6229,0,0,6105,6105,1400-2-20,2021-05-10
756,قمرو,قند مرودشت‌,1,150,5382000,36980,35880,35880,-1100,-2.97,36980,0,0,35880,35880,1400-2-20,2021-05-10
757,خودرو2,ايران‌ خودرو,1,81000000,148878000000,1894,1838,1838,-56,-2.96,1838,-56,-2.96,1838,1838,1400-2-20,2021-05-10
758,غپونه,نوش پونه مشهد,1,275,5015175,18609,18237,18237,-372,-2,18609,0,0,18237,18237,1400-2-20,2021-05-10
759,خچرخش,چرخشگر,1,283,5020420,18280,17740,17740,-540,-2.95,18280,0,0,17740,17740,1400-2-20,2021-05-10
760,دجابر,داروسازي‌ جابرابن‌حيان‌,1,280,5499200,20240,19640,19640,-600,-2.96,20240,0,0,19640,19640,1400-2-20,2021-05-10
761,خزر,فنرسازي‌زر,1,150,6924000,47580,46160,46160,-1420,-2.98,47580,0,0,46160,46160,1400-2-20,2021-05-10
762,ثنوسا,نوسازي‌وساختمان‌تهران‌,1,556,7005600,12980,12600,12600,-380,-2.93,12980,0,0,12600,12600,1400-2-20,2021-05-10
763,اراد654,مرابحه عام دولتي65-ش.خ0210,1,3230277,3006464027778,967274,930714,930714,-36560,-3.78,930714,-36560,-3.78,930714,930714,1400-2-20,2021-05-10
764,سحرا021,سلف موازي برق نيروي برق حرارتي,1,200000,58000000000,286757,290000,290000,3243,1.13,290000,3243,1.13,290000,290000,1400-2-20,2021-05-10
765,ضغدر3004,اختيارخ وغدير-11200-1400/03/26,1,55,24750000,500,450,450,-50,-10,450,-50,-10,450,450,1400-2-20,2021-05-10
766,ضغدر3001,اختيارخ وغدير-7200-1400/03/26,1,10,29800000,2600,2980,2980,380,14.62,2980,380,14.62,2980,2980,1400-2-20,2021-05-10
767,پا ه 8,بار پايه هفته 8,1,14000,7462000,561,533,533,-28,-4.99,533,-28,-4.99,533,533,1400-2-20,2021-05-10
768,نمرينو,ايران‌ مرينوس‌,1,4000,439120000,113170,109780,109780,-3390,-3,113140,-30,-0.03,109780,109780,1400-2-20,2021-05-10
769,اخابر2,مخابرات ايران,1,50000000,456500000000,9410,9130,9130,-280,-2.98,9130,-280,-2.98,9130,9130,1400-2-20,2021-05-10
770,ثجوان,تامين مسكن جوانان,1,18400,200173600,11101,10879,10879,-222,-2,11099,-2,-0.02,10879,10879,1400-2-20,2021-05-10
771,ضترا8057,اختيارخ شتران-3000-1400/08/09,1,20,36000000,1757,1800,1800,43,2.45,1800,43,2.45,1800,1800,1400-2-20,2021-05-10
772,كهرام,توليدي گرانيت بهسرام,1,46,5116258,113492,111223,111223,-2269,-2,113491,-1,0,111223,111223,1400-2-20,2021-05-10
773,صينا205,صكوك منفعت سينا دارو-3ماهه 19%,1,500,490000000,980000,980000,980000,0,0,980000,0,0,980000,980000,1400-2-20,2021-05-10
774,زعف0008پ19,زعفران0008نگين تروند قاينات(پ),1,100,11621000,120448,116210,116210,-4238,-3.52,116210,-4238,-3.52,116210,116210,1400-2-20,2021-05-10
775,حخزر,كشتيراني درياي خزر,1,191,5261095,28396,27545,27545,-851,-3,28396,0,0,27545,27545,1400-2-20,2021-05-10
776,شبهرن2,نفت‌ بهران‌,1,18800000,200220000000,10750,10650,10650,-100,-0.93,10650,-100,-0.93,10650,10650,1400-2-20,2021-05-10
777,ثزاگرس,سرمايه گذاري توسعه عمران زاگرس,1,215,11643325,57005,54155,54155,-2850,-5,57003,-2,0,54155,54155,1400-2-20,2021-05-10
778,غشهد,شهد ايران ‌,1,718,5069080,7270,7060,7060,-210,-2.89,7270,0,0,7060,7060,1400-2-20,2021-05-10
779,تاپيكو2,س. نفت و گاز و پتروشيمي تأمين,1,20400000,200124000000,9750,9810,9810,60,0.62,9810,60,0.62,9810,9810,1400-2-20,2021-05-10
780,وليز,ليزينگ‌ايران‌,1,597,5528220,9540,9260,9260,-280,-2.94,9540,0,0,9260,9260,1400-2-20,2021-05-10
781,وبصادر2,بانك صادرات ايران,1,550000000,1181950000000,2215,2149,2149,-66,-2.98,2149,-66,-2.98,2149,2149,1400-2-20,2021-05-10
782,شتران2,پالايش نفت تهران,1,20000000,148800000000,7670,7440,7440,-230,-3,7440,-230,-3,7440,7440,1400-2-20,2021-05-10
783,پست0008پ04,پسته فندقي32-30سبزدانه0008(پ),1,4,6480000,1588333,1620000,1620000,31667,1.99,1620000,31667,1.99,1620000,1620000,1400-2-20,2021-05-10
784,ضپيك7040,اختيارخ تاپيكو-6070-00/07/18,1,10,26000000,2400,2600,2600,200,8.33,2600,200,8.33,2600,2600,1400-2-20,2021-05-10
785,وسالت,بانك قرض الحسنه رسالت,1,4347,5064255,1110,1165,1165,55,4.95,1110,0,0,1165,1165,1400-2-20,2021-05-10
786,چكاوه,صنايع‌كاغذسازي‌كاوه‌,1,338,6040060,18420,17870,17870,-550,-2.99,18420,0,0,17870,17870,1400-2-20,2021-05-10
787,شلرد02,كود شيميايي اوره لردگان,1,44,44520960,993000,1011840,1011840,18840,1.9,1011840,18840,1.9,1011840,1011840,1400-2-20,2021-05-10
788,وتجارت2,بانك تجارت,1,60000000,141720000000,2435,2362,2362,-73,-3,2362,-73,-3,2362,2362,1400-2-20,2021-05-10
789,آ س پ,آ.س.پ,1,621,9719892,16136,15652,15652,-484,-3,16136,0,0,15652,15652,1400-2-20,2021-05-10
790,تملي711,تسهيلات مسكن ب. ملي-بهمن97,1,12,5700000,475000,475000,475000,0,0,475000,0,0,475000,475000,1400-2-20,2021-05-10
791,ضپيك7042,اختيارخ تاپيكو-8070-00/07/18,1,2,2440000,1217,1220,1220,3,0.25,1220,3,0.25,1220,1220,1400-2-20,2021-05-10
792,خكمك,كمك‌فنرايندامين‌,1,1000,26320000,27130,26320,26320,-810,-2.99,27130,0,0,26320,26320,1400-2-20,2021-05-10
793,آينده,بازرگاني آينده سازان بهشت پارس,1,258,5019906,19854,19457,19457,-397,-2,19854,0,0,19457,19457,1400-2-20,2021-05-10
794,خلنت,لنت‌ ترمزايران‌,1,100,6082000,62700,60820,60820,-1880,-3,62700,0,0,60820,60820,1400-2-20,2021-05-10
795,ضخود4000,اختيارخ خودرو-1400-1400/04/02,1,19,9500000,590,500,500,-90,-15.25,500,-90,-15.25,500,500,1400-2-20,2021-05-10
796,ضفار8048,اختيارخ فارس-5400-1400/08/05,1,30,85500000,2800,2850,2850,50,1.79,2850,50,1.79,2850,2850,1400-2-20,2021-05-10
797,جم2,پتروشيمي جم,1,1500000,52650000000,35270,35100,35100,-170,-0.48,35100,-170,-0.48,35100,35100,1400-2-20,2021-05-10
798,ولملت,واسپاري ملت,1,2614,19918680,7850,7620,7620,-230,-2.93,7850,0,0,7620,7620,1400-2-20,2021-05-10
799,دسينا,داروسازي‌ سينا,1,400,9236000,23800,23090,23090,-710,-2.98,23800,0,0,23090,23090,1400-2-20,2021-05-10
800,زير0003پ02,زيره سبز0003 دانش(پ),1,100,59999900,580000,599999,599999,19999,3.45,599999,19999,3.45,599999,599999,1400-2-20,2021-05-10
801,پسهند,صنايع‌ لاستيكي‌  سهند,1,150,5580000,38350,37200,37200,-1150,-3,38350,0,0,37200,37200,1400-2-20,2021-05-10
802,داسوه,داروسازي‌ اسوه‌,1,300,10866000,37330,36220,36220,-1110,-2.97,37330,0,0,36220,36220,1400-2-20,2021-05-10
803,اروند10,منفعت صبا اروند لوتوس 14001222,1,500,493250000,986500,986500,986500,0,0,986500,0,0,986500,986500,1400-2-20,2021-05-10
804,وپاسار2,بانك  پاسارگاد,1,5000000,82800000000,16390,16560,16560,170,1.04,16560,170,1.04,16560,16560,1400-2-20,2021-05-10
805,زكشت,كشاورزي مكانيزه اصفهان كشت,1,254,9946640,40371,39160,39160,-1211,-3,40371,0,0,39160,39160,1400-2-20,2021-05-10
806,اراد554,مرابحه عام دولت5-ش.خ 0209,1,10777000,9179622283000,970000,851779,851779,-118221,-12.19,851779,-118221,-12.19,851779,851779,1400-2-20,2021-05-10
807,ثشرق,سرمايه گذاري مسكن شمال شرق,1,1500,10035000,6890,6690,6690,-200,-2.9,6890,0,0,6690,6690,1400-2-20,2021-05-10
808,قجام4,فرآوردههاي غذايي وقندتربت‌جام‌,1,5000000,77465000000,16138,15493,15493,-645,-4,15493,-645,-4,15493,15493,1400-2-20,2021-05-10
809,اراد474,مرابحه عام دولت4-ش.خ 0008,1,4437000,4411438443000,984990,994239,994239,9249,0.94,994239,9249,0.94,994239,994239,1400-2-20,2021-05-10
810,تملي706,تسهيلات مسكن ب. ملي-شهريور97,1,1,473815,498752,473815,473815,-24937,-5,473815,-24937,-5,473815,473815,1400-2-20,2021-05-10
811,شستا003,اجاره تامين اجتماعي-سپهر000523,1,23019,22821681132,991428,991428,991428,0,0,991428,0,0,991428,991428,1400-2-20,2021-05-10
812,داوه,داروسازي آوه سينا,1,509,9963166,20179,19574,19574,-605,-3,20179,0,0,19574,19574,1400-2-20,2021-05-10
813,زمگسا,كشاورزي‌ ودامپروي‌ مگسال‌,1,1580,49801600,32490,31520,31520,-970,-2.99,32490,0,0,31520,31520,1400-2-20,2021-05-10
814,فسا,پتروشيمي فسا,1,10000,17360000,1771,1736,1736,-35,-1.98,1771,0,0,1736,1736,1400-2-20,2021-05-10
815,پر ه 8,پر باري هفته 8,1,11000,6380000,376000,580,580,-375420,-99.85,580,-375420,-99.85,580,580,1400-2-20,2021-05-10
816,تملي712,تسهيلات مسكن ب. ملي-اسفند97,1,9,5240205,612889,582245,582245,-30644,-5,582245,-30644,-5,582245,582245,1400-2-20,2021-05-10
817,ضفلا3002,اختيارخ فولاد-6420-1400/03/19,1,15,44850000,3001,2990,2990,-11,-0.37,2990,-11,-0.37,2990,2990,1400-2-20,2021-05-10
818,ضخود4001,اختيارخ خودرو-1600-1400/04/02,1,100,35000000,1,350,350,349,34900,350,349,34900,350,350,1400-2-20,2021-05-10
819,ومعادنح2,ح . توسعه‌معادن‌وفلزات‌,1,20850000,100080000000,4670,4800,4800,130,2.78,4800,130,2.78,4800,4800,1400-2-20,2021-05-10
820,ضصاد3003,اختيارخ وبصادر-3000-1400/03/12,1,90,990000,5,11,11,6,120,11,6,120,11,11,1400-2-20,2021-05-10
