,نماد,نام,تعداد,حجم,ارزش,دیروز,اولین,آخرین معامله - مقدار,آخرین معامله - تغییر,آخرین معامله - درصد,قیمت پایانی - مقدار,قیمت پایانی - تغییر,قیمت پایانی - درصد,کمترین,بیشترین,تاریخ,gregorian_date
0,خودرو,ايران‌ خودرو,18287,694270995,1436542239214,2002,2050,2047,45,2.25,2069,67,3.35,2010,2102,1400-10-21,2022-01-11
1,پالايش,صندوق پالايشي يكم-سهام,12389,13645187,963630075980,70150,70800,70310,160,0.23,70620,470,0.67,70200,71170,1400-10-21,2022-01-11
2,دارا يكم,صندوق واسطه گري مالي يكم-سهام,11821,9311489,1033064645770,110380,111450,110390,10,0.01,110950,570,0.52,109920,112390,1400-10-21,2022-01-11
3,خبنيان,بنيان ديزل,11635,29112614,41315756376,1462,1419,1419,-43,-2.94,1419,-43,-2.94,1419,1433,1400-10-21,2022-01-11
4,خساپا,سايپا,9604,365951828,629495526898,1709,1740,1693,-16,-0.94,1720,11,0.64,1671,1775,1400-10-21,2022-01-11
5,خگستر,گسترش‌سرمايه‌گذاري‌ايران‌خودرو,9526,378546787,960189383049,2436,2500,2523,87,3.57,2537,101,4.15,2470,2557,1400-10-21,2022-01-11
6,شپنا,پالايش نفت اصفهان,6854,63860397,366820504510,5750,5790,5730,-20,-0.35,5740,-10,-0.17,5680,5870,1400-10-21,2022-01-11
7,فملي,ملي‌ صنايع‌ مس‌ ايران‌,5642,46061110,325527688630,7050,7050,7050,0,0,7070,20,0.28,7000,7200,1400-10-21,2022-01-11
8,فرابورس,فرابورس ايران,5595,20955983,331293486470,16020,16250,15490,-530,-3.31,15810,-210,-1.31,15330,16580,1400-10-21,2022-01-11
9,كالا,بورس كالاي ايران,5299,14098058,385087626090,26580,27400,26900,320,1.2,27310,730,2.75,26310,27900,1400-10-21,2022-01-11
10,كمند,صندوق س. با درآمد ثابت كمند,5295,212295524,2130507529622,10028,10035,10036,8,0.08,10036,8,0.08,10035,10037,1400-10-21,2022-01-11
11,انرژي3,سايراشخاص بورس انرژي,4905,3097618,239591865430,77230,78000,75850,-1380,-1.79,77350,120,0.16,74500,80900,1400-10-21,2022-01-11
12,وبصادر,بانك صادرات ايران,4827,184582560,370999975050,2000,2035,1990,-10,-0.5,2010,10,0.5,1960,2071,1400-10-21,2022-01-11
13,شتران,پالايش نفت تهران,4662,58872098,221418202336,3720,3750,3740,20,0.54,3761,41,1.1,3712,3825,1400-10-21,2022-01-11
14,وبملت,بانك ملت,4639,140336592,460130161335,3214,3216,3309,95,2.96,3279,65,2.02,3216,3348,1400-10-21,2022-01-11
15,ختوقا,قطعات‌ اتومبيل‌ ايران‌,4515,127729594,375068281793,2842,2901,2970,128,4.5,2936,94,3.31,2801,2984,1400-10-21,2022-01-11
16,فولاد,فولاد مباركه اصفهان,4386,27833048,281137128560,10030,10180,10050,20,0.2,10100,70,0.7,10040,10270,1400-10-21,2022-01-11
17,وبرق,س.کارکنان صنعت برق زنجان وقزوي,4256,5376964,477928022400,92950,88350,88350,-4600,-4.95,88900,-4050,-4.36,88350,92300,1400-10-21,2022-01-11
18,توسن,توسعه سامانه ي نرم افزاري نگين,4039,15053053,340260471400,22650,22750,22750,100,0.44,22600,-50,-0.22,21550,23150,1400-10-21,2022-01-11
19,شبندر,پالايش نفت بندرعباس,4032,49739087,317490635030,6310,6400,6420,110,1.74,6380,70,1.11,6310,6450,1400-10-21,2022-01-11
20,بركت,گروه دارويي بركت,3866,11348695,185980220700,15980,16500,16190,210,1.31,16390,410,2.57,16060,16750,1400-10-21,2022-01-11
21,بورس,بورس اوراق بهادار تهران,3798,20386331,200681729060,9900,10100,9680,-220,-2.22,9840,-60,-0.61,9510,10230,1400-10-21,2022-01-11
22,خپارس,پارس‌ خودرو,3789,188709189,205277180595,1078,1086,1070,-8,-0.74,1088,10,0.93,1061,1117,1400-10-21,2022-01-11
23,خبهمن,گروه‌بهمن‌,3457,100174658,204164186299,2019,2040,2024,5,0.25,2038,19,0.94,1990,2087,1400-10-21,2022-01-11
24,كاما,باما,3422,29548414,191015037930,6190,6220,6490,300,4.85,6460,270,4.36,6220,6490,1400-10-21,2022-01-11
25,تپكو,توليدتجهيزات‌سنگين‌هپكو,3269,69585880,173408555820,2472,2472,2503,31,1.25,2492,20,0.81,2440,2546,1400-10-21,2022-01-11
26,كدما,معدني‌ دماوند,3216,2054009,128644161260,62710,63990,62250,-460,-0.73,62630,-80,-0.13,60360,65000,1400-10-21,2022-01-11
27,فسبزوار,پارس فولاد سبزوار,3129,2388728,81675081520,34180,34200,34200,20,0.06,34190,10,0.03,34120,34350,1400-10-21,2022-01-11
28,وتجارت,بانك تجارت,3080,76580519,149071402351,1924,1979,1935,11,0.57,1947,23,1.2,1912,1990,1400-10-21,2022-01-11
29,كلر,كلر پارس,2640,1425691,126722575750,91850,87300,91400,-450,-0.49,88900,-2950,-3.21,87300,92000,1400-10-21,2022-01-11
30,فالوم,آلومتك‌,2634,15275387,265902348340,18210,17300,17300,-910,-5,17410,-800,-4.39,17300,18480,1400-10-21,2022-01-11
31,خزاميا,زامياد,2551,19896411,171272012440,8550,8560,8450,-100,-1.17,8610,60,0.7,8370,8900,1400-10-21,2022-01-11
32,فجهان,مجتمع جهان فولاد سيرجان,2546,10251516,56390537760,5500,5510,5500,0,0,5500,0,0,5490,5520,1400-10-21,2022-01-11
33,كيان,صندوق س. با درآمد ثابت كيان,2508,32109065,1044768677089,32519,32537,32538,19,0.06,32538,19,0.06,32536,32541,1400-10-21,2022-01-11
34,آريا,پليمر آريا ساسول,2480,685673,72586473450,104650,106550,106400,1750,1.67,105550,900,0.86,104700,107200,1400-10-21,2022-01-11
35,فروي,ذوب روي اصفهان,2388,4464453,82986654910,18540,17790,18530,-10,-0.05,18590,50,0.27,17700,19200,1400-10-21,2022-01-11
36,امين,تامين سرمايه امين,2356,6611641,69106481640,10360,10400,10490,130,1.25,10450,90,0.87,10230,10500,1400-10-21,2022-01-11
37,پترول,گ.س.وت.ص.پتروشيمي خليج فارس,2333,35702879,79081326137,2211,2213,2202,-9,-0.41,2215,4,0.18,2196,2259,1400-10-21,2022-01-11
38,شپديس,پتروشيمي پرديس,2264,1290432,208100499380,163750,164990,161850,-1900,-1.16,161260,-2490,-1.52,158060,165000,1400-10-21,2022-01-11
39,حتوكا,حمل‌ونقل‌توكا,2262,18403552,248194406830,12960,13600,13500,540,4.17,13490,530,4.09,13000,13600,1400-10-21,2022-01-11
40,شفنح,ح . پتروشيمي فناوران,2238,18783087,149094642820,7830,7910,7890,60,0.77,7940,110,1.4,7880,8200,1400-10-21,2022-01-11
41,نوري,پتروشيمي نوري,2110,1260342,129458681720,101760,105000,103150,1390,1.37,102720,960,0.94,98830,105000,1400-10-21,2022-01-11
42,مديريت,س. و خدمات مديريت صند. ب كشوري,2103,1767574,15635884560,8790,8750,8790,0,0,8850,60,0.68,8750,8960,1400-10-21,2022-01-11
43,ديران,ايران‌دارو,2085,9296344,155099692720,17300,16440,17040,-260,-1.5,16680,-620,-3.58,16440,17270,1400-10-21,2022-01-11
44,پارند,صندوق س. پارند پايدار سپهر,2082,83923155,842024133870,10028,10033,10034,6,0.06,10033,5,0.05,10033,10034,1400-10-21,2022-01-11
45,ثشاهد,سرمايه‌ گذاري‌ شاهد,2061,13109355,123077786320,9020,9080,9370,350,3.88,9390,370,4.1,9080,9470,1400-10-21,2022-01-11
46,لپارس,پارس‌ الكتريك‌,2039,1238690,128256855530,99250,102000,104210,4960,5,103540,4290,4.32,100800,104210,1400-10-21,2022-01-11
47,كيمياتك,آريان كيميا تك,2021,450708,10856275110,24030,24000,24000,-30,-0.12,24070,40,0.17,23700,24500,1400-10-21,2022-01-11
48,صبا,سرمايه گذاري صبا تامين,1970,22742964,139092581610,6050,6110,6150,100,1.65,6120,70,1.16,6030,6160,1400-10-21,2022-01-11
49,وسديد,گروه ‌صنعتي‌سديد,1954,36097252,36376678129,1011,1020,1007,-4,-0.4,1008,-3,-0.3,993,1031,1400-10-21,2022-01-11
50,حآفرين,ريل پرداز نو آفرين,1947,18735933,69157512253,3709,3670,3653,-56,-1.51,3691,-18,-0.49,3560,3825,1400-10-21,2022-01-11
51,ضخود2019,اختيارخ خودرو-2500-1401/02/07,1937,76698,13621923000,169,180,172,3,1.78,178,9,5.33,168,193,1400-10-21,2022-01-11
52,تسه0009,امتيازتسهيلات مسكن آذر 1400,1923,39669,48232942065,1157986,1215885,1215885,57899,5,1215885,57899,5,1215885,1215885,1400-10-21,2022-01-11
53,گدنا,تهيه توزيع غذاي دنا آفرين فدك,1892,1245427,15762995220,12560,12740,12700,140,1.11,12660,100,0.8,12210,13080,1400-10-21,2022-01-11
54,اعتماد,صندوق س.اعتماد آفرين پارسيان-د,1861,38285210,1579446219040,41231,41254,41256,25,0.06,41255,24,0.06,41254,41257,1400-10-21,2022-01-11
55,غزر,صنعتي زر ماكارون,1853,2685229,24102733490,8890,8890,9000,110,1.24,8960,70,0.79,8860,9280,1400-10-21,2022-01-11
56,شگويا,پتروشيمي تندگويان,1835,5369046,57636190450,10580,10660,10700,120,1.13,10670,90,0.85,10630,10910,1400-10-21,2022-01-11
57,مثقال,صندوق س.پشتوانه طلاي زرين آگاه,1830,9763340,96922182553,10000,10000,9709,-291,-2.91,9927,-73,-0.73,9600,10005,1400-10-21,2022-01-11
58,ذوب,ذوب آهن اصفهان,1772,27561646,89944517416,3237,3310,3250,13,0.4,3263,26,0.8,3218,3332,1400-10-21,2022-01-11
59,شصدف,صنعتي دوده فام,1721,2244041,82357311150,35550,36000,36600,1050,2.95,36700,1150,3.23,36000,37250,1400-10-21,2022-01-11
60,فتوسا,توليد و توسعه سرب روي ايرانيان,1717,1145451,12680622990,10810,10370,10960,150,1.39,11030,220,2.04,10370,11300,1400-10-21,2022-01-11
61,حكشتي,كشتيراني جمهوري اسلامي ايران,1697,8316925,118349456550,14050,14010,14100,50,0.36,14220,170,1.21,13950,14480,1400-10-21,2022-01-11
62,لكما,كارخانجات‌مخابراتي‌ايران‌,1673,50962756,45771301920,922,930,897,-25,-2.71,898,-24,-2.6,895,930,1400-10-21,2022-01-11
63,فارس,صنايع پتروشيمي خليج فارس,1666,11418776,115546820800,10210,10210,10000,-210,-2.06,10120,-90,-0.88,9980,10340,1400-10-21,2022-01-11
64,ثاميد,توسعه و عمران اميد,1623,10432486,14339458577,1375,1370,1378,3,0.22,1375,0,0,1363,1385,1400-10-21,2022-01-11
65,وخارزم,سرمايه گذاري خوارزمي,1612,19087918,80746031190,4148,4153,4206,58,1.4,4230,82,1.98,4153,4285,1400-10-21,2022-01-11
66,سپيد,سپيد ماكيان,1605,875771,50643678570,57830,57500,57690,-140,-0.24,57830,0,0,57000,58800,1400-10-21,2022-01-11
67,چخزر,صنايع چوب خزر كاسپين,1575,2365472,86055692450,37600,37600,35750,-1850,-4.92,36400,-1200,-3.19,35750,38600,1400-10-21,2022-01-11
68,فخوز,فولاد  خوزستان,1574,9439438,56877289680,6110,6120,5970,-140,-2.29,6070,-40,-0.65,5950,6120,1400-10-21,2022-01-11
69,غنوش,نوش‌ مازندران‌,1566,6753413,82228297360,11660,11500,12240,580,4.97,12180,520,4.46,11500,12240,1400-10-21,2022-01-11
70,شاروم,پتروشيمي اروميه,1551,682277,9005645440,12990,13070,13210,220,1.69,13120,130,1,13000,13400,1400-10-21,2022-01-11
71,خنصير,مهندسي‌نصيرماشين‌,1536,6068057,113273259420,19280,19480,18320,-960,-4.98,18670,-610,-3.16,18320,19480,1400-10-21,2022-01-11
72,امين يكم,صندوق درآمد ثابت امين يكم فردا,1497,37470577,378617696068,10098,10105,10105,7,0.07,10104,6,0.06,10101,10107,1400-10-21,2022-01-11
73,ثبهساز,بهساز كاشانه تهران,1496,7099543,10879937048,1534,1522,1520,-14,-0.91,1533,-1,-0.07,1510,1567,1400-10-21,2022-01-11
74,وغدير,سرمايه‌گذاري‌غدير(هلدينگ‌,1493,7559560,105075848980,13880,14000,13880,0,0,13900,20,0.14,13780,14170,1400-10-21,2022-01-11
75,بوعلي,پتروشيمي بوعلي سينا,1483,443056,31660417520,71230,71250,71290,60,0.08,71310,80,0.11,71230,72750,1400-10-21,2022-01-11
76,سپيدار,سپيدار سيستم آسيا,1452,230549,4715695200,20550,20250,20400,-150,-0.73,20500,-50,-0.24,20150,21250,1400-10-21,2022-01-11
77,تاپكيش,تجارت الكترونيك پارسيان كيش,1361,5653389,98147191510,18010,18000,17350,-660,-3.66,17360,-650,-3.61,17110,18180,1400-10-21,2022-01-11
78,آبادا,توليد نيروي برق آبادان,1352,688049,6504448190,9640,9440,9420,-220,-2.28,9550,-90,-0.93,9280,9730,1400-10-21,2022-01-11
79,ومدير,گ.مديريت ارزش سرمايه ص ب كشوري,1345,4217124,18798671472,4359,4439,4468,109,2.5,4458,99,2.27,4366,4550,1400-10-21,2022-01-11
80,شفن,پتروشيمي فناوران,1312,3111017,38825133340,12260,12260,12420,160,1.31,12330,70,0.57,12260,12720,1400-10-21,2022-01-11
81,افران,صندوق س افرا نماد پايدار-ثابت,1301,29248770,445189936722,15212,15221,15221,9,0.06,15221,9,0.06,15220,15222,1400-10-21,2022-01-11
82,آپ,آسان پرداخت پرشين,1295,10434160,91898118350,8400,8750,8820,420,5,8810,410,4.88,8500,8820,1400-10-21,2022-01-11
83,وسين,بيمه سينا,1271,5059174,16500438909,3293,3293,3300,7,0.21,3261,-32,-0.97,3198,3350,1400-10-21,2022-01-11
84,سيتا,سرمايه گذاري سيمان تامين,1267,1337213,11751299510,8830,8900,8760,-70,-0.79,8820,-10,-0.11,8690,8900,1400-10-21,2022-01-11
85,طلا,صندوق س.پشتوانه طلاي لوتوس,1259,2130195,180336475514,83519,85006,83800,281,0.34,84657,1138,1.36,83707,85428,1400-10-21,2022-01-11
86,وهامون,سرمايه گذاري هامون صبا,1255,1819102,4899824297,2673,2700,2681,8,0.3,2680,7,0.26,2670,2729,1400-10-21,2022-01-11
87,سحرخيز,صندوق س. گروه زعفران سحرخيز,1252,2677679,50315868684,18554,19000,18590,36,0.19,18791,237,1.28,18554,19100,1400-10-21,2022-01-11
88,غكورش,صنعت غذايي كورش,1251,637776,29564120540,46620,46230,46630,10,0.02,46480,-140,-0.3,45520,47500,1400-10-21,2022-01-11
89,وسپهر,سرمايه گذاري مالي سپهرصادرات,1246,2299842,16241135300,7060,7060,7060,0,0,7060,0,0,7060,7080,1400-10-21,2022-01-11
90,شاراك,پتروشيمي شازند,1226,2086990,85761704420,41030,41030,40930,-100,-0.24,41090,60,0.15,40880,41620,1400-10-21,2022-01-11
91,بپيوند,برق و انرژي پيوندگستر پارس,1216,635158,5796208560,9120,9010,9070,-50,-0.55,9120,0,0,9010,9270,1400-10-21,2022-01-11
92,بگيلان,توسعه مسير برق گيلان,1204,301107,4138662680,13510,13610,13790,280,2.07,13550,40,0.3,13610,13880,1400-10-21,2022-01-11
93,وكبهمن,مديريت سرمايه گذاري كوثربهمن,1203,391025,3645916660,9480,9360,9240,-240,-2.53,9440,-40,-0.42,9210,9500,1400-10-21,2022-01-11
94,وساغربي,شركت س استان آذربايجان غربي,1187,65917720,27585719849,418,417,419,1,0.24,418,0,0,415,423,1400-10-21,2022-01-11
95,كزغال,زغال سنگ پروده طبس,1186,516402,15236057150,29500,29100,29500,0,0,29500,0,0,29100,30000,1400-10-21,2022-01-11
96,زملارد,كشاورزي و دامپروري ملارد شير,1182,397148,3109882140,7810,7810,7800,-10,-0.13,7810,0,0,7600,8020,1400-10-21,2022-01-11
97,قتربت,قند تربت حيدريه,1181,191104,11246470400,57150,58850,58850,1700,2.97,58850,1700,2.97,58850,58850,1400-10-21,2022-01-11
98,زاگرس,پتروشيمي زاگرس,1148,335691,64684004550,191200,191350,191200,0,0,192250,1050,0.55,190500,195000,1400-10-21,2022-01-11
99,سمگا,گروه سرمايه گذاري ميراث فرهنگي,1147,29029365,277403094860,9120,9520,9570,450,4.93,9560,440,4.82,9180,9570,1400-10-21,2022-01-11
100,ونيرو,سرمايه‌گذاري‌نيرو,1144,34727290,80942104159,2240,2191,2343,103,4.6,2331,91,4.06,2191,2352,1400-10-21,2022-01-11
101,زنگان,صنعت روي زنگان,1140,839155,53113157000,64250,67100,61100,-3150,-4.9,63300,-950,-1.48,61100,67100,1400-10-21,2022-01-11
102,قرن,پديده شيمي قرن,1130,1830606,45416441820,24430,25000,24680,250,1.02,24810,380,1.56,24390,25460,1400-10-21,2022-01-11
103,بالاس,مهندسي ساختمان تاسيسات راه آهن,1128,2309918,60417603750,26550,26500,27150,600,2.26,26150,-400,-1.51,25250,27300,1400-10-21,2022-01-11
104,رافزا,رايان هم افزا,1128,119663,6974427450,58550,58650,57800,-750,-1.28,58450,-100,-0.17,57000,59700,1400-10-21,2022-01-11
105,بترانس,ايران‌ ترانسفو,1123,28330396,54121150373,1886,1873,1890,4,0.21,1910,24,1.27,1873,1958,1400-10-21,2022-01-11
106,فسرب,ملي‌ سرب‌وروي‌ ايران‌,1107,24206486,42209707159,1738,1780,1738,0,0,1744,6,0.35,1710,1800,1400-10-21,2022-01-11
107,شغدير,پتروشيمي غدير,1107,600797,48642866060,80930,81500,80740,-190,-0.23,80960,30,0.04,80410,81500,1400-10-21,2022-01-11
108,وسكرد,شركت س استان كردستان,1087,65643086,27566922189,419,422,420,1,0.24,420,1,0.24,417,425,1400-10-21,2022-01-11
109,لطيف,محصولات كاغذي لطيف,1074,193753,7329556850,37600,37300,37800,200,0.53,37700,100,0.27,37050,38650,1400-10-21,2022-01-11
110,كوير,توليدي فولاد سپيد فراب كوير,1069,7466352,35809094570,4970,4900,4760,-210,-4.23,4840,-130,-2.62,4730,4980,1400-10-21,2022-01-11
111,ولكار,ليزينگ كارآفرين,1066,481944,1936583276,4022,3970,4064,42,1.04,4022,0,0,3970,4075,1400-10-21,2022-01-11
112,ولپارس,ليزينگ پارسيان,1065,2276854,6414264426,2831,2777,2794,-37,-1.31,2825,-6,-0.21,2777,2889,1400-10-21,2022-01-11
113,تاپيكو,س. نفت و گاز و پتروشيمي تأمين,1047,5147368,71314783640,14110,14110,13700,-410,-2.91,13950,-160,-1.13,13560,14270,1400-10-21,2022-01-11
114,حتايد,تايدواترخاورميانه,1034,9931213,51112489051,5259,5258,5180,-79,-1.5,5147,-112,-2.13,5002,5258,1400-10-21,2022-01-11
115,خريختح,ح . صنايع‌ريخته‌گري‌ايران‌,1032,22574203,36060244473,1544,1582,1552,8,0.52,1597,53,3.43,1500,1655,1400-10-21,2022-01-11
116,غگيلا,شيرپاستوريزه پگاه گيلان,1017,1183122,18076776400,15430,15100,15140,-290,-1.88,15280,-150,-0.97,14920,15800,1400-10-21,2022-01-11
117,هاي وب,داده گسترعصرنوين-هاي وب,998,5859412,46330660070,7810,7800,7880,70,0.9,7910,100,1.28,7800,8050,1400-10-21,2022-01-11
118,ثفارس,عمران‌وتوسعه‌فارس‌,996,7010155,44317248470,6450,6500,6280,-170,-2.64,6320,-130,-2.02,6180,6570,1400-10-21,2022-01-11
119,نهال,صندوق س. طلاي سرخ نوويرا,994,1223786,23435960048,18835,19399,19100,265,1.41,19150,315,1.67,18970,19595,1400-10-21,2022-01-11
120,ورازي,بيمه رازي,990,29699635,37378267709,1229,1265,1250,21,1.71,1259,30,2.44,1210,1265,1400-10-21,2022-01-11
121,وپارس,بانك‌پارسيان‌,985,23210015,43274985469,1860,1910,1840,-20,-1.08,1862,2,0.11,1829,1910,1400-10-21,2022-01-11
122,خكمك,كمك‌فنرايندامين‌,979,3538691,83526349440,22760,23890,23100,340,1.49,23600,840,3.69,22910,23890,1400-10-21,2022-01-11
123,كماسه,تامين‌ ماسه‌ ريخته‌گري‌,975,14343785,43596761812,2955,2957,3000,45,1.52,3039,84,2.84,2956,3098,1400-10-21,2022-01-11
124,ضخود2018,اختيارخ خودرو-2000-1401/02/07,968,30235,12574975000,385,390,417,32,8.31,416,31,8.05,390,430,1400-10-21,2022-01-11
125,خصدرا,صنعتي‌ دريايي‌ ايران‌,955,16711948,33310807659,1974,1977,1994,20,1.01,1993,19,0.96,1932,2030,1400-10-21,2022-01-11
126,ونوين,بانك‌اقتصادنوين‌,942,14521273,51715597988,3557,3520,3530,-27,-0.76,3561,4,0.11,3467,3649,1400-10-21,2022-01-11
127,پيزد,مجتمع صنايع لاستيك يزد,932,149059,7325495550,49200,50300,48000,-1200,-2.44,49150,-50,-0.1,47900,50300,1400-10-21,2022-01-11
128,ومعادن,توسعه‌معادن‌وفلزات‌,926,10093760,94937460180,9340,9500,9510,170,1.82,9390,50,0.54,9150,9560,1400-10-21,2022-01-11
129,فگستر,گسترش صنايع روي ايرانيان,921,953998,9556135690,10060,9790,9850,-210,-2.09,10030,-30,-0.3,9790,10300,1400-10-21,2022-01-11
130,خكار,ايركا پارت صنعت,920,12721924,40980054948,3226,3297,3150,-76,-2.36,3221,-5,-0.15,3088,3348,1400-10-21,2022-01-11
131,فسپا,گروه‌صنعتي‌سپاهان‌,919,4024552,68249172560,16230,17000,17030,800,4.93,16960,730,4.5,16550,17040,1400-10-21,2022-01-11
132,ثنوسا,نوسازي‌وساختمان‌تهران‌,900,13540894,60948613190,4680,4570,4520,-160,-3.42,4500,-180,-3.85,4450,4800,1400-10-21,2022-01-11
133,خمحركه,نيرو محركه‌,898,9964824,34659385942,3432,3520,3432,0,0,3478,46,1.34,3402,3595,1400-10-21,2022-01-11
134,فاذر,صنايع‌ آذرآب‌,897,23037205,19637273549,844,847,843,-1,-0.12,852,8,0.95,840,871,1400-10-21,2022-01-11
135,كگل,معدني و صنعتي گل گهر,881,3245957,72733797500,22380,22380,22400,20,0.09,22400,20,0.09,22150,22600,1400-10-21,2022-01-11
136,سنيرح,ح . سيمان‌ سفيدني‌ريز,863,1642929,28197409470,17500,17000,17010,-490,-2.8,17160,-340,-1.94,16850,18000,1400-10-21,2022-01-11
137,خريخت,صنايع‌ريخته‌گري‌ايران‌,852,8859390,25153440282,2858,2941,2760,-98,-3.43,2839,-19,-0.66,2751,2948,1400-10-21,2022-01-11
138,وملي,گروه‌ صنعتي‌ ملي‌ (هلدينگ‌,836,282155,39167223540,136070,140000,138000,1930,1.42,138810,2740,2.01,136110,141000,1400-10-21,2022-01-11
139,كمرجان,بازرگاني و توليدي مرجان كار,835,7459746,39496283220,5400,5210,5290,-110,-2.04,5290,-110,-2.04,5160,5550,1400-10-21,2022-01-11
140,خموتور,موتورسازان‌تراكتورسازي‌ايران‌,834,6183574,28253704506,4616,4690,4585,-31,-0.67,4569,-47,-1.02,4431,4770,1400-10-21,2022-01-11
141,خمهرح,ح . مهركام‌پارس‌,832,17714822,10822785695,603,616,601,-2,-0.33,611,8,1.33,590,627,1400-10-21,2022-01-11
142,شلعاب,لعابيران‌,827,6744126,36055091560,5130,5170,5380,250,4.87,5350,220,4.29,5170,5380,1400-10-21,2022-01-11
143,تملتح,ح . تامين سرمايه بانك ملت,821,5683463,6398126592,1130,1120,1120,-10,-0.88,1126,-4,-0.35,1106,1149,1400-10-21,2022-01-11
144,غگل,گلوكوزان‌,811,9210983,28705878351,3087,3090,3120,33,1.07,3116,29,0.94,3085,3160,1400-10-21,2022-01-11
145,سرو,صندوق س سروسودمند مدبران-سهام,802,773153,52377412700,67130,67940,67000,-130,-0.19,67750,620,0.92,66950,68380,1400-10-21,2022-01-11
146,تملت,تامين سرمايه بانك ملت,792,7509183,18897145886,2487,2460,2540,53,2.13,2517,30,1.21,2427,2547,1400-10-21,2022-01-11
147,غمارگ,مارگارين‌,785,18607306,48910141503,2509,2634,2634,125,4.98,2629,120,4.78,2577,2634,1400-10-21,2022-01-11
148,كاوه,فولاد كاوه جنوب كيش,784,2954206,37798813420,12950,12900,12800,-150,-1.16,12870,-80,-0.62,12620,13040,1400-10-21,2022-01-11
149,گشان,توسعه بين المللي پديده شانديز,778,1490180,26655885420,17740,17530,17760,20,0.11,17890,150,0.85,17530,18120,1400-10-21,2022-01-11
150,ماديرا,صنايع ماديران,771,5593799,28746858130,5080,5120,5160,80,1.57,5140,60,1.18,5020,5300,1400-10-21,2022-01-11
151,ملت,بيمه ملت,766,31567022,38448873488,1214,1210,1220,6,0.49,1218,4,0.33,1200,1231,1400-10-21,2022-01-11
152,وپويا,سرمايه گذاري پويا,757,1626840,5360907351,3305,3305,3261,-44,-1.33,3301,-4,-0.12,3235,3349,1400-10-21,2022-01-11
153,تسه0008,امتيازتسهيلات مسكن آبان1400,744,10857,13259850496,1163887,1222081,1222081,58194,5,1221318,57431,4.93,1160000,1222081,1400-10-21,2022-01-11
154,ولغدر,ليزينگ‌خودروغدير,741,6398387,57104921660,8630,8900,8750,120,1.39,8920,290,3.36,8610,9060,1400-10-21,2022-01-11
155,چكارن,كارتن‌ ايران‌,740,14396902,37039393610,2539,2570,2558,19,0.75,2573,34,1.34,2550,2640,1400-10-21,2022-01-11
156,واحصا,احياء صنايع خراسان,740,1167128,38979563100,33250,32300,32400,-850,-2.56,33400,150,0.45,32300,34200,1400-10-21,2022-01-11
157,خزر,فنرسازي‌زر,739,3516561,33756496640,9610,9660,9380,-230,-2.39,9600,-10,-0.1,9320,9930,1400-10-21,2022-01-11
158,پرديسح,ح .  سرمايه گذاري پرديس,721,13556448,16422133120,1193,1210,1220,27,2.26,1211,18,1.51,1190,1235,1400-10-21,2022-01-11
159,بكامح,ح.كارخانجات توليدي شهيد قندي,720,23818903,11002690220,449,451,493,44,9.8,462,13,2.9,441,493,1400-10-21,2022-01-11
160,ثتران,سرمايه گذاري مسكن تهران,712,8439993,25473033274,2900,2960,3045,145,5,3018,118,4.07,2960,3045,1400-10-21,2022-01-11
161,وايران,ليزينگ ايرانيان,705,14143589,37330073834,2549,2570,2676,127,4.98,2639,90,3.53,2504,2676,1400-10-21,2022-01-11
162,ختور,رادياتور ايران‌,705,2870803,35713746440,12330,12700,12250,-80,-0.65,12440,110,0.89,12020,12800,1400-10-21,2022-01-11
163,غدام,خوراك‌  دام‌ پارس‌,694,323600,29220443230,88760,92700,88650,-110,-0.12,90300,1540,1.74,87320,92700,1400-10-21,2022-01-11
164,بكاب,صنايع‌جوشكاب‌يزد,684,251712,18633666950,72120,73550,74450,2330,3.23,74030,1910,2.65,70000,75490,1400-10-21,2022-01-11
165,اپال,فرآوري معدني اپال كاني پارس,683,1073746,25269047600,23560,23570,23470,-90,-0.38,23550,-10,-0.04,23460,24270,1400-10-21,2022-01-11
166,خمهر,مهركام‌پارس‌,681,15050895,28442750265,1845,1850,1856,11,0.6,1890,45,2.44,1832,1937,1400-10-21,2022-01-11
167,وساپا,سرمايه‌گذاري‌ سايپا,677,10444789,44982153411,4269,4270,4240,-29,-0.68,4307,38,0.89,4230,4410,1400-10-21,2022-01-11
168,وسكرمان,س.سهام عدالت استان كرمان,673,44995023,19232012946,425,424,427,2,0.47,427,2,0.47,422,433,1400-10-21,2022-01-11
169,شپلي,پلي اكريل ايران,671,5864490,40302416340,6690,6890,6890,200,2.99,6870,180,2.69,6710,6890,1400-10-21,2022-01-11
170,تكشا,گسترش‌صنايع‌وخدمات‌كشاورزي‌,652,1548530,57565768780,37170,35320,38340,1170,3.15,37170,0,0,35320,39000,1400-10-21,2022-01-11
171,قثابت,قند ثابت‌ خراسان‌,649,11952196,19288004992,1603,1603,1620,17,1.06,1614,11,0.69,1594,1645,1400-10-21,2022-01-11
172,شبصير,توليدات پتروشيمي قائد بصير,648,312670,33145065700,103050,103050,105900,2850,2.77,106000,2950,2.86,103050,106950,1400-10-21,2022-01-11
173,تسه0006,امتيازتسهيلات مسكن شهريور1400,645,13069,15915527206,1160797,1218836,1218836,58039,5,1217808,57011,4.91,1170002,1218836,1400-10-21,2022-01-11
174,ولساپا,ليزينگ رايان‌ سايپا,644,16056892,22466096125,1399,1413,1387,-12,-0.86,1399,0,0,1371,1428,1400-10-21,2022-01-11
175,خكرمان,گروه اقتصادي كرمان خودرو,638,11966153,41071129087,3376,3382,3420,44,1.3,3432,56,1.66,3382,3476,1400-10-21,2022-01-11
176,سامان,بانك سامان,627,6996972,48803911310,6820,6910,6980,160,2.35,6980,160,2.35,6800,7020,1400-10-21,2022-01-11
177,كچاد,معدني‌وصنعتي‌چادرملو,625,5534625,165040669450,29830,29830,29830,0,0,29820,-10,-0.03,29530,29990,1400-10-21,2022-01-11
178,شجم,صنايع پتروشيمي تخت جمشيد,625,3453014,38384312010,11440,11020,11490,50,0.44,11120,-320,-2.8,10870,11730,1400-10-21,2022-01-11
179,ورنا,سرمايه‌گذاري‌ رنا(هلدينگ‌,624,6809053,20788822873,3048,3075,3042,-6,-0.2,3053,5,0.16,2980,3138,1400-10-21,2022-01-11
180,غگرجي,بيسكويت‌  گرجي‌,616,16796713,30257327539,1755,1788,1800,45,2.56,1801,46,2.62,1760,1842,1400-10-21,2022-01-11
181,ثتوسا,س.توسعه و عمران استان اردبيل,615,1349053,17332672420,13200,12810,12810,-390,-2.95,12850,-350,-2.65,12810,13290,1400-10-21,2022-01-11
182,شبريز,پالايش نفت تبريز,615,2355203,76552686360,32430,33000,32440,10,0.03,32490,60,0.19,32110,33490,1400-10-21,2022-01-11
183,زكوثر,سرمايه گذاري كشاورزي كوثر,607,981108,13478666310,13410,13610,13650,240,1.79,13700,290,2.16,13610,13950,1400-10-21,2022-01-11
184,فوكا,فولاد كاويان,604,3914492,52455558390,13680,13270,13670,-10,-0.07,13400,-280,-2.05,13270,13940,1400-10-21,2022-01-11
185,پارس,پتروشيمي پارس,601,148712,24999904330,165960,172300,165850,-110,-0.07,166530,570,0.34,165780,172300,1400-10-21,2022-01-11
186,ثاخت,بين‌المللي‌توسعه‌ساختمان,598,10665501,19607716088,1840,1815,1844,4,0.22,1838,-2,-0.11,1807,1874,1400-10-21,2022-01-11
187,ضخود2020,اختيارخ خودرو-3000-1401/02/07,585,32455,2726375000,83,90,81,-2,-2.41,84,1,1.2,80,96,1400-10-21,2022-01-11
188,وهور,مديريت انرژي اميد  تابان هور,584,16185659,19322958194,1206,1218,1170,-36,-2.99,1199,-7,-0.58,1170,1226,1400-10-21,2022-01-11
189,خمحور,توليدمحورخودرو,582,7616889,22612581707,3002,3010,2911,-91,-3.03,2969,-33,-1.1,2890,3110,1400-10-21,2022-01-11
190,كفپارس,فرآورده‌هاي‌ نسوز پارس‌,577,7592093,20987605756,2690,2700,2781,91,3.38,2764,74,2.75,2700,2810,1400-10-21,2022-01-11
191,دروز,داروسازي‌ روزدارو,576,2134251,63644106610,29300,30690,29310,10,0.03,29820,520,1.77,27900,30760,1400-10-21,2022-01-11
192,لبوتان,گروه‌صنعتي‌بوتان‌,575,926451,40482739780,45710,44350,43430,-2280,-4.99,43700,-2010,-4.4,43430,45970,1400-10-21,2022-01-11
193,سكه0012پ01,تمام سكه طرح جديد0012رفاه,574,145800,175461175500,1183087,1203111,1197000,13913,1.18,1203437,20350,1.72,1192000,1214700,1400-10-21,2022-01-11
194,شاوان,پالايش نفت لاوان,571,279152,34999720850,124050,125050,125300,1250,1.01,124850,800,0.64,124350,126950,1400-10-21,2022-01-11
195,هرمز,فولاد هرمزگان جنوب,569,1800281,26119438180,14710,14710,14310,-400,-2.72,14660,-50,-0.34,14280,14930,1400-10-21,2022-01-11
196,سنير,سيمان‌ سفيد ني‌ريز,564,597074,16106114480,26760,27800,27000,240,0.9,26980,220,0.82,25500,27990,1400-10-21,2022-01-11
197,شپترو,پتروشيمي آبادان,563,7620672,21588839977,2894,2880,2812,-82,-2.83,2833,-61,-2.11,2808,2889,1400-10-21,2022-01-11
198,دماوند,توليد نيروي برق دماوند,561,1036770,17874744900,17410,17050,17200,-210,-1.21,17330,-80,-0.46,17000,17600,1400-10-21,2022-01-11
199,قاسم,قاسم ايران,559,7818034,27865692783,3401,3450,3571,170,5,3564,163,4.79,3401,3571,1400-10-21,2022-01-11
200,بجهرم,توسعه مولد نيروگاهي جهرم,557,6640343,12578927325,1873,1863,1910,37,1.98,1888,15,0.8,1863,1947,1400-10-21,2022-01-11
201,غديس,پاكديس,556,2905959,29561271600,10520,10740,10100,-420,-3.99,10170,-350,-3.33,10000,10740,1400-10-21,2022-01-11
202,اتكاي,بيمه اتكايي ايرانيان,554,18582937,180108447910,9520,9580,9830,310,3.26,9690,170,1.79,9490,9950,1400-10-21,2022-01-11
203,شرنگي,شيميايي رنگين,553,209691,44152076550,215350,209100,215250,-100,-0.05,210550,-4800,-2.23,208900,215300,1400-10-21,2022-01-11
204,آگاس,صندوق س.هستي بخش آگاه-س,553,364725,27442395167,74786,75700,74811,25,0.03,75241,455,0.61,74700,75893,1400-10-21,2022-01-11
205,غپينو,پارس‌ مينو,548,9595788,20286531455,2043,2120,2137,94,4.6,2114,71,3.48,2013,2145,1400-10-21,2022-01-11
206,سيمرغ,سيمرغ,543,946758,20968111820,21540,21900,22100,560,2.6,22150,610,2.83,21810,22560,1400-10-21,2022-01-11
207,پارسان,گسترش نفت و گاز پارسيان,540,2211960,70355199330,31660,32400,31160,-500,-1.58,31750,90,0.28,31160,32500,1400-10-21,2022-01-11
208,شسپا,نفت سپاهان,539,7617012,24935527866,3296,3241,3261,-35,-1.06,3288,-8,-0.24,3210,3350,1400-10-21,2022-01-11
209,تليسه,دامداري تليسه نمونه,539,6936937,14094820659,1986,1980,2036,50,2.52,2032,46,2.32,1980,2071,1400-10-21,2022-01-11
210,شيران,س. صنايع‌شيميايي‌ايران,537,1241957,24366806060,19380,19570,19410,30,0.15,19460,80,0.41,19350,19970,1400-10-21,2022-01-11
211,فروس,فروسيليس‌ ايران‌,535,7168910,45477473590,6060,6170,6360,300,4.95,6340,280,4.62,6090,6360,1400-10-21,2022-01-11
212,وبانك,سرمايه گذاري گروه توسعه ملي,533,4731683,38201641540,8100,8050,8000,-100,-1.23,8090,-10,-0.12,7970,8240,1400-10-21,2022-01-11
213,غمينو,شركت صنايع غذايي مينو شرق,531,5131211,20238097083,3786,3730,3969,183,4.83,3944,158,4.17,3730,3975,1400-10-21,2022-01-11
214,وليز,ليزينگ‌ايران‌,528,8388281,13428082667,1620,1640,1578,-42,-2.59,1601,-19,-1.17,1541,1669,1400-10-21,2022-01-11
215,پتاير,ايران‌ تاير,528,8004489,14148972811,1752,1750,1760,8,0.46,1768,16,0.91,1724,1804,1400-10-21,2022-01-11
216,سرچشمه,سرمايه گذاري مس سرچشمه,525,4556014,24843455450,5310,5440,5570,260,4.9,5450,140,2.64,5340,5570,1400-10-21,2022-01-11
217,تسه0007,امتيازتسهيلات مسكن مهر1400,524,8103,9896282696,1163826,1151000,1222017,58191,5,1221311,57485,4.94,1151000,1222017,1400-10-21,2022-01-11
218,خرينگ,رينگ‌سازي‌مشهد,523,1054091,25738114060,24550,24600,23980,-570,-2.32,24420,-130,-0.53,23840,25200,1400-10-21,2022-01-11
219,غالبر,لبنيات‌ كالبر,522,1700270,17361363580,10410,10520,10250,-160,-1.54,10210,-200,-1.92,9890,10850,1400-10-21,2022-01-11
220,حآسا,آسيا سير ارس,519,2820071,35522768690,12010,12160,12610,600,5,12600,590,4.91,12160,12610,1400-10-21,2022-01-11
221,حفاري,حفاري شمال,517,5961979,24267121810,4058,4140,4100,42,1.03,4070,12,0.3,4022,4140,1400-10-21,2022-01-11
222,وگردش,بانك گردشگري,517,5839184,59654777900,10190,10150,10240,50,0.49,10220,30,0.29,10150,10330,1400-10-21,2022-01-11
223,ومهان,گروه توسعه مالي مهر آيندگان,516,11751998,51310208537,4385,4225,4370,-15,-0.34,4366,-19,-0.43,4225,4420,1400-10-21,2022-01-11
224,كرماشا,صنايع پتروشيمي كرمانشاه,515,1482997,76693710010,52190,52200,51810,-380,-0.73,51720,-470,-0.9,51000,53450,1400-10-21,2022-01-11
225,وصنا,گروه‌صنايع‌بهشهرايران‌,512,4837194,14639313133,3051,3118,3010,-41,-1.34,3026,-25,-0.82,2976,3118,1400-10-21,2022-01-11
226,كارا,صندوق س. كارا -د,507,21689463,228837048390,10545,10551,10551,6,0.06,10551,6,0.06,10550,10552,1400-10-21,2022-01-11
227,رانفور,خدمات‌انفورماتيك‌,502,19957577,69254055927,3464,3370,3534,70,2.02,3470,6,0.17,3370,3570,1400-10-21,2022-01-11
228,چدن,توليدي چدن سازان,499,6078736,13230043291,2205,2258,2177,-28,-1.27,2178,-27,-1.22,2139,2258,1400-10-21,2022-01-11
229,خاذين,سايپاآذين‌,494,7799440,21142326390,2667,2740,2697,30,1.12,2711,44,1.65,2632,2775,1400-10-21,2022-01-11
230,خفنر,فنرسازي‌خاور,490,1853749,12988206610,7070,7090,6910,-160,-2.26,7020,-50,-0.71,6810,7250,1400-10-21,2022-01-11
231,اخابر,مخابرات ايران,485,3140078,22414859980,7010,7240,7060,50,0.71,7030,20,0.29,7040,7330,1400-10-21,2022-01-11
232,وصنعت,سرمايه گذاري توسعه صنعت وتجارت,483,4020145,26684035650,6490,6490,6680,190,2.93,6640,150,2.31,6400,6770,1400-10-21,2022-01-11
233,غبهنوش,بهنوش‌ ايران‌,481,392462,22534104830,56620,57600,56800,180,0.32,57420,800,1.41,56710,59450,1400-10-21,2022-01-11
234,غصينو,صنعتي مينو,479,2008284,29994039430,14240,14850,14950,710,4.99,14590,350,2.46,14480,14950,1400-10-21,2022-01-11
235,تاصيكو,سرمايه گذاري صدرتامين,478,3145704,25923366660,8420,8420,8190,-230,-2.73,8370,-50,-0.59,8100,8420,1400-10-21,2022-01-11
236,شتوكا,توكا رنگ فولاد سپاهان,475,918958,12469550190,13500,13630,13460,-40,-0.3,13570,70,0.52,13200,13980,1400-10-21,2022-01-11
237,سبزوا,سيمان لار سبزوار,471,4824295,8522160117,1777,1762,1760,-17,-0.96,1771,-6,-0.34,1734,1835,1400-10-21,2022-01-11
238,وفتخار,سرمايه گذاري افتخار سهام,470,2341516,4465092924,1853,1853,1886,33,1.78,1889,36,1.94,1853,1908,1400-10-21,2022-01-11
239,كرازي,كارخانجات‌توليدي‌شيشه‌رازي‌,465,15547924,18852817511,1210,1212,1216,6,0.5,1213,3,0.25,1198,1240,1400-10-21,2022-01-11
240,رتاپ,تجارت الكترونيك  پارسيان,462,1655796,8181127920,4880,5000,4970,90,1.84,4920,40,0.82,4900,5040,1400-10-21,2022-01-11
241,گكيش,توريستي ورفاهي آبادگران كيش,457,1190790,24193377750,21250,20200,20200,-1050,-4.94,20300,-950,-4.47,20200,21600,1400-10-21,2022-01-11
242,قشكر,شكرشاهرود,456,13585405,29266042380,2218,2170,2150,-68,-3.07,2154,-64,-2.89,2123,2225,1400-10-21,2022-01-11
243,وهنر,گروه توسعه هنر ايران,455,5866572,14227580436,2489,2470,2415,-74,-2.97,2425,-64,-2.57,2415,2524,1400-10-21,2022-01-11
244,البرز,بيمه البرز,452,7773268,13215442036,1693,1694,1712,19,1.12,1698,5,0.3,1681,1731,1400-10-21,2022-01-11
245,خاهن,آهنگري‌ تراكتورسازي‌ ايران‌,451,3709895,15392568519,4237,4059,4180,-57,-1.35,4180,-57,-1.35,4048,4280,1400-10-21,2022-01-11
246,زقيام,كشت و دام قيام اصفهان,449,17591712,23742235416,1301,1300,1366,65,5,1350,49,3.77,1261,1366,1400-10-21,2022-01-11
247,فنفت,صنايع تجهيزات نفت,449,3976639,75759819670,18850,18320,19410,560,2.97,19050,200,1.06,18320,19410,1400-10-21,2022-01-11
248,مبين,مبين انرژي خليج فارس,447,2409866,55805368430,24240,24190,23030,-1210,-4.99,23690,-550,-2.27,23030,24220,1400-10-21,2022-01-11
249,ياقوت,صندوق س ياقوت آگاه-ثابت,437,3419644,47818730396,13975,13975,13983,8,0.06,13984,9,0.06,13975,13984,1400-10-21,2022-01-11
250,پرداخت,به پرداخت ملت,437,1202075,17569136200,14070,14400,14730,660,4.69,14620,550,3.91,14100,14750,1400-10-21,2022-01-11
251,لسرما,سرما آفرين‌,436,1248389,25423387970,19530,20000,20500,970,4.97,20360,830,4.25,19660,20500,1400-10-21,2022-01-11
252,نطرين,عطرين نخ قم,436,1542515,10230268140,6680,6580,6580,-100,-1.5,6650,-30,-0.45,6360,6790,1400-10-21,2022-01-11
253,غسالم,سالمين‌,433,3697544,9799058501,2602,2604,2620,18,0.69,2634,32,1.23,2604,2698,1400-10-21,2022-01-11
254,بپاس,بيمه پاسارگاد,428,1252903,46390453700,37000,37100,37100,100,0.27,37000,0,0,37000,37150,1400-10-21,2022-01-11
255,كامياب,صندوق س. كامياب آشنا-د,424,11183950,125694549784,11233,11238,11239,6,0.05,11239,6,0.05,11238,11240,1400-10-21,2022-01-11
256,شپاكسا,پاكسان‌,415,1161821,22387286400,19820,19750,19290,-530,-2.67,19270,-550,-2.77,18970,19750,1400-10-21,2022-01-11
257,كترام,توليدي‌ كاشي‌ تكسرام‌,415,2428374,49712478850,19530,19650,20500,970,4.97,20470,940,4.81,19650,20500,1400-10-21,2022-01-11
258,وسكرشا,س.سهام عدالت استان كرمانشاه,410,26155908,11265587259,430,424,431,1,0.23,431,1,0.23,424,437,1400-10-21,2022-01-11
259,فنورد,نوردوقطعات‌ فولادي‌,409,110644,18727674680,164100,169550,172300,8200,5,169260,5160,3.14,164360,172300,1400-10-21,2022-01-11
260,غچين,كشت‌ و صنعت‌ چين‌ چين,409,1302934,15158068780,11470,11690,11700,230,2.01,11630,160,1.39,11060,11860,1400-10-21,2022-01-11
261,تسه0005,امتيازتسهيلات مسكن مرداد 1400,408,5584,6795024424,1161119,1192000,1219174,58055,5,1216874,55755,4.8,1192000,1219174,1400-10-21,2022-01-11
262,پكوير,كوير تاير,408,3488725,17534588420,5180,5100,5000,-180,-3.47,5030,-150,-2.9,4930,5200,1400-10-21,2022-01-11
263,فلوله,لوله‌وماشين‌سازي‌ايران‌,406,10929777,10385525810,953,944,944,-9,-0.94,951,-2,-0.21,940,975,1400-10-21,2022-01-11
264,ثبات,صندوق س. ثبات ويستا -د,398,18248493,195916801196,10730,10735,10736,6,0.06,10736,6,0.06,10735,10737,1400-10-21,2022-01-11
265,زدشت,كشت و صنعت دشت خرم دره,396,1359725,16806066730,12280,12280,12500,220,1.79,12360,80,0.65,12050,12670,1400-10-21,2022-01-11
266,دسانكو,داروسازي سبحان انكولوژي,396,1390954,15939873930,11330,11400,11480,150,1.32,11460,130,1.15,11060,11680,1400-10-21,2022-01-11
267,كتوكا,توليدي و خدمات صنايع نسوز توكا,395,2065419,14147167190,6880,6780,6740,-140,-2.03,6850,-30,-0.44,6660,7020,1400-10-21,2022-01-11
268,غويتا,ويتانا,395,2513722,11841312670,4690,4660,4720,30,0.64,4710,20,0.43,4610,4830,1400-10-21,2022-01-11
269,حريل,ريل پردازسير,392,5266213,12748256598,2372,2440,2375,3,0.13,2413,41,1.73,2375,2460,1400-10-21,2022-01-11
270,غبشهر,صنعتي‌ بهشهر,387,5397878,18259998679,3345,3280,3398,53,1.58,3368,23,0.69,3280,3449,1400-10-21,2022-01-11
271,حسير,ريل سير كوثر,386,1961007,30907203150,15020,15770,15770,750,4.99,15760,740,4.93,15620,15770,1400-10-21,2022-01-11
272,همراه,شركت ارتباطات سيار ايران,384,2082354,16335931280,7850,7880,7740,-110,-1.4,7850,0,0,7690,8010,1400-10-21,2022-01-11
273,وساخت,سرمايه‌ گذاري‌ ساختمان‌ايران‌,383,491504,15668022360,30810,30820,32350,1540,5,31880,1070,3.47,30820,32350,1400-10-21,2022-01-11
274,ضملت1134,اختيارخ وبملت-3500-1400/11/13,381,17515,882257000,51,56,50,-1,-1.96,50,-1,-1.96,43,74,1400-10-21,2022-01-11
275,هماي,صندوق س هماي آگاه-ثابت,377,4309145,43619496509,10115,10122,10124,9,0.09,10123,8,0.08,10117,10124,1400-10-21,2022-01-11
276,كبافق,معادن‌ بافق‌,376,392266,10095828330,25520,25500,25590,70,0.27,25680,160,0.63,25500,26150,1400-10-21,2022-01-11
277,دكپسول,توليد ژلاتين كپسول ايران,375,733669,22320781700,29150,28400,30400,1250,4.29,30400,1250,4.29,28400,30600,1400-10-21,2022-01-11
278,سفارس,سيمان فارس و خوزستان,375,1220865,18799626370,15450,15620,15240,-210,-1.36,15420,-30,-0.19,15170,15650,1400-10-21,2022-01-11
279,اميد,تامين سرمايه اميد,372,4047913,36065805310,8890,8930,8860,-30,-0.34,8910,20,0.22,8860,8940,1400-10-21,2022-01-11
280,كروي,توسعه‌ معادن‌ روي‌ ايران‌,369,442366,9649484350,21810,21220,21830,20,0.09,21810,0,0,21220,22250,1400-10-21,2022-01-11
281,خكاوه,سايپا ديزل,366,17223954,72013351674,3982,4181,4181,199,5,4181,199,5,4181,4181,1400-10-21,2022-01-11
282,فايرا,آلومينيوم‌ايران‌,365,1007732,17640151450,17000,17850,17100,100,0.59,17130,130,0.76,17100,17850,1400-10-21,2022-01-11
283,فاسمين,كالسيمين‌,362,2183663,36246038180,16420,16360,16790,370,2.25,16580,160,0.97,16360,16940,1400-10-21,2022-01-11
284,جوين,كشت و صنعت جوين,362,6553134,15532163832,2433,2361,2361,-72,-2.96,2370,-63,-2.59,2361,2429,1400-10-21,2022-01-11
285,كپرور,فرآوري زغال سنگ پروده طبس,359,1031398,30348617850,28050,28200,29400,1350,4.81,29400,1350,4.81,28200,29450,1400-10-21,2022-01-11
286,فجر,فولاد اميركبيركاشان,359,517717,11594799080,22340,22890,22200,-140,-0.63,22370,30,0.13,22020,22890,1400-10-21,2022-01-11
287,اطلس,صندوق س.توسعه اندوخته آينده-س,359,84681,19949910199,234754,236000,234481,-273,-0.12,235589,835,0.36,234400,236999,1400-10-21,2022-01-11
288,كارين,صندوق س نگين سامان-ثابت,357,16360717,165595728100,10113,10120,10121,8,0.08,10122,9,0.09,10119,10122,1400-10-21,2022-01-11
289,خوساز,محورسازان‌ايران‌خودرو,357,2159796,15162651530,7050,6970,7000,-50,-0.71,7020,-30,-0.43,6840,7250,1400-10-21,2022-01-11
290,فسازانح,ح . غلتك سازان سپاهان,356,3383674,8100549405,2382,2487,2340,-42,-1.76,2394,12,0.5,2314,2487,1400-10-21,2022-01-11
291,حسينا,توسعه خدمات دريايي وبندري سينا,354,621445,28077059500,43250,43200,45050,1800,4.16,45200,1950,4.51,42300,45400,1400-10-21,2022-01-11
292,ثاصفا,شركت‌ ساختمان‌ اصفهان‌,351,1381322,11466344590,8160,8400,8200,40,0.49,8300,140,1.72,7950,8400,1400-10-21,2022-01-11
293,تسه0004,امتيازتسهيلات مسكن تير1400,351,5681,6918600499,1161652,1219734,1219734,58082,5,1217849,56197,4.84,1170000,1219734,1400-10-21,2022-01-11
294,بايكا,كارخانجات كابلسازي ‌ايران‌,349,575101,8614701310,15200,14440,14670,-530,-3.49,15000,-200,-1.32,14440,15560,1400-10-21,2022-01-11
295,كساوه,صنايع‌ كاشي‌ و سراميك‌ سينا,349,939487,42201510370,45280,45880,45350,70,0.15,44920,-360,-0.8,43420,45900,1400-10-21,2022-01-11
296,بكام,كارخانجات توليدي شهيد قندي,348,4998617,7541210766,1497,1461,1525,28,1.87,1503,6,0.4,1461,1529,1400-10-21,2022-01-11
297,ثنور,سرمايه گذاري كوه نور,348,3753160,29379598280,8040,7810,7800,-240,-2.99,7830,-210,-2.61,7800,8010,1400-10-21,2022-01-11
298,ثشرق,سرمايه گذاري مسكن شمال شرق,347,4161726,13591679935,3260,3217,3288,28,0.86,3266,6,0.18,3200,3344,1400-10-21,2022-01-11
299,لابسا,آبسال‌,345,961936,29891332220,31540,31310,31830,290,0.92,31070,-470,-1.49,30100,31940,1400-10-21,2022-01-11
300,بشهاب,لامپ‌  پارس‌ شهاب‌,345,445896,61759695950,136240,140000,139460,3220,2.36,138510,2270,1.67,137000,140470,1400-10-21,2022-01-11
301,گكوثر,هتل پارسيان كوثر اصفهان,344,5641790,7903513246,1384,1390,1400,16,1.16,1393,9,0.65,1378,1435,1400-10-21,2022-01-11
302,خراسان,پتروشيمي خراسان,343,138655,16083735070,119150,116310,116480,-2670,-2.24,118540,-610,-0.51,114500,117990,1400-10-21,2022-01-11
303,مرقام,ايران‌ارقام‌,339,1328295,12811720050,9560,9670,9640,80,0.84,9640,80,0.84,9260,9790,1400-10-21,2022-01-11
304,ونيكي,سرمايه‌گذاري‌ ملي‌ايران‌,335,2071618,18873617870,9210,9070,9050,-160,-1.74,9180,-30,-0.33,9020,9230,1400-10-21,2022-01-11
305,شكام,صنايع شيميايي كيمياگران امروز,335,2085285,58367800200,27800,28400,27550,-250,-0.9,28000,200,0.72,27500,28700,1400-10-21,2022-01-11
306,كسرام,پارس‌ سرام‌,334,4750595,19873885148,4046,4225,4248,202,4.99,4183,137,3.39,4003,4248,1400-10-21,2022-01-11
307,ساوه,سيمان ساوه,333,133745,6037108100,46400,44750,45350,-1050,-2.26,45850,-550,-1.19,44700,46200,1400-10-21,2022-01-11
308,ميدكو,توسعه معادن وص.معدني خاورميانه,332,6645969,306907376930,46180,46180,46180,0,0,46180,0,0,45710,46190,1400-10-21,2022-01-11
309,آ س پ,آ.س.پ,331,1738540,9530106640,5520,5590,5560,40,0.72,5490,-30,-0.54,5270,5660,1400-10-21,2022-01-11
310,سدبير,س. تدبيرگران فارس وخوزستان,331,1053352,36919987600,38900,35050,35050,-3850,-9.9,35050,-3850,-9.9,35050,35050,1400-10-21,2022-01-11
311,سغرب,سيمان‌غرب‌,330,1340490,20176573990,15480,15750,15270,-210,-1.36,15050,-430,-2.78,14710,15750,1400-10-21,2022-01-11
312,بكهنوج,توليد برق ماهتاب كهنوج,330,12784935,13407069780,1036,1050,1051,15,1.45,1048,12,1.16,1027,1064,1400-10-21,2022-01-11
313,سكارون,سيمان كارون,328,236204,7986359650,34300,33350,33550,-750,-2.19,33900,-400,-1.17,33300,34500,1400-10-21,2022-01-11
314,پكرمان,گروه‌ صنعتي‌ بارز,328,753741,13502407990,18100,18300,17640,-460,-2.54,17960,-140,-0.77,17500,18800,1400-10-21,2022-01-11
315,تسه0003,امتيازتسهيلات مسكن خرداد1400,327,4446,5491271354,1178898,1187636,1237842,58944,5,1235104,56206,4.77,1177280,1237842,1400-10-21,2022-01-11
316,وكار,بانك‌ كارآفرين‌,326,4944271,11375507791,2323,2270,2300,-23,-0.99,2316,-7,-0.3,2270,2332,1400-10-21,2022-01-11
317,فرآور,فرآوري‌موادمعدني‌ايران‌,326,470106,11811296120,24750,24320,25220,470,1.9,25070,320,1.29,24320,25680,1400-10-21,2022-01-11
318,شگل,گلتاش‌,322,2413791,13613495600,5600,5550,5650,50,0.89,5640,40,0.71,5520,5720,1400-10-21,2022-01-11
319,مدير,ص.س.مديريت ثروت ص.بازنشستگي-س,320,956890,8600206316,8992,9001,8933,-59,-0.66,8988,-4,-0.04,8900,9119,1400-10-21,2022-01-11
320,ضسپا1114,اختيارخ خساپا-2000-1400/11/20,319,18311,710957000,40,32,36,-4,-10,39,-1,-2.5,32,48,1400-10-21,2022-01-11
321,زشگزا,شير و گوشت زاگرس شهركرد,319,2237938,10424958984,4568,4560,4700,132,2.89,4635,67,1.47,4500,4796,1400-10-21,2022-01-11
322,فپنتا,سپنتا,318,65062,30372726340,444790,465000,467020,22230,5,466830,22040,4.96,455010,467020,1400-10-21,2022-01-11
323,چافست,افست‌,317,1614407,13687974340,8910,8490,8470,-440,-4.94,8520,-390,-4.38,8470,8740,1400-10-21,2022-01-11
324,وتوصا,گروه س توسعه صنعتي ايران,317,1702087,17312071910,10100,10000,10300,200,1.98,10170,70,0.69,10000,10420,1400-10-21,2022-01-11
325,ولانا,شركت ليزينگ آريا دانا,315,1116010,12323313250,11230,10900,10900,-330,-2.94,11040,-190,-1.69,10900,11550,1400-10-21,2022-01-11
326,ارزش,صندوق س ارزش آفرين بيدار-سهام,315,1600711,14406547150,8920,8990,8920,0,0,9000,80,0.9,8890,9060,1400-10-21,2022-01-11
327,وسنا,سرمايه گذاري نيروگاهي ايران,313,1404587,12175356610,8850,8600,8660,-190,-2.15,8670,-180,-2.03,8590,9060,1400-10-21,2022-01-11
328,وآذر,سرمايه‌گذاري‌توسعه‌آذربايجان‌,309,279086,9650194940,35690,35750,34300,-1390,-3.89,34950,-740,-2.07,34000,35750,1400-10-21,2022-01-11
329,شاملا,معدني‌ املاح‌  ايران‌,309,1779293,21004262200,11260,11790,11820,560,4.97,11800,540,4.8,11330,11820,1400-10-21,2022-01-11
330,تسه0002,امتيازتسهيلاتمسكن ارديبهشت1400,307,4321,5277020074,1164312,1155500,1222527,58215,5,1221250,56938,4.89,1155500,1222527,1400-10-21,2022-01-11
331,ولشرق,ليزينگ ايران و شرق,305,3472881,7476010686,2205,2130,2123,-82,-3.72,2177,-28,-1.27,2100,2240,1400-10-21,2022-01-11
332,پكويرح,ح. كوير تاير,305,1969070,5375438777,2731,2691,2730,-1,-0.04,2730,-1,-0.04,2691,2818,1400-10-21,2022-01-11
333,غشصفا,شيرپاستوريزه‌پگاه‌اصفهان‌,305,3588672,67480480190,19730,18750,19150,-580,-2.94,18800,-930,-4.71,18750,19730,1400-10-21,2022-01-11
334,چكاوه,صنايع‌كاغذسازي‌كاوه‌,303,1033586,8157478320,7870,8090,7740,-130,-1.65,7880,10,0.13,7700,8150,1400-10-21,2022-01-11
335,تبرك,گروه كارخانجات صنعتي تبرك,302,1388299,10975329230,7820,7730,8090,270,3.45,7880,60,0.77,7730,8100,1400-10-21,2022-01-11
336,فزرين,زرين معدن آسيا,300,1178401,12539488000,10490,10600,10680,190,1.81,10620,130,1.24,10490,10890,1400-10-21,2022-01-11
337,وسپه,سرمايه‌گذاري‌ سپه‌,300,1897676,15283549390,8060,8000,8020,-40,-0.5,8060,0,0,7970,8130,1400-10-21,2022-01-11
338,وسگيلا,شركت س استان گيلان,299,19159906,8235822513,436,418,436,0,0,434,-2,-0.46,418,442,1400-10-21,2022-01-11
339,وخاور,بانك خاورميانه,298,7301632,36513756881,5031,5070,4980,-51,-1.01,5009,-22,-0.44,4965,5070,1400-10-21,2022-01-11
340,وبوعلي,سرمايه‌گذاري‌بوعلي‌,298,2106403,7443087046,3574,3560,3510,-64,-1.79,3553,-21,-0.59,3482,3589,1400-10-21,2022-01-11
341,تايرا,تراكتورسازي‌ايران‌,297,588111,11664534390,20070,20380,19450,-620,-3.09,19960,-110,-0.55,19420,20380,1400-10-21,2022-01-11
342,قهكمت,قندهكمتان‌,295,4344987,19889289604,4377,4500,4595,218,4.98,4578,201,4.59,4419,4595,1400-10-21,2022-01-11
343,سخاش,سيمان‌خاش‌,293,119230,9585783580,78720,77970,80100,1380,1.75,79850,1130,1.44,77970,81640,1400-10-21,2022-01-11
344,ولملت,واسپاري ملت,289,3018337,9008891476,3077,3022,2929,-148,-4.81,3019,-58,-1.88,2924,3140,1400-10-21,2022-01-11
345,كمينا,شيشه سازي مينا,289,2695520,21060907170,8200,7790,7790,-410,-5,7810,-390,-4.76,7790,8210,1400-10-21,2022-01-11
346,ثاباد,توريستي ورفاهي آبادگران ايران,289,885529,34034265010,36680,37950,38510,1830,4.99,38430,1750,4.77,37720,38510,1400-10-21,2022-01-11
347,خشرق,الكتريك‌ خودرو شرق‌,288,1133221,13131212530,11360,11780,11490,130,1.14,11550,190,1.67,11360,11880,1400-10-21,2022-01-11
348,زبينا,كشاورزي و دامپروري بينالود,288,4246000,9085629582,2134,2100,2149,15,0.7,2138,4,0.19,2070,2190,1400-10-21,2022-01-11
349,ثامان,سامان‌ گستراصفهان‌,288,1187222,11446558410,9360,9600,9770,410,4.38,9560,200,2.14,9510,9770,1400-10-21,2022-01-11
350,دزهراوي,داروسازي‌زهراوي‌,288,1577084,6374956829,4069,3970,4060,-9,-0.22,4057,-12,-0.29,3950,4140,1400-10-21,2022-01-11
351,زشريف,كشت وصنعت شريف آباد,288,2963944,9814858102,3271,3120,3395,124,3.79,3297,26,0.79,3119,3400,1400-10-21,2022-01-11
352,پلاستح,ح.كارخانجات توليدي پلاستيران,287,4267859,13190927274,3138,3232,3120,-18,-0.57,3091,-47,-1.5,3044,3232,1400-10-21,2022-01-11
353,وصندوق,سرمايه‌گذاري‌صندوق‌بازنشستگي‌,286,2082230,23750153560,11630,11630,11400,-230,-1.98,11580,-50,-0.43,11200,11710,1400-10-21,2022-01-11
354,شفارس,صنايع‌ شيميايي‌ فارس‌,286,4715771,4662232417,983,971,985,2,0.2,985,2,0.2,971,1005,1400-10-21,2022-01-11
355,ددام,داروسازي زاگرس فارمد پارس,285,950329,7906638490,8080,8130,8230,150,1.86,8220,140,1.73,8130,8480,1400-10-21,2022-01-11
356,سغدير,توسعه سرمايه و صنعت غدير,285,787088,11648518930,14440,14650,14700,260,1.8,14650,210,1.45,14380,15060,1400-10-21,2022-01-11
357,شبهرن,نفت‌ بهران‌,283,823977,8941778650,10960,11050,10890,-70,-0.64,10940,-20,-0.18,10700,11080,1400-10-21,2022-01-11
358,فباهنر,مس‌ شهيدباهنر,283,503783,13323337550,26230,26820,26390,160,0.61,26330,100,0.38,26120,27170,1400-10-21,2022-01-11
359,آريان,سرمايه گذاري پارس آريان,282,2836865,36893250570,12870,12620,12550,-320,-2.49,12920,50,0.39,12520,13250,1400-10-21,2022-01-11
360,كهمدا,شيشه‌ همدان‌,280,1389815,13414608330,9470,9480,9750,280,2.96,9630,160,1.69,9470,9780,1400-10-21,2022-01-11
361,غبهار,كشت وصنعت بهاران گلبهار خراسان,279,1073226,20860189210,18910,19200,19470,560,2.96,19440,530,2.8,19200,19470,1400-10-21,2022-01-11
362,حپترو,حمل و نقل پتروشيمي( سهامي عام,279,346253,7071844620,20200,20110,20490,290,1.44,20310,110,0.54,19900,20940,1400-10-21,2022-01-11
363,وآوا,سرمايه گذاري آوا نوين,278,2117436,5252469904,2522,2465,2461,-61,-2.42,2507,-15,-0.59,2422,2550,1400-10-21,2022-01-11
364,شخارك,پتروشيمي‌ خارك‌,277,498232,24323489850,49470,49470,48300,-1170,-2.37,49310,-160,-0.32,48220,49560,1400-10-21,2022-01-11
365,چفيبر,فيبر ايران‌,277,1756791,12191117090,7030,7170,7060,30,0.43,6960,-70,-1,6800,7170,1400-10-21,2022-01-11
366,غاذر,كشت‌وصنعت‌پياذر,276,482977,16801474190,35250,34500,34600,-650,-1.84,34790,-460,-1.3,34500,35580,1400-10-21,2022-01-11
367,غشهداب,كشت و صنعت شهداب ناب خراسان,275,2923392,7307697228,2488,2454,2471,-17,-0.68,2494,6,0.24,2454,2545,1400-10-21,2022-01-11
368,قصفها,قنداصفهان‌,275,114167,8333758380,71380,70000,74140,2760,3.87,72320,940,1.32,70000,74270,1400-10-21,2022-01-11
369,كيميا,معدني كيمياي زنجان گستران,275,933535,11810562410,12710,12540,12570,-140,-1.1,12660,-50,-0.39,12430,13010,1400-10-21,2022-01-11
370,شنفت,نفت‌ پارس‌,273,1414724,13731596770,9820,9410,9580,-240,-2.44,9800,-20,-0.2,9410,9800,1400-10-21,2022-01-11
371,ساينا,صنايع بهداشتي ساينا,272,183169,16283990200,85550,87000,89800,4250,4.97,88850,3300,3.86,85550,89800,1400-10-21,2022-01-11
372,قلرست,قند لرستان‌,271,1257517,19467087930,14760,15370,15490,730,4.95,15480,720,4.88,15100,15490,1400-10-21,2022-01-11
373,آسيا,بيمه آسيا,271,7469638,12901530349,1733,1710,1732,-1,-0.06,1729,-4,-0.23,1710,1760,1400-10-21,2022-01-11
374,ودي,بيمه  دي,268,2773927,11143191308,3984,4070,4024,40,1,4009,25,0.63,3950,4090,1400-10-21,2022-01-11
375,كپشير,پشم‌شيشه‌ايران‌,263,717934,7590958800,10430,10340,10390,-40,-0.38,10510,80,0.77,10340,10940,1400-10-21,2022-01-11
376,كلوند,كاشي‌ الوند,263,764430,15975390350,21330,20640,21040,-290,-1.36,20900,-430,-2.02,20500,21740,1400-10-21,2022-01-11
377,غمهرا,توليدي‌مهرام‌,262,1031551,9263356770,9120,9370,9050,-70,-0.77,9030,-90,-0.99,8780,9460,1400-10-21,2022-01-11
378,زكشت,كشاورزي مكانيزه اصفهان كشت,260,323156,5354346270,16650,17000,16450,-200,-1.2,16620,-30,-0.18,16230,17130,1400-10-21,2022-01-11
379,جم پيلن,پلي پروپيلن جم - جم پيلن,259,122377,14523221930,118130,119130,116940,-1190,-1.01,118210,80,0.07,116800,121470,1400-10-21,2022-01-11
380,غگلستا,شير پاستوريزه پگاه گلستان,259,1339158,12567058150,9030,8910,9220,190,2.1,9330,300,3.32,8910,9480,1400-10-21,2022-01-11
381,وسبحان,سرمايه گذاري سبحان,259,5732406,12947962170,2249,2231,2241,-8,-0.36,2258,9,0.4,2230,2280,1400-10-21,2022-01-11
382,وملل,اعتباري ملل,258,2453074,23718643990,9520,9520,9600,80,0.84,9610,90,0.95,9380,9970,1400-10-21,2022-01-11
383,تسه9908,امتياز تسهيلات مسكن آبان99,258,4451,5394039173,1156727,1125050,1214563,57836,5,1211871,55144,4.77,1125050,1214563,1400-10-21,2022-01-11
384,ثرود,سرمايه‌گذاري مسكن زاينده رود,256,1698194,8804776020,5100,5320,5240,140,2.75,5150,50,0.98,5100,5320,1400-10-21,2022-01-11
385,فافق,صنايع مس افق كرمان,255,2367358,7403595396,3150,3225,3111,-39,-1.24,3132,-18,-0.57,3061,3225,1400-10-21,2022-01-11
386,سبهان,سيمان‌ بهبهان‌,253,152629,6300322440,41580,41000,41580,0,0,41450,-130,-0.31,40700,42180,1400-10-21,2022-01-11
387,زفكا,كشت و دامداري فكا,253,1661921,11835765340,7220,7060,7100,-120,-1.66,7130,-90,-1.25,7010,7400,1400-10-21,2022-01-11
388,تسه0001,امتيازتسهيلات مسكن فروردين1400,253,3288,4022019987,1165572,1171294,1223850,58278,5,1223242,57670,4.95,1171294,1223850,1400-10-21,2022-01-11
389,شپارس,بين‌ المللي‌ محصولات‌  پارس‌,253,1244608,8930515910,7230,7270,7100,-130,-1.8,7200,-30,-0.41,6920,7510,1400-10-21,2022-01-11
390,زماهان,مجتمع توليد گوشت مرغ ماهان,252,1144344,7423149790,6240,6260,6450,210,3.37,6370,130,2.08,6260,6550,1400-10-21,2022-01-11
391,بهپاك,صنعتي بهپاك,252,2758269,18487304630,6700,6820,6720,20,0.3,6700,0,0,6620,6850,1400-10-21,2022-01-11
392,وساشرقي,شركت س استان آذربايجان شرقي,250,20990828,9088144708,439,421,438,-1,-0.23,437,-2,-0.46,421,441,1400-10-21,2022-01-11
393,تابا,تابان نيرو سپاهان,249,459528,9882048750,21350,21900,20750,-600,-2.81,21500,150,0.7,20750,21950,1400-10-21,2022-01-11
394,ختراك,ريخته‌گري‌ تراكتورسازي‌ ايران‌,246,1963338,9683449884,4922,4801,4870,-52,-1.06,4929,7,0.14,4801,5050,1400-10-21,2022-01-11
395,كگاز,شيشه‌ و گاز,244,584947,8489137830,14290,14500,14670,380,2.66,14420,130,0.91,14340,14880,1400-10-21,2022-01-11
396,وشهر,بانك شهر,243,1976231,8002359922,4049,4049,4051,2,0.05,4049,0,0,4030,4089,1400-10-21,2022-01-11
397,وگستر,گسترش سرمايه گذاري ايرانيان,242,802678,3946227200,4870,4740,4950,80,1.64,4880,10,0.21,4740,5040,1400-10-21,2022-01-11
398,تسه9911,امتياز تسهيلات مسكن بهمن99,240,3223,3929906314,1164642,1140522,1222874,58232,5,1219332,54690,4.7,1140522,1222874,1400-10-21,2022-01-11
399,كنور,توسعه معدني و صنعتي صبانور,239,446192,8236230830,18790,18610,18210,-580,-3.09,18760,-30,-0.16,18150,18890,1400-10-21,2022-01-11
400,دتوليد,داروسازي توليد دارو,239,867054,6486360400,7470,7290,7370,-100,-1.34,7470,0,0,7290,7590,1400-10-21,2022-01-11
401,ارفع,شركت آهن و فولاد ارفع,239,534976,7481684650,14260,14000,13810,-450,-3.16,14230,-30,-0.21,13800,14270,1400-10-21,2022-01-11
402,وپسا,س. پتروشيمي ساختمان  خليج فارس,238,4490207,6750079207,1525,1494,1528,3,0.2,1511,-14,-0.92,1480,1557,1400-10-21,2022-01-11
403,سشرق,سيمان‌ شرق‌,237,1329783,9362580810,7120,7020,7010,-110,-1.54,7070,-50,-0.7,6980,7200,1400-10-21,2022-01-11
404,فجام,جام‌دارو,237,2396214,9550135371,3949,3921,3970,21,0.53,3974,25,0.63,3920,4095,1400-10-21,2022-01-11
405,فافزا,فولاد افزا سپاهان,236,242750,7112868950,30300,28800,28800,-1500,-4.95,29550,-750,-2.48,28800,31000,1400-10-21,2022-01-11
406,تنوين,تامين سرمايه نوين,234,5936387,37191558090,6260,6260,6210,-50,-0.8,6260,0,0,6120,6300,1400-10-21,2022-01-11
407,آساميد,صندوق س.مشترك آسمان اميد -د,232,5715138,79076587609,13832,13839,13836,4,0.03,13836,4,0.03,13836,13839,1400-10-21,2022-01-11
408,عيار,صندوق سكه طلاي مفيد,232,320937,9824442220,29826,31476,30300,474,1.59,30612,786,2.64,30200,31476,1400-10-21,2022-01-11
409,تسه9912,امتياز تسهيلات مسكن اسفند99,231,3432,4198188720,1166361,1175001,1224679,58318,5,1223248,56887,4.88,1175001,1224679,1400-10-21,2022-01-11
410,گوهران,سرمايه گذاري توسعه گوهران اميد,231,821604,4085578320,4970,4990,4980,10,0.2,4970,0,0,4930,5060,1400-10-21,2022-01-11
411,بموتو,موتوژن‌,230,162499,11831401590,73540,73490,73030,-510,-0.69,73100,-440,-0.6,72140,73900,1400-10-21,2022-01-11
412,ولقمان,سرمايه گذاري لقمان,226,1107345,3050150443,2767,2800,2685,-82,-2.96,2763,-4,-0.14,2684,2849,1400-10-21,2022-01-11
413,واميد,گروه مديريت سرمايه گذاري اميد,226,2844923,40529743200,14280,14290,14100,-180,-1.26,14270,-10,-0.07,14010,14600,1400-10-21,2022-01-11
414,ولشرقح,ح . ليزينگ ايران و شرق,225,7204851,4578138053,666,640,633,-33,-4.95,635,-31,-4.65,633,667,1400-10-21,2022-01-11
415,ثباغ,شهر سازي و خانه سازي باغميشه,224,1765557,13260268520,7540,7770,7470,-70,-0.93,7510,-30,-0.4,7280,7900,1400-10-21,2022-01-11
416,تسه9910,امتياز تسهيلات مسكن دي99,222,4138,5048316940,1165186,1223445,1223445,58259,5,1219990,54804,4.7,1136952,1223445,1400-10-21,2022-01-11
417,خپويش,سازه‌ پويش‌,220,239669,16937430130,67380,70150,70740,3360,4.99,70670,3290,4.88,68080,70740,1400-10-21,2022-01-11
418,دانا,بيمه دانا,219,3659060,16593874550,4503,4511,4577,74,1.64,4535,32,0.71,4511,4620,1400-10-21,2022-01-11
419,وبشهر,توسعه‌ صنايع‌ بهشهر(هلدينگ,216,1989265,13225724180,6720,6500,6650,-70,-1.04,6700,-20,-0.3,6500,6780,1400-10-21,2022-01-11
420,سصفها,سيمان‌اصفهان‌,215,561631,13959879960,25190,24330,24780,-410,-1.63,24880,-310,-1.23,24330,25600,1400-10-21,2022-01-11
421,رنيك,جنرال مكانيك,215,382759,4032867110,10510,10450,10770,260,2.47,10520,10,0.1,10420,10810,1400-10-21,2022-01-11
422,ميهن,بيمه ميهن,213,2573633,5913014355,2359,2400,2317,-42,-1.78,2336,-23,-0.97,2251,2400,1400-10-21,2022-01-11
423,وتوكا,سرمايه‌گذاري‌توكافولاد(هلدينگ,212,1256943,8696065460,6940,7000,6870,-70,-1.01,6930,-10,-0.14,6820,7180,1400-10-21,2022-01-11
424,صنوين,صندوق سرمايه‌گذاري صنوين-مختلط,212,62653,7173825740,114240,114600,114100,-140,-0.12,114500,260,0.23,113720,115450,1400-10-21,2022-01-11
425,دامين,داروسازي‌ امين‌,211,1602202,3655670589,2337,2326,2297,-40,-1.71,2323,-14,-0.6,2250,2328,1400-10-21,2022-01-11
426,انار,صندوق س.انارنماد ارزش-درسهام,209,639547,5675232280,8860,8920,8900,40,0.45,8870,10,0.11,8820,9060,1400-10-21,2022-01-11
427,پرديس,سرمايه گذاري پرديس,208,2118393,7264363816,3326,3407,3370,44,1.32,3375,49,1.47,3271,3492,1400-10-21,2022-01-11
428,فمراد,آلومراد,206,318979,3943769600,12300,12290,12130,-170,-1.38,12320,20,0.16,12030,12570,1400-10-21,2022-01-11
429,سيستم,همكاران سيستم,206,1561343,8088120240,5120,5270,5150,30,0.59,5140,20,0.39,5010,5290,1400-10-21,2022-01-11
430,شرانل,نفت ايرانول,206,407628,18451352300,45050,45850,44700,-350,-0.78,45150,100,0.22,44700,45850,1400-10-21,2022-01-11
431,فسازان,غلتك سازان سپاهان,204,784813,3325645663,4237,4390,4200,-37,-0.87,4237,0,0,4159,4390,1400-10-21,2022-01-11
432,آوا,صندوق س.سهام آواي معيار-س,203,470531,3574930729,7554,7555,7540,-14,-0.19,7598,44,0.58,7511,7740,1400-10-21,2022-01-11
433,زر,صندوق س.پشتوانه سكه طلاي زر,202,145621,7559523858,50991,53500,51700,709,1.39,51912,921,1.81,51660,53500,1400-10-21,2022-01-11
434,ضخود2015,اختيارخ خودرو-1400-1401/02/07,201,6307,5190089000,764,750,791,27,3.53,823,59,7.72,750,888,1400-10-21,2022-01-11
435,تكمبا,كمباين‌ سازي‌ ايران‌,201,1446031,5070902538,3578,3466,3469,-109,-3.05,3553,-25,-0.7,3466,3690,1400-10-21,2022-01-11
436,ثعمرا,عمران و توسعه شاهد,201,1279615,8727568260,6810,6730,6850,40,0.59,6820,10,0.15,6610,6980,1400-10-21,2022-01-11
437,حپارسا,توسعه حمل و نقل ريلي پارسيان,201,541139,15380345000,28500,28000,28700,200,0.7,28400,-100,-0.35,28000,29500,1400-10-21,2022-01-11
438,شيراز,پتروشيمي‌شيراز,200,288449,20439750940,71010,71050,70250,-760,-1.07,70980,-30,-0.04,70100,71700,1400-10-21,2022-01-11
439,دكوثر,داروسازي‌ كوثر,199,1306774,3320924572,2614,2600,2548,-66,-2.52,2597,-17,-0.65,2500,2614,1400-10-21,2022-01-11
440,گوهر,صندوق سكه طلاي كيان,199,275674,16432322901,58450,59999,59275,825,1.41,59608,1158,1.98,59104,60368,1400-10-21,2022-01-11
441,خاتم,صندوق س خاتم ايساتيس پويا-ثابت,199,7962286,100599438028,12628,12634,12635,7,0.06,12634,6,0.05,12634,12635,1400-10-21,2022-01-11
442,حشكوه,دليجان طلايي شكوه پارس,199,3165272,10448107965,3259,3259,3259,0,0,3301,42,1.29,3200,3350,1400-10-21,2022-01-11
443,كاريس,صندوق س.سپهر كاريزما-س,199,581998,7555510365,12911,12920,12856,-55,-0.43,12982,71,0.55,12850,13194,1400-10-21,2022-01-11
444,حخزر,كشتيراني درياي خزر,196,805175,11713662270,13890,14000,14580,690,4.97,14370,480,3.46,14000,14580,1400-10-21,2022-01-11
445,ساراب,سيمان‌ داراب‌,195,628194,10515754550,16390,16970,16650,260,1.59,16630,240,1.46,16010,17090,1400-10-21,2022-01-11
446,ريشمك,توليد و صادرات ريشمك,194,329820,10153934100,31000,30250,30600,-400,-1.29,30850,-150,-0.48,30100,31300,1400-10-21,2022-01-11
447,دتوزيع,توزيع دارو پخش,194,210131,5238988150,24800,24600,24650,-150,-0.6,24850,50,0.2,24600,25300,1400-10-21,2022-01-11
448,اخزا002,اسنادخزانه-م2بودجه00-031024,194,262337,135494601330,515860,516000,519960,4100,0.79,516490,630,0.12,515200,519990,1400-10-21,2022-01-11
449,بميلا,توسعه بازرگاني آهن وفولادميلاد,192,2139618,18501123770,8400,8640,8650,250,2.98,8650,250,2.98,8400,8650,1400-10-21,2022-01-11
450,ضخود2017,اختيارخ خودرو-1800-1401/02/07,191,10564,5634978000,503,600,532,29,5.77,533,30,5.96,522,600,1400-10-21,2022-01-11
451,كسعدي,كاشي‌ سعدي‌,190,1092799,7633521040,6900,6900,6960,60,0.87,6950,50,0.72,6900,7170,1400-10-21,2022-01-11
452,بنو,بيمه تجارت نو,190,1216218,7563296010,6350,6400,6200,-150,-2.36,6280,-70,-1.1,6110,6430,1400-10-21,2022-01-11
453,شكلر,نيروكلر,189,220392,7729233260,36420,36450,35070,-1350,-3.71,35670,-750,-2.06,34630,36450,1400-10-21,2022-01-11
454,دتماد,توليدمواداوليه‌داروپخش‌,189,132035,5161947790,39150,38860,39180,30,0.08,39130,-20,-0.05,38650,39890,1400-10-21,2022-01-11
455,دجابر,داروسازي‌ جابرابن‌حيان‌,189,678903,6969985710,10270,10050,10300,30,0.29,10270,0,0,10050,10770,1400-10-21,2022-01-11
456,سصوفي,سيمان‌ صوفيان‌,189,414690,6037955740,14290,14200,14250,-40,-0.28,14400,110,0.77,14200,14860,1400-10-21,2022-01-11
457,وايرا,سرمايه گذاري صنايع ايران,187,1310525,5774020834,4289,4417,4342,53,1.24,4355,66,1.54,4320,4417,1400-10-21,2022-01-11
458,قنقش,قند نقش جهان,187,102745,14273555450,137350,137450,138300,950,0.69,138900,1550,1.13,134950,140050,1400-10-21,2022-01-11
459,شراز,پالايش نفت شيراز,187,134163,14829950250,109900,112600,109050,-850,-0.77,110100,200,0.18,109000,112600,1400-10-21,2022-01-11
460,وثنو,سرمايه گذاري ساختماني نوين,187,3841659,15995226665,4068,3963,4110,42,1.03,4164,96,2.36,3963,4180,1400-10-21,2022-01-11
461,وثوق,سرمايه گذاري وثوق امين,186,842203,7543240490,9110,9380,8840,-270,-2.96,8990,-120,-1.32,8840,9380,1400-10-21,2022-01-11
462,توريل,توكاريل,186,1274644,9655902050,7250,7500,7610,360,4.97,7470,220,3.03,7350,7610,1400-10-21,2022-01-11
463,وبيمه,سرمايه‌ گذاري‌ صنعت‌ بيمه‌,186,3718150,5713823408,1547,1532,1528,-19,-1.23,1543,-4,-0.26,1525,1578,1400-10-21,2022-01-11
464,تسه9909,امتياز تسهيلات مسكن آذر99,186,2858,3480916084,1163843,1167818,1222035,58192,5,1217955,54112,4.65,1167818,1222035,1400-10-21,2022-01-11
465,بمپنا,توليد برق عسلويه  مپنا,184,913116,5289475500,5890,5690,5750,-140,-2.38,5860,-30,-0.51,5650,6100,1400-10-21,2022-01-11
466,ومعلم,بيمه معلم,183,1895679,3435337319,1836,1773,1798,-38,-2.07,1830,-6,-0.33,1773,1829,1400-10-21,2022-01-11
467,شوينده,مديريت صنعت شوينده ت.ص.بهشهر,182,617054,11295391700,18270,18270,18390,120,0.66,18300,30,0.16,18200,18790,1400-10-21,2022-01-11
468,كساپا,سايپاشيشه‌,182,417965,6137551600,15000,14510,14600,-400,-2.67,14870,-130,-0.87,14250,15200,1400-10-21,2022-01-11
469,اخزا006,اسنادخزانه-م6بودجه00-030723,182,497501,270566782020,544110,543160,545970,1860,0.34,543850,-260,-0.05,542160,546200,1400-10-21,2022-01-11
470,كفرآور,فرآورده هاي سيمان شرق,181,532788,10510854650,19450,19220,19680,230,1.18,19730,280,1.44,19220,20020,1400-10-21,2022-01-11
471,نيرو,نيرو سرمايه,181,457206,13763016050,29400,29400,30250,850,2.89,30100,700,2.38,29400,30250,1400-10-21,2022-01-11
472,غپاك,لبنيات‌ پاك‌,181,710500,8744303800,12200,12240,12200,0,0,12260,60,0.49,12110,12520,1400-10-21,2022-01-11
473,وسكاب,س.ص.بازنشستگي كاركنان بانكها,180,1674811,4845221897,2876,2861,2900,24,0.83,2882,6,0.21,2861,2943,1400-10-21,2022-01-11
474,كگهر,سنگ آهن گهرزمين,179,1261060,60648036250,48100,48100,47800,-300,-0.62,48100,0,0,47800,48300,1400-10-21,2022-01-11
475,كاردان,صندوق س تجارت شاخصي كاردان,179,29083,5192954890,177180,179790,177890,710,0.4,178560,1380,0.78,175600,181300,1400-10-21,2022-01-11
476,دفارا,داروسازي‌ فارابي‌,178,496943,6071230790,12640,12770,12290,-350,-2.77,12460,-180,-1.42,12010,12770,1400-10-21,2022-01-11
477,افق ملت,صندوق س در سهام افق ملت,178,12398,1687783120,138170,138300,135020,-3150,-2.28,136130,-2040,-1.48,135000,138300,1400-10-21,2022-01-11
478,نمرينو,ايران‌ مرينوس‌,177,71940,5174637000,74900,72700,71500,-3400,-4.54,73800,-1100,-1.47,71160,74830,1400-10-21,2022-01-11
479,جم,پتروشيمي جم,177,294295,14724328210,50100,50100,49220,-880,-1.76,50090,-10,-0.02,49110,51990,1400-10-21,2022-01-11
480,سخواف,سيمان مجد خواف,177,1715989,11703044980,6500,6820,6820,320,4.92,6820,320,4.92,6820,6820,1400-10-21,2022-01-11
481,كاذر,فرآورده‌هاي‌نسوزآذر,177,592384,7265730940,12340,12400,12230,-110,-0.89,12300,-40,-0.32,11950,12600,1400-10-21,2022-01-11
482,وبهمن,سرمايه‌گذاري‌بهمن‌,176,464265,6540879360,13710,14240,14100,390,2.84,13870,160,1.17,13800,14390,1400-10-21,2022-01-11
483,ثالوند,سرمايه گذاري مسكن الوند,175,738272,4217377470,5680,5800,5610,-70,-1.23,5690,10,0.18,5600,5870,1400-10-21,2022-01-11
484,آكورد,صندوق س. آرمان آتي كوثر-د,175,1745700,63242588438,36210,36228,36228,18,0.05,36228,18,0.05,36227,36233,1400-10-21,2022-01-11
485,ستران,سيمان‌ تهران‌,175,397541,7633498900,19020,19440,19030,10,0.05,19110,90,0.47,19020,19500,1400-10-21,2022-01-11
486,وحكمت,بيمه حكمت صبا,174,4550842,14114345980,3195,3100,3100,-95,-2.97,3101,-94,-2.94,3100,3147,1400-10-21,2022-01-11
487,پاسا,ايران‌ياساتايرورابر,173,734524,9507826610,12900,12890,12620,-280,-2.17,12930,30,0.23,12610,13200,1400-10-21,2022-01-11
488,ماني,صندوق س. با درآمد ثابت ماني,172,3883359,41963440668,10801,10806,10806,5,0.05,10806,5,0.05,10805,10807,1400-10-21,2022-01-11
489,شفا,سرمايه گذاري شفادارو,172,267589,3003203580,11130,11500,11240,110,0.99,11150,20,0.18,11100,11500,1400-10-21,2022-01-11
490,شاملاح,ح . معدني‌ املاح‌  ايران‌,171,773362,5393333370,6910,7000,6900,-10,-0.14,6970,60,0.87,6840,7300,1400-10-21,2022-01-11
491,بزاگرس,نيروگاه زاگرس كوثر,170,1939682,6059024974,3139,3081,3100,-39,-1.24,3133,-6,-0.19,3051,3189,1400-10-21,2022-01-11
492,وپترو,سرمايه‌گذاري صنايع پتروشيمي‌,168,403395,4230995390,10510,10680,10680,170,1.62,10500,-10,-0.1,10300,10680,1400-10-21,2022-01-11
493,بنيرو,نيروترانس‌,167,1805731,3113072034,1772,1835,1720,-52,-2.93,1761,-11,-0.62,1700,1835,1400-10-21,2022-01-11
494,فولاژ,فولاد آلياژي ايران,165,764738,13186195770,17280,16500,17290,10,0.06,17270,-10,-0.06,16500,17470,1400-10-21,2022-01-11
495,سپاها,سيمان‌سپاهان‌,164,837092,6143181590,7300,7400,7300,0,0,7320,20,0.27,7220,7420,1400-10-21,2022-01-11
496,شپاس,نفت پاسارگاد,164,295954,4472124360,15270,15640,15040,-230,-1.51,15220,-50,-0.33,14990,15660,1400-10-21,2022-01-11
497,شكربن,كربن‌ ايران‌,163,97484,8096428690,83680,83680,83250,-430,-0.51,83310,-370,-0.44,82500,84950,1400-10-21,2022-01-11
498,تسه9902,امتياز تسهيلات مسكن ارديبهشت99,161,3076,3733828098,1156705,1214000,1214540,57835,5,1213858,57153,4.94,1180010,1214540,1400-10-21,2022-01-11
499,ولملتح,ح . واسپاري ملت,160,5139367,5786376396,1151,1110,1128,-23,-2,1126,-25,-2.17,1068,1199,1400-10-21,2022-01-11
500,قيستو,شركت قند بيستون,160,327807,7156853150,21450,21000,22050,600,2.8,21700,250,1.17,20900,22050,1400-10-21,2022-01-11
501,پلاسك,پلاسكوكار,160,1725643,7227172108,4297,4171,4190,-107,-2.49,4243,-54,-1.26,4116,4378,1400-10-21,2022-01-11
502,اپرداز,آتيه داده پرداز,160,272049,5434845450,20400,20600,19950,-450,-2.21,20250,-150,-0.74,19500,20950,1400-10-21,2022-01-11
503,وجامي,سرمايه گذاري جامي,159,1090707,4037455530,3885,3691,3691,-194,-4.99,3800,-85,-2.19,3691,3800,1400-10-21,2022-01-11
504,غشوكو,شوكو پارس,157,1071247,8340917900,7750,7890,7840,90,1.16,7780,30,0.39,7570,7890,1400-10-21,2022-01-11
505,ضملت1133,اختيارخ وبملت-3000-1400/11/13,157,5750,1971105000,307,360,363,56,18.24,343,36,11.73,310,370,1400-10-21,2022-01-11
506,دسبحان,سبحان دارو,157,268205,2388390410,9200,9440,8880,-320,-3.48,9130,-70,-0.76,8750,9440,1400-10-21,2022-01-11
507,كشرق,صنعتي و معدني شمال شرق شاهرود,157,102248,7025822350,66650,68400,69000,2350,3.53,67600,950,1.43,65900,69600,1400-10-21,2022-01-11
508,فنوال,نورد آلومينيوم‌,156,487876,11245669770,22910,22360,22710,-200,-0.87,23020,110,0.48,22350,23800,1400-10-21,2022-01-11
509,ثمسكن,سرمايه‌گذاري‌ مسكن‌,155,1369407,4629093438,3312,3256,3409,97,2.93,3334,22,0.66,3256,3440,1400-10-21,2022-01-11
510,زعف0110پ11,زعفران0110نگين سحرخيز(پ),153,34529,13199100039,396107,385000,383498,-12609,-3.18,382261,-13846,-3.5,378700,395999,1400-10-21,2022-01-11
511,پاكشو,گروه صنعتي پاكشو,153,703658,4209111620,6040,6050,5950,-90,-1.49,6040,0,0,5930,6060,1400-10-21,2022-01-11
512,دبالك,مواد اوليه دارويي البرز بالك,153,405442,3116938480,7710,7570,7690,-20,-0.26,7710,0,0,7570,7770,1400-10-21,2022-01-11
513,خچرخش,چرخشگر,148,624399,4345381060,6880,6760,6860,-20,-0.29,6900,20,0.29,6760,7100,1400-10-21,2022-01-11
514,پارسيان,بيمه پارسيان,147,1830795,15069340340,8210,8270,8250,40,0.49,8230,20,0.24,8200,8390,1400-10-21,2022-01-11
515,نوين,بيمه نوين,147,1694507,6126406047,3631,3631,3648,17,0.47,3625,-6,-0.17,3589,3685,1400-10-21,2022-01-11
516,بفجر,فجر انرژي خليج فارس,146,784442,8317522510,10980,10960,10460,-520,-4.74,10940,-40,-0.36,10440,10960,1400-10-21,2022-01-11
517,پخش,پخش البرز,145,322289,8074159300,24500,23900,24550,50,0.2,24800,300,1.22,23900,25400,1400-10-21,2022-01-11
518,زيتون,صندوق س زيتون نماد پايا- مختلط,145,568421,5314562960,9380,9480,9300,-80,-0.85,9350,-30,-0.32,9270,9480,1400-10-21,2022-01-11
519,خودكفا,اقتصادي و خودكفايي آزادگان,142,1318629,9111726390,6710,6910,6910,200,2.98,6800,90,1.34,6910,6910,1400-10-21,2022-01-11
520,كي بي سي,شركت كي بي سي,142,339084,5990976230,17170,17110,17720,550,3.2,17360,190,1.11,17000,17900,1400-10-21,2022-01-11
521,شدوصح,ح . دوده‌ صنعتي‌ پارس‌,141,565984,3959395410,6990,6880,6920,-70,-1,7000,10,0.14,6880,7130,1400-10-21,2022-01-11
522,كوثر,بيمه كوثر,140,1506032,5666535074,3787,3795,3680,-107,-2.83,3782,-5,-0.13,3680,3795,1400-10-21,2022-01-11
523,ضسپا1112,اختيارخ خساپا-1600-1400/11/20,140,6666,1358431000,199,210,200,1,0.5,204,5,2.51,190,259,1400-10-21,2022-01-11
524,ولراز,ليزينگ رازي,140,230515,4132246930,18230,18640,17900,-330,-1.81,18000,-230,-1.26,17700,18640,1400-10-21,2022-01-11
525,اخزا001,اسنادخزانه-م1بودجه00-030821,140,259906,138948111490,534740,537100,537090,2350,0.44,534610,-130,-0.02,519570,537100,1400-10-21,2022-01-11
526,ولصنم,ليزينگ‌صنعت‌ومعدن‌,140,808027,2801094411,3490,3496,3381,-109,-3.12,3486,-4,-0.11,3376,3586,1400-10-21,2022-01-11
527,غفارس,شير پاستوريزه پگاه فارس,139,558722,2763823230,4950,4840,4930,-20,-0.4,4950,0,0,4840,5040,1400-10-21,2022-01-11
528,سدور,سيمان‌ دورود,139,612710,3181493710,5090,5160,5150,60,1.18,5110,20,0.39,5070,5310,1400-10-21,2022-01-11
529,اخزا003,اسنادخزانه-م3بودجه00-030418,137,101133,58384669380,577450,575750,582970,5520,0.96,577310,-140,-0.02,574530,582980,1400-10-21,2022-01-11
530,درهآور,دارويي ره آورد تامين,136,207559,4217208200,20450,19950,20300,-150,-0.73,20400,-50,-0.24,19950,20950,1400-10-21,2022-01-11
531,سپر,صندوق س سپر سرمايه بيدار- ثابت,136,2236060,30304446755,13540,13550,13555,15,0.11,13553,13,0.1,13550,13555,1400-10-21,2022-01-11
532,شصفها,پتروشيمي‌ اصفهان‌,136,75877,8780403900,118050,115700,117550,-500,-0.42,116600,-1450,-1.23,115700,117950,1400-10-21,2022-01-11
533,مفاخر,توسعه فناوري اطلاعات خوارزمي,136,213645,5752229800,27050,26200,26550,-500,-1.85,27000,-50,-0.18,26150,27800,1400-10-21,2022-01-11
534,واعتبار,سرمايه گذاري اعتبار ايران,135,908085,2499598193,2835,2819,2767,-68,-2.4,2820,-15,-0.53,2694,2890,1400-10-21,2022-01-11
535,تسه9907,امتياز تسهيلات مسكن مهر99,134,1957,2378619120,1158700,1150553,1216635,57935,5,1215441,56741,4.9,1150553,1216635,1400-10-21,2022-01-11
536,رمپنا,گروه مپنا (سهامي عام),134,344651,5473285650,16340,16210,15900,-440,-2.69,16320,-20,-0.12,15840,16210,1400-10-21,2022-01-11
537,مداران,داده‌پردازي‌ايران‌,133,409177,6317665260,15160,14420,15240,80,0.53,15280,120,0.79,14420,15800,1400-10-21,2022-01-11
538,تيپيكو,سرمايه گذاري دارويي تامين,133,209311,3790706840,18320,17750,18010,-310,-1.69,18310,-10,-0.05,17750,18330,1400-10-21,2022-01-11
539,كحافظ,كاشي‌ وسراميك‌ حافظ‌,133,1435653,5323292811,3808,3721,3642,-166,-4.36,3770,-38,-1,3618,3900,1400-10-21,2022-01-11
540,زعف0110پ18,زعفران0110نگين بهرامن(پ),132,57629,21772212072,398928,385000,379999,-18929,-4.74,377800,-21128,-5.3,375000,385000,1400-10-21,2022-01-11
541,زعف0110پ19,زعفران0110نگين تروند قاينات(پ),131,79154,29761855854,388686,373010,379990,-8696,-2.24,375999,-12687,-3.26,372637,387000,1400-10-21,2022-01-11
542,سپاس,صندوق س. پاداش سهامداري-ثابت,130,4275652,42894235951,10028,10033,10035,7,0.07,10032,4,0.04,10032,10036,1400-10-21,2022-01-11
543,فن آوا,گروه فن آوا,128,278038,2893461430,10400,10680,10600,200,1.92,10400,0,0,10120,10680,1400-10-21,2022-01-11
544,سخزر,سيمان‌ خزر,128,524345,8691565350,16630,17290,16510,-120,-0.72,16600,-30,-0.18,16230,17290,1400-10-21,2022-01-11
545,شكبير,پتروشيمي اميركبير,127,121181,10913494900,92100,90050,89350,-2750,-2.99,91850,-250,-0.27,89350,92100,1400-10-21,2022-01-11
546,تصميم,صندوق س با درآمد ثابت تصميم,127,615795,11396387078,18494,18508,18508,14,0.08,18507,13,0.07,18505,18508,1400-10-21,2022-01-11
547,سمازن,سيمان‌مازندران‌,127,278558,3904136970,13930,14230,13990,60,0.43,13950,20,0.14,13920,14230,1400-10-21,2022-01-11
548,غشهد,شهد ايران ‌,126,501252,2143828133,4405,4228,4265,-140,-3.18,4386,-19,-0.43,4228,4370,1400-10-21,2022-01-11
549,غشاذر,پگاه‌آذربايجان‌غربي‌,125,1072213,4932833775,4760,4524,4600,-160,-3.36,4704,-56,-1.18,4524,4748,1400-10-21,2022-01-11
550,خلنت,لنت‌ ترمزايران‌,124,49128,3425695440,66410,69730,69730,3320,5,67090,680,1.02,69730,69730,1400-10-21,2022-01-11
551,زعف0110پ20,زعفران0110نگين وحدت جام(پ),124,39831,14974492711,390436,380004,378000,-12436,-3.19,375951,-14485,-3.71,374000,380004,1400-10-21,2022-01-11
552,سقاين,سيمان‌ قائن‌,123,112618,4578215510,40180,40430,40120,-60,-0.15,40330,150,0.37,40000,41430,1400-10-21,2022-01-11
553,دابور,داروسازي‌ ابوريحان‌,123,195077,4287997080,21990,22070,21910,-80,-0.36,21990,0,0,21880,22340,1400-10-21,2022-01-11
554,زعف0110پ05,زعفران0110نگين زرين(پ),122,74236,28782467454,392076,380503,387800,-4276,-1.09,387716,-4360,-1.11,375000,390000,1400-10-21,2022-01-11
555,سدشت,صنايع سيمان دشتستان,122,77023,1878607230,25360,24100,24200,-1160,-4.57,25230,-130,-0.51,24100,25090,1400-10-21,2022-01-11
556,قزوين,كارخانجات‌ قند قزوين‌,122,6019725,26733598725,4230,4441,4441,211,4.99,4441,211,4.99,4441,4441,1400-10-21,2022-01-11
557,زمگسا,كشاورزي‌ ودامپروي‌ مگسال‌,122,257466,4376804320,17630,17080,17170,-460,-2.61,17430,-200,-1.13,16750,17590,1400-10-21,2022-01-11
558,پلاست,كارخانجات توليدي پلاستيران,121,756833,5090144730,6800,6710,6620,-180,-2.65,6760,-40,-0.59,6600,6850,1400-10-21,2022-01-11
559,فبيرا,بسته‌ بندي‌ ايران‌,121,2373371,4104633673,1730,1710,1723,-7,-0.4,1730,0,0,1708,1780,1400-10-21,2022-01-11
560,بسويچ,پارس‌سويچ‌,121,434302,5989264660,13800,13410,13380,-420,-3.04,13800,0,0,13300,14000,1400-10-21,2022-01-11
561,تكنو,تكنوتار,119,476877,2922375430,6390,6080,6080,-310,-4.85,6340,-50,-0.78,6080,6250,1400-10-21,2022-01-11
562,تسه9812,امتياز تسهيلات مسكن اسفند98,119,2566,3100109691,1157431,1162628,1215302,57871,5,1208149,50718,4.38,1162628,1215302,1400-10-21,2022-01-11
563,سفار,سيمان‌فارس‌,117,85044,4496011210,52350,53100,52300,-50,-0.1,52510,160,0.31,52160,54180,1400-10-21,2022-01-11
564,آبين,كشت و صنعت آبشيرين,117,1491389,2304068292,1579,1536,1536,-43,-2.72,1571,-8,-0.51,1533,1588,1400-10-21,2022-01-11
565,غگلپا,شير پاستوريزه پگاه گلپايگان,117,54991,2997826950,55150,54100,54400,-750,-1.36,55000,-150,-0.27,53950,56250,1400-10-21,2022-01-11
566,داسوه,داروسازي‌ اسوه‌,117,149182,3687485310,24890,24890,24590,-300,-1.21,24840,-50,-0.2,24200,25470,1400-10-21,2022-01-11
567,شفارا,پتروشيمي فارابي,116,708064,4175216660,5850,5850,5850,0,0,5870,20,0.34,5850,6020,1400-10-21,2022-01-11
568,دحاوي,الحاوي,116,620702,2625833629,4348,4348,4230,-118,-2.71,4315,-33,-0.76,4218,4348,1400-10-21,2022-01-11
569,سكرد,سيمان كردستان,116,783450,3631397769,4658,4471,4685,27,0.58,4653,-5,-0.11,4471,4772,1400-10-21,2022-01-11
570,سپ,پرداخت الكترونيك سامان كيش,116,95867,2991679020,31760,31000,31500,-260,-0.82,31730,-30,-0.09,30870,32200,1400-10-21,2022-01-11
571,تسه9901,امتياز تسهيلات مسكن فروردين99,115,1947,2380959174,1166478,1170893,1224801,58323,5,1222886,56408,4.84,1161210,1224801,1400-10-21,2022-01-11
572,وتوسم,سرمايه‌گذاري‌توسعه‌ملي‌,115,707055,6085714460,8660,8800,8660,0,0,8640,-20,-0.23,8530,8800,1400-10-21,2022-01-11
573,ساروم,سيمان‌اروميه‌,115,150686,5656487720,37850,37860,37890,40,0.11,37730,-120,-0.32,37330,38480,1400-10-21,2022-01-11
574,بساما,بيمه سامان,115,283584,5563760270,19110,19530,19730,620,3.24,19290,180,0.94,19140,19770,1400-10-21,2022-01-11
575,وصندوقح,ح.سرمايه گذاري صندوق بازنشستگي,114,1019732,10177409100,9990,9970,10000,10,0.1,9980,-10,-0.1,9910,10010,1400-10-21,2022-01-11
576,غشان,شيرپاستوريزه‌پگاه‌خراسان‌,114,645593,2457814696,3848,3869,3720,-128,-3.33,3841,-7,-0.18,3684,3900,1400-10-21,2022-01-11
577,شستان,پتروشيمي گلستان,114,678610,2581892082,3868,3944,3791,-77,-1.99,3836,-32,-0.83,3791,3944,1400-10-21,2022-01-11
578,اخزا007,اسنادخزانه-م7بودجه00-030912,114,220820,116885924650,532620,534800,530010,-2610,-0.49,529330,-3290,-0.62,527780,534800,1400-10-21,2022-01-11
579,فيروزه,صندوق شاخص30 شركت فيروزه- سهام,113,40689,6702720630,164510,167660,162900,-1610,-0.98,164730,220,0.13,162900,167660,1400-10-21,2022-01-11
580,اخزا917,اسنادخزانه-م17بودجه99-010226,112,24241,22538358000,930530,928060,929810,-720,-0.08,929760,-770,-0.08,928060,931510,1400-10-21,2022-01-11
581,دلر,داروسازي‌ اكسير,112,83764,3313696620,39170,38910,39710,540,1.38,39240,70,0.18,38910,40230,1400-10-21,2022-01-11
582,ولتجار,واسپاري تجارت وسرمايه ايرانيان,112,1887390,4659115042,2594,2465,2465,-129,-4.97,2532,-62,-2.39,2465,2560,1400-10-21,2022-01-11
583,كفرا,فراورده‌ هاي‌ نسوزايران‌,112,243719,1851283940,7560,7370,7510,-50,-0.66,7560,0,0,7370,7780,1400-10-21,2022-01-11
584,ركيش,كارت اعتباري ايران كيش,111,668863,4200012180,6160,5950,6170,10,0.16,6190,30,0.49,5950,6450,1400-10-21,2022-01-11
585,اخزا004,اسنادخزانه-م4بودجه00-030522,111,301800,170206486500,566010,566110,564040,-1970,-0.35,563970,-2040,-0.36,549940,567200,1400-10-21,2022-01-11
586,بالبر,كابل‌ البرز,111,501478,11689452180,22200,23310,23310,1110,5,23060,860,3.87,23310,23310,1400-10-21,2022-01-11
587,داوه,داروسازي آوه سينا,110,293229,2513409010,8780,8550,8480,-300,-3.42,8740,-40,-0.46,8450,8850,1400-10-21,2022-01-11
588,فيروزا,صندوق بادرآمد ثابت فيروزه آسيا,109,4058857,106467933463,26211,26239,26230,19,0.07,26231,20,0.08,26230,26239,1400-10-21,2022-01-11
589,دشيمي,شيمي‌ داروئي‌ داروپخش‌,109,391726,8258011880,20930,21750,21050,120,0.57,21020,90,0.43,20910,21750,1400-10-21,2022-01-11
590,كفراح,ح . فراورده‌ هاي‌ نسوزايران‌,107,351836,1635088339,4609,4609,4590,-19,-0.41,4647,38,0.82,4570,4766,1400-10-21,2022-01-11
591,ضخود2016,اختيارخ خودرو-1600-1401/02/07,107,3638,2440609000,638,699,659,21,3.29,671,33,5.17,650,800,1400-10-21,2022-01-11
592,تسه9906,امتياز تسهيلات مسكن شهريور99,106,1586,1934859319,1166182,1150001,1224491,58309,5,1219962,53780,4.61,1150001,1224491,1400-10-21,2022-01-11
593,اعتلا,شركت سرمايه گذاري اعتلاء البرز,106,803751,2840090500,3517,3530,3410,-107,-3.04,3520,3,0.09,3410,3619,1400-10-21,2022-01-11
594,خديزل,بهمن  ديزل,105,62596,3359907350,52500,54450,53300,800,1.52,52700,200,0.38,52650,54450,1400-10-21,2022-01-11
595,كتوكاح,ح.توليدي وخدمات صنايع نسوزتوكا,105,376475,1845480450,24518,4902,4902,-19616,-80.01,4902,-19616,-80.01,4902,4902,1400-10-21,2022-01-11
596,لوتوس,تامين سرمايه لوتوس پارسيان,105,1294730,7386094630,5720,5720,5730,10,0.17,5720,0,0,5610,5730,1400-10-21,2022-01-11
597,تسه9905,امتياز تسهيلات مسكن مرداد99,104,868,1059481977,1167104,1140040,1225459,58355,5,1220601,53497,4.58,1140040,1225459,1400-10-21,2022-01-11
598,غپآذر,شير پگاه آذربايجان شرقي,104,383217,10802686950,26950,26950,28250,1300,4.82,27900,950,3.53,26950,28250,1400-10-21,2022-01-11
599,زگلدشت,كشت و دام گلدشت نمونه اصفهان,104,254506,2165198580,8750,8500,8680,-70,-0.8,8710,-40,-0.46,8340,8720,1400-10-21,2022-01-11
600,سرود,سيمان‌شاهرود,104,140681,2898702160,21080,20350,20500,-580,-2.75,20980,-100,-0.47,20100,21500,1400-10-21,2022-01-11
601,غپونه,نوش پونه مشهد,104,268104,3038007440,11460,11210,11680,220,1.92,11420,-40,-0.35,11210,11700,1400-10-21,2022-01-11
602,تسه9904,امتياز تسهيلات مسكن تير99,103,1321,1604853610,1158745,1165727,1216682,57937,5,1214878,56133,4.84,1165727,1216682,1400-10-21,2022-01-11
603,تماوند,تامين سرمايه دماوند,103,4634392,27647675520,5900,5960,5890,-10,-0.17,5970,70,1.19,5880,6010,1400-10-21,2022-01-11
604,لخزر,پارس‌ خزر,102,29472,3200115580,109070,112000,107680,-1390,-1.27,108960,-110,-0.1,107590,112000,1400-10-21,2022-01-11
605,فلامي,لاميران‌,102,280885,5157384030,18390,18600,18050,-340,-1.85,18380,-10,-0.05,17800,18970,1400-10-21,2022-01-11
606,اهرم,صندوق س سهامي كاريزما- اهرمي,102,597313,5866772420,9820,9900,9830,10,0.1,9820,0,0,9800,9920,1400-10-21,2022-01-11
607,اخزا008,اسنادخزانه-م8بودجه00-030919,101,161445,85332455660,530420,532000,530090,-330,-0.06,528550,-1870,-0.35,528000,532000,1400-10-21,2022-01-11
608,زرين,صندوق س. سهام زرين كوروش-س,101,267757,3362917844,12441,12495,12391,-50,-0.4,12560,119,0.96,12391,12650,1400-10-21,2022-01-11
609,كيان2,صندوق س. با درآمد ثابت كيان,100,10000000,10000000,32519,1,1,-32518,-100,1,-32518,-100,1,1,1400-10-21,2022-01-11
610,بخاور,بيمه زندگي خاورميانه,100,1308077,2860217451,2175,2140,2283,108,4.97,2177,2,0.09,2136,2283,1400-10-21,2022-01-11
611,ما,بيمه  ما,99,426249,2001117447,4744,4660,4651,-93,-1.96,4737,-7,-0.15,4644,4899,1400-10-21,2022-01-11
612,شتوكاح,ح . توكا رنگ فولاد سپاهان,98,228681,2600632180,11390,11060,11550,160,1.4,11370,-20,-0.18,11010,11720,1400-10-21,2022-01-11
613,كهربا,صندوق س.پشتوانه سكه طلا كهربا,98,1198437,12378101525,10110,10307,10327,217,2.15,10329,219,2.17,10200,10400,1400-10-21,2022-01-11
614,قشهد,شهد,98,179891,2649867000,15030,14560,14560,-470,-3.13,14980,-50,-0.33,14560,15000,1400-10-21,2022-01-11
615,مارون,پتروشيمي مارون,98,72022,12269140350,173150,168500,171000,-2150,-1.24,172800,-350,-0.2,168500,175000,1400-10-21,2022-01-11
616,حرهشا,رهشاد سپاهان (سهامي عام,97,46200,3596670000,75600,77850,77850,2250,2.98,77000,1400,1.85,77850,77850,1400-10-21,2022-01-11
617,دسبحا,گروه دارويي سبحان,94,188467,3459810470,18660,18000,18110,-550,-2.95,18620,-40,-0.21,17840,18660,1400-10-21,2022-01-11
618,تسه9903,امتياز تسهيلات مسكن خرداد99,93,839,1028132045,1170257,1150020,1228769,58512,5,1225425,55168,4.71,1111745,1228769,1400-10-21,2022-01-11
619,اوصتا,صندوق انديشه ورزان صباتامين -د,92,3715894,78694863863,21168,21178,21177,9,0.04,21178,10,0.05,21177,21178,1400-10-21,2022-01-11
620,شدوص,دوده‌ صنعتي‌ پارس‌,92,290598,3451542720,11960,11940,11900,-60,-0.5,11940,-20,-0.17,11700,12040,1400-10-21,2022-01-11
621,فاما,صنعتي‌ آما,92,336956,5840066770,17690,17990,17170,-520,-2.94,17540,-150,-0.85,17170,17990,1400-10-21,2022-01-11
622,وتعاون,بيمه تعاون,91,613327,988349677,1691,1650,1607,-84,-4.97,1685,-6,-0.35,1607,1650,1400-10-21,2022-01-11
623,دعبيد,لابراتوارداروسازي‌  دكترعبيدي‌,91,138688,2581054910,18790,18170,18370,-420,-2.24,18780,-10,-0.05,18170,18800,1400-10-21,2022-01-11
624,سخوز,سيمان خوزستان,90,157561,3309364660,21240,21500,21020,-220,-1.04,21180,-60,-0.28,20690,21500,1400-10-21,2022-01-11
625,كقزوي,شيشه‌ قزوين‌,89,779305,6373749810,8220,8440,8060,-160,-1.95,8190,-30,-0.36,8060,8440,1400-10-21,2022-01-11
626,وكادو,تكادو,88,266014,3798068910,14330,14010,14490,160,1.12,14310,-20,-0.14,14010,14550,1400-10-21,2022-01-11
627,دكيمي,كيميدارو,88,127399,2087594750,16780,15990,16060,-720,-4.29,16720,-60,-0.36,15980,16950,1400-10-21,2022-01-11
628,سايرا,ايرانيت‌,87,162282,4201874700,25650,25150,26150,500,1.95,25850,200,0.78,25150,26150,1400-10-21,2022-01-11
629,وبازار,صندوق س شاخصي بازارآشنا,86,442166,5061239110,11310,11340,11460,150,1.33,11450,140,1.24,11300,11600,1400-10-21,2022-01-11
630,كطبس,ذغال‌سنگ‌ نگين‌ ط‌بس‌,85,73868,3382579140,45350,45400,46040,690,1.52,45450,100,0.22,45270,46300,1400-10-21,2022-01-11
631,ثنام,س ساختماني ب نام آوران مهندسي,84,682543,5576376310,8590,8170,8170,-420,-4.89,8330,-260,-3.03,8170,8170,1400-10-21,2022-01-11
632,گنگين,اقتصادي نگين گردشگري ايرانيان,84,456908,13423013000,29550,29100,29700,150,0.51,29500,-50,-0.17,28850,29750,1400-10-21,2022-01-11
633,قپيرا,فرآورده‌هاي‌غدايي‌وقندپيرانشهر,83,176139,1398119330,8170,8400,8100,-70,-0.86,8150,-20,-0.24,7770,8400,1400-10-21,2022-01-11
634,تسه9811,امتياز تسهيلات مسكن بهمن98,82,1556,1873528588,1155273,1213000,1213036,57763,5,1204067,48794,4.22,1124010,1213036,1400-10-21,2022-01-11
635,وملت,سرمايه گذاري ملت,80,1454344,3535510264,2480,2431,2431,-49,-1.98,2446,-34,-1.37,2431,2431,1400-10-21,2022-01-11
636,ضصاد1113,اختيارخ وبصادر-2000-1400/11/06,79,3387,267711000,94,115,76,-18,-19.15,79,-15,-15.96,59,123,1400-10-21,2022-01-11
637,وتوشه,سرمايه‌ گذاري‌ پارس‌ توشه‌,79,217390,1125835370,5190,5150,5190,0,0,5190,0,0,5120,5350,1400-10-21,2022-01-11
638,زعف0110پ16,زعفران0110نگين بيرجند(پ),77,108176,40693803819,388300,375001,377999,-10301,-2.65,376181,-12119,-3.12,375000,379989,1400-10-21,2022-01-11
639,اتكام,بيمه اتكايي امين,76,343632,1675910006,4865,4755,4894,29,0.6,4866,1,0.02,4755,4937,1400-10-21,2022-01-11
640,سكرما,سيمان‌ كرمان‌,75,58961,873068550,14710,14800,14900,190,1.29,14720,10,0.07,14630,14960,1400-10-21,2022-01-11
641,دالبر,البرزدارو,75,205151,2473061550,11910,12200,11970,60,0.5,11930,20,0.17,11950,12220,1400-10-21,2022-01-11
642,وارس,سرمايه گذاري ارس صبا,75,206305,2196866960,10580,10290,10720,140,1.32,10600,20,0.19,10290,10810,1400-10-21,2022-01-11
643,ولبهمن,شركت بهمن ليزينگ,75,432633,2705431960,6240,6220,6290,50,0.8,6240,0,0,6190,6330,1400-10-21,2022-01-11
644,كاسپين,داروسازي كاسپين تامين,73,104408,2260035200,22000,21750,21550,-450,-2.05,21950,-50,-0.23,21450,22150,1400-10-21,2022-01-11
645,سباقر,سيمان باقران,72,230914,2667921000,11900,11980,11550,-350,-2.94,11800,-100,-0.84,11550,11980,1400-10-21,2022-01-11
646,فلات,گروه صنايع معادن فلات ايرانيان,71,683483,6344064360,9560,9350,9280,-280,-2.93,9370,-190,-1.99,9280,9560,1400-10-21,2022-01-11
647,كخاكح,ح . صنايع‌خاك‌چيني‌ايران‌,71,146493,1388655800,9320,9280,9350,30,0.32,9480,160,1.72,9280,9640,1400-10-21,2022-01-11
648,سكه0011پ02,تمام سكه طرح جديد0011ملت,71,11900,14325446600,1182976,1206999,1199000,16024,1.35,1203819,20843,1.76,1195005,1209500,1400-10-21,2022-01-11
649,دپارس,پارس‌ دارو,71,55846,1609204710,28510,28940,28800,290,1.02,28540,30,0.11,28180,29260,1400-10-21,2022-01-11
650,اخزا005,اسنادخزانه-م5بودجه00-030626,70,101465,56041788980,553560,552010,554750,1190,0.21,552330,-1230,-0.22,552000,554750,1400-10-21,2022-01-11
651,سجام,مجتمع سيمان غرب آسيا,69,859026,1721774642,2063,2002,2010,-53,-2.57,2052,-11,-0.53,2002,2040,1400-10-21,2022-01-11
652,شمواد,توليد مواداوليه الياف مصنوعي,69,87656,4216253600,46250,48100,48100,1850,4,47700,1450,3.14,48100,48100,1400-10-21,2022-01-11
653,تشتاد,صنايع توليدي اشتاد ايران‌,69,362782,1719114229,4775,4632,4850,75,1.57,4769,-6,-0.13,4632,4850,1400-10-21,2022-01-11
654,اوان,مبين وان كيش,68,92055,895564300,9750,9780,9670,-80,-0.82,9750,0,0,9360,9990,1400-10-21,2022-01-11
655,طخود2017,اختيارف خودرو-1800-1401/02/07,68,3043,182683000,71,60,60,-11,-15.49,60,-11,-15.49,60,70,1400-10-21,2022-01-11
656,رتكو,كنترل‌خوردگي‌تكين‌كو,68,108146,756138590,7090,6790,6850,-240,-3.39,7080,-10,-0.14,6790,7300,1400-10-21,2022-01-11
657,ساربيل,سيمان آرتا اردبيل,67,83486,1774226540,21350,21330,21060,-290,-1.36,21340,-10,-0.05,20650,21540,1400-10-21,2022-01-11
658,فردا,صندوق س آواي فرداي زاگرس-ثابت,67,1280421,15598226628,12177,12182,12182,5,0.04,12182,5,0.04,12182,12183,1400-10-21,2022-01-11
659,دارو,كارخانجات‌داروپخش‌,67,95185,2826323920,29690,30260,29600,-90,-0.3,29690,0,0,28660,30260,1400-10-21,2022-01-11
660,وثخوز,سرمايه گذاري و توسعه خوزستان,66,133908,3767065450,28400,27700,28000,-400,-1.41,28300,-100,-0.35,27700,29100,1400-10-21,2022-01-11
661,سكه0012پ04,تمام سكه طرح جديد0012صادرات,66,17500,21049733100,1184156,1208000,1196500,12344,1.04,1202842,18686,1.58,1195000,1209900,1400-10-21,2022-01-11
662,هجرت,پخش هجرت,66,36917,967078300,25700,26200,25800,100,0.39,25750,50,0.19,25550,26400,1400-10-21,2022-01-11
663,پسهند,صنايع‌ لاستيكي‌  سهند,66,97408,2854996520,28580,28850,28760,180,0.63,28720,140,0.49,28230,29600,1400-10-21,2022-01-11
664,قمرو,قند مرودشت‌,65,134044,2813778270,21100,20800,20700,-400,-1.9,21080,-20,-0.09,20550,21470,1400-10-21,2022-01-11
665,سكه0112پ03,تمام سكه طرح جديد0112سامان,64,14700,17679104900,1175428,1207499,1198000,22572,1.92,1202660,27232,2.32,1197000,1209000,1400-10-21,2022-01-11
666,اخزا910,اسنادخزانه-م10بودجه99-020807,63,45204,30866801620,681280,681660,684000,2720,0.4,682830,1550,0.23,681660,684000,1400-10-21,2022-01-11
667,اراد50,مرابحه عام دولت5-ش.خ0302,62,1489100,1489100231000,1000010,1000000,1000000,-10,0,1000000,-10,0,1000000,1000010,1400-10-21,2022-01-11
668,كخاك,صنايع‌خاك‌چيني‌ايران‌,62,158085,2117454640,13540,13150,13200,-340,-2.51,13520,-20,-0.15,13150,13790,1400-10-21,2022-01-11
669,فخاس,فولاد خراسان,61,60543,1318574580,22480,21620,21660,-820,-3.65,22470,-10,-0.04,21620,21950,1400-10-21,2022-01-11
670,ثزاگرس,سرمايه گذاري توسعه عمران زاگرس,61,59154,1849653800,31200,31500,31800,600,1.92,31200,0,0,30600,31800,1400-10-21,2022-01-11
671,بفجرح,ح . فجر انرژي خليج فارس,60,509441,4358433390,8630,8630,8540,-90,-1.04,8560,-70,-0.81,8460,8700,1400-10-21,2022-01-11
672,لازما,كارخانه هاي صنعتي آزمايش,60,158733,3746098800,24800,23600,23600,-1200,-4.84,24300,-500,-2.02,23600,23600,1400-10-21,2022-01-11
673,وآرين,شركت توسعه اقتصادي آرين,59,944697,1647579026,1767,1722,1739,-28,-1.58,1763,-4,-0.23,1714,1799,1400-10-21,2022-01-11
674,ويسا,سرمايه گذاري ايساتيس پويا,58,276844,2079826830,7720,7600,7570,-150,-1.94,7680,-40,-0.52,7490,7830,1400-10-21,2022-01-11
675,ثاژن,سخت آژند,57,384588,1526531563,3910,3896,3988,78,1.99,3928,18,0.46,3896,3988,1400-10-21,2022-01-11
676,سشمال,سيمان‌ شمال‌,57,237554,1761879040,7520,7330,7400,-120,-1.6,7510,-10,-0.13,7330,7590,1400-10-21,2022-01-11
677,فسا,پتروشيمي فسا,56,550356,478259364,895,869,869,-26,-2.91,894,-1,-0.11,869,869,1400-10-21,2022-01-11
678,ضخود2021,اختيارخ خودرو-3500-1401/02/07,56,2946,135718000,48,90,43,-5,-10.42,46,-2,-4.17,43,90,1400-10-21,2022-01-11
679,سهگمت,سيمان‌هگمتان‌,55,139979,2836628390,20580,19760,20470,-110,-0.53,20520,-60,-0.29,19760,20570,1400-10-21,2022-01-11
680,وامين,س. امين توان آفرين ساز,55,111832,1384838480,12470,12350,12380,-90,-0.72,12470,0,0,12300,12460,1400-10-21,2022-01-11
681,وزمين,بانك ايران زمين,55,428904,3572770320,8170,8330,8330,160,1.96,8210,40,0.49,8330,8330,1400-10-21,2022-01-11
682,واتي,سرمايه‌ گذاري‌ آتيه‌ دماوند,53,197236,1808592460,9200,9280,9100,-100,-1.09,9200,0,0,9000,9550,1400-10-21,2022-01-11
683,حبندرح,ح.دريايي وكشتيراني خط دريابندر,53,272165,2762896320,9910,10190,10200,290,2.93,10150,240,2.42,9660,10200,1400-10-21,2022-01-11
684,زعف0110پ09,زعفران0110نگين نوين(پ),52,34114,12820926955,389571,380000,378000,-11571,-2.97,375826,-13745,-3.53,373000,380000,1400-10-21,2022-01-11
685,وحافظح,ح . بيمه حافظ,52,436482,1378225119,3344,3491,3144,-200,-5.98,3158,-186,-5.56,3144,3491,1400-10-21,2022-01-11
686,شساخت,مهندسي و ساختمان صنايع نفت,52,213325,9416314350,44150,44150,44150,0,0,44150,0,0,43500,44200,1400-10-21,2022-01-11
687,ومشان,س. فني و مهندسي مشانير,50,28612,1226139600,44150,42850,42850,-1300,-2.94,43800,-350,-0.79,42850,42950,1400-10-21,2022-01-11
688,كصدف,كاشي صدف سرام استقلال آباده,50,69510,1445616250,20750,21250,20150,-600,-2.89,20750,0,0,20150,21250,1400-10-21,2022-01-11
689,سهرمز,سيمان‌هرمزگان‌,50,82378,1347620250,16410,16410,16280,-130,-0.79,16410,0,0,16090,16410,1400-10-21,2022-01-11
690,ضسپا1113,اختيارخ خساپا-1800-1400/11/20,49,2313,240999000,91,140,102,11,12.09,104,13,14.29,90,140,1400-10-21,2022-01-11
691,سپيدما,صندوق س. سپيد دماوند-د,48,1452426,16947867698,11662,11668,11668,6,0.05,11669,7,0.06,11668,11669,1400-10-21,2022-01-11
692,ضسپا1111,اختيارخ خساپا-1400-1400/11/20,48,2670,921214000,357,379,339,-18,-5.04,345,-12,-3.36,337,390,1400-10-21,2022-01-11
693,تكنار,مجتمع معادن مس تكنار,47,37806,1899678350,50250,49250,50100,-150,-0.3,50250,0,0,49200,51700,1400-10-21,2022-01-11
694,سبجنو,سيمان‌ بجنورد,47,44265,1619802020,36860,36860,37050,190,0.52,36830,-30,-0.08,36160,37400,1400-10-21,2022-01-11
695,ضفلا1163,اختيارخ فولاد-10000-1400/11/24,47,1080,843538000,760,810,819,59,7.76,781,21,2.76,748,830,1400-10-21,2022-01-11
696,دفرا,فرآورده‌هاي‌ تزريقي‌ ايران‌,47,52967,728752810,13760,14040,13500,-260,-1.89,13760,0,0,13490,14050,1400-10-21,2022-01-11
697,سيدكو,سرمايه گذاري توسعه صنايع سيمان,44,224246,1271229030,5800,5640,5600,-200,-3.45,5790,-10,-0.17,5580,5800,1400-10-21,2022-01-11
698,وپخش,داروپخش‌ (هلدينگ‌,43,23776,782104280,33450,32550,32500,-950,-2.84,33440,-10,-0.03,32470,33340,1400-10-21,2022-01-11
699,حبندر,دريايي و کشتيراني خط دريابندر,43,414682,5556738800,13010,13400,13400,390,3,13230,220,1.69,13400,13400,1400-10-21,2022-01-11
700,فاهواز,نورد و لوله اهواز,41,1162401,5963117130,5230,5130,5130,-100,-1.91,5180,-50,-0.96,5130,5130,1400-10-21,2022-01-11
701,آساس,صندوق س.آسمان آرماني سهام-س,41,13794,2243924395,161085,162341,162800,1715,1.06,162674,1589,0.99,161530,163460,1400-10-21,2022-01-11
702,سفانو,سيمان فارس نو,41,52958,1258267230,23780,24290,23690,-90,-0.38,23780,0,0,23640,24320,1400-10-21,2022-01-11
703,وآفري,بيمه كارآفرين,41,281233,1137978123,4048,4050,4030,-18,-0.44,4048,0,0,4030,4090,1400-10-21,2022-01-11
704,الماس,صندوق س.امين تدبيرگران فردا-س,41,6271,617974285,97587,99980,97900,313,0.32,98545,958,0.98,97030,99980,1400-10-21,2022-01-11
705,سجامح,ح.مجتمع سيمان غرب آسيا,40,547273,404596856,743,734,740,-3,-0.4,739,-4,-0.54,732,757,1400-10-21,2022-01-11
706,اخزا901,اسنادخزانه-م1بودجه99-010621,39,113012,98494827700,870030,866010,871800,1770,0.2,871540,1510,0.17,866000,871800,1400-10-21,2022-01-11
707,ارمغان,ص سرمايه گذاري ارمغان ايرانيان,38,343439,3444729193,10021,10029,10026,5,0.05,10030,9,0.09,10022,10032,1400-10-21,2022-01-11
708,پارتا,مجتمع‌صنعتي‌آرتاويل‌تاير,38,113324,2047764680,19020,18070,18070,-950,-4.99,18900,-120,-0.63,18070,18070,1400-10-21,2022-01-11
709,اخزا902,اسنادخزانه-م2بودجه99-011019,36,155170,126429364040,813530,809050,814200,670,0.08,814780,1250,0.15,809050,815500,1400-10-21,2022-01-11
710,افرا,افرانت,35,72517,1515605300,21950,20900,20900,-1050,-4.78,21850,-100,-0.46,20900,20900,1400-10-21,2022-01-11
711,شزنگ,تجهيزنيروي‌زنگان‌,35,10609,1193512500,115950,112500,112500,-3450,-2.98,115550,-400,-0.34,112500,112500,1400-10-21,2022-01-11
712,سكه0111پ05,تمام سكه طرح جديد0111آينده,35,5500,6599227800,1170211,1208000,1197000,26789,2.29,1199860,29649,2.53,1191002,1208000,1400-10-21,2022-01-11
713,دسينا,داروسازي‌ سينا,34,202620,4141659670,20320,19910,20540,220,1.08,20350,30,0.15,19910,20550,1400-10-21,2022-01-11
714,پدرخش,درخشان‌ تهران‌,34,384883,2574867270,6380,6690,6690,310,4.86,6430,50,0.78,6690,6690,1400-10-21,2022-01-11
715,اخزا010,اسناد خزانه-م10بودجه00-031115,34,24271,12376922392,512103,510080,508511,-3592,-0.7,509947,-2156,-0.42,508511,510110,1400-10-21,2022-01-11
716,ضبدر1163,اختيارخ شبندر-6000-1400/11/13,33,435,234644000,454,520,560,106,23.35,539,85,18.72,500,750,1400-10-21,2022-01-11
717,قشرين,قند شيرين خراسان,33,209676,1140637440,5600,5440,5440,-160,-2.86,5580,-20,-0.36,5440,5440,1400-10-21,2022-01-11
718,ثغرب,شركت سرمايه گذاري مسكن شمالغرب,32,383153,1358965292,3727,3542,3560,-167,-4.48,3710,-17,-0.46,3541,3599,1400-10-21,2022-01-11
719,ثروتم,صندوق س. ثروت آفرين پارسيان-س,31,21090,1782277970,83203,84804,85366,2163,2.6,84508,1305,1.57,83640,85367,1400-10-21,2022-01-11
720,اراد96,مرابحه عام دولت96-ش.خ030414,31,5910000,5501205300000,1000000,930830,930830,-69170,-6.92,930830,-69170,-6.92,930830,930830,1400-10-21,2022-01-11
721,صايند,صندوق س. گنجينه آينده روشن-د,31,350200,3509601900,10022,10022,10020,-2,-0.02,10022,0,0,10020,10024,1400-10-21,2022-01-11
722,سمتاز,سيمان ممتازان كرمان,30,33878,473286360,14300,14160,13890,-410,-2.87,14280,-20,-0.14,13880,14160,1400-10-21,2022-01-11
723,اخزا909,اسنادخزانه-م9بودجه99-020316,29,128845,95690000690,740730,740410,743060,2330,0.31,742680,1950,0.26,740410,743070,1400-10-21,2022-01-11
724,واحيا,م .صنايع و معادن احياء سپاهان,28,440440,7386811800,16300,16780,16010,-290,-1.78,16360,60,0.37,16010,16780,1400-10-21,2022-01-11
725,اخزا816,اسنادخزانه-م16بودجه98-010503,28,213533,191305406170,892530,896000,896390,3860,0.43,895910,3380,0.38,893000,896400,1400-10-21,2022-01-11
726,اخزا903,اسنادخزانه-م3بودجه99-011110,28,15713,12642015060,803650,804000,805890,2240,0.28,804560,910,0.11,803130,805890,1400-10-21,2022-01-11
727,طخود2018,اختيارف خودرو-2000-1401/02/07,27,1157,157245000,150,140,155,5,3.33,136,-14,-9.33,100,155,1400-10-21,2022-01-11
728,زعف0110پ10,زعفران0110نگين طلاي سرخ(پ),26,1721,657390269,395155,375102,377999,-17156,-4.34,381982,-13173,-3.33,375102,384001,1400-10-21,2022-01-11
729,داريوش,صندوق س. ثروت داريوش -س,26,163948,1539804780,9323,9370,9340,17,0.18,9392,69,0.74,9300,9480,1400-10-21,2022-01-11
730,ضصاد1112,اختيارخ وبصادر-1800-1400/11/06,26,413,93899000,224,240,242,18,8.04,227,3,1.34,200,242,1400-10-21,2022-01-11
731,دقاضي,داروسازي شهيد قاضي,25,15475,405821300,25900,25500,26200,300,1.16,25900,0,0,25500,26650,1400-10-21,2022-01-11
732,ساذري,آذريت‌,25,60756,415571040,7050,6840,6840,-210,-2.98,7040,-10,-0.14,6840,6840,1400-10-21,2022-01-11
733,اخزا918,اسنادخزانه-م18بودجه99-010323,25,19869,18141228360,915630,912700,917600,1970,0.22,913040,-2590,-0.28,912530,917610,1400-10-21,2022-01-11
734,غدشت,دشت‌ مرغاب‌,24,97498,1955809880,21110,20060,20060,-1050,-4.97,20960,-150,-0.71,20060,20060,1400-10-21,2022-01-11
735,سلار,شركت سيمان لارستان,24,28328,610468400,22200,21550,21550,-650,-2.93,22150,-50,-0.23,21550,21550,1400-10-21,2022-01-11
736,ضصاد1114,اختيارخ وبصادر-2500-1400/11/06,24,928,3117000,6,9,2,-4,-66.67,3,-3,-50,2,9,1400-10-21,2022-01-11
737,قنيشا,قند  نيشابور,23,36880,1555598400,44400,42180,42180,-2220,-5,44150,-250,-0.56,42180,42180,1400-10-21,2022-01-11
738,گنجين,صندوق س. گنجينه يكم آويد-د,23,83977,1223173880,14557,14559,14568,11,0.08,14566,9,0.06,14559,14568,1400-10-21,2022-01-11
739,اخزا814,اسنادخزانه-م14بودجه98-010318,22,34572,31847716700,919090,919000,920000,910,0.1,921200,2110,0.23,919000,922000,1400-10-21,2022-01-11
740,لپيام,گسترش صنايع پيام,22,61722,1570824900,26750,25450,25450,-1300,-4.86,26550,-200,-0.75,25450,25450,1400-10-21,2022-01-11
741,اخزا908,اسنادخزانه-م8بودجه99-020606,22,51476,36402583640,706040,706310,709600,3560,0.5,707180,1140,0.16,706310,709600,1400-10-21,2022-01-11
742,بذر2,صندوق س بذر اميد آفرين-سهام,22,1550000,1550000,95280,1,1,-95279,-100,1,-95279,-100,1,1,1400-10-21,2022-01-11
743,ضشنا2014,اختيارخ شپنا-5000-1401/02/25,22,635,905275000,1482,1550,1340,-142,-9.58,1426,-56,-3.78,1300,1600,1400-10-21,2022-01-11
744,اخزا009,اسناد خزانه-م9بودجه00-031101,21,889,459931370,519870,517110,519800,-70,-0.01,517360,-2510,-0.48,515120,519800,1400-10-21,2022-01-11
745,اخزا813,اسنادخزانه-م13بودجه98-010219,21,9217,8600146560,932090,932100,934500,2410,0.26,933070,980,0.11,932000,934500,1400-10-21,2022-01-11
746,هپارس102,اختيارف ت پارس-157010-01/02/05,20,150000,150000,1,1,1,0,0,1,0,0,1,1,1400-10-21,2022-01-11
747,ماني2,صندوق س. با درآمد ثابت ماني,20,2000000,2000000,10801,1,1,-10800,-99.99,1,-10800,-99.99,1,1,1400-10-21,2022-01-11
748,ضپال2007,اختيارخ اپال-32000-1401/02/12,19,512,66853000,143,149,121,-22,-15.38,131,-12,-8.39,120,149,1400-10-21,2022-01-11
749,اخزا914,اسنادخزانه-م14بودجه99-021025,17,78428,51741794790,653770,650550,653710,-60,-0.01,659740,5970,0.91,650550,660000,1400-10-21,2022-01-11
750,اراد94,مرابحه عام دولت94-ش.خ030816,16,3086000,2842206000000,920030,921000,921000,970,0.11,921000,970,0.11,921000,921000,1400-10-21,2022-01-11
751,سي تيپ2ن17,گواهي سيمان تيپ2ماهان كرمان(ن),16,468000,2243592000,4794,4794,4794,0,0,4794,0,0,4794,4794,1400-10-21,2022-01-11
752,آتيمس,صندوق س.آرمان آتيه درخشان مس-س,15,4314,766684909,177243,180967,177656,413,0.23,177720,477,0.27,177323,180967,1400-10-21,2022-01-11
753,هكشو208,اختيارف ت پاكشو10000-02/08/29,15,343136,228528576,662,666,666,4,0.6,666,4,0.6,666,666,1400-10-21,2022-01-11
754,كرونا2,تامين مالي جمعي صرفا اهداي سود,15,4774,47740000,10000,10000,10000,0,0,10000,0,0,10000,10000,1400-10-21,2022-01-11
755,طلا2,صندوق س.پشتوانه طلاي لوتوس,14,1400000,1400000,83519,1,1,-83518,-100,1,-83518,-100,1,1,1400-10-21,2022-01-11
756,پلوله,گازلوله‌,14,15425,340121250,22700,22050,22050,-650,-2.86,22700,0,0,22050,22050,1400-10-21,2022-01-11
757,اخزا812,اسنادخزانه-م12بودجه98-001111,14,24605,24305168300,987660,987500,987810,150,0.02,987810,150,0.02,987310,988470,1400-10-21,2022-01-11
758,برن0104پ01,برنج طارم0104تجارت مازندران(پ),13,854,485368482,569095,570000,570010,915,0.16,568347,-748,-0.13,568000,574000,1400-10-21,2022-01-11
759,هفارس104,اختيارف ت فارس-11832-01/04/12,13,80395,40599475,429,505,505,76,17.72,505,76,17.72,505,505,1400-10-21,2022-01-11
760,دفاراح,ح . داروسازي‌ فارابي‌,12,89404,906150600,10120,10200,10100,-20,-0.2,10140,20,0.2,10100,10200,1400-10-21,2022-01-11
761,خعمرا,توسعه و عمران شهرستان نائين,12,64271,404264590,6110,6290,6290,180,2.95,6120,10,0.16,6290,6290,1400-10-21,2022-01-11
762,اخزا911,اسنادخزانه-م11بودجه99-020906,12,46688,31329370080,671180,670020,672400,1220,0.18,671040,-140,-0.02,670020,676000,1400-10-21,2022-01-11
763,ثنظام,س. ساختماني نظام مهندسي ايران,12,6425,96824750,15530,15070,15070,-460,-2.96,15070,-460,-2.96,15070,15070,1400-10-21,2022-01-11
764,تملي802,تسهيلات مسكن ب. ملي-ارديبهشت98,11,97,82626638,870160,869950,870000,-160,-0.02,851821,-18339,-2.11,826652,906000,1400-10-21,2022-01-11
765,جهرم,پتروشيمي جهرم,11,145759,184530894,1332,1266,1266,-66,-4.95,1331,-1,-0.08,1266,1266,1400-10-21,2022-01-11
766,اخزا817,اسنادخزانه-م17بودجه98-010512,11,3787,3365152670,888330,889000,889000,670,0.08,888610,280,0.03,885630,889000,1400-10-21,2022-01-11
767,دارا,صندوق س. دارا الگوريتم-د,11,23393,235611310,10064,10071,10074,10,0.1,10072,8,0.08,10071,10074,1400-10-21,2022-01-11
768,هنوري102,اختيارف ت نوري59561-01/02/15,11,94075,94075,1,1,1,0,0,1,0,0,1,1,1400-10-21,2022-01-11
769,آسام,صندوق س.آرمان سپهر آشنا-م,11,688020,80950723810,117689,117200,117663,-26,-0.02,117658,-31,-0.03,117200,117663,1400-10-21,2022-01-11
770,سفاسي,شركت فارسيت اهواز,10,49512,166409832,3464,3361,3361,-103,-2.97,3462,-2,-0.06,3361,3361,1400-10-21,2022-01-11
771,ضفلا1165,اختيارخ فولاد-14000-1400/11/24,10,96,4959000,89,80,32,-57,-64.04,52,-37,-41.57,30,80,1400-10-21,2022-01-11
772,تپولا,مهندسي مرآت پولاد,10,32413,448271790,14250,13830,13830,-420,-2.95,13830,-420,-2.95,13830,13830,1400-10-21,2022-01-11
773,اخزا815,اسنادخزانه-م15بودجه98-010406,10,12539,11421476800,909080,907500,911000,1920,0.21,910880,1800,0.2,907500,911900,1400-10-21,2022-01-11
774,اگ010155,گام بانك اقتصاد نوين0101,10,100000,94200010000,940588,942001,942000,1412,0.15,942000,1412,0.15,942000,942001,1400-10-21,2022-01-11
775,كامياب2,صندوق س. كامياب آشنا-د,10,1000000,1000000,11233,1,1,-11232,-99.99,1,-11232,-99.99,1,1,1400-10-21,2022-01-11
776,كباده,توليد خاك نسوزاستقلال آباده,10,20679,698950200,32850,33800,33800,950,2.89,32900,50,0.15,33800,33800,1400-10-21,2022-01-11
777,ثمين,صندوق س. ثروت افزون ثمين-س,10,171400,1714028395,10009,9990,10002,-7,-0.07,10000,-9,-0.09,9990,10099,1400-10-21,2022-01-11
778,داريك,صندوق س.اعتماد داريك-د,9,277201,3364111336,12132,12136,12136,4,0.03,12136,4,0.03,12136,12136,1400-10-21,2022-01-11
779,ضجار2013,اختيارخ وتجارت-2000-1401/02/21,9,102,32509000,357,303,320,-37,-10.36,319,-38,-10.64,302,361,1400-10-21,2022-01-11
780,ضصاد3016,اختيارخ وبصادر-2500-1401/03/11,9,660,63000000,1,75,120,119,11900,95,94,9400,75,120,1400-10-21,2022-01-11
781,فنرژي,گسترش صنايع انرژي آذرآب,9,21605,205247500,9890,9500,9500,-390,-3.94,9500,-390,-3.94,9500,9500,1400-10-21,2022-01-11
782,غناب,روغن‌ نباتي‌ ناب,9,2809,411237600,142150,146400,146400,4250,2.99,142300,150,0.11,146400,146400,1400-10-21,2022-01-11
783,وحافظ,بيمه حافظ,9,86746,564716460,6710,6510,6510,-200,-2.98,6700,-10,-0.15,6510,6510,1400-10-21,2022-01-11
784,سنوين,سرمايه گذاري اقتصاد نوين,9,17627,93951910,5490,5330,5330,-160,-2.91,5490,0,0,5330,5330,1400-10-21,2022-01-11
785,ضصاد1111,اختيارخ وبصادر-1600-1400/11/06,8,186,87103000,430,490,450,20,4.65,468,38,8.84,400,490,1400-10-21,2022-01-11
786,خفولا,خدمات فني فولاد يزد,8,9450,201285000,21950,21300,21300,-650,-2.96,21300,-650,-2.96,21300,21300,1400-10-21,2022-01-11
787,سيلام,سيمان‌ ايلام‌,8,13785,89051100,6800,6460,6460,-340,-5,6800,0,0,6460,6460,1400-10-21,2022-01-11
788,اخزا904,اسنادخزانه-م4بودجه99-011215,7,14500,11478500000,790230,791000,793000,2770,0.35,791620,1390,0.18,791000,793000,1400-10-21,2022-01-11
789,آسام2,صندوق س.آرمان سپهر آشنا-م,7,700000,700000,117689,1,1,-117688,-100,1,-117688,-100,1,1,1400-10-21,2022-01-11
790,ضملي1160,اختيارخ فملي-6000-1400/11/03,7,67,134000000,1100,1000,1000,-100,-9.09,1000,-100,-9.09,1000,1000,1400-10-21,2022-01-11
791,اخزا818,اسنادخزانه-م18بودجه98-010614,7,811,708577000,873320,873710,873700,380,0.04,873710,390,0.04,873700,873750,1400-10-21,2022-01-11
792,عيار2,صندوق سكه طلاي مفيد,6,60000,60000,29826,1,1,-29825,-100,1,-29825,-100,1,1,1400-10-21,2022-01-11
793,زگلدشتح,ح.كشت و دام گلدشت نمونه اصفهان,6,6110,44532000,7410,7700,7200,-210,-2.83,7290,-120,-1.62,7200,7700,1400-10-21,2022-01-11
794,ويستا,صندوق س. ويستا -س,6,5479,55557060,10155,10140,10140,-15,-0.15,10140,-15,-0.15,10140,10140,1400-10-21,2022-01-11
795,ضپاس1009,اختيارخ وپارس-1600-1400/10/22,6,46,10344000,205,220,230,25,12.2,225,20,9.76,220,230,1400-10-21,2022-01-11
796,ضبدر3010,اختيارخ شبندر-4500-1401/03/29,6,60,175000000,2850,3000,2800,-50,-1.75,2917,67,2.35,2800,3000,1400-10-21,2022-01-11
797,شرق1400,مشاركت ليزينگ ايران وشرق140010,6,5548,5658760000,1010940,1000000,1020000,9060,0.9,1019960,9020,0.89,1000000,1020000,1400-10-21,2022-01-11
798,زعف0110پ21,زعفران0110نگين ملل(پ),6,1780,671665350,395335,380000,375000,-20335,-5.14,377340,-17995,-4.55,375000,380500,1400-10-21,2022-01-11
799,ساروج,بين المللي ساروج بوشهر,6,96458,1577515560,16480,16480,15820,-660,-4,16470,-10,-0.06,15820,16540,1400-10-21,2022-01-11
800,سي تيپ2ن05,گواهي سيمان تيپ 2خاش(ن),6,290000,1728400000,5677,5960,5960,283,4.99,5960,283,4.99,5960,5960,1400-10-21,2022-01-11
801,سپرمي,پرميت‌,6,7167,90089190,12330,12570,12570,240,1.95,12340,10,0.08,12570,12570,1400-10-21,2022-01-11
802,ضهمن3000,اختيارخ خبهمن-1200-1401/03/11,6,56,62900000,1075,1150,1100,25,2.33,1123,48,4.47,1100,1150,1400-10-21,2022-01-11
803,ضمخا1035,اختيارخ اخابر-7000-1400/10/26,6,57,17402000,256,400,100,-156,-60.94,305,49,19.14,100,400,1400-10-21,2022-01-11
804,ثهام,صندوق س ثروت هامرز-سهام,6,967,10106310,10450,10450,10450,0,0,10450,0,0,10450,10650,1400-10-21,2022-01-11
805,گوهر2,صندوق سكه طلاي كيان,5,50000,50000,58450,1,1,-58449,-100,1,-58449,-100,1,1,1400-10-21,2022-01-11
806,ضملت1132,اختيارخ وبملت-2500-1400/11/13,5,69,55640000,731,800,800,69,9.44,806,75,10.26,788,820,1400-10-21,2022-01-11
807,سي تيپ2ن01,گواهي سيمان تيپ 2 فارس(ن),5,164000,946116000,5495,5769,5769,274,4.99,5769,274,4.99,5769,5769,1400-10-21,2022-01-11
808,امين يكم2,صندوق درآمد ثابت امين يكم فردا,5,5000000,5000000,10098,1,1,-10097,-99.99,1,-10097,-99.99,1,1,1400-10-21,2022-01-11
809,فراز,صندوق س.سهام فراز داريك-س,5,12986,184927712,14239,14240,14240,1,0.01,14241,2,0.01,14240,14244,1400-10-21,2022-01-11
810,حاريا,كشتيراني آريا,5,3500,42560000,12400,12160,12160,-240,-1.94,12160,-240,-1.94,12160,12160,1400-10-21,2022-01-11
811,ضجار2011,اختيارخ وتجارت-1600-1401/02/21,5,89,52510000,1,590,590,589,58900,590,589,58900,590,590,1400-10-21,2022-01-11
812,زملاردح,ح.كشاورزي و دامپروري ملارد شير,5,803,4673460,1000,5820,5820,4820,482,5820,4820,482,5820,5820,1400-10-21,2022-01-11
813,افران2,صندوق س افرا نماد پايدار-ثابت,5,16800000,16800000,15212,1,1,-15211,-99.99,1,-15211,-99.99,1,1,1400-10-21,2022-01-11
814,ثعتما,س. ساختماني اعتماد گستر,5,3160,68256000,22700,21600,21600,-1100,-4.85,22700,0,0,21600,21600,1400-10-21,2022-01-11
815,اوج,صندوق س.اوج دماوند-س,5,5963,59645121,10003,10002,10005,2,0.02,10003,0,0,10002,10005,1400-10-21,2022-01-11
816,ضداريوش904,اختيارخ داريوش-11500-14010915,5,36,52920000,1938,1470,1470,-468,-24.15,1470,-468,-24.15,1470,1470,1400-10-21,2022-01-11
817,سي تيپ2ن18,گواهي سيمان تيپ2سامان غرب(ن),5,110000,537790000,4794,4889,4889,95,1.98,4889,95,1.98,4889,4889,1400-10-21,2022-01-11
818,حگردش,ريل گردش ايرانيان,5,8465,32141605,3914,3797,3797,-117,-2.99,3914,0,0,3797,3797,1400-10-21,2022-01-11
819,شگويات.ف0104,اختيارف.تبعي شگويا010408,5,26500,26500,1,1,1,0,0,1,0,0,1,1,1400-10-21,2022-01-11
820,صپا ه 17,بار پايه هفته 17صنعتي,4,22000,11440000,570,520,520,-50,-8.77,520,-50,-8.77,520,520,1400-10-21,2022-01-11
821,سي تيپ2ن11,گواهي سيمان تيپ2دورود(ن),4,207000,1041831000,4794,5033,5033,239,4.99,5033,239,4.99,5033,5033,1400-10-21,2022-01-11
822,پست0108پ10,پسته فندقي34-32مه ولات0108(پ),4,130,266590000,2100000,2050000,2080000,-20000,-0.95,2050692,-49308,-2.35,2050000,2080000,1400-10-21,2022-01-11
823,ضملت1136,اختيارخ وبملت-4500-1400/11/13,4,52,599000,60,89,10,-50,-83.33,12,-48,-80,10,89,1400-10-21,2022-01-11
824,تملي711,تسهيلات مسكن ب. ملي-بهمن97,4,62,55581398,869819,913309,826329,-43490,-5,896474,26655,3.06,826329,913309,1400-10-21,2022-01-11
825,تملي706,تسهيلات مسكن ب. ملي-شهريور97,4,146,104936820,743178,706020,780336,37158,5,718745,-24433,-3.29,706020,780336,1400-10-21,2022-01-11
826,نخو0102پ01,نخود متوسط0102شيري(پ),4,71,24734200,360050,355000,342048,-18002,-5,348369,-11681,-3.24,342048,355000,1400-10-21,2022-01-11
827,ضغدر1131,اختيارخ وغدير-12000-1400/11/20,4,5,18485000,3500,3495,4000,500,14.29,3697,197,5.63,3495,4000,1400-10-21,2022-01-11
828,سي تيپ2ن07,گواهي سيمان تيپ 2تهران(ن),4,66000,373428000,5389,5658,5658,269,4.99,5658,269,4.99,5658,5658,1400-10-21,2022-01-11
829,ضجار2014,اختيارخ وتجارت-2500-1401/02/21,4,20,2075000,52,105,100,48,92.31,104,52,100,100,105,1400-10-21,2022-01-11
830,اشاد10,مشاركت دولتي10-شرايط خاص001226,4,700,689500000,987000,985000,985000,-2000,-0.2,985000,-2000,-0.2,985000,985000,1400-10-21,2022-01-11
831,سي تيپ2ن02,گواهي سيمان تيپ2صوفيان(ن),4,100000,585000000,5572,5850,5850,278,4.99,5850,278,4.99,5850,5850,1400-10-21,2022-01-11
832,آرمان,بيمه آرمان,3,5100,25398000,5130,4980,4980,-150,-2.92,5130,0,0,4980,4980,1400-10-21,2022-01-11
833,بذر,صندوق س بذر اميد آفرين-سهام,3,200,18976000,95280,94880,94880,-400,-0.42,94880,-400,-0.42,94880,94880,1400-10-21,2022-01-11
834,ضبدر1165,اختيارخ شبندر-8000-1400/11/13,3,30,1710000,33,120,25,-8,-24.24,57,24,72.73,25,120,1400-10-21,2022-01-11
835,ضمخا1036,اختيارخ اخابر-8000-1400/10/26,3,111,444000,24,4,4,-20,-83.33,4,-20,-83.33,4,4,1400-10-21,2022-01-11
836,وسخوز,شركت س استان خوزستان,3,37337,22514211,634,603,603,-31,-4.89,634,0,0,603,603,1400-10-21,2022-01-11
837,ضملت1131,اختيارخ وبملت-2000-1400/11/13,3,7,8945000,900,1110,1289,389,43.22,1278,378,42,1110,1390,1400-10-21,2022-01-11
838,ثبات2,صندوق س. ثبات ويستا -د,3,19000000,19000000,10730,1,1,-10729,-99.99,1,-10729,-99.99,1,1,1400-10-21,2022-01-11
839,ضترا1133,اختيارخ شتران-4411-1400/11/10,3,13,1115364,40,41,10,-30,-75,38,-2,-5,10,41,1400-10-21,2022-01-11
840,اخزا905,اسنادخزانه-م5بودجه99-020218,3,328,246930880,755870,752660,759960,4090,0.54,752840,-3030,-0.4,752660,759960,1400-10-21,2022-01-11
841,ضترا1131,اختيارخ شتران-3529-1400/11/10,3,8,7623921,666,444,411,-255,-38.29,420,-246,-36.94,411,444,1400-10-21,2022-01-11
842,ضترا1135,اختيارخ شتران-6176-1400/11/10,3,110,249370,2,1,1,-1,-50,1,-1,-50,1,1,1400-10-21,2022-01-11
843,وسخراش,شركت س استان خراسان شمالي,3,63489,82599189,1369,1301,1301,-68,-4.97,1369,0,0,1301,1301,1400-10-21,2022-01-11
844,بتك,كارخانجات كابل سازي‌ تك‌,3,789,28404000,34621,36000,36000,1379,3.98,34650,29,0.08,36000,36000,1400-10-21,2022-01-11
845,خفناور,مهندسي صنعتي روان فن آور,3,5155,169341750,33850,32850,32850,-1000,-2.95,32850,-1000,-2.95,32850,32850,1400-10-21,2022-01-11
846,شسم,توليد سموم‌ علف‌ كش,3,12,1252200,101350,104350,104350,3000,2.96,104350,3000,2.96,104350,104350,1400-10-21,2022-01-11
847,سي تيپ2ن12,گواهي سيمان تيپ2خزر(ن),3,99000,498267000,4794,5033,5033,239,4.99,5033,239,4.99,5033,5033,1400-10-21,2022-01-11
848,كمند2,صندوق س. با درآمد ثابت كمند,3,109800000,109800000,10028,1,1,-10027,-99.99,1,-10027,-99.99,1,1,1400-10-21,2022-01-11
849,سپيدما2,صندوق س. سپيد دماوند-د,3,21000000,21000000,11662,1,1,-11661,-99.99,1,-11661,-99.99,1,1,1400-10-21,2022-01-11
850,پادا,صندوق س.پاداش سرمايه پارس-س,3,1850,193930000,105210,105300,104800,-410,-0.39,104827,-383,-0.36,104800,105300,1400-10-21,2022-01-11
851,سي تيپ2ن04,گواهي سيمان تيپ2فارس نو(ن),3,33000,181599000,5241,5503,5503,262,5,5503,262,5,5503,5503,1400-10-21,2022-01-11
852,ضپاس1010,اختيارخ وپارس-1800-1400/10/22,3,48,1781000,86,40,27,-59,-68.6,37,-49,-56.98,27,40,1400-10-21,2022-01-11
853,اطلس2,صندوق س.توسعه اندوخته آينده-س,2,20000,20000,234754,1,1,-234753,-100,1,-234753,-100,1,1,1400-10-21,2022-01-11
854,ضملت3011,اختيارخ وبملت-3000-1401/03/18,2,21,20270000,1,270,1000,999,99900,965,964,96400,270,1000,1400-10-21,2022-01-11
855,سي تيپ2ن29,گواهي سيمان تيپ2فيروزكوه(ن),2,20000,102580000,4885,5129,5129,244,4.99,5129,244,4.99,5129,5129,1400-10-21,2022-01-11
856,هفارس014,اختيارف ت فارس11832-1401/04/12,2,200000,101000000,1,505,505,504,50400,505,504,50400,505,505,1400-10-21,2022-01-11
857,سخند,صندوق س.سپهرخبرگان نفت-د,2,810,8129400,10025,10030,10040,15,0.15,10036,11,0.11,10030,10040,1400-10-21,2022-01-11
858,دشيري,شيرين دارو,2,200,21950000,113100,109750,109750,-3350,-2.96,113100,0,0,109750,109750,1400-10-21,2022-01-11
859,سپر4,صندوق س سپر سرمايه بيدار- ثابت,2,8828000,119538470000,13540,13541,13540,0,0,13541,1,0.01,13540,13541,1400-10-21,2022-01-11
860,گپارس,امور رفاهي كارگزاران پارس,2,102,10424400,105350,102200,102200,-3150,-2.99,105350,0,0,102200,102200,1400-10-21,2022-01-11
861,وسرضوي,س.سهام عدالت استان خراسان رضوي,2,16066,11069474,725,689,689,-36,-4.97,725,0,0,689,689,1400-10-21,2022-01-11
862,ضملت1135,اختيارخ وبملت-4000-1400/11/13,2,109,1070000,12,10,8,-4,-33.33,10,-2,-16.67,8,10,1400-10-21,2022-01-11
863,سي تيپ2ن27,گواهي سيمان تيپ2آبيك(ن),2,150000,810600000,5147,5404,5404,257,4.99,5404,257,4.99,5404,5404,1400-10-21,2022-01-11
864,طجار2013,اختيارف وتجارت-2000-1401/02/21,2,31,5270000,200,170,170,-30,-15,170,-30,-15,170,170,1400-10-21,2022-01-11
865,ضبدر3009,اختيارخ شبندر-4000-1401/03/29,2,10,33800000,3400,3360,3400,0,0,3380,-20,-0.59,3360,3400,1400-10-21,2022-01-11
866,ضپنا2017,اختيارخ رمپنا-24000-1401/02/07,2,6,6000,1,1,1,0,0,1,0,0,1,1,1400-10-21,2022-01-11
867,سي تيپ2ن32,گواهي سيمان تيپ2هرمزگان(ن),2,80000,440720000,5509,5509,5509,0,0,5509,0,0,5509,5509,1400-10-21,2022-01-11
868,كارا2,صندوق س. كارا -د,2,5000000,5000000,10545,1,1,-10544,-99.99,1,-10544,-99.99,1,1,1400-10-21,2022-01-11
869,نگين,ص.س. زمين و ساختمان نگين شهرري,2,12,630080,52290,53090,52090,-200,-0.38,52510,220,0.42,52090,53090,1400-10-21,2022-01-11
870,كهرام,توليدي گرانيت بهسرام,2,232,20149200,88600,86850,86850,-1750,-1.98,88600,0,0,86850,86850,1400-10-21,2022-01-11
871,وسالت,بانك قرض الحسنه رسالت,2,5001,7106421,1354,1421,1421,67,4.95,1421,67,4.95,1421,1421,1400-10-21,2022-01-11
872,اعتماد2,صندوق س.اعتماد آفرين پارسيان-د,2,17000000,17000000,41231,1,1,-41230,-100,1,-41230,-100,1,1,1400-10-21,2022-01-11
873,صخود401,ص مرابحه خودرو401- 3ماهه 18%,2,15000,13650000000,940000,910000,910000,-30000,-3.19,910000,-30000,-3.19,910000,910000,1400-10-21,2022-01-11
874,سي تيپ2ن13,گواهي سيمان تيپ2بجنورد(ن),2,61000,308721000,4820,5061,5061,241,5,5061,241,5,5061,5061,1400-10-21,2022-01-11
875,ضمخا1037,اختيارخ اخابر-9000-1400/10/26,2,39,39000,2,1,1,-1,-50,1,-1,-50,1,1,1400-10-21,2022-01-11
876,ضملي1162,اختيارخ فملي-8000-1400/11/03,2,30,600000,150,10,10,-140,-93.33,10,-140,-93.33,10,10,1400-10-21,2022-01-11
877,پا ه 17,بار پايه هفته 17,2,18000,9330000,518,520,518,0,0,518,0,0,518,520,1400-10-21,2022-01-11
878,ضملت3009,اختيارخ وبملت-2000-1401/03/18,2,43,72180000,1,1660,1700,1699,169900,1679,1678,167800,1660,1700,1400-10-21,2022-01-11
879,ضترا1132,اختيارخ شتران-3970-1400/11/10,1,13,4715360,494,160,160,-334,-67.61,160,-334,-67.61,160,160,1400-10-21,2022-01-11
880,اراد914,مرابحه عام دولت91-ش.خ010525,1,12000000,11916000000000,995000,993000,993000,-2000,-0.2,993000,-2000,-0.2,993000,993000,1400-10-21,2022-01-11
881,پست0108پ09,پسته بادامي32-30مه ولات0108(پ),1,3,6540000,2200000,2180000,2180000,-20000,-0.91,2180000,-20000,-0.91,2180000,2180000,1400-10-21,2022-01-11
882,ضخوز2027,اختيارخ فخوز-10000-1401/02/18,1,1,100000,1000,100,100,-900,-90,100,-900,-90,100,100,1400-10-21,2022-01-11
883,اراد964,مرابحه عام دولت96-ش.خ030414,1,2400000,2233992000000,1000000,930830,930830,-69170,-6.92,930830,-69170,-6.92,930830,930830,1400-10-21,2022-01-11
884,ضپاس2013,اختيارخ وپارس-2000-1401/02/28,1,2,600000,440,300,300,-140,-31.82,300,-140,-31.82,300,300,1400-10-21,2022-01-11
885,ولقمان2,سرمايه گذاري لقمان,1,7065000,19520595000,2767,2763,2763,-4,-0.14,2763,-4,-0.14,2763,2763,1400-10-21,2022-01-11
886,زير0103پ02,زيره سبز0103 دانش(پ),1,1,1030000,1050000,1030000,1030000,-20000,-1.9,1030000,-20000,-1.9,1030000,1030000,1400-10-21,2022-01-11
887,طپاس1011,اختيارف وپارس-2000-1400/10/22,1,19,1520000,71,80,80,9,12.68,80,9,12.68,80,80,1400-10-21,2022-01-11
888,ضترا3011,اختيارخ شتران-3000-1401/03/08,1,7,9730000,1,1390,1390,1389,138900,1390,1389,138900,1390,1390,1400-10-21,2022-01-11
889,ضملي1157,اختيارخ فملي-4000-1400/11/03,1,2,11600000,2667,2900,2900,233,8.74,2900,233,8.74,2900,2900,1400-10-21,2022-01-11
890,ضفلا1162,اختيارخ فولاد-9000-1400/11/24,1,1,1440000,1508,1440,1440,-68,-4.51,1440,-68,-4.51,1440,1440,1400-10-21,2022-01-11
891,ضصاد3015,اختيارخ وبصادر-2000-1401/03/11,1,10,4800000,520,480,480,-40,-7.69,480,-40,-7.69,480,480,1400-10-21,2022-01-11
892,خاهن2,آهنگري‌ تراكتورسازي‌ ايران‌,1,144000000,597888000000,4237,4152,4152,-85,-2.01,4152,-85,-2.01,4152,4152,1400-10-21,2022-01-11
893,صكم ر 4,كم باري روز 4صنعتي,1,17000,7990000,385,470,470,85,22.08,470,85,22.08,470,470,1400-10-21,2022-01-11
894,اراد954,مرابحه عام دولت95-ش.خ020514,1,1990000,1950200000000,942210,980000,980000,37790,4.01,980000,37790,4.01,980000,980000,1400-10-21,2022-01-11
895,سي تيپ2ن19,گواهي سيمان تيپ2غرب آسيا(ن),1,20000,95880000,4794,4794,4794,0,0,4794,0,0,4794,4794,1400-10-21,2022-01-11
896,انار2,صندوق س.انارنماد ارزش-درسهام,1,200000,200000,8860,1,1,-8859,-99.99,1,-8859,-99.99,1,1,1400-10-21,2022-01-11
897,زير0103پ01,زيره سبز0103كيميابذر(پ),1,20,20000000,988546,1000000,1000000,11454,1.16,1000000,11454,1.16,1000000,1000000,1400-10-21,2022-01-11
898,ضذوب3000,اختيارخ ذوب-2000-1401/03/04,1,2,3200000,1650,1600,1600,-50,-3.03,1600,-50,-3.03,1600,1600,1400-10-21,2022-01-11
899,ضبدر3011,اختيارخ شبندر-5000-1401/03/29,1,10,25000000,2450,2500,2500,50,2.04,2500,50,2.04,2500,2500,1400-10-21,2022-01-11
900,اگ0012542,گام بانك پارسيان0012,1,295671,284225575590,955000,961290,961290,6290,0.66,961290,6290,0.66,961290,961290,1400-10-21,2022-01-11
901,كاريس4,صندوق س.سپهر كاريزما-س,1,7500000,96750000000,12911,12900,12900,-11,-0.09,12900,-11,-0.09,12900,12900,1400-10-21,2022-01-11
902,كابگن,توليدي و صنعتي آبگينه‌,1,10,67400,6680,6740,6740,60,0.9,6740,60,0.9,6740,6740,1400-10-21,2022-01-11
903,پست0108پ04,پسته فندقي32-30سبزدانه0108(پ),1,40,89960000,2250000,2249000,2249000,-1000,-0.04,2249000,-1000,-0.04,2249000,2249000,1400-10-21,2022-01-11
904,تبريز0342,مشاركت ش تبريز034-3 ماهه 18%,1,900000,900000000000,1000000,1000000,1000000,0,0,1000000,0,0,1000000,1000000,1400-10-21,2022-01-11
905,اراد554,مرابحه عام دولت5-ش.خ 0209,1,70000,65968000000,948000,942400,942400,-5600,-0.59,942400,-5600,-0.59,942400,942400,1400-10-21,2022-01-11
906,مصفها203,مشاركت ش اصفهان203-3ماهه18%,1,1000,920000000,940000,920000,920000,-20000,-2.13,920000,-20000,-2.13,920000,920000,1400-10-21,2022-01-11
907,ضشنا2011,اختيارخ شپنا-3500-1401/02/25,1,2,5580000,2900,2790,2790,-110,-3.79,2790,-110,-3.79,2790,2790,1400-10-21,2022-01-11
908,صپابهمن,بار پايه صنعتي بهمن,1,540,307800,350,570,570,220,62.86,570,220,62.86,570,570,1400-10-21,2022-01-11
909,ضفلا1164,اختيارخ فولاد-12000-1400/11/24,1,1,199000,190,199,199,9,4.74,199,9,4.74,199,199,1400-10-21,2022-01-11
910,سفارود,كارخانه فارسيت درود,1,400,5000000,13020,12500,12500,-520,-3.99,12500,-520,-3.99,12500,12500,1400-10-21,2022-01-11
911,ضخود2022,اختيارخ خودرو-4000-1401/02/07,1,2,100000,40,50,50,10,25,50,10,25,50,50,1400-10-21,2022-01-11
912,اراد854,مرابحه عام دولت85-ش.خ010704,1,2000000,1954150000000,968000,977075,977075,9075,0.94,977075,9075,0.94,977075,977075,1400-10-21,2022-01-11
913,فبستم,صنايع ‌بسته‌بندي‌ مشهد,1,100,104200,993,1042,1042,49,4.93,1042,49,4.93,1042,1042,1400-10-21,2022-01-11
914,ضپنا2016,اختيارخ رمپنا-20000-1401/02/07,1,5,10000,740,2,2,-738,-99.73,2,-738,-99.73,2,2,1400-10-21,2022-01-11
915,فسديد,لوله‌وتجهيزات‌ سديد - ورشكسته,1,100,9105000,91950,91050,91050,-900,-0.98,91050,-900,-0.98,91050,91050,1400-10-21,2022-01-11
916,سي تيپ2ن06,گواهي سيمان تيپ 2شاهرود(ن),1,25000,125825000,4794,5033,5033,239,4.99,5033,239,4.99,5033,5033,1400-10-21,2022-01-11
917,اراد63,مرابحه عام دولت63-ش.خ0309,1,1000,1035000000,1050000,1035000,1035000,-15000,-1.43,1035000,-15000,-1.43,1035000,1035000,1400-10-21,2022-01-11
918,ضفار1129,اختيارخ فارس-6400-1400/11/06,1,1,3000000,2000,3000,3000,1000,50,3000,1000,50,3000,3000,1400-10-21,2022-01-11
919,پارسا211,مشاركت ليزينگ پارسيان-3ماهه18%,1,5,4850000,970000,970000,970000,0,0,970000,0,0,970000,970000,1400-10-21,2022-01-11
920,كشم0101پ01,كشمش سبز0101خليل آباد(پ),1,9,5670000,613000,630000,630000,17000,2.77,630000,17000,2.77,630000,630000,1400-10-21,2022-01-11
921,ثقزوي,شركت عمران و سازندگي قزوين,1,240,5016000,21500,20900,20900,-600,-2.79,20900,-600,-2.79,20900,20900,1400-10-21,2022-01-11
922,ضبدر3012,اختيارخ شبندر-6000-1401/03/29,1,10,18000000,1,1800,1800,1799,179900,1800,1799,179900,1800,1800,1400-10-21,2022-01-11
923,اخزا820,اسنادخزانه-م20بودجه98-020806,1,25,17075000,679980,683000,683000,3020,0.44,683000,3020,0.44,683000,683000,1400-10-21,2022-01-11
924,ضملت3012,اختيارخ وبملت-3500-1401/03/18,1,1,50000,1,50,50,49,4900,50,49,4900,50,50,1400-10-21,2022-01-11
925,هاي وب2,داده گسترعصرنوين-هاي وب,1,19975000,157802500000,7810,7900,7900,90,1.15,7900,90,1.15,7900,7900,1400-10-21,2022-01-11
926,شاوان2,پالايش نفت لاوان,1,340000,42279000000,124050,124350,124350,300,0.24,124350,300,0.24,124350,124350,1400-10-21,2022-01-11
927,كهربا2,صندوق س.پشتوانه سكه طلا كهربا,1,1000000,1000000,10110,1,1,-10109,-99.99,1,-10109,-99.99,1,1,1400-10-21,2022-01-11
928,آگاس2,صندوق س.هستي بخش آگاه-س,1,100000,100000,74786,1,1,-74785,-100,1,-74785,-100,1,1,1400-10-21,2022-01-11
929,اراد354,مرابحه عام دولت3-ش.خ 0103,1,100000,97790000000,980000,977900,977900,-2100,-0.21,977900,-2100,-0.21,977900,977900,1400-10-21,2022-01-11
930,اراد834,مرابحه عام دولت83-ش.خ041220,1,200000,200000000000,1000000,1000000,1000000,0,0,1000000,0,0,1000000,1000000,1400-10-21,2022-01-11
931,سپر2,صندوق س سپر سرمايه بيدار- ثابت,1,6000000,6000000,13540,1,1,-13539,-99.99,1,-13539,-99.99,1,1,1400-10-21,2022-01-11
932,ضذوب3002,اختيارخ ذوب-3000-1401/03/04,1,5,4250000,1200,850,850,-350,-29.17,850,-350,-29.17,850,850,1400-10-21,2022-01-11
933,اراد504,مرابحه عام دولت5-ش.خ0302,1,480000,480000000000,1000010,1000000,1000000,-10,0,1000000,-10,0,1000000,1000000,1400-10-21,2022-01-11
934,خاتم2,صندوق س خاتم ايساتيس پويا-ثابت,1,400000,400000,12628,1,1,-12627,-99.99,1,-12627,-99.99,1,1,1400-10-21,2022-01-11
935,ضترا1134,اختيارخ شتران-5294-1400/11/10,1,1,2267,25,1,1,-24,-96,1,-24,-96,1,1,1400-10-21,2022-01-11
936,پست0108پ08,پسته فندقي32-30مه ولات0108(پ),1,3,6450000,2208772,2150000,2150000,-58772,-2.66,2150000,-58772,-2.66,2150000,2150000,1400-10-21,2022-01-11
937,اراد51,مرابحه عام دولت5-ش.خ 0010,1,100,100000000,1000000,1000000,1000000,0,0,1000000,0,0,1000000,1000000,1400-10-21,2022-01-11
938,ضمخا1034,اختيارخ اخابر-6000-1400/10/26,1,2,2000000,1000,1000,1000,0,0,1000,0,0,1000,1000,1400-10-21,2022-01-11
939,طسپا1112,اختيارف خساپا-1600-1400/11/20,1,100,4000000,30,40,40,10,33.33,40,10,33.33,40,40,1400-10-21,2022-01-11
940,ضشگويا1202,اختيارخ شگويا-10000-14001222,1,1,2150000,2107,2150,2150,43,2.04,2150,43,2.04,2150,2150,1400-10-21,2022-01-11
941,داريوش2,صندوق س. ثروت داريوش -س,1,100000,100000,9323,1,1,-9322,-99.99,1,-9322,-99.99,1,1,1400-10-21,2022-01-11
942,اراد95,مرابحه عام دولت95-ش.خ020514,1,10000,9600000000,942210,960000,960000,17790,1.89,960000,17790,1.89,960000,960000,1400-10-21,2022-01-11
943,سي تيپ2ن23,گواهي سيمان تيپ2فراز(ن),1,10000,49740000,4974,4974,4974,0,0,4974,0,0,4974,4974,1400-10-21,2022-01-11
944,شكف,كف,1,70,5351500,78000,76450,76450,-1550,-1.99,76450,-1550,-1.99,76450,76450,1400-10-21,2022-01-11
945,كمان,س.خ.كمان كاريزما 35% تاديه,1,100000,38529800000,385074,385298,385298,224,0.06,385298,224,0.06,385298,385298,1400-10-21,2022-01-11
946,اراد944,مرابحه عام دولت94-ش.خ030816,1,2500000,2302500000000,920030,921000,921000,970,0.11,921000,970,0.11,921000,921000,1400-10-21,2022-01-11
947,ملت2,بيمه ملت,1,299900000,367377500000,1214,1225,1225,11,0.91,1225,11,0.91,1225,1225,1400-10-21,2022-01-11
948,سامان2,بانك سامان,1,21463553,150030235470,6820,6990,6990,170,2.49,6990,170,2.49,6990,6990,1400-10-21,2022-01-11
949,سي تيپ2ن10,گواهي سيمان تيپ 2غرب(ن),1,20000,100660000,4794,5033,5033,239,4.99,5033,239,4.99,5033,5033,1400-10-21,2022-01-11
950,تابان042,اجاره تابان سپهر14031126,1,1000000,1005990000000,979700,1005990,1005990,26290,2.68,1005990,26290,2.68,1005990,1005990,1400-10-21,2022-01-11
951,اخزا9182,اسنادخزانه-م18بودجه99-010323,1,256318,234787288000,915630,916000,916000,370,0.04,916000,370,0.04,916000,916000,1400-10-21,2022-01-11
952,شوينده2,مديريت صنعت شوينده ت.ص.بهشهر,1,2000000,36600000000,18270,18300,18300,30,0.16,18300,30,0.16,18300,18300,1400-10-21,2022-01-11
953,ضبدر1164,اختيارخ شبندر-7000-1400/11/13,1,10,800000,68,80,80,12,17.65,80,12,17.65,80,80,1400-10-21,2022-01-11
954,ضپاس1011,اختيارخ وپارس-2000-1400/10/22,1,100,2000000,4,20,20,16,400,20,16,400,20,20,1400-10-21,2022-01-11
955,وخاور2,بانك خاورميانه,1,8240713,41459027103,5031,5031,5031,0,0,5031,0,0,5031,5031,1400-10-21,2022-01-11
956,اراد874,مرابحه عام دولت87-ش.خ030304,1,2000000,1931428000000,960490,965714,965714,5224,0.54,965714,5224,0.54,965714,965714,1400-10-21,2022-01-11
957,شتولي,تولي‌پرس‌,1,250,5037500,20550,20150,20150,-400,-1.95,20150,-400,-1.95,20150,20150,1400-10-21,2022-01-11
