,نماد,نام,تعداد,حجم,ارزش,دیروز,اولین,آخرین معامله - مقدار,آخرین معامله - تغییر,آخرین معامله - درصد,قیمت پایانی - مقدار,قیمت پایانی - تغییر,قیمت پایانی - درصد,کمترین,بیشترین,تاریخ,gregorian_date
0,پالايش,صندوق پالايشي يكم-سهام,11913,10787225,749050554290,69920,69750,69930,10,0.01,69440,-480,-0.69,68880,69990,1400-10-26,2022-01-16
1,شتران,پالايش نفت تهران,10277,72378236,259579342487,3644,3620,3617,-27,-0.74,3586,-58,-1.59,3515,3670,1400-10-26,2022-01-16
2,خودرو,ايران‌ خودرو,9792,314510393,615354783053,1957,1930,1988,31,1.58,1957,0,0,1882,2011,1400-10-26,2022-01-16
3,شپنا,پالايش نفت اصفهان,7963,76475563,416777398270,5570,5570,5550,-20,-0.36,5450,-120,-2.15,5350,5570,1400-10-26,2022-01-16
4,دارا يكم,صندوق واسطه گري مالي يكم-سهام,7332,4552785,493263016020,108730,108160,109130,400,0.37,108340,-390,-0.36,107410,109190,1400-10-26,2022-01-16
5,خگستر,گسترش‌سرمايه‌گذاري‌ايران‌خودرو,5877,166209603,407149123660,2471,2468,2491,20,0.81,2450,-21,-0.85,2366,2530,1400-10-26,2022-01-16
6,فولاد,فولاد مباركه اصفهان,5531,39831559,398099911880,10050,10060,10030,-20,-0.2,9990,-60,-0.6,9890,10100,1400-10-26,2022-01-16
7,خساپا,سايپا,5409,157841693,256347400816,1627,1624,1638,11,0.68,1624,-3,-0.18,1575,1655,1400-10-26,2022-01-16
8,فرابورس,فرابورس ايران,5171,30685180,430770326530,14720,14300,14030,-690,-4.69,14040,-680,-4.62,13990,14460,1400-10-26,2022-01-16
9,كرمان,س. توسعه و عمران استان كرمان,5096,204480149,174267023397,907,854,856,-51,-5.62,852,-55,-6.06,824,870,1400-10-26,2022-01-16
10,بركت,گروه دارويي بركت,4918,14902775,238981268630,15750,15500,16200,450,2.86,16040,290,1.84,15500,16400,1400-10-26,2022-01-16
11,كيمياتك,آريان كيميا تك,4596,6567194,165284503450,24040,24430,25240,1200,4.99,25170,1130,4.7,24000,25240,1400-10-26,2022-01-16
12,توسن,توسعه سامانه ي نرم افزاري نگين,4494,7259426,178431489250,23750,24000,24750,1000,4.21,24600,850,3.58,23950,24900,1400-10-26,2022-01-16
13,شسينا,صنايع‌شيميايي‌سينا,4481,107539799,245121555533,2379,2399,2261,-118,-4.96,2279,-100,-4.2,2261,2420,1400-10-26,2022-01-16
14,شبندر,پالايش نفت بندرعباس,4416,47391223,296315603010,6380,6250,6300,-80,-1.25,6250,-130,-2.04,6180,6350,1400-10-26,2022-01-16
15,سمگا,گروه سرمايه گذاري ميراث فرهنگي,4407,44563063,443202618540,10200,9900,10210,10,0.1,9950,-250,-2.45,9690,10210,1400-10-26,2022-01-16
16,كالا,بورس كالاي ايران,4325,18478013,452489075270,25690,25000,24650,-1040,-4.05,24490,-1200,-4.67,24410,25450,1400-10-26,2022-01-16
17,كمند,صندوق س. با درآمد ثابت كمند,4175,157512405,1585157556196,10058,10063,10064,6,0.06,10064,6,0.06,10063,10064,1400-10-26,2022-01-16
18,بورس,بورس اوراق بهادار تهران,4161,40196568,348575717330,9100,8800,8710,-390,-4.29,8670,-430,-4.73,8650,8990,1400-10-26,2022-01-16
19,فملي,ملي‌ صنايع‌ مس‌ ايران‌,4138,32857123,231473919340,7110,7110,7080,-30,-0.42,7040,-70,-0.98,6980,7120,1400-10-26,2022-01-16
20,سدبير,س. تدبيرگران فارس وخوزستان,3821,6565549,222043738050,34100,34800,34850,750,2.2,33800,-300,-0.88,32400,35550,1400-10-26,2022-01-16
21,ختوقا,قطعات‌ اتومبيل‌ ايران‌,3571,92565952,247545347100,2801,2670,2692,-109,-3.89,2674,-127,-4.53,2661,2799,1400-10-26,2022-01-16
22,چخزر,صنايع چوب خزر كاسپين,3534,6299129,211529305950,32900,31900,34500,1600,4.86,33600,700,2.13,31900,34500,1400-10-26,2022-01-16
23,فجهان,مجتمع جهان فولاد سيرجان,3221,14699776,80818973040,5500,5420,5500,0,0,5500,0,0,5420,5510,1400-10-26,2022-01-16
24,كاما,باما,3219,25737594,152390896050,6120,6000,6050,-70,-1.14,5920,-200,-3.27,5820,6110,1400-10-26,2022-01-16
25,زقيام,كشت و دام قيام اصفهان,3179,103063472,156892832646,1483,1454,1557,74,4.99,1522,39,2.63,1409,1557,1400-10-26,2022-01-16
26,فسبزوار,پارس فولاد سبزوار,3178,2648373,90508170770,34180,34200,34000,-180,-0.53,34180,0,0,33980,34220,1400-10-26,2022-01-16
27,نوري,پتروشيمي نوري,3115,2005676,204828039280,103360,103450,102670,-690,-0.67,102120,-1240,-1.2,100610,103450,1400-10-26,2022-01-16
28,كدما,معدني‌ دماوند,2937,2378107,138715627450,60350,59930,59030,-1320,-2.19,58330,-2020,-3.35,57500,59940,1400-10-26,2022-01-16
29,كرماشا,صنايع پتروشيمي كرمانشاه,2836,2316920,112640305380,50860,51550,48490,-2370,-4.66,48620,-2240,-4.4,48320,51550,1400-10-26,2022-01-16
30,شپديس,پتروشيمي پرديس,2784,1908363,288614776700,158440,159000,150570,-7870,-4.97,151240,-7200,-4.54,150520,159000,1400-10-26,2022-01-16
31,خپارس,پارس‌ خودرو,2747,110115572,113559658083,1029,1017,1041,12,1.17,1031,2,0.19,1008,1052,1400-10-26,2022-01-16
32,شفن,پتروشيمي فناوران,2723,7938721,104595864630,13480,13600,12930,-550,-4.08,13220,-260,-1.93,12810,13830,1400-10-26,2022-01-16
33,غگيلا,شيرپاستوريزه پگاه گيلان,2571,5131541,86070906630,16050,16390,16790,740,4.61,16770,720,4.49,16150,16850,1400-10-26,2022-01-16
34,مديريت,س. و خدمات مديريت صند. ب كشوري,2553,5828510,50299982500,8900,8800,8700,-200,-2.25,8630,-270,-3.03,8460,8900,1400-10-26,2022-01-16
35,وتجارت,بانك تجارت,2548,78779141,144850315662,1859,1850,1853,-6,-0.32,1839,-20,-1.08,1800,1866,1400-10-26,2022-01-16
36,پترول,گ.س.وت.ص.پتروشيمي خليج فارس,2514,45322554,97110483884,2180,2141,2166,-14,-0.64,2143,-37,-1.7,2113,2190,1400-10-26,2022-01-16
37,خنصير,مهندسي‌نصيرماشين‌,2504,13689031,222990492750,16950,16110,16800,-150,-0.88,16290,-660,-3.89,16110,16830,1400-10-26,2022-01-16
38,غصينو,صنعتي مينو,2460,12057096,185349487930,15610,15980,15030,-580,-3.72,15370,-240,-1.54,14830,16300,1400-10-26,2022-01-16
39,كيان,صندوق س. با درآمد ثابت كيان,2400,23241197,758382617091,32611,32630,32630,19,0.06,32631,20,0.06,32629,32633,1400-10-26,2022-01-16
40,وبملت,بانك ملت,2393,58590137,182736750827,3180,3174,3160,-20,-0.63,3119,-61,-1.92,3080,3174,1400-10-26,2022-01-16
41,امين,تامين سرمايه امين,2321,5472418,58349960710,10630,10660,10660,30,0.28,10660,30,0.28,10660,10690,1400-10-26,2022-01-16
42,وبصادر,بانك صادرات ايران,2253,74570021,141836029292,1934,1880,1921,-13,-0.67,1902,-32,-1.65,1880,1949,1400-10-26,2022-01-16
43,زملاردح,ح.كشاورزي و دامپروري ملارد شير,2251,1390810,7670146820,5800,5530,5510,-290,-5,5510,-290,-5,5510,5600,1400-10-26,2022-01-16
44,فاذر,صنايع‌ آذرآب‌,2236,79223748,67344532995,833,840,854,21,2.52,850,17,2.04,816,868,1400-10-26,2022-01-16
45,پسهند,صنايع‌ لاستيكي‌  سهند,2194,5223031,164687325380,30070,31570,31570,1500,4.99,31530,1460,4.86,31110,31570,1400-10-26,2022-01-16
46,تسه0009,امتيازتسهيلات مسكن آذر 1400,2142,70761,88101577838,1264223,1234100,1220000,-44223,-3.5,1245058,-19165,-1.52,1201012,1275000,1400-10-26,2022-01-16
47,ضخود2019,اختيارخ خودرو-2500-1401/02/07,2139,89694,13744333000,154,155,157,3,1.95,153,-1,-0.65,148,160,1400-10-26,2022-01-16
48,صبا,سرمايه گذاري صبا تامين,2132,22479561,138803128740,6210,6140,6170,-40,-0.64,6170,-40,-0.64,6090,6240,1400-10-26,2022-01-16
49,وسديد,گروه ‌صنعتي‌سديد,2082,38268018,37839078410,1015,1020,987,-28,-2.76,989,-26,-2.56,985,1020,1400-10-26,2022-01-16
50,غزر,صنعتي زر ماكارون,2004,2429782,21361401110,9010,8770,8800,-210,-2.33,8840,-170,-1.89,8720,9050,1400-10-26,2022-01-16
51,لپارس,پارس‌ الكتريك‌,1980,1166544,112116245200,100770,96500,97710,-3060,-3.04,96110,-4660,-4.62,95740,99100,1400-10-26,2022-01-16
52,اعتماد,صندوق س.اعتماد آفرين پارسيان-د,1962,39603360,1638138188530,41340,41364,41364,24,0.06,41364,24,0.06,41363,41366,1400-10-26,2022-01-16
53,امين يكم,صندوق درآمد ثابت امين يكم فردا,1941,55387285,560716279616,10119,10124,10128,9,0.09,10124,5,0.05,10121,10128,1400-10-26,2022-01-16
54,شگويا,پتروشيمي تندگويان,1931,6321070,66034820070,10600,10470,10600,0,0,10500,-100,-0.94,10300,10600,1400-10-26,2022-01-16
55,بوعلي,پتروشيمي بوعلي سينا,1897,1371621,97567138810,71970,71850,71260,-710,-0.99,71150,-820,-1.14,70160,72000,1400-10-26,2022-01-16
56,خودكفا,اقتصادي و خودكفايي آزادگان,1891,16070464,117772023710,7350,7570,7130,-220,-2.99,7330,-20,-0.27,7130,7570,1400-10-26,2022-01-16
57,انرژي3,سايراشخاص بورس انرژي,1875,1963926,133004759850,71180,68550,67630,-3550,-4.99,67720,-3460,-4.86,67630,69950,1400-10-26,2022-01-16
58,گدنا,تهيه توزيع غذاي دنا آفرين فدك,1873,956954,10823700110,11740,11310,11260,-480,-4.09,11400,-340,-2.9,11200,11660,1400-10-26,2022-01-16
59,وخارزم,سرمايه گذاري خوارزمي,1860,19615448,79467013997,4103,4086,4082,-21,-0.51,4051,-52,-1.27,3990,4139,1400-10-26,2022-01-16
60,ذوب,ذوب آهن اصفهان,1856,23603195,74115360777,3223,3159,3160,-63,-1.95,3143,-80,-2.48,3101,3222,1400-10-26,2022-01-16
61,ثاميد,توسعه و عمران اميد,1852,11366285,15073120787,1365,1351,1327,-38,-2.78,1334,-31,-2.27,1310,1358,1400-10-26,2022-01-16
62,حسير,ريل سير كوثر,1850,9300600,144565758360,15840,15080,15880,40,0.25,15540,-300,-1.89,15050,16200,1400-10-26,2022-01-16
63,سپيدار,سپيدار سيستم آسيا,1760,268367,5089832150,19500,19200,19100,-400,-2.05,19300,-200,-1.03,18800,19650,1400-10-26,2022-01-16
64,وساغربي,شركت س استان آذربايجان غربي,1759,102340967,41827479620,413,410,413,0,0,409,-4,-0.97,403,414,1400-10-26,2022-01-16
65,سپيد,سپيد ماكيان,1718,606025,35153996300,58550,58000,58080,-470,-0.8,58010,-540,-0.92,57300,59500,1400-10-26,2022-01-16
66,وغدير,سرمايه‌گذاري‌غدير(هلدينگ‌,1714,9414481,127492622670,13800,13700,13540,-260,-1.88,13540,-260,-1.88,13310,13800,1400-10-26,2022-01-16
67,تاصيكو,سرمايه گذاري صدرتامين,1614,16271131,131452541210,8100,8100,8160,60,0.74,8080,-20,-0.25,7970,8200,1400-10-26,2022-01-16
68,ثبهساز,بهساز كاشانه تهران,1604,7530781,11006191916,1502,1469,1466,-36,-2.4,1471,-31,-2.06,1440,1499,1400-10-26,2022-01-16
69,تليسه,دامداري تليسه نمونه,1591,24409780,55269461636,2217,2228,2327,110,4.96,2264,47,2.12,2131,2327,1400-10-26,2022-01-16
70,شاروم,پتروشيمي اروميه,1574,916987,11734180640,12950,12640,13170,220,1.7,12830,-120,-0.93,12500,13190,1400-10-26,2022-01-16
71,غگل,گلوكوزان‌,1560,23499715,75172082993,3341,3300,3180,-161,-4.82,3199,-142,-4.25,3174,3327,1400-10-26,2022-01-16
72,شبريز,پالايش نفت تبريز,1557,2628864,87254572110,32580,31810,33660,1080,3.31,33100,520,1.6,31810,33990,1400-10-26,2022-01-16
73,خزاميا,زامياد,1554,13064263,105161558990,8080,8170,8140,60,0.74,8050,-30,-0.37,7770,8260,1400-10-26,2022-01-16
74,زملارد,كشاورزي و دامپروري ملارد شير,1546,1626220,12896770880,8280,8120,7920,-360,-4.35,7970,-310,-3.74,7870,8180,1400-10-26,2022-01-16
75,وكبهمن,مديريت سرمايه گذاري كوثربهمن,1510,723469,6467180910,9320,9070,8990,-330,-3.54,9150,-170,-1.82,8860,9100,1400-10-26,2022-01-16
76,آپ,آسان پرداخت پرشين,1498,7509384,66384632030,9060,9000,8860,-200,-2.21,8840,-220,-2.43,8610,9200,1400-10-26,2022-01-16
77,غكورش,صنعت غذايي كورش,1497,942301,43951437670,46550,45120,47010,460,0.99,46620,70,0.15,45120,47500,1400-10-26,2022-01-16
78,افران,صندوق س افرا نماد پايدار-ثابت,1479,38894955,593644467065,15254,15262,15263,9,0.06,15263,9,0.06,15262,15264,1400-10-26,2022-01-16
79,وهامون,سرمايه گذاري هامون صبا,1474,3192214,8357188790,2653,2610,2631,-22,-0.83,2633,-20,-0.75,2600,2651,1400-10-26,2022-01-16
80,زاگرس,پتروشيمي زاگرس,1468,389119,73564280450,191150,191150,188300,-2850,-1.49,189600,-1550,-0.81,185600,193200,1400-10-26,2022-01-16
81,سيتا,سرمايه گذاري سيمان تامين,1447,2348194,20239882140,8750,8650,8750,0,0,8680,-70,-0.8,8530,8770,1400-10-26,2022-01-16
82,پارس,پتروشيمي پارس,1424,738404,123848988520,164990,164810,168800,3810,2.31,167730,2740,1.66,160000,172000,1400-10-26,2022-01-16
83,وسپهر,سرمايه گذاري مالي سپهرصادرات,1424,4801468,33899516890,7060,7060,7060,0,0,7060,0,0,7060,7070,1400-10-26,2022-01-16
84,كارا,صندوق س. كارا -د,1397,62489437,661110298239,10573,10580,10580,7,0.07,10580,7,0.07,10579,10581,1400-10-26,2022-01-16
85,كزغال,زغال سنگ پروده طبس,1388,1244203,36738272850,29750,29100,29750,0,0,29550,-200,-0.67,29000,30100,1400-10-26,2022-01-16
86,بپيوند,برق و انرژي پيوندگستر پارس,1374,490627,4358382280,9060,8910,8910,-150,-1.66,9010,-50,-0.55,8850,8980,1400-10-26,2022-01-16
87,چكارن,كارتن‌ ايران‌,1363,21858128,60027322407,2621,2708,2752,131,5,2746,125,4.77,2683,2752,1400-10-26,2022-01-16
88,ملت,بيمه ملت,1363,65657560,81695380053,1242,1259,1245,3,0.24,1244,2,0.16,1221,1259,1400-10-26,2022-01-16
89,قاسم,قاسم ايران,1348,14190638,52444309862,3550,3610,3688,138,3.89,3696,146,4.11,3500,3727,1400-10-26,2022-01-16
90,شاراك,پتروشيمي شازند,1306,2579390,102485308360,40710,40650,39890,-820,-2.01,39730,-980,-2.41,39200,40650,1400-10-26,2022-01-16
91,حكشتي,كشتيراني جمهوري اسلامي ايران,1305,5161639,67939969590,13530,13340,13210,-320,-2.37,13310,-220,-1.63,12910,13450,1400-10-26,2022-01-16
92,گشان,توسعه بين المللي پديده شانديز,1301,3519473,58764952890,17190,16680,16900,-290,-1.69,16700,-490,-2.85,16680,17100,1400-10-26,2022-01-16
93,خزر,فنرسازي‌زر,1292,5340402,49526494220,8980,8750,9410,430,4.79,9270,290,3.23,8750,9420,1400-10-26,2022-01-16
94,فنفت,صنايع تجهيزات نفت,1291,7539919,158361159980,20180,21180,20450,270,1.34,21000,820,4.06,20030,21180,1400-10-26,2022-01-16
95,بكامح,ح.كارخانجات توليدي شهيد قندي,1287,41284058,17966140313,467,470,440,-27,-5.78,435,-32,-6.85,421,470,1400-10-26,2022-01-16
96,سحرخيز,صندوق س. گروه زعفران سحرخيز,1285,2168441,37449304871,17961,17777,17100,-861,-4.79,17270,-691,-3.85,17058,17777,1400-10-26,2022-01-16
97,فتوسا,توليد و توسعه سرب روي ايرانيان,1276,701949,7823927190,11070,10780,11030,-40,-0.36,11110,40,0.36,10780,11280,1400-10-26,2022-01-16
98,شيراز,پتروشيمي‌شيراز,1275,1791200,120929818460,70700,70600,68120,-2580,-3.65,67510,-3190,-4.51,67170,71580,1400-10-26,2022-01-16
99,وسكرد,شركت س استان كردستان,1273,73677318,30227054453,414,410,412,-2,-0.48,410,-4,-0.97,407,415,1400-10-26,2022-01-16
100,ختور,رادياتور ايران‌,1269,5735106,62440317460,11380,10920,11030,-350,-3.08,10890,-490,-4.31,10820,11290,1400-10-26,2022-01-16
101,آبادا,توليد نيروي برق آبادان,1240,639747,5792148090,9380,8960,9020,-360,-3.84,9250,-130,-1.39,8960,9120,1400-10-26,2022-01-16
102,قتربت,قند تربت حيدريه,1220,191108,12199327250,62000,63850,63850,1850,2.98,63850,1850,2.98,62450,63850,1400-10-26,2022-01-16
103,فنورد,نوردوقطعات‌ فولادي‌,1213,448048,83690170660,182380,175400,184890,2510,1.38,186790,4410,2.42,175400,191490,1400-10-26,2022-01-16
104,بگيلان,توسعه مسير برق گيلان,1213,230957,3072985300,13540,13240,13310,-230,-1.7,13510,-30,-0.22,13220,13540,1400-10-26,2022-01-16
105,ولپارس,ليزينگ پارسيان,1212,3500184,9449669608,2788,2783,2679,-109,-3.91,2730,-58,-2.08,2667,2783,1400-10-26,2022-01-16
106,ومدير,گ.مديريت ارزش سرمايه ص ب كشوري,1201,2896727,12510968744,4372,4281,4350,-22,-0.5,4329,-43,-0.98,4281,4399,1400-10-26,2022-01-16
107,قچار,فراوردههاي غذايي وقند چهارمحال,1200,7901823,75973941330,9490,9450,9700,210,2.21,9610,120,1.26,9220,9940,1400-10-26,2022-01-16
108,غشصفا,شيرپاستوريزه‌پگاه‌اصفهان‌,1194,4651469,84347383700,18800,19100,17860,-940,-5,18130,-670,-3.56,17860,19100,1400-10-26,2022-01-16
109,لطيف,محصولات كاغذي لطيف,1192,364895,13293233250,36700,35450,36200,-500,-1.36,36450,-250,-0.68,35450,37100,1400-10-26,2022-01-16
110,هاي وب,داده گسترعصرنوين-هاي وب,1158,8795205,67427696140,7720,7650,7650,-70,-0.91,7670,-50,-0.65,7590,7870,1400-10-26,2022-01-16
111,فسرب,ملي‌ سرب‌وروي‌ ايران‌,1155,37360942,59122229564,1661,1582,1601,-60,-3.61,1582,-79,-4.76,1578,1630,1400-10-26,2022-01-16
112,كاوه,فولاد كاوه جنوب كيش,1149,4639737,56767681930,12650,12300,12210,-440,-3.48,12330,-320,-2.53,12020,12570,1400-10-26,2022-01-16
113,قرن,پديده شيمي قرن,1147,2085037,52666313700,24890,23700,25680,790,3.17,25260,370,1.49,23700,25950,1400-10-26,2022-01-16
114,ثبات,صندوق س. ثبات ويستا -د,1145,60722615,653622873647,10759,10764,10765,6,0.06,10764,5,0.05,10764,10765,1400-10-26,2022-01-16
115,بترانس,ايران‌ ترانسفو,1141,24066193,42908404400,1829,1827,1790,-39,-2.13,1783,-46,-2.52,1757,1827,1400-10-26,2022-01-16
116,وملي,گروه‌ صنعتي‌ ملي‌ (هلدينگ‌,1140,444274,54955144600,129400,123610,124990,-4410,-3.41,123700,-5700,-4.4,122930,128000,1400-10-26,2022-01-16
117,كماسه,تامين‌ ماسه‌ ريخته‌گري‌,1128,18514280,51223195944,2864,2900,2731,-133,-4.64,2767,-97,-3.39,2721,2913,1400-10-26,2022-01-16
118,پارند,صندوق س. پارند پايدار سپهر,1126,37958375,381889760239,10054,10061,10061,7,0.07,10061,7,0.07,10060,10061,1400-10-26,2022-01-16
119,فروي,ذوب روي اصفهان,1121,3038060,52788604270,18160,18020,17260,-900,-4.96,17380,-780,-4.3,17260,18300,1400-10-26,2022-01-16
120,فگستر,گسترش صنايع روي ايرانيان,1109,1458624,13949847490,9990,9510,9500,-490,-4.9,9570,-420,-4.2,9500,9820,1400-10-26,2022-01-16
121,رافزا,رايان هم افزا,1099,45718,2629661250,58600,57000,57400,-1200,-2.05,58400,-200,-0.34,56400,58500,1400-10-26,2022-01-16
122,ولكار,ليزينگ كارآفرين,1088,436456,1668232120,3981,3830,3841,-140,-3.52,3962,-19,-0.48,3790,3880,1400-10-26,2022-01-16
123,شصدف,صنعتي دوده فام,1076,910867,31934101950,35600,34900,35650,50,0.14,35050,-550,-1.54,34150,35900,1400-10-26,2022-01-16
124,بپاس,بيمه پاسارگاد,1072,8528115,297892438850,35300,33550,35050,-250,-0.71,34950,-350,-0.99,33550,35100,1400-10-26,2022-01-16
125,وليز,ليزينگ‌ايران‌,1046,15868950,28310375641,1711,1760,1796,85,4.97,1784,73,4.27,1668,1796,1400-10-26,2022-01-16
126,فخوز,فولاد  خوزستان,1044,11750092,69571257200,6000,5940,5950,-50,-0.83,5950,-50,-0.83,5840,6010,1400-10-26,2022-01-16
127,ثشاهد,سرمايه‌ گذاري‌ شاهد,1038,6510468,58539634170,8980,8980,9030,50,0.56,8990,10,0.11,8820,9130,1400-10-26,2022-01-16
128,كوير,توليدي فولاد سپيد فراب كوير,1012,11120468,48592374439,4565,4475,4337,-228,-4.99,4370,-195,-4.27,4337,4558,1400-10-26,2022-01-16
129,وپارس,بانك‌پارسيان‌,1008,25873761,46814516201,1833,1769,1818,-15,-0.82,1823,-10,-0.55,1769,1859,1400-10-26,2022-01-16
130,وسكرمان,س.سهام عدالت استان كرمان,998,89516063,36977049579,422,414,410,-12,-2.84,413,-9,-2.13,407,420,1400-10-26,2022-01-16
131,ضخود2018,اختيارخ خودرو-2000-1401/02/07,985,31205,11335334000,372,368,380,8,2.15,363,-9,-2.42,336,386,1400-10-26,2022-01-16
132,پيزد,مجتمع صنايع لاستيك يزد,978,306916,14810715750,49450,51400,48000,-1450,-2.93,48250,-1200,-2.43,47000,51400,1400-10-26,2022-01-16
133,كترام,توليدي‌ كاشي‌ تكسرام‌,974,2740152,60930940260,21260,21540,22320,1060,4.99,22240,980,4.61,21530,22320,1400-10-26,2022-01-16
134,حآفرين,ريل پرداز نو آفرين,958,11716527,42472669043,3668,3720,3565,-103,-2.81,3625,-43,-1.17,3520,3736,1400-10-26,2022-01-16
135,پارسان,گسترش نفت و گاز پارسيان,915,3650288,111328529820,31110,31050,31000,-110,-0.35,30520,-590,-1.9,29910,31200,1400-10-26,2022-01-16
136,ومعادن,توسعه‌معادن‌وفلزات‌,905,9988517,91209798200,9250,9200,9180,-70,-0.76,9160,-90,-0.97,9000,9220,1400-10-26,2022-01-16
137,كپارس,كاشي‌ پارس‌,901,9314528,67562444650,6990,7100,7330,340,4.86,7250,260,3.72,7050,7330,1400-10-26,2022-01-16
138,وفتخار,سرمايه گذاري افتخار سهام,879,5020412,10321967072,1997,2056,2056,59,2.95,2056,59,2.95,2056,2056,1400-10-26,2022-01-16
139,كگل,معدني و صنعتي گل گهر,862,2782358,60596926850,22120,22080,21820,-300,-1.36,21940,-180,-0.81,21330,22130,1400-10-26,2022-01-16
140,ثاخت,بين‌المللي‌توسعه‌ساختمان,850,15983220,27411672194,1761,1755,1723,-38,-2.16,1715,-46,-2.61,1681,1755,1400-10-26,2022-01-16
141,سفارس,سيمان فارس و خوزستان,846,3651911,54947945080,15010,15000,15220,210,1.4,15050,40,0.27,14560,15400,1400-10-26,2022-01-16
142,تپمپي,پمپ‌ سازي‌ ايران‌,829,3271952,68786469380,20180,20630,21180,1000,4.96,21020,840,4.16,20060,21180,1400-10-26,2022-01-16
143,شغدير,پتروشيمي غدير,817,624378,49353418180,80250,80940,79500,-750,-0.93,79040,-1210,-1.51,78130,81000,1400-10-26,2022-01-16
144,غديس,پاكديس,816,2618602,29057511880,10750,10760,11000,250,2.33,11100,350,3.26,10660,11280,1400-10-26,2022-01-16
145,خراسان,پتروشيمي خراسان,816,1504485,167639594330,116960,116620,112300,-4660,-3.98,111430,-5530,-4.73,111120,118880,1400-10-26,2022-01-16
146,تاپيكو,س. نفت و گاز و پتروشيمي تأمين,801,5557960,73702380880,13500,13400,13360,-140,-1.04,13350,-150,-1.11,13070,13410,1400-10-26,2022-01-16
147,تسه0006,امتيازتسهيلات مسكن شهريور1400,796,19462,23960780254,1255855,1210005,1193063,-62792,-5,1231157,-24698,-1.97,1193063,1270000,1400-10-26,2022-01-16
148,وصنا,گروه‌صنايع‌بهشهرايران‌,791,13699360,40546271388,3108,2992,2953,-155,-4.99,2960,-148,-4.76,2953,3030,1400-10-26,2022-01-16
149,كچاد,معدني‌وصنعتي‌چادرملو,783,2913771,85219817360,29740,29660,29080,-660,-2.22,29380,-360,-1.21,29000,29780,1400-10-26,2022-01-16
150,تاپكيش,تجارت الكترونيك پارسيان كيش,776,2535336,41266054800,16310,16900,16310,0,0,16280,-30,-0.18,15910,16900,1400-10-26,2022-01-16
151,تملتح,ح . تامين سرمايه بانك ملت,761,4100899,4497417413,1105,1070,1095,-10,-0.9,1097,-8,-0.72,1070,1119,1400-10-26,2022-01-16
152,كبافق,معادن‌ بافق‌,752,1238644,29424369720,24890,25000,23930,-960,-3.86,23760,-1130,-4.54,23650,25000,1400-10-26,2022-01-16
153,سرو,صندوق س سروسودمند مدبران-سهام,743,868121,57124104050,66000,65730,66350,350,0.53,65800,-200,-0.3,65220,66350,1400-10-26,2022-01-16
154,نطرين,عطرين نخ قم,742,4611627,30911424130,6750,6600,6880,130,1.93,6700,-50,-0.74,6420,7000,1400-10-26,2022-01-16
155,حتوكا,حمل‌ونقل‌توكا,740,2924777,38672086310,13800,13640,13110,-690,-5,13220,-580,-4.2,13110,13770,1400-10-26,2022-01-16
156,وپويا,سرمايه گذاري پويا,735,1049505,3354972168,3261,3210,3211,-50,-1.53,3246,-15,-0.46,3177,3220,1400-10-26,2022-01-16
157,ثفارس,عمران‌وتوسعه‌فارس‌,734,6277507,39648459990,6560,6510,6240,-320,-4.88,6320,-240,-3.66,6240,6630,1400-10-26,2022-01-16
158,رتاپ,تجارت الكترونيك  پارسيان,728,5031737,25252283725,4972,4840,5059,87,1.75,5019,47,0.95,4741,5180,1400-10-26,2022-01-16
159,چكاپا,گروه صنايع كاغذ پارس,727,7731189,21554967497,2849,2844,2795,-54,-1.9,2788,-61,-2.14,2749,2868,1400-10-26,2022-01-16
160,خكمك,كمك‌فنرايندامين‌,724,1625017,38329798100,23130,22510,23880,750,3.24,23590,460,1.99,22510,24090,1400-10-26,2022-01-16
161,كساوه,صنايع‌ كاشي‌ و سراميك‌ سينا,723,1646377,76579673610,45610,45700,47500,1890,4.14,46510,900,1.97,45000,47500,1400-10-26,2022-01-16
162,قثابت,قند ثابت‌ خراسان‌,717,17677399,28692101761,1676,1644,1627,-49,-2.92,1623,-53,-3.16,1593,1669,1400-10-26,2022-01-16
163,تسه0008,امتيازتسهيلات مسكن آبان1400,707,9303,11537912298,1255813,1215555,1193023,-62790,-5,1240236,-15577,-1.24,1193023,1279000,1400-10-26,2022-01-16
164,سبزوا,سيمان لار سبزوار,704,8882278,15528045399,1750,1681,1780,30,1.71,1748,-2,-0.11,1681,1787,1400-10-26,2022-01-16
165,كتوكاح,ح.توليدي وخدمات صنايع نسوزتوكا,698,4216780,17907484206,4460,4310,4291,-169,-3.79,4247,-213,-4.78,4237,4433,1400-10-26,2022-01-16
166,زنگان,صنعت روي زنگان,681,582905,32250918950,57650,55150,56200,-1450,-2.52,55350,-2300,-3.99,54800,57750,1400-10-26,2022-01-16
167,فردا,صندوق س آواي فرداي زاگرس-ثابت,675,31443887,384092577597,12209,12215,12216,7,0.06,12215,6,0.05,12215,12216,1400-10-26,2022-01-16
168,شلعاب,لعابيران‌,675,5130967,24729675590,5040,4950,4830,-210,-4.17,4820,-220,-4.37,4790,5090,1400-10-26,2022-01-16
169,اپال,فرآوري معدني اپال كاني پارس,674,1043302,24453507760,23540,23540,23320,-220,-0.93,23520,-20,-0.08,23310,23540,1400-10-26,2022-01-16
170,فجر,فولاد اميركبيركاشان,673,1688534,36220554220,21940,21750,21600,-340,-1.55,21450,-490,-2.23,21110,21760,1400-10-26,2022-01-16
171,فروس,فروسيليس‌ ايران‌,656,5233282,34749074040,6510,6550,6830,320,4.92,6640,130,2,6350,6830,1400-10-26,2022-01-16
172,ونيرو,سرمايه‌گذاري‌نيرو,655,18661225,43053192237,2319,2300,2309,-10,-0.43,2307,-12,-0.52,2272,2350,1400-10-26,2022-01-16
173,خمحركه,نيرو محركه‌,655,7651696,24707494805,3304,3261,3280,-24,-0.73,3229,-75,-2.27,3141,3350,1400-10-26,2022-01-16
174,آگاس,صندوق س.هستي بخش آگاه-س,648,610180,45004778448,74314,73860,74266,-48,-0.06,73757,-557,-0.75,73321,74500,1400-10-26,2022-01-16
175,تملت,تامين سرمايه بانك ملت,647,3717094,9464557264,2528,2531,2566,38,1.5,2539,11,0.44,2500,2570,1400-10-26,2022-01-16
176,ثامان,سامان‌ گستراصفهان‌,646,4187837,45330863650,10420,10780,10940,520,4.99,10820,400,3.84,10370,10940,1400-10-26,2022-01-16
177,غپاك,لبنيات‌ پاك‌,644,1968690,25463499530,13110,13240,12760,-350,-2.67,12930,-180,-1.37,12510,13610,1400-10-26,2022-01-16
178,ماديرا,صنايع ماديران,637,4846084,23873331800,4920,5000,5010,90,1.83,4930,10,0.2,4790,5040,1400-10-26,2022-01-16
179,دانا,بيمه دانا,635,9079521,42308431615,4546,4600,4700,154,3.39,4660,114,2.51,4600,4758,1400-10-26,2022-01-16
180,بجهرم,توسعه مولد نيروگاهي جهرم,632,7685848,13952227326,1859,1814,1828,-31,-1.67,1824,-35,-1.88,1799,1857,1400-10-26,2022-01-16
181,غنوش,نوش‌ مازندران‌,629,2504654,28698594280,12030,11510,11430,-600,-4.99,11460,-570,-4.74,11430,11840,1400-10-26,2022-01-16
182,اخابر,مخابرات ايران,627,9285115,64859523890,7030,6950,7000,-30,-0.43,7010,-20,-0.28,6780,7200,1400-10-26,2022-01-16
183,نهال,صندوق س. طلاي سرخ نوويرا,625,1125138,20640970569,18619,18420,18060,-559,-3,18345,-274,-1.47,18000,18990,1400-10-26,2022-01-16
184,مبين,مبين انرژي خليج فارس,624,3416543,75957141920,22270,23000,21700,-570,-2.56,22250,-20,-0.09,21210,23000,1400-10-26,2022-01-16
185,شاوان,پالايش نفت لاوان,624,390129,48421307750,125700,127450,126400,700,0.56,124350,-1350,-1.07,121950,127500,1400-10-26,2022-01-16
186,خكار,ايركا پارت صنعت,618,9240389,26549611807,2979,2911,2930,-49,-1.64,2873,-106,-3.56,2831,2971,1400-10-26,2022-01-16
187,شسپا,نفت سپاهان,610,10398416,33509565540,3270,3295,3242,-28,-0.86,3248,-22,-0.67,3185,3295,1400-10-26,2022-01-16
188,وبيمه,سرمايه‌ گذاري‌ صنعت‌ بيمه‌,610,27132656,43613250895,1585,1554,1628,43,2.71,1607,22,1.39,1554,1639,1400-10-26,2022-01-16
189,شيران,س. صنايع‌شيميايي‌ايران,603,1154372,21865789130,19360,19100,19020,-340,-1.76,19230,-130,-0.67,18700,19280,1400-10-26,2022-01-16
190,وگردش,بانك گردشگري,602,17013019,174666873530,10260,10270,10290,30,0.29,10270,10,0.1,10100,10330,1400-10-26,2022-01-16
191,لكما,كارخانجات‌مخابراتي‌ايران‌,602,24401803,20416079199,861,840,836,-25,-2.9,837,-24,-2.79,836,856,1400-10-26,2022-01-16
192,زبينا,كشاورزي و دامپروري بينالود,600,10351603,23335553806,2288,2197,2316,28,1.22,2254,-34,-1.49,2174,2342,1400-10-26,2022-01-16
193,ولساپا,ليزينگ رايان‌ سايپا,597,13040848,17298791058,1353,1332,1344,-9,-0.67,1327,-26,-1.92,1305,1349,1400-10-26,2022-01-16
194,ياقوت,صندوق س ياقوت آگاه-ثابت,596,14151786,198018500595,13992,14000,13996,4,0.03,13992,0,0,13990,14000,1400-10-26,2022-01-16
195,سيمرغ,سيمرغ,593,1514136,34336204530,23020,22850,22940,-80,-0.35,22680,-340,-1.48,22210,23150,1400-10-26,2022-01-16
196,وايران,ليزينگ ايرانيان,592,11467984,30392582643,2785,2646,2648,-137,-4.92,2650,-135,-4.85,2646,2699,1400-10-26,2022-01-16
197,ورنا,سرمايه‌گذاري‌ رنا(هلدينگ‌,592,12078310,35069841730,2923,2924,2902,-21,-0.72,2904,-19,-0.65,2862,2966,1400-10-26,2022-01-16
198,حفاري,حفاري شمال,591,6013241,23089825616,3949,3857,3850,-99,-2.51,3840,-109,-2.76,3800,3914,1400-10-26,2022-01-16
199,تسه0007,امتيازتسهيلات مسكن مهر1400,584,7570,9381979227,1263075,1220122,1199922,-63153,-5,1239363,-23712,-1.88,1199922,1300000,1400-10-26,2022-01-16
200,ونوين,بانك‌اقتصادنوين‌,583,6596326,22313098558,3444,3442,3366,-78,-2.26,3411,-33,-0.96,3345,3444,1400-10-26,2022-01-16
201,غويتا,ويتانا,582,4169742,19003620010,4768,4742,4557,-211,-4.43,4558,-210,-4.4,4530,4742,1400-10-26,2022-01-16
202,رمپنا,گروه مپنا (سهامي عام),581,4052704,63550618320,16120,15390,15760,-360,-2.23,15880,-240,-1.49,15390,16180,1400-10-26,2022-01-16
203,تكشا,گسترش‌صنايع‌وخدمات‌كشاورزي‌,580,1235051,49201642960,38100,38020,40000,1900,4.99,39840,1740,4.57,38010,40000,1400-10-26,2022-01-16
204,پكرمان,گروه‌ صنعتي‌ بارز,580,2624520,51814396870,19140,19500,19570,430,2.25,19740,600,3.13,19220,20070,1400-10-26,2022-01-16
205,البرز,بيمه البرز,574,10794448,17883594617,1668,1680,1684,16,0.96,1657,-11,-0.66,1638,1690,1400-10-26,2022-01-16
206,خموتور,موتورسازان‌تراكتورسازي‌ايران‌,565,4807353,19877010300,4336,4260,4120,-216,-4.98,4135,-201,-4.64,4120,4260,1400-10-26,2022-01-16
207,بشهاب,لامپ‌  پارس‌ شهاب‌,564,381237,55670959590,142410,149530,144360,1950,1.37,146030,3620,2.54,139920,149530,1400-10-26,2022-01-16
208,غبشهر,صنعتي‌ بهشهر,562,10104645,35045481371,3450,3365,3533,83,2.41,3468,18,0.52,3365,3560,1400-10-26,2022-01-16
209,سصفها,سيمان‌اصفهان‌,558,2251547,53275839600,24850,24310,23820,-1030,-4.14,23660,-1190,-4.79,23610,24890,1400-10-26,2022-01-16
210,هرمز,فولاد هرمزگان جنوب,556,1650178,23328478410,14550,14070,14090,-460,-3.16,14470,-80,-0.55,14030,14370,1400-10-26,2022-01-16
211,خكاوه,سايپا ديزل,556,13678015,59694811576,4240,4298,4367,127,3,4364,124,2.92,4206,4367,1400-10-26,2022-01-16
212,وهور,مديريت انرژي اميد  تابان هور,554,15902336,18085214973,1178,1140,1137,-41,-3.48,1154,-24,-2.04,1120,1168,1400-10-26,2022-01-16
213,وآذر,سرمايه‌گذاري‌توسعه‌آذربايجان‌,550,1050278,33415474000,33450,33340,31970,-1480,-4.42,31820,-1630,-4.87,31780,33350,1400-10-26,2022-01-16
214,فولاژ,فولاد آلياژي ايران,543,2795180,46211472500,17230,16700,16710,-520,-3.02,16820,-410,-2.38,16370,17050,1400-10-26,2022-01-16
215,غمارگ,مارگارين‌,541,8521214,22684015470,2688,2660,2700,12,0.45,2662,-26,-0.97,2566,2717,1400-10-26,2022-01-16
216,ارفع,شركت آهن و فولاد ارفع,536,1570988,21671623840,14010,13350,13880,-130,-0.93,13940,-70,-0.5,13350,14180,1400-10-26,2022-01-16
217,پتاير,ايران‌ تاير,532,11286901,19336921145,1750,1751,1730,-20,-1.14,1713,-37,-2.11,1700,1756,1400-10-26,2022-01-16
218,چدن,توليدي چدن سازان,523,5749494,11998179740,2168,2150,2097,-71,-3.27,2100,-68,-3.14,2061,2150,1400-10-26,2022-01-16
219,وسكرشا,س.سهام عدالت استان كرمانشاه,523,39375783,16425065979,426,415,418,-8,-1.88,417,-9,-2.11,413,425,1400-10-26,2022-01-16
220,خمحور,توليدمحورخودرو,522,9847558,26650506236,2837,2758,2730,-107,-3.77,2706,-131,-4.62,2696,2778,1400-10-26,2022-01-16
221,بالاس,مهندسي ساختمان تاسيسات راه آهن,510,1072893,26779152650,26200,26050,25450,-750,-2.86,24950,-1250,-4.77,24900,26050,1400-10-26,2022-01-16
222,كاذر,فرآورده‌هاي‌نسوزآذر,510,2215871,25889774540,12250,11960,11640,-610,-4.98,11680,-570,-4.65,11640,12290,1400-10-26,2022-01-16
223,ثنور,سرمايه گذاري كوه نور,507,3934473,28841150330,7540,7390,7320,-220,-2.92,7330,-210,-2.79,7320,7560,1400-10-26,2022-01-16
224,دكپسول,توليد ژلاتين كپسول ايران,503,898815,25525523950,29700,28750,28850,-850,-2.86,28400,-1300,-4.38,28250,29500,1400-10-26,2022-01-16
225,سنير,سيمان‌ سفيد ني‌ريز,502,901535,23286841560,27080,25950,25890,-1190,-4.39,25830,-1250,-4.62,25730,26510,1400-10-26,2022-01-16
226,خريخت,صنايع‌ريخته‌گري‌ايران‌,501,10457629,26378372091,2623,2506,2555,-68,-2.59,2522,-101,-3.85,2492,2590,1400-10-26,2022-01-16
227,شجم,صنايع پتروشيمي تخت جمشيد,499,2063776,21807229190,11010,10540,10620,-390,-3.54,10660,-350,-3.18,10460,10990,1400-10-26,2022-01-16
228,مرقام,ايران‌ارقام‌,499,1465346,13785422810,9060,9400,9370,310,3.42,9380,320,3.53,9130,9510,1400-10-26,2022-01-16
229,كسعدي,كاشي‌ سعدي‌,495,2923312,20139043220,6890,6660,7070,180,2.61,6890,0,0,6560,7120,1400-10-26,2022-01-16
230,غگرجي,بيسكويت‌  گرجي‌,494,8445548,14817110943,1842,1790,1750,-92,-4.99,1754,-88,-4.78,1750,1791,1400-10-26,2022-01-16
231,طلا,صندوق س.پشتوانه طلاي لوتوس,494,349563,29208288128,83067,83992,83599,532,0.64,83557,490,0.59,83300,83992,1400-10-26,2022-01-16
232,تسه9908,امتياز تسهيلات مسكن آبان99,493,10656,13025156182,1248415,1248415,1185995,-62420,-5,1222331,-26084,-2.09,1185995,1268987,1400-10-26,2022-01-16
233,كتوكا,توليدي و خدمات صنايع نسوز توكا,487,4617303,29383877400,6670,6440,6600,-70,-1.05,6360,-310,-4.65,6340,6600,1400-10-26,2022-01-16
234,دتوزيع,توزيع دارو پخش,485,925734,21912089250,24650,24650,23800,-850,-3.45,23650,-1000,-4.06,23450,24650,1400-10-26,2022-01-16
235,كيسون,شركت كيسون,485,10741211,16919708139,1595,1570,1583,-12,-0.75,1575,-20,-1.25,1548,1630,1400-10-26,2022-01-16
236,كمرجان,بازرگاني و توليدي مرجان كار,484,4018475,20419170380,5320,5150,5060,-260,-4.89,5080,-240,-4.51,5060,5380,1400-10-26,2022-01-16
237,ديران,ايران‌دارو,484,1703847,26594814300,16370,16400,15560,-810,-4.95,15610,-760,-4.64,15560,16400,1400-10-26,2022-01-16
238,كرازي,كارخانجات‌توليدي‌شيشه‌رازي‌,480,11020700,13068871603,1196,1182,1181,-15,-1.25,1187,-9,-0.75,1173,1204,1400-10-26,2022-01-16
239,شكلر,نيروكلر,475,550455,18112405470,32820,31220,33900,1080,3.29,32900,80,0.24,31220,34100,1400-10-26,2022-01-16
240,ومهان,گروه توسعه مالي مهر آيندگان,473,8255793,34485273953,4261,4200,4208,-53,-1.24,4203,-58,-1.36,4074,4290,1400-10-26,2022-01-16
241,تسه0005,امتيازتسهيلات مسكن مرداد 1400,471,7049,8732014959,1251743,1230522,1189158,-62585,-5,1238759,-12984,-1.04,1189158,1269900,1400-10-26,2022-01-16
242,بكام,كارخانجات توليدي شهيد قندي,471,9257720,14131906126,1565,1598,1530,-35,-2.24,1528,-37,-2.36,1491,1598,1400-10-26,2022-01-16
243,زكوثر,سرمايه گذاري كشاورزي كوثر,468,1105848,15154814910,14190,13850,13700,-490,-3.45,13700,-490,-3.45,13600,14110,1400-10-26,2022-01-16
244,وبانك,سرمايه گذاري گروه توسعه ملي,468,5428599,43205720790,8030,8000,8030,0,0,7990,-40,-0.5,7900,8040,1400-10-26,2022-01-16
245,شفارس,صنايع‌ شيميايي‌ فارس‌,466,11542486,11016637504,977,960,950,-27,-2.76,960,-17,-1.74,947,980,1400-10-26,2022-01-16
246,غپينو,پارس‌ مينو,464,6506710,13261744178,2092,2120,2030,-62,-2.96,2042,-50,-2.39,1993,2120,1400-10-26,2022-01-16
247,شتوكا,توكا رنگ فولاد سپاهان,462,1400625,19315070040,14400,13800,13900,-500,-3.47,13790,-610,-4.24,13680,14190,1400-10-26,2022-01-16
248,خرينگ,رينگ‌سازي‌مشهد,456,649441,16414818200,25890,25920,25000,-890,-3.44,25280,-610,-2.36,24800,26490,1400-10-26,2022-01-16
249,وساپا,سرمايه‌گذاري‌ سايپا,453,5759397,23056120225,4040,4038,4030,-10,-0.25,4003,-37,-0.92,3920,4100,1400-10-26,2022-01-16
250,غدام,خوراك‌  دام‌ پارس‌,453,177282,15302396850,88810,85500,86460,-2350,-2.65,86320,-2490,-2.8,85500,88580,1400-10-26,2022-01-16
251,ستران,سيمان‌ تهران‌,451,2422173,47928261620,18950,19300,19890,940,4.96,19790,840,4.43,18580,19890,1400-10-26,2022-01-16
252,زشريف,كشت وصنعت شريف آباد,450,3885324,13557998324,3417,3470,3430,13,0.38,3481,64,1.87,3333,3585,1400-10-26,2022-01-16
253,بهپاك,صنعتي بهپاك,450,2347303,15737240380,6780,6570,6740,-40,-0.59,6700,-80,-1.18,6570,6890,1400-10-26,2022-01-16
254,خمهرح,ح . مهركام‌پارس‌,449,8384864,4671914918,563,555,561,-2,-0.36,557,-6,-1.07,538,572,1400-10-26,2022-01-16
255,تابا,تابان نيرو سپاهان,447,1017406,20693115800,20300,19750,20400,100,0.49,20350,50,0.25,19700,20900,1400-10-26,2022-01-16
256,اطلس,صندوق س.توسعه اندوخته آينده-س,447,173706,40187283260,233901,233999,232340,-1561,-0.67,231352,-2549,-1.09,230000,233999,1400-10-26,2022-01-16
257,خلنت,لنت‌ ترمزايران‌,447,575116,36851570110,67380,64020,64990,-2390,-3.55,64080,-3300,-4.9,64020,66000,1400-10-26,2022-01-16
258,خمهر,مهركام‌پارس‌,441,7555319,13269809985,1790,1753,1754,-36,-2.01,1758,-32,-1.79,1714,1835,1400-10-26,2022-01-16
259,فلوله,لوله‌وماشين‌سازي‌ايران‌,440,11943535,11189466379,953,966,931,-22,-2.31,941,-12,-1.26,928,966,1400-10-26,2022-01-16
260,ساوه,سيمان ساوه,439,124167,5471559200,45000,43200,44500,-500,-1.11,44650,-350,-0.78,43200,44600,1400-10-26,2022-01-16
261,ثنوسا,نوسازي‌وساختمان‌تهران‌,437,5501336,24681111940,4696,4560,4462,-234,-4.98,4486,-210,-4.47,4462,4650,1400-10-26,2022-01-16
262,توريل,توكاريل,437,2911528,21035074260,7570,7250,7360,-210,-2.77,7220,-350,-4.62,7200,7450,1400-10-26,2022-01-16
263,فاراك,ماشين‌ سازي‌ اراك‌,436,15827963,21418616951,1370,1371,1350,-20,-1.46,1353,-17,-1.24,1330,1374,1400-10-26,2022-01-16
264,خريختح,ح . صنايع‌ريخته‌گري‌ايران‌,435,9059843,12790206262,1456,1400,1402,-54,-3.71,1412,-44,-3.02,1351,1446,1400-10-26,2022-01-16
265,خاذين,سايپاآذين‌,434,6124620,15710075688,2655,2580,2551,-104,-3.92,2565,-90,-3.39,2523,2655,1400-10-26,2022-01-16
266,غسالم,سالمين‌,431,4491034,11629614923,2638,2650,2590,-48,-1.82,2598,-40,-1.52,2551,2650,1400-10-26,2022-01-16
267,هماي,صندوق س هماي آگاه-ثابت,429,6425324,65209547783,10142,10150,10151,9,0.09,10149,7,0.07,10144,10151,1400-10-26,2022-01-16
268,كي بي سي,شركت كي بي سي,429,887616,16381221250,18660,18500,18000,-660,-3.54,18460,-200,-1.07,17730,19380,1400-10-26,2022-01-16
269,حتايد,تايدواترخاورميانه,426,4043806,20442467400,5000,5060,5180,180,3.6,5060,60,1.2,4850,5200,1400-10-26,2022-01-16
270,زدشت,كشت و صنعت دشت خرم دره,423,1008094,13269404000,13280,13290,13280,0,0,13180,-100,-0.75,12740,13360,1400-10-26,2022-01-16
271,ثالوند,سرمايه گذاري مسكن الوند,421,2963592,16608109440,5660,5450,5380,-280,-4.95,5600,-60,-1.06,5380,5850,1400-10-26,2022-01-16
272,شگل,گلتاش‌,419,4674277,24700359570,5550,5600,5280,-270,-4.86,5280,-270,-4.86,5280,5600,1400-10-26,2022-01-16
273,فاسمين,كالسيمين‌,413,2455281,39853050460,16470,16110,16270,-200,-1.21,16230,-240,-1.46,16110,16480,1400-10-26,2022-01-16
274,دماوند,توليد نيروي برق دماوند,412,1200388,19785979580,17100,16470,16490,-610,-3.57,16760,-340,-1.99,16380,16800,1400-10-26,2022-01-16
275,شبصير,توليدات پتروشيمي قائد بصير,411,191243,19708980600,104850,104850,104350,-500,-0.48,103150,-1700,-1.62,101550,105350,1400-10-26,2022-01-16
276,غشهداب,كشت و صنعت شهداب ناب خراسان,406,6114381,15057733178,2517,2470,2485,-32,-1.27,2463,-54,-2.15,2411,2505,1400-10-26,2022-01-16
277,تسه9902,امتياز تسهيلات مسكن ارديبهشت99,405,6337,7815992266,1249542,1188788,1192275,-57267,-4.58,1233390,-16152,-1.29,1188788,1260000,1400-10-26,2022-01-16
278,تبرك,گروه كارخانجات صنعتي تبرك,404,1159032,9159520910,7900,7730,8000,100,1.27,7900,0,0,7660,8050,1400-10-26,2022-01-16
279,فرآور,فرآوري‌موادمعدني‌ايران‌,401,957071,24270541870,25080,25150,25020,-60,-0.24,25360,280,1.12,24710,25870,1400-10-26,2022-01-16
280,اتكاي,بيمه اتكايي ايرانيان,399,2004305,19167149720,9600,9400,9700,100,1.04,9560,-40,-0.42,9400,9780,1400-10-26,2022-01-16
281,تسه0004,امتيازتسهيلات مسكن تير1400,398,5628,6977312409,1259436,1250000,1196465,-62971,-5,1239750,-19686,-1.56,1196465,1322407,1400-10-26,2022-01-16
282,پرداخت,به پرداخت ملت,392,1838919,26526238160,15100,15080,14350,-750,-4.97,14420,-680,-4.5,14350,15400,1400-10-26,2022-01-16
283,كفپارس,فرآورده‌هاي‌ نسوز پارس‌,391,5150935,13327280464,2653,2600,2645,-8,-0.3,2591,-62,-2.34,2536,2676,1400-10-26,2022-01-16
284,سكه0012پ01,تمام سكه طرح جديد0012رفاه,389,118100,140603745000,1184808,1194900,1193600,8792,0.74,1190548,5740,0.48,1185101,1195000,1400-10-26,2022-01-16
285,دامين,داروسازي‌ امين‌,389,6169917,13415667265,2283,2200,2199,-84,-3.68,2180,-103,-4.51,2169,2263,1400-10-26,2022-01-16
286,فباهنر,مس‌ شهيدباهنر,387,489191,12922826750,26600,26600,27210,610,2.29,26510,-90,-0.34,26000,27210,1400-10-26,2022-01-16
287,همراه,شركت ارتباطات سيار ايران,386,2827385,22070206390,7820,7620,7800,-20,-0.26,7820,0,0,7620,7910,1400-10-26,2022-01-16
288,تنوين,تامين سرمايه نوين,386,5481976,34100451670,6250,6200,6160,-90,-1.44,6220,-30,-0.48,6040,6300,1400-10-26,2022-01-16
289,بموتو,موتوژن‌,386,2692102,189919300210,70910,69870,69910,-1000,-1.41,70550,-360,-0.51,68410,71720,1400-10-26,2022-01-16
290,مثقال,صندوق س.پشتوانه طلاي زرين آگاه,386,1077658,10116285942,9448,9390,9475,27,0.29,9387,-61,-0.65,9330,9497,1400-10-26,2022-01-16
291,حريل,ريل پردازسير,384,4347735,9691272005,2298,2255,2248,-50,-2.18,2250,-48,-2.09,2195,2270,1400-10-26,2022-01-16
292,خكرمان,گروه اقتصادي كرمان خودرو,382,7564710,25705636237,3392,3292,3427,35,1.03,3398,6,0.18,3292,3450,1400-10-26,2022-01-16
293,آسيا,بيمه آسيا,381,11670188,19239648297,1701,1657,1642,-59,-3.47,1649,-52,-3.06,1632,1678,1400-10-26,2022-01-16
294,غگلستا,شير پاستوريزه پگاه گلستان,379,2150598,19295375030,9410,9400,8970,-440,-4.68,8970,-440,-4.68,8940,9400,1400-10-26,2022-01-16
295,شپترو,پتروشيمي آبادان,379,6231445,17140237349,2812,2751,2743,-69,-2.45,2751,-61,-2.17,2728,2812,1400-10-26,2022-01-16
296,دتوليد,داروسازي توليد دارو,376,1184046,8473883250,7440,7250,7230,-210,-2.82,7270,-170,-2.28,7070,7380,1400-10-26,2022-01-16
297,كارين,صندوق س نگين سامان-ثابت,375,15435276,156653773319,10143,10148,10151,8,0.08,10149,6,0.06,10148,10151,1400-10-26,2022-01-16
298,وهنر,گروه توسعه هنر ايران,374,4017009,9130633701,2291,2350,2275,-16,-0.7,2274,-17,-0.74,2223,2350,1400-10-26,2022-01-16
299,قيستو,شركت قند بيستون,373,1047265,24169125100,22500,22500,23150,650,2.89,23100,600,2.67,22500,23150,1400-10-26,2022-01-16
300,جم,پتروشيمي جم,372,971375,47598628340,50130,50080,48610,-1520,-3.03,49580,-550,-1.1,48000,50080,1400-10-26,2022-01-16
301,دسانكو,داروسازي سبحان انكولوژي,371,1579089,18559792890,11660,11900,11790,130,1.11,11750,90,0.77,11630,11900,1400-10-26,2022-01-16
302,غبهار,كشت وصنعت بهاران گلبهار خراسان,367,1345273,26304350930,19510,19510,19580,70,0.36,19550,40,0.21,19500,19870,1400-10-26,2022-01-16
303,شكربن,كربن‌ ايران‌,366,358430,28256087440,81260,80650,78980,-2280,-2.81,78830,-2430,-2.99,78000,80650,1400-10-26,2022-01-16
304,سخاش,سيمان‌خاش‌,360,168396,12629579860,77930,74500,75410,-2520,-3.23,75290,-2640,-3.39,74040,77540,1400-10-26,2022-01-16
305,سشرق,سيمان‌ شرق‌,359,1794835,12190084320,6730,6530,6800,70,1.04,6780,50,0.74,6530,6970,1400-10-26,2022-01-16
306,ونيكي,سرمايه‌گذاري‌ ملي‌ايران‌,357,2857457,25191756340,9080,8760,8850,-230,-2.53,8970,-110,-1.21,8720,8900,1400-10-26,2022-01-16
307,وبوعلي,سرمايه‌گذاري‌بوعلي‌,357,2138972,7418788001,3540,3500,3500,-40,-1.13,3504,-36,-1.02,3390,3588,1400-10-26,2022-01-16
308,فسپا,گروه‌صنعتي‌سپاهان‌,356,1160759,19079380390,16560,16560,16690,130,0.79,16440,-120,-0.72,16150,16880,1400-10-26,2022-01-16
309,تسه0002,امتيازتسهيلاتمسكن ارديبهشت1400,356,5706,7039408667,1258513,1195789,1195588,-62925,-5,1233685,-24828,-1.97,1195588,1279777,1400-10-26,2022-01-16
310,كلر,كلر پارس,353,561796,47099428000,87950,84350,83600,-4350,-4.95,83850,-4100,-4.66,83600,88700,1400-10-26,2022-01-16
311,فارس,صنايع پتروشيمي خليج فارس,353,3447975,34993447360,10120,10120,10120,0,0,10130,10,0.1,10110,10220,1400-10-26,2022-01-16
312,شبهرن,نفت‌ بهران‌,353,1554990,16887881630,10890,10800,10950,60,0.55,10880,-10,-0.09,10790,11040,1400-10-26,2022-01-16
313,تسه0003,امتيازتسهيلات مسكن خرداد1400,353,4865,6037279198,1268025,1220000,1206111,-61914,-4.88,1240962,-27063,-2.13,1204624,1299000,1400-10-26,2022-01-16
314,واميد,گروه مديريت سرمايه گذاري اميد,352,3820647,53173118390,14210,14210,14000,-210,-1.48,14080,-130,-0.91,13500,14210,1400-10-26,2022-01-16
315,كسرا,سراميك‌هاي‌صنعتي‌اردكان‌,350,2547724,35627033320,14200,14200,13900,-300,-2.11,13980,-220,-1.55,13770,14200,1400-10-26,2022-01-16
316,شراز,پالايش نفت شيراز,349,266351,30557123500,114950,115550,114850,-100,-0.09,114800,-150,-0.13,111100,118800,1400-10-26,2022-01-16
317,غچين,كشت‌ و صنعت‌ چين‌ چين,346,1564681,16872923670,11270,10990,10710,-560,-4.97,10780,-490,-4.35,10710,11350,1400-10-26,2022-01-16
318,كامياب,صندوق س. كامياب آشنا-د,345,6315379,71176775718,11264,11270,11271,7,0.06,11270,6,0.05,11270,11271,1400-10-26,2022-01-16
319,آ س پ,آ.س.پ,345,2649968,13598854230,5260,5000,5160,-100,-1.9,5140,-120,-2.28,5000,5370,1400-10-26,2022-01-16
320,وشهر,بانك شهر,343,3877270,15743157896,4048,4060,4060,12,0.3,4056,8,0.2,4010,4119,1400-10-26,2022-01-16
321,وسگيلا,شركت س استان گيلان,342,24717462,10382661974,431,413,416,-15,-3.48,426,-5,-1.16,412,425,1400-10-26,2022-01-16
322,لازما,كارخانه هاي صنعتي آزمايش,340,941466,21855052250,23550,23500,22850,-700,-2.97,23200,-350,-1.49,22850,24200,1400-10-26,2022-01-16
323,فپنتا,سپنتا,339,20619,9959118480,495400,492000,479900,-15500,-3.13,487060,-8340,-1.68,476000,492000,1400-10-26,2022-01-16
324,كروي,توسعه‌ معادن‌ روي‌ ايران‌,338,769015,16402521590,22030,21270,21620,-410,-1.86,21470,-560,-2.54,20940,21690,1400-10-26,2022-01-16
325,واتي,سرمايه‌ گذاري‌ آتيه‌ دماوند,337,5364696,45895586480,8930,9110,8690,-240,-2.69,8560,-370,-4.14,8490,9110,1400-10-26,2022-01-16
326,خفنر,فنرسازي‌خاور,335,2149765,13341851330,6480,6190,6160,-320,-4.94,6210,-270,-4.17,6160,6380,1400-10-26,2022-01-16
327,سپر,صندوق س سپر سرمايه بيدار- ثابت,334,12440950,168995226236,13578,13585,13585,7,0.05,13584,6,0.04,13581,13590,1400-10-26,2022-01-16
328,سبهان,سيمان‌ بهبهان‌,331,144679,6038079030,41150,41500,42140,990,2.41,41380,230,0.56,41000,42500,1400-10-26,2022-01-16
329,وصنعت,سرمايه گذاري توسعه صنعت وتجارت,330,1942944,12445482210,6580,6410,6390,-190,-2.89,6440,-140,-2.13,6380,6460,1400-10-26,2022-01-16
330,فلامي,لاميران‌,329,574907,9704998660,16790,17090,16990,200,1.19,16850,60,0.36,16000,17390,1400-10-26,2022-01-16
331,ريشمك,توليد و صادرات ريشمك,328,835397,23137157400,29100,27650,28000,-1100,-3.78,27700,-1400,-4.81,27650,28800,1400-10-26,2022-01-16
332,تسه0001,امتيازتسهيلات مسكن فروردين1400,327,5145,6364173023,1262324,1242500,1199208,-63116,-5,1236963,-25361,-2.01,1199208,1260000,1400-10-26,2022-01-16
333,فافق,صنايع مس افق كرمان,319,4468298,13823369966,3137,3140,3109,-28,-0.89,3094,-43,-1.37,3043,3189,1400-10-26,2022-01-16
334,وكار,بانك‌ كارآفرين‌,316,3413882,7545466377,2295,2234,2210,-85,-3.7,2277,-18,-0.78,2196,2260,1400-10-26,2022-01-16
335,وخاور,بانك خاورميانه,315,8101552,40316195292,4971,4880,5000,29,0.58,4975,4,0.08,4880,5030,1400-10-26,2022-01-16
336,ضخود2016,اختيارخ خودرو-1600-1401/02/07,315,13547,7551698000,572,635,582,10,1.75,557,-15,-2.62,536,635,1400-10-26,2022-01-16
337,وساخت,سرمايه‌ گذاري‌ ساختمان‌ايران‌,314,380259,12415350580,34110,33000,32410,-1700,-4.98,32870,-1240,-3.64,32410,33600,1400-10-26,2022-01-16
338,تسه9912,امتياز تسهيلات مسكن اسفند99,314,4650,5761341461,1255864,1240000,1194000,-61864,-4.93,1238998,-16866,-1.34,1193071,1300000,1400-10-26,2022-01-16
339,كحافظ,كاشي‌ وسراميك‌ حافظ‌,313,2368510,8855079645,3697,3550,3780,83,2.25,3722,25,0.68,3515,3881,1400-10-26,2022-01-16
340,فسازانح,ح . غلتك سازان سپاهان,311,2014154,4564858623,2293,2328,2297,4,0.17,2266,-27,-1.18,2150,2328,1400-10-26,2022-01-16
341,ميدكو,توسعه معادن وص.معدني خاورميانه,311,3218836,147868631350,46000,46000,45950,-50,-0.11,45940,-60,-0.13,45100,46000,1400-10-26,2022-01-16
342,ودي,بيمه  دي,309,2659662,10880249985,4174,4180,4165,-9,-0.22,4112,-62,-1.49,4000,4180,1400-10-26,2022-01-16
343,غگلپا,شير پاستوريزه پگاه گلپايگان,308,367186,21564053650,56950,56500,58200,1250,2.19,58750,1800,3.16,55600,59750,1400-10-26,2022-01-16
344,ضسپا1114,اختيارخ خساپا-2000-1400/11/20,308,14939,387269000,28,30,27,-1,-3.57,26,-2,-7.14,22,30,1400-10-26,2022-01-16
345,رانفور,خدمات‌انفورماتيك‌,304,5935961,20359815764,3478,3480,3467,-11,-0.32,3458,-20,-0.58,3350,3500,1400-10-26,2022-01-16
346,آكورد,صندوق س. آرمان آتي كوثر-د,304,5855635,212671367319,36301,36318,36319,18,0.05,36319,18,0.05,36318,36324,1400-10-26,2022-01-16
347,وآرين,شركت توسعه اقتصادي آرين,303,6195044,11722556728,1838,1889,1893,55,2.99,1892,54,2.94,1852,1893,1400-10-26,2022-01-16
348,سخزر,سيمان‌ خزر,303,427014,6717725200,16310,15650,15530,-780,-4.78,16040,-270,-1.66,15500,16280,1400-10-26,2022-01-16
349,ورازي,بيمه رازي,301,12521645,14413451908,1186,1151,1151,-35,-2.95,1151,-35,-2.95,1151,1180,1400-10-26,2022-01-16
350,فزرين,زرين معدن آسيا,300,1367422,14296023590,10510,10250,10560,50,0.48,10460,-50,-0.48,10200,10740,1400-10-26,2022-01-16
351,زكشت,كشاورزي مكانيزه اصفهان كشت,299,932184,15635266170,17640,17100,16760,-880,-4.99,16770,-870,-4.93,16760,17480,1400-10-26,2022-01-16
352,خشرق,الكتريك‌ خودرو شرق‌,298,908528,9762484850,10940,10600,10700,-240,-2.19,10800,-140,-1.28,10410,10940,1400-10-26,2022-01-16
353,جوين,كشت و صنعت جوين,296,6605728,16113247811,2397,2445,2468,71,2.96,2439,42,1.75,2331,2468,1400-10-26,2022-01-16
354,حآسا,آسيا سير ارس,295,706365,8418376770,12130,12470,11810,-320,-2.64,12010,-120,-0.99,11720,12470,1400-10-26,2022-01-16
355,وتوكا,سرمايه‌گذاري‌توكافولاد(هلدينگ,295,2281656,14949913510,6640,6660,6580,-60,-0.9,6550,-90,-1.36,6370,6730,1400-10-26,2022-01-16
356,قشكر,شكرشاهرود,291,8072384,16978976363,2178,2178,2087,-91,-4.18,2103,-75,-3.44,2072,2186,1400-10-26,2022-01-16
357,پخش,پخش البرز,288,899477,21858228900,24500,24100,24750,250,1.02,24300,-200,-0.82,23300,25000,1400-10-26,2022-01-16
358,بساما,بيمه سامان,287,851865,18058518570,20420,21390,21440,1020,5,21200,780,3.82,19900,21440,1400-10-26,2022-01-16
359,فوكا,فولاد كاويان,287,1560000,20244546780,13330,12950,13100,-230,-1.73,13100,-230,-1.73,12940,13180,1400-10-26,2022-01-16
360,كهمدا,شيشه‌ همدان‌,286,2233265,21287938210,9810,9570,9500,-310,-3.16,9530,-280,-2.85,9370,9790,1400-10-26,2022-01-16
361,ثاباد,توريستي ورفاهي آبادگران ايران,286,338709,12920785360,39990,39110,38000,-1990,-4.98,38320,-1670,-4.18,38000,39130,1400-10-26,2022-01-16
362,قلرست,قند لرستان‌,286,1831018,28934496690,15180,14600,15930,750,4.94,15800,620,4.08,14580,15930,1400-10-26,2022-01-16
363,ثرود,سرمايه‌گذاري مسكن زاينده رود,284,1570888,8048033800,5370,5180,5120,-250,-4.66,5230,-140,-2.61,5110,5300,1400-10-26,2022-01-16
364,بكهنوج,توليد برق ماهتاب كهنوج,284,6735370,6877688524,1056,1020,1026,-30,-2.84,1040,-16,-1.52,1007,1049,1400-10-26,2022-01-16
365,شوينده,مديريت صنعت شوينده ت.ص.بهشهر,284,1423785,24584311820,17720,17500,17340,-380,-2.14,17270,-450,-2.54,17020,17500,1400-10-26,2022-01-16
366,شكام,صنايع شيميايي كيمياگران امروز,283,2024446,57158506850,28900,29950,29050,150,0.52,28250,-650,-2.25,27900,29950,1400-10-26,2022-01-16
367,تسه9911,امتياز تسهيلات مسكن بهمن99,282,4960,6089261451,1254677,1210120,1192000,-62677,-5,1227674,-27003,-2.15,1191944,1249990,1400-10-26,2022-01-16
368,زفكا,كشت و دامداري فكا,280,1705737,12135024020,7320,7590,7140,-180,-2.46,7150,-170,-2.32,7000,7590,1400-10-26,2022-01-16
369,خچرخش,چرخشگر,279,3067731,19649685960,6700,6470,6410,-290,-4.33,6410,-290,-4.33,6370,6720,1400-10-26,2022-01-16
370,شتوكاح,ح . توكا رنگ فولاد سپاهان,279,2018769,25502352850,12430,12690,12470,40,0.32,12630,200,1.61,11900,12980,1400-10-26,2022-01-16
371,خاهن,آهنگري‌ تراكتورسازي‌ ايران‌,277,1933398,7642141776,4129,3955,3947,-182,-4.41,4070,-59,-1.43,3923,4045,1400-10-26,2022-01-16
372,گكوثر,هتل پارسيان كوثر اصفهان,275,4257937,5716001143,1373,1344,1351,-22,-1.6,1361,-12,-0.87,1331,1370,1400-10-26,2022-01-16
373,ولملتح,ح . واسپاري ملت,272,5856520,5975321009,1053,1017,1030,-23,-2.18,1020,-33,-3.13,1000,1053,1400-10-26,2022-01-16
374,ضشنا2014,اختيارخ شپنا-5000-1401/02/25,271,7234,7901269000,1254,1112,1119,-135,-10.77,1092,-162,-12.92,1060,1175,1400-10-26,2022-01-16
375,شفا,سرمايه گذاري شفادارو,268,1127504,11880407750,11070,10680,10560,-510,-4.61,10620,-450,-4.07,10520,10780,1400-10-26,2022-01-16
376,ددام,داروسازي زاگرس فارمد پارس,268,893278,7070844280,8130,7900,8100,-30,-0.37,8020,-110,-1.35,7730,8150,1400-10-26,2022-01-16
377,فجام,جام‌دارو,267,2264726,8745796975,3978,3940,3939,-39,-0.98,3908,-70,-1.76,3780,3996,1400-10-26,2022-01-16
378,واحيا,م .صنايع و معادن احياء سپاهان,267,2398770,36280369430,15560,15140,15100,-460,-2.96,15230,-330,-2.12,15100,15770,1400-10-26,2022-01-16
379,دزهراوي,داروسازي‌زهراوي‌,265,1147579,4445527816,3994,3873,3863,-131,-3.28,3957,-37,-0.93,3823,3999,1400-10-26,2022-01-16
380,دعبيد,لابراتوارداروسازي‌  دكترعبيدي‌,265,821870,14546624270,18520,17600,17600,-920,-4.97,18150,-370,-2,17600,18000,1400-10-26,2022-01-16
381,اپرداز,آتيه داده پرداز,264,416935,7940203000,20000,19050,19250,-750,-3.75,19450,-550,-2.75,19000,20000,1400-10-26,2022-01-16
382,آريان,سرمايه گذاري پارس آريان,264,3797239,46295395680,12450,12150,12430,-20,-0.16,12330,-120,-0.96,12100,12440,1400-10-26,2022-01-16
383,چافست,افست‌,262,1867867,14583429670,8200,8000,7790,-410,-5,7810,-390,-4.76,7790,8100,1400-10-26,2022-01-16
384,ختراك,ريخته‌گري‌ تراكتورسازي‌ ايران‌,261,1425037,6571641946,4694,4600,4745,51,1.09,4656,-38,-0.81,4473,4745,1400-10-26,2022-01-16
385,ولشرق,ليزينگ ايران و شرق,261,3017361,6214750868,2112,2010,2090,-22,-1.04,2089,-23,-1.09,2007,2148,1400-10-26,2022-01-16
386,بميلا,توسعه بازرگاني آهن وفولادميلاد,259,2878773,25784040450,9220,8960,9050,-170,-1.84,8960,-260,-2.82,8950,9160,1400-10-26,2022-01-16
387,تسه9910,امتياز تسهيلات مسكن دي99,259,3442,4236158353,1254384,1210000,1233000,-21384,-1.7,1230726,-23658,-1.89,1191665,1297000,1400-10-26,2022-01-16
388,فنوال,نورد آلومينيوم‌,258,648730,15195214580,23480,23500,23500,20,0.09,23420,-60,-0.26,22530,23750,1400-10-26,2022-01-16
389,كيميا,معدني كيمياي زنجان گستران,257,738920,8544712860,12010,11720,11600,-410,-3.41,11740,-270,-2.25,11420,11760,1400-10-26,2022-01-16
390,غبهنوش,بهنوش‌ ايران‌,256,174009,9851296260,58710,57050,57900,-810,-1.38,57270,-1440,-2.45,55900,58950,1400-10-26,2022-01-16
391,چكاوه,صنايع‌كاغذسازي‌كاوه‌,255,2291982,17226478850,7900,7510,7600,-300,-3.8,7520,-380,-4.81,7510,7780,1400-10-26,2022-01-16
392,فن آواح,ح.گروه فن آوا,255,1499074,13727611650,9300,9300,9030,-270,-2.9,9160,-140,-1.51,9030,9300,1400-10-26,2022-01-16
393,وآوا,سرمايه گذاري آوا نوين,251,1826898,4337821785,2466,2363,2377,-89,-3.61,2438,-28,-1.14,2350,2400,1400-10-26,2022-01-16
394,شنفت,نفت‌ پارس‌,246,2752783,25207791930,9630,9150,9280,-350,-3.63,9440,-190,-1.97,9150,9350,1400-10-26,2022-01-16
395,فايرا,آلومينيوم‌ايران‌,245,1291936,22576264790,17750,17560,17640,-110,-0.62,17660,-90,-0.51,17130,17880,1400-10-26,2022-01-16
396,غاذر,كشت‌وصنعت‌پياذر,244,342539,12043736910,35060,35200,35100,40,0.11,35140,80,0.23,34210,35520,1400-10-26,2022-01-16
397,ضصاد1113,اختيارخ وبصادر-2000-1400/11/06,241,11122,445006000,46,25,40,-6,-13.04,40,-6,-13.04,25,60,1400-10-26,2022-01-16
398,مدير,ص.س.مديريت ثروت ص.بازنشستگي-س,240,762059,6599250041,8725,8650,8749,24,0.28,8660,-65,-0.74,8603,8749,1400-10-26,2022-01-16
399,سصوفي,سيمان‌ صوفيان‌,239,736513,10140729910,14180,13570,13740,-440,-3.1,13890,-290,-2.05,13510,14100,1400-10-26,2022-01-16
400,فمراد,آلومراد,239,452614,5364984930,12220,11820,12000,-220,-1.8,12090,-130,-1.06,11630,12350,1400-10-26,2022-01-16
401,وسكاب,س.ص.بازنشستگي كاركنان بانكها,238,3336637,9482025318,2864,2841,2878,14,0.49,2850,-14,-0.49,2821,2880,1400-10-26,2022-01-16
402,ثمسكن,سرمايه‌گذاري‌ مسكن‌,237,2470511,7874238298,3338,3330,3235,-103,-3.09,3255,-83,-2.49,3172,3382,1400-10-26,2022-01-16
403,ومعلم,بيمه معلم,236,2973559,5521315195,1842,1841,1845,3,0.16,1847,5,0.27,1811,1895,1400-10-26,2022-01-16
404,تسه9909,امتياز تسهيلات مسكن آذر99,236,2841,3501698347,1254485,1200001,1249700,-4785,-0.38,1232558,-21927,-1.75,1200001,1269973,1400-10-26,2022-01-16
405,شپارس,بين‌ المللي‌ محصولات‌  پارس‌,236,1481305,10155855850,7150,6840,7000,-150,-2.1,6940,-210,-2.94,6800,7020,1400-10-26,2022-01-16
406,سبجنو,سيمان‌ بجنورد,235,526656,19381106230,36760,36580,36910,150,0.41,36800,40,0.11,35600,38500,1400-10-26,2022-01-16
407,تپولا,مهندسي مرآت پولاد,234,1116634,14103816740,13020,12630,12630,-390,-3,12630,-390,-3,12630,12970,1400-10-26,2022-01-16
408,گوهر,صندوق سكه طلاي كيان,233,592344,34947051916,58666,58311,59330,664,1.13,58998,332,0.57,58311,59879,1400-10-26,2022-01-16
409,بخاور,بيمه زندگي خاورميانه,233,1610691,3800905610,2275,2388,2372,97,4.26,2295,20,0.88,2320,2388,1400-10-26,2022-01-16
410,ساينا,صنايع بهداشتي ساينا,233,99411,8888796950,93700,93700,89050,-4650,-4.96,91050,-2650,-2.83,89050,93700,1400-10-26,2022-01-16
411,غالبر,لبنيات‌ كالبر,231,710474,7064395440,10040,10130,10030,-10,-0.1,9990,-50,-0.5,9860,10130,1400-10-26,2022-01-16
412,شدوصح,ح . دوده‌ صنعتي‌ پارس‌,230,1247702,8559469940,6890,6830,6900,10,0.15,6860,-30,-0.44,6700,6990,1400-10-26,2022-01-16
413,زماهان,مجتمع توليد گوشت مرغ ماهان,229,1476638,9484835650,6610,6380,6400,-210,-3.18,6490,-120,-1.82,6350,6600,1400-10-26,2022-01-16
414,شپاكسا,پاكسان‌,229,517284,9746276910,19320,18960,18830,-490,-2.54,19000,-320,-1.66,18550,19200,1400-10-26,2022-01-16
415,ارزش,صندوق س ارزش آفرين بيدار-سهام,229,1349147,11805969230,8810,8760,8830,20,0.23,8750,-60,-0.68,8690,8830,1400-10-26,2022-01-16
416,تمحركه,ماشين سازي نيرو محركه,228,464772,7163200410,15680,15260,15210,-470,-3,15480,-200,-1.28,15210,15990,1400-10-26,2022-01-16
417,سپاها,سيمان‌سپاهان‌,227,1883041,13186174470,7140,7000,6980,-160,-2.24,7010,-130,-1.82,6950,7100,1400-10-26,2022-01-16
418,تسه9903,امتياز تسهيلات مسكن خرداد99,226,2643,3209617804,1245260,1183000,1182997,-62263,-5,1214384,-30876,-2.48,1182997,1250000,1400-10-26,2022-01-16
419,آساميد,صندوق س.مشترك آسمان اميد -د,225,5006014,69461168290,13867,13875,13877,10,0.07,13876,9,0.06,13874,13877,1400-10-26,2022-01-16
420,جم پيلن,پلي پروپيلن جم - جم پيلن,225,201622,23667670390,118010,115620,118300,290,0.25,117850,-160,-0.14,115620,119150,1400-10-26,2022-01-16
421,فسازان,غلتك سازان سپاهان,225,930424,3805892687,4173,4040,4150,-23,-0.55,4152,-21,-0.5,4040,4158,1400-10-26,2022-01-16
422,ضخود2015,اختيارخ خودرو-1400-1401/02/07,224,6002,4159540000,701,710,725,24,3.42,693,-8,-1.14,660,730,1400-10-26,2022-01-16
423,وسپه,سرمايه‌گذاري‌ سپه‌,223,1330164,10321331600,7950,7710,7800,-150,-1.89,7900,-50,-0.63,7690,7820,1400-10-26,2022-01-16
424,چفيبر,فيبر ايران‌,223,1005740,6544412150,6800,6590,6660,-140,-2.06,6660,-140,-2.06,6460,6660,1400-10-26,2022-01-16
425,كاردان,صندوق س تجارت شاخصي كاردان,220,36154,6320404270,175090,174000,176500,1410,0.81,174820,-270,-0.15,173220,177980,1400-10-26,2022-01-16
426,ضخود2020,اختيارخ خودرو-3000-1401/02/07,219,11043,791832000,73,80,72,-1,-1.37,72,-1,-1.37,68,81,1400-10-26,2022-01-16
427,وساشرقي,شركت س استان آذربايجان شرقي,218,11130243,4653014082,434,416,420,-14,-3.23,432,-2,-0.46,414,420,1400-10-26,2022-01-16
428,شخارك,پتروشيمي‌ خارك‌,217,366235,17611977490,49130,49050,47810,-1320,-2.69,48940,-190,-0.39,47810,49050,1400-10-26,2022-01-16
429,شرانل,نفت ايرانول,217,243697,10684034550,44300,43100,44800,500,1.13,44150,-150,-0.34,43050,45500,1400-10-26,2022-01-16
430,بنو,بيمه تجارت نو,216,2459264,14557189400,6120,6130,5820,-300,-4.9,5920,-200,-3.27,5820,6130,1400-10-26,2022-01-16
431,دكوثر,داروسازي‌ كوثر,216,4885589,11861495680,2553,2430,2482,-71,-2.78,2448,-105,-4.11,2426,2489,1400-10-26,2022-01-16
432,وگستر,گسترش سرمايه گذاري ايرانيان,215,904400,4260828903,4805,4770,4762,-43,-0.89,4778,-27,-0.56,4590,4770,1400-10-26,2022-01-16
433,تسه9904,امتياز تسهيلات مسكن تير99,214,2385,2902928240,1250879,1188336,1188336,-62543,-5,1217161,-33718,-2.7,1188336,1250000,1400-10-26,2022-01-16
434,وصندوقح,ح.سرمايه گذاري صندوق بازنشستگي,214,3072430,29229225210,9640,9550,9650,10,0.1,9510,-130,-1.35,9450,9730,1400-10-26,2022-01-16
435,ساروم,سيمان‌اروميه‌,213,378162,13702903370,36940,36140,36940,0,0,36270,-670,-1.81,35500,37070,1400-10-26,2022-01-16
436,ولشرقح,ح . ليزينگ ايران و شرق,211,6929708,3888450681,589,561,560,-29,-4.92,561,-28,-4.75,560,572,1400-10-26,2022-01-16
437,غپآذر,شير پگاه آذربايجان شرقي,211,1114460,35718430500,30550,32050,32050,1500,4.91,32050,1500,4.91,32000,32050,1400-10-26,2022-01-16
438,ثباغ,شهر سازي و خانه سازي باغميشه,211,1118566,8272968900,7370,7250,7430,60,0.81,7380,10,0.14,7120,7650,1400-10-26,2022-01-16
439,كسرام,پارس‌ سرام‌,210,1604007,6494418678,4222,4048,4100,-122,-2.89,4141,-81,-1.92,4015,4230,1400-10-26,2022-01-16
440,وتوصا,گروه س توسعه صنعتي ايران,209,1088150,10928768650,10100,9840,10100,0,0,10060,-40,-0.4,9840,10300,1400-10-26,2022-01-16
441,وپترو,سرمايه‌گذاري صنايع پتروشيمي‌,209,636337,6439071700,10420,10390,10340,-80,-0.77,10290,-130,-1.25,10000,10390,1400-10-26,2022-01-16
442,دتماد,توليدمواداوليه‌داروپخش‌,208,219646,8465923680,39000,38760,38990,-10,-0.03,38740,-260,-0.67,38030,39460,1400-10-26,2022-01-16
443,قزوين,كارخانجات‌ قند قزوين‌,207,6604837,28387589426,4524,4298,4298,-226,-5,4298,-226,-5,4298,4298,1400-10-26,2022-01-16
444,قنقش,قند نقش جهان,204,144528,20205844750,137750,135150,139800,2050,1.49,139800,2050,1.49,135100,140500,1400-10-26,2022-01-16
445,ضخود2017,اختيارخ خودرو-1800-1401/02/07,203,11267,5180748000,472,450,480,8,1.69,460,-12,-2.54,440,485,1400-10-26,2022-01-16
446,قهكمت,قندهكمتان‌,202,1248995,5547249640,4636,4620,4430,-206,-4.44,4561,-75,-1.62,4405,4620,1400-10-26,2022-01-16
447,غمهرا,توليدي‌مهرام‌,199,940307,7829627800,8730,8510,8480,-250,-2.86,8500,-230,-2.63,8300,8510,1400-10-26,2022-01-16
448,دجابر,داروسازي‌ جابرابن‌حيان‌,193,741321,7334032690,10160,9800,9910,-250,-2.46,10020,-140,-1.38,9660,10260,1400-10-26,2022-01-16
449,تسه9812,امتياز تسهيلات مسكن اسفند98,193,3198,3931314554,1250175,1188000,1196373,-53802,-4.3,1229304,-20871,-1.67,1188000,1249890,1400-10-26,2022-01-16
450,شدوص,دوده‌ صنعتي‌ پارس‌,192,1304420,14698082150,11660,11100,11350,-310,-2.66,11270,-390,-3.34,11090,11580,1400-10-26,2022-01-16
451,ولراز,ليزينگ رازي,192,304827,5249993650,17680,17880,17170,-510,-2.88,17220,-460,-2.6,17150,17880,1400-10-26,2022-01-16
452,پكوير,كوير تاير,191,744136,3688875720,5100,5030,5090,-10,-0.2,5060,-40,-0.78,4870,5100,1400-10-26,2022-01-16
453,بزاگرس,نيروگاه زاگرس كوثر,191,1613752,4836922977,3107,3030,3008,-99,-3.19,3070,-37,-1.19,2952,3030,1400-10-26,2022-01-16
454,تسه9907,امتياز تسهيلات مسكن مهر99,190,1974,2422459042,1252880,1197581,1190236,-62644,-5,1227183,-25697,-2.05,1190236,1280000,1400-10-26,2022-01-16
455,پاسا,ايران‌ياساتايرورابر,189,530951,6995494660,13180,12890,13180,0,0,13180,0,0,12890,13500,1400-10-26,2022-01-16
456,ومشان,س. فني و مهندسي مشانير,189,116200,4923615750,42000,41450,43250,1250,2.98,42350,350,0.83,40750,43250,1400-10-26,2022-01-16
457,وجامي,سرمايه گذاري جامي,188,901834,3219054957,3679,3569,3569,-110,-2.99,3637,-42,-1.14,3569,3588,1400-10-26,2022-01-16
458,ثشرق,سرمايه گذاري مسكن شمال شرق,186,4072269,12657672121,3257,3170,3100,-157,-4.82,3125,-132,-4.05,3095,3294,1400-10-26,2022-01-16
459,تسه9906,امتياز تسهيلات مسكن شهريور99,186,3250,3992307597,1256054,1193252,1200000,-56054,-4.46,1228402,-27652,-2.2,1193252,1309999,1400-10-26,2022-01-16
460,ولملت,واسپاري ملت,185,2385796,6227927693,2736,2623,2600,-136,-4.97,2679,-57,-2.08,2600,2700,1400-10-26,2022-01-16
461,خپويش,سازه‌ پويش‌,185,114455,8211933650,72180,68710,73670,1490,2.06,71940,-240,-0.33,68600,74400,1400-10-26,2022-01-16
462,اخزا002,اسنادخزانه-م2بودجه00-031024,185,400309,207739078640,516230,517340,519150,2920,0.57,518950,2720,0.53,517330,520890,1400-10-26,2022-01-16
463,ولغدر,ليزينگ‌خودروغدير,183,1228223,9872636820,8450,8030,8030,-420,-4.97,8160,-290,-3.43,8030,8140,1400-10-26,2022-01-16
464,زشگزا,شير و گوشت زاگرس شهركرد,182,697328,3402016232,4925,4718,4920,-5,-0.1,4915,-10,-0.2,4718,4979,1400-10-26,2022-01-16
465,وصندوق,سرمايه‌گذاري‌صندوق‌بازنشستگي‌,182,1160599,13034840810,11460,11390,11250,-210,-1.83,11430,-30,-0.26,11050,11390,1400-10-26,2022-01-16
466,آوا,صندوق س.سهام آواي معيار-س,182,490160,3716501105,7631,7686,7622,-9,-0.12,7582,-49,-0.64,7498,7686,1400-10-26,2022-01-16
467,كنور,توسعه معدني و صنعتي صبانور,181,270966,4874857060,18670,17960,18050,-620,-3.32,18630,-40,-0.21,17900,18260,1400-10-26,2022-01-16
468,اخزا001,اسنادخزانه-م1بودجه00-030821,181,418753,225600652760,536600,536300,540000,3400,0.63,538740,2140,0.4,536300,540000,1400-10-26,2022-01-16
469,ولصنم,ليزينگ‌صنعت‌ومعدن‌,181,966382,3302995023,3473,3500,3387,-86,-2.48,3461,-12,-0.35,3333,3568,1400-10-26,2022-01-16
470,وتوسم,سرمايه‌گذاري‌توسعه‌ملي‌,180,1267337,10634194120,8520,8530,8390,-130,-1.53,8430,-90,-1.06,8250,8580,1400-10-26,2022-01-16
471,دلر,داروسازي‌ اكسير,179,324230,12948042610,39820,39860,39980,160,0.4,39900,80,0.2,39420,40370,1400-10-26,2022-01-16
472,نوين,بيمه نوين,179,1809820,6333995896,3551,3551,3567,16,0.45,3529,-22,-0.62,3450,3605,1400-10-26,2022-01-16
473,ولبهمن,شركت بهمن ليزينگ,179,2247237,13922312100,6260,6270,6140,-120,-1.92,6200,-60,-0.96,6100,6390,1400-10-26,2022-01-16
474,لسرما,سرما آفرين‌,178,352453,7117673760,20130,20390,20310,180,0.89,20160,30,0.15,19790,20470,1400-10-26,2022-01-16
475,غشاذر,پگاه‌آذربايجان‌غربي‌,178,1230538,5536747063,4675,4670,4442,-233,-4.98,4607,-68,-1.45,4442,4675,1400-10-26,2022-01-16
476,سخواف,سيمان مجد خواف,178,1511829,11248007760,7230,7440,7440,210,2.9,7440,210,2.9,7440,7440,1400-10-26,2022-01-16
477,وحكمت,بيمه حكمت صبا,177,3483167,10409308382,3070,3157,2978,-92,-3,2988,-82,-2.67,2978,3160,1400-10-26,2022-01-16
478,ثعمرا,عمران و توسعه شاهد,176,850430,5525638420,6660,6620,6550,-110,-1.65,6600,-60,-0.9,6390,6630,1400-10-26,2022-01-16
479,پكويرح,ح. كوير تاير,176,1437796,3827287397,2718,2715,2700,-18,-0.66,2662,-56,-2.06,2601,2715,1400-10-26,2022-01-16
480,كوثر,بيمه كوثر,176,986013,3589592813,3740,3737,3611,-129,-3.45,3725,-15,-0.4,3590,3737,1400-10-26,2022-01-16
481,تسه9901,امتياز تسهيلات مسكن فروردين99,176,2355,2907506338,1264711,1202222,1206420,-58291,-4.61,1234610,-30101,-2.38,1201476,1249900,1400-10-26,2022-01-16
482,زگلدشت,كشت و دام گلدشت نمونه اصفهان,175,732474,6234257080,8820,8420,8680,-140,-1.59,8680,-140,-1.59,8420,8690,1400-10-26,2022-01-16
483,كلوند,كاشي‌ الوند,174,294424,6193734230,21500,20730,21410,-90,-0.42,21300,-200,-0.93,20730,21410,1400-10-26,2022-01-16
484,قصفها,قنداصفهان‌,174,57777,4110087500,73110,70000,72470,-640,-0.88,72550,-560,-0.77,70000,72900,1400-10-26,2022-01-16
485,كپرور,فرآوري زغال سنگ پروده طبس,173,259792,7625618500,30100,29900,29100,-1000,-3.32,29700,-400,-1.33,28600,30300,1400-10-26,2022-01-16
486,ميهن,بيمه ميهن,173,3553769,8040284163,2307,2226,2254,-53,-2.3,2283,-24,-1.04,2210,2344,1400-10-26,2022-01-16
487,رنيك,جنرال مكانيك,171,319989,3266327930,10510,10150,10300,-210,-2,10440,-70,-0.67,10100,10390,1400-10-26,2022-01-16
488,حپارسا,توسعه حمل و نقل ريلي پارسيان,170,390993,11119271450,28500,27700,28300,-200,-0.7,28450,-50,-0.18,27700,28800,1400-10-26,2022-01-16
489,حپترو,حمل و نقل پتروشيمي( سهامي عام,170,345048,6636614780,20140,19330,19140,-1000,-4.97,19720,-420,-2.09,19140,19980,1400-10-26,2022-01-16
490,خاتم,صندوق س خاتم ايساتيس پويا-ثابت,170,6048016,76573017535,12654,12660,12660,6,0.05,12661,7,0.06,12660,12661,1400-10-26,2022-01-16
491,كساپا,سايپاشيشه‌,169,522113,6851930160,13800,13130,13110,-690,-5,13460,-340,-2.46,13110,13600,1400-10-26,2022-01-16
492,بكاب,صنايع‌جوشكاب‌يزد,169,104387,6759058250,68150,64750,64750,-3400,-4.99,66450,-1700,-2.49,64750,64750,1400-10-26,2022-01-16
493,وسين,بيمه سينا,168,4235424,13651515150,3322,3223,3223,-99,-2.98,3223,-99,-2.98,3223,3298,1400-10-26,2022-01-16
494,بسويچ,پارس‌سويچ‌,168,410343,5274758860,13490,12840,12890,-600,-4.45,13250,-240,-1.78,12820,13800,1400-10-26,2022-01-16
495,غمينو,شركت صنايع غذايي مينو شرق,168,1093303,4248845783,3983,3899,3940,-43,-1.08,3955,-28,-0.7,3821,4030,1400-10-26,2022-01-16
496,اعتلا,شركت سرمايه گذاري اعتلاء البرز,166,1462231,5023236190,3475,3371,3510,35,1.01,3461,-14,-0.4,3362,3518,1400-10-26,2022-01-16
497,سدور,سيمان‌ دورود,165,851195,4171965290,5040,4840,4980,-60,-1.19,5000,-40,-0.79,4820,5050,1400-10-26,2022-01-16
498,سمازن,سيمان‌مازندران‌,164,438734,6040109860,13830,13780,13890,60,0.43,13800,-30,-0.22,13700,13940,1400-10-26,2022-01-16
499,سپيدما,صندوق س. سپيد دماوند-د,164,6067061,70986553178,11694,11700,11700,6,0.05,11700,6,0.05,11700,11701,1400-10-26,2022-01-16
500,وتوس,توسعه‌شهري‌توس‌گستر,164,347915,2323630260,6930,6670,6700,-230,-3.32,6890,-40,-0.58,6600,6900,1400-10-26,2022-01-16
501,صنوين,صندوق سرمايه‌گذاري صنوين-مختلط,164,39698,4466299310,113130,113070,112750,-380,-0.34,112510,-620,-0.55,111200,114300,1400-10-26,2022-01-16
502,درهآور,دارويي ره آورد تامين,163,223205,4520636600,20450,20150,20200,-250,-1.22,20400,-50,-0.24,20000,20550,1400-10-26,2022-01-16
503,پلاست,كارخانجات توليدي پلاستيران,162,678360,4502533770,6690,6500,6610,-80,-1.2,6670,-20,-0.3,6490,6780,1400-10-26,2022-01-16
504,دسبحان,سبحان دارو,161,570409,4718748630,8690,8280,8410,-280,-3.22,8550,-140,-1.61,8260,8410,1400-10-26,2022-01-16
505,وسبحان,سرمايه گذاري سبحان,161,5856272,12835403242,2221,2183,2222,1,0.05,2196,-25,-1.13,2182,2222,1400-10-26,2022-01-16
506,اهرم,صندوق س سهامي كاريزما- اهرمي,159,491353,4737509230,9730,9700,9660,-70,-0.72,9640,-90,-0.92,9620,9710,1400-10-26,2022-01-16
507,تسه9905,امتياز تسهيلات مسكن مرداد99,159,2404,3032071232,1268308,1204893,1220000,-48308,-3.81,1261261,-7047,-0.56,1204893,1331722,1400-10-26,2022-01-16
508,گوهران,سرمايه گذاري توسعه گوهران اميد,158,719810,3538215928,4972,4972,4928,-44,-0.88,4959,-13,-0.26,4884,4984,1400-10-26,2022-01-16
509,شاملا,معدني‌ املاح‌  ايران‌,158,751222,8282926530,11430,10960,11240,-190,-1.66,11200,-230,-2.01,10860,11240,1400-10-26,2022-01-16
510,دكيمي,كيميدارو,158,343250,5480489560,16480,16060,15990,-490,-2.97,16280,-200,-1.21,15660,16480,1400-10-26,2022-01-16
511,ضسپا1112,اختيارخ خساپا-1600-1400/11/20,158,5291,787152000,161,187,162,1,0.62,149,-12,-7.45,135,187,1400-10-26,2022-01-16
512,وپسا,س. پتروشيمي ساختمان  خليج فارس,158,4591473,6715258282,1481,1439,1458,-23,-1.55,1468,-13,-0.88,1438,1492,1400-10-26,2022-01-16
513,تسه9811,امتياز تسهيلات مسكن بهمن98,157,2647,3248199692,1233695,1173011,1183340,-50355,-4.08,1227125,-6570,-0.53,1173011,1247970,1400-10-26,2022-01-16
514,نمرينو,ايران‌ مرينوس‌,157,69771,4823587310,72390,70130,68780,-3610,-4.99,71290,-1100,-1.52,68780,70500,1400-10-26,2022-01-16
515,وملل,اعتباري ملل,156,775788,7287733110,9540,9090,9470,-70,-0.73,9510,-30,-0.31,9090,9590,1400-10-26,2022-01-16
516,غفارس,شير پاستوريزه پگاه فارس,156,841392,4033236739,4938,4757,4785,-153,-3.1,4898,-40,-0.81,4757,4930,1400-10-26,2022-01-16
517,وثخوز,سرمايه گذاري و توسعه خوزستان,155,370944,11369075650,29800,30650,30650,850,2.85,30650,850,2.85,30300,30650,1400-10-26,2022-01-16
518,پلاسك,پلاسكوكار,155,1135233,4562133755,4188,4006,4022,-166,-3.96,4134,-54,-1.29,3979,4177,1400-10-26,2022-01-16
519,مفاخر,توسعه فناوري اطلاعات خوارزمي,154,283414,7437242350,26650,25650,25350,-1300,-4.88,26450,-200,-0.75,25350,27350,1400-10-26,2022-01-16
520,تپكو,توليدتجهيزات‌سنگين‌هپكو,152,4488176,10556189952,2424,2352,2352,-72,-2.97,2386,-38,-1.57,2352,2352,1400-10-26,2022-01-16
521,دفارا,داروسازي‌ فارابي‌,151,395382,4625059330,12280,11690,11780,-500,-4.07,12090,-190,-1.55,11670,12000,1400-10-26,2022-01-16
522,لابسا,آبسال‌,150,205127,6343266120,31190,30010,31180,-10,-0.03,31080,-110,-0.35,30010,31800,1400-10-26,2022-01-16
523,زمگسا,كشاورزي‌ ودامپروي‌ مگسال‌,150,251087,4385988820,18240,17330,17600,-640,-3.51,18000,-240,-1.32,17330,17930,1400-10-26,2022-01-16
524,وسنا,سرمايه گذاري نيروگاهي ايران,149,799814,6468738480,8280,8110,8190,-90,-1.09,8170,-110,-1.33,8040,8480,1400-10-26,2022-01-16
525,واحصا,احياء صنايع خراسان,147,134329,4364476600,31600,32500,32500,900,2.85,32000,400,1.27,31900,32500,1400-10-26,2022-01-16
526,سپ,پرداخت الكترونيك سامان كيش,146,173928,5428862110,31760,30350,31530,-230,-0.72,31710,-50,-0.16,30350,31560,1400-10-26,2022-01-16
527,زر,صندوق س.پشتوانه سكه طلاي زر,146,204532,10547317907,50927,51700,51599,672,1.32,51568,641,1.26,51280,51700,1400-10-26,2022-01-16
528,ساراب,سيمان‌ داراب‌,146,1504316,25179831400,16510,16000,16880,370,2.24,16740,230,1.39,15800,16880,1400-10-26,2022-01-16
529,شاملاح,ح . معدني‌ املاح‌  ايران‌,146,691943,4595119830,6840,6750,6670,-170,-2.49,6640,-200,-2.92,6580,6890,1400-10-26,2022-01-16
530,زعف0110پ19,زعفران0110نگين تروند قاينات(پ),145,64886,23104873518,363292,353012,350000,-13292,-3.66,356084,-7208,-1.98,346231,360500,1400-10-26,2022-01-16
531,كگاز,شيشه‌ و گاز,145,521210,7300446450,14360,14500,14010,-350,-2.44,14180,-180,-1.25,13680,14690,1400-10-26,2022-01-16
532,ثپرديس,سرمايه گذاري مسكن پرديس,144,2035048,6995861708,3617,3543,3437,-180,-4.98,3529,-88,-2.43,3437,3543,1400-10-26,2022-01-16
533,دروز,داروسازي‌ روزدارو,144,192679,5676244900,29780,30700,29940,160,0.54,29660,-120,-0.4,28540,30700,1400-10-26,2022-01-16
534,شرنگي,شيميايي رنگين,143,79774,18340042600,223250,229900,229900,6650,2.98,229900,6650,2.98,229900,229900,1400-10-26,2022-01-16
535,پلوله,گازلوله‌,143,427660,9228977150,22650,21550,21600,-1050,-4.64,21600,-1050,-4.64,21550,22750,1400-10-26,2022-01-16
536,فردا2,صندوق س آواي فرداي زاگرس-ثابت,143,14300000,14300000,12209,1,1,-12208,-99.99,1,-12208,-99.99,1,1,1400-10-26,2022-01-16
537,پارسيان,بيمه پارسيان,143,789357,6515400930,8260,8290,8270,10,0.12,8260,0,0,8200,8300,1400-10-26,2022-01-16
538,دپارس,پارس‌ دارو,143,127523,3548073220,28470,27380,28730,260,0.91,28310,-160,-0.56,27210,28750,1400-10-26,2022-01-16
539,سغرب,سيمان‌غرب‌,142,273928,3829557420,14030,14400,14390,360,2.57,14020,-10,-0.07,13650,14400,1400-10-26,2022-01-16
540,غشهد,شهد ايران ‌,140,706504,2917266630,4331,4120,4126,-205,-4.73,4289,-42,-0.97,4115,4194,1400-10-26,2022-01-16
541,آبين,كشت و صنعت آبشيرين,139,4014867,6168758392,1583,1560,1536,-47,-2.97,1553,-30,-1.9,1536,1560,1400-10-26,2022-01-16
542,حخزر,كشتيراني درياي خزر,139,676760,9498789350,14760,14210,14030,-730,-4.95,14270,-490,-3.32,14030,14430,1400-10-26,2022-01-16
543,پلاستح,ح.كارخانجات توليدي پلاستيران,138,1734466,5290454072,3009,2975,3099,90,2.99,3050,41,1.36,2970,3099,1400-10-26,2022-01-16
544,پاكشو,گروه صنعتي پاكشو,138,790812,4697897160,6020,5900,5890,-130,-2.16,6020,0,0,5890,6000,1400-10-26,2022-01-16
545,بنيرو,نيروترانس‌,137,1825771,3015848554,1718,1690,1676,-42,-2.44,1704,-14,-0.81,1636,1690,1400-10-26,2022-01-16
546,كگهر,سنگ آهن گهرزمين,137,591047,28145360600,48000,47000,47200,-800,-1.67,47900,-100,-0.21,46950,48000,1400-10-26,2022-01-16
547,تماوند,تامين سرمايه دماوند,137,4012180,23459107270,5970,5970,5800,-170,-2.85,5850,-120,-2.01,5800,5990,1400-10-26,2022-01-16
548,تكمبا,كمباين‌ سازي‌ ايران‌,136,1613562,5564367247,3526,3410,3436,-90,-2.55,3496,-30,-0.85,3410,3499,1400-10-26,2022-01-16
549,اخزا007,اسنادخزانه-م7بودجه00-030912,135,444641,236582227880,531190,532060,533890,2700,0.51,532070,880,0.17,531050,533890,1400-10-26,2022-01-16
550,ثتوسا,س.توسعه و عمران استان اردبيل,135,744410,8970926050,12420,12050,12050,-370,-2.98,12050,-370,-2.98,12050,12100,1400-10-26,2022-01-16
551,سيستم,همكاران سيستم,135,750290,3756545820,5120,5090,4960,-160,-3.13,5100,-20,-0.39,4910,5120,1400-10-26,2022-01-16
552,زيتون,صندوق س زيتون نماد پايا- مختلط,133,356534,3296981550,9270,9270,9340,70,0.76,9250,-20,-0.22,9200,9340,1400-10-26,2022-01-16
553,انار,صندوق س.انارنماد ارزش-درسهام,132,328894,2928918440,9000,9000,8950,-50,-0.56,8910,-90,-1,8850,9020,1400-10-26,2022-01-16
554,شصفها,پتروشيمي‌ اصفهان‌,132,119700,13330946950,113600,111550,111350,-2250,-1.98,111400,-2200,-1.94,111350,113650,1400-10-26,2022-01-16
555,سپاس,صندوق س. پاداش سهامداري-ثابت,131,2812294,28296756782,10054,10063,10062,8,0.08,10062,8,0.08,10060,10064,1400-10-26,2022-01-16
556,دبالك,مواد اوليه دارويي البرز بالك,131,604365,4440801990,7660,7370,7400,-260,-3.39,7560,-100,-1.31,7280,7690,1400-10-26,2022-01-16
557,وكادو,تكادو,129,678315,9149155530,13890,13500,13500,-390,-2.81,13500,-390,-2.81,13480,14050,1400-10-26,2022-01-16
558,تصميم,صندوق س با درآمد ثابت تصميم,128,681266,12639028480,18539,18553,18553,14,0.08,18552,13,0.07,18550,18553,1400-10-26,2022-01-16
559,عيار,صندوق سكه طلاي مفيد,126,146904,4423705039,30020,29920,30125,105,0.35,30113,93,0.31,29920,30480,1400-10-26,2022-01-16
560,اتكام,بيمه اتكايي امين,125,1014094,4955389502,4867,4869,4915,48,0.99,4873,6,0.12,4867,4919,1400-10-26,2022-01-16
561,هجرت,پخش هجرت,125,191299,4725172400,25600,24650,24800,-800,-3.13,25300,-300,-1.17,24450,25250,1400-10-26,2022-01-16
562,كطبس,ذغال‌سنگ‌ نگين‌ ط‌بس‌,124,359945,16414740560,45350,43820,45600,250,0.55,45600,250,0.55,43820,46570,1400-10-26,2022-01-16
563,خوساز,محورسازان‌ايران‌خودرو,124,558899,3681654830,6730,6890,6630,-100,-1.49,6690,-40,-0.59,6410,6890,1400-10-26,2022-01-16
564,كقزوي,شيشه‌ قزوين‌,124,776204,6352163290,8160,8150,8160,0,0,8170,10,0.12,8050,8370,1400-10-26,2022-01-16
565,اوان,مبين وان كيش,121,383965,3523503260,9640,9600,9160,-480,-4.98,9520,-120,-1.24,9160,9600,1400-10-26,2022-01-16
566,كپشير,پشم‌شيشه‌ايران‌,120,170450,1739063000,10390,10070,10350,-40,-0.38,10370,-20,-0.19,10030,10350,1400-10-26,2022-01-16
567,دالبر,البرزدارو,120,277953,3252073630,11890,11990,11820,-70,-0.59,11850,-40,-0.34,11300,11990,1400-10-26,2022-01-16
568,حشكوه,دليجان طلايي شكوه پارس,119,1771543,5809553122,3353,3256,3290,-63,-1.88,3310,-43,-1.28,3253,3359,1400-10-26,2022-01-16
569,سخوز,سيمان خوزستان,119,214998,4461080060,21190,21540,20800,-390,-1.84,21060,-130,-0.61,20360,21540,1400-10-26,2022-01-16
570,سرود,سيمان‌شاهرود,119,167715,3384939170,20750,19880,20570,-180,-0.87,20620,-130,-0.63,19720,20640,1400-10-26,2022-01-16
571,حسينا,توسعه خدمات دريايي وبندري سينا,118,69859,3014915350,43700,41800,44750,1050,2.4,43600,-100,-0.23,41700,45000,1400-10-26,2022-01-16
572,لخزر,پارس‌ خزر,117,14448,1513481290,108280,103300,105060,-3220,-2.97,107910,-370,-0.34,103300,107910,1400-10-26,2022-01-16
573,زعف0110پ18,زعفران0110نگين بهرامن(پ),116,55868,19917046941,363136,360001,364000,864,0.24,356502,-6634,-1.83,349000,364000,1400-10-26,2022-01-16
574,اخزا006,اسنادخزانه-م6بودجه00-030723,116,135047,74144184370,546130,548990,549740,3610,0.66,549030,2900,0.53,547010,558750,1400-10-26,2022-01-16
575,وملت,سرمايه گذاري ملت,115,2541970,5991470352,2404,2400,2356,-48,-2,2357,-47,-1.96,2356,2400,1400-10-26,2022-01-16
576,فافزا,فولاد افزا سپاهان,113,129475,3754076000,28700,29350,29150,450,1.57,28800,100,0.35,28100,29350,1400-10-26,2022-01-16
577,وحافظح,ح . بيمه حافظ,112,5436026,14538242555,2839,3009,2669,-170,-5.99,2674,-165,-5.81,2669,3009,1400-10-26,2022-01-16
578,زعف0110پ11,زعفران0110نگين سحرخيز(پ),111,37614,13555166490,369057,367000,357000,-12057,-3.27,360376,-8681,-2.35,351001,367000,1400-10-26,2022-01-16
579,پرديس,سرمايه گذاري پرديس,110,1052232,3443655479,3343,3274,3320,-23,-0.69,3326,-17,-0.51,3255,3469,1400-10-26,2022-01-16
580,وبشهر,توسعه‌ صنايع‌ بهشهر(هلدينگ,109,515898,3397542990,6730,6490,6610,-120,-1.78,6720,-10,-0.15,6490,6670,1400-10-26,2022-01-16
581,لبوتان,گروه‌صنعتي‌بوتان‌,108,70043,2921143210,42360,41000,42670,310,0.73,42230,-130,-0.31,41000,42670,1400-10-26,2022-01-16
582,غشان,شيرپاستوريزه‌پگاه‌خراسان‌,107,730095,2684501830,3813,3780,3697,-116,-3.04,3788,-25,-0.66,3623,3830,1400-10-26,2022-01-16
583,خديزل,بهمن  ديزل,107,63774,3378379150,52700,51850,53000,300,0.57,52750,50,0.09,51850,54000,1400-10-26,2022-01-16
584,حبندرح,ح.دريايي وكشتيراني خط دريابندر,107,778523,8605505830,10740,11060,11060,320,2.98,11050,310,2.89,10740,11060,1400-10-26,2022-01-16
585,شكبير,پتروشيمي اميركبير,105,433826,38693646650,91800,91200,89900,-1900,-2.07,90750,-1050,-1.14,89050,91300,1400-10-26,2022-01-16
586,سكرما,سيمان‌ كرمان‌,105,637695,9234840110,14640,14660,14620,-20,-0.14,14540,-100,-0.68,14300,14900,1400-10-26,2022-01-16
587,شساخت,مهندسي و ساختمان صنايع نفت,104,454898,20066230050,44150,44150,44150,0,0,44150,0,0,43000,44200,1400-10-26,2022-01-16
588,شلرد,كود شيميايي اوره لردگان,104,1987210,22594577700,11718,11370,11370,-348,-2.97,11530,-188,-1.6,11370,11370,1400-10-26,2022-01-16
589,كاريس,صندوق س.سپهر كاريزما-س,102,373376,4720433557,12764,12600,12685,-79,-0.62,12643,-121,-0.95,12600,12798,1400-10-26,2022-01-16
590,كمينا,شيشه سازي مينا,100,245097,1864260760,7700,7520,7600,-100,-1.3,7680,-20,-0.26,7520,7790,1400-10-26,2022-01-16
591,فيروزا,صندوق بادرآمد ثابت فيروزه آسيا,100,5340987,140461994535,26278,26290,26292,14,0.05,26299,21,0.08,26290,26299,1400-10-26,2022-01-16
592,فخاس,فولاد خراسان,100,220795,4717912280,22430,21370,21700,-730,-3.25,22380,-50,-0.22,21310,21850,1400-10-26,2022-01-16
593,سقاين,سيمان‌ قائن‌,99,126373,5089038820,40600,40310,41190,590,1.45,40490,-110,-0.27,39740,41300,1400-10-26,2022-01-16
594,فاما,صنعتي‌ آما,98,226297,3748800890,17380,16610,16550,-830,-4.78,17170,-210,-1.21,16520,16800,1400-10-26,2022-01-16
595,ساربيل,سيمان آرتا اردبيل,96,144004,3086686000,21290,21780,21290,0,0,21320,30,0.14,21110,21800,1400-10-26,2022-01-16
596,سفار,سيمان‌فارس‌,96,58776,2955147030,52110,50050,50600,-1510,-2.9,51730,-380,-0.73,49700,50980,1400-10-26,2022-01-16
597,واعتبار,سرمايه گذاري اعتبار ايران,96,1110390,2969744675,2772,2715,2720,-52,-1.88,2752,-20,-0.72,2634,2720,1400-10-26,2022-01-16
598,دابور,داروسازي‌ ابوريحان‌,95,72028,1534813280,21920,21110,21900,-20,-0.09,21860,-60,-0.27,20830,21900,1400-10-26,2022-01-16
599,سفانو,سيمان فارس نو,95,224217,5255842740,23310,23790,23500,190,0.82,23360,50,0.21,22810,23790,1400-10-26,2022-01-16
600,كهربا,صندوق س.پشتوانه سكه طلا كهربا,94,6841325,69889031505,10103,10191,10279,176,1.74,10216,113,1.12,10163,10279,1400-10-26,2022-01-16
601,كفراح,ح . فراورده‌ هاي‌ نسوزايران‌,92,354560,1596610014,4630,4310,4412,-218,-4.71,4503,-127,-2.74,4310,4600,1400-10-26,2022-01-16
602,وپخش,داروپخش‌ (هلدينگ‌,91,229204,7239740860,33160,31540,31990,-1170,-3.53,32910,-250,-0.75,31510,32450,1400-10-26,2022-01-16
603,داوه,داروسازي آوه سينا,89,174050,1447024390,8620,8300,8420,-200,-2.32,8590,-30,-0.35,8220,8570,1400-10-26,2022-01-16
604,سدشت,صنايع سيمان دشتستان,89,103267,2480747210,24960,23720,24100,-860,-3.45,24800,-160,-0.64,23720,24490,1400-10-26,2022-01-16
605,وبهمن,سرمايه‌گذاري‌بهمن‌,88,163005,2145216600,13710,13710,13150,-560,-4.08,13630,-80,-0.58,13090,13710,1400-10-26,2022-01-16
606,سهرمز,سيمان‌هرمزگان‌,87,138345,2154436930,16270,16450,15760,-510,-3.13,16160,-110,-0.68,15460,16450,1400-10-26,2022-01-16
607,قمرو,قند مرودشت‌,86,117341,2479477850,21470,20750,21570,100,0.47,21410,-60,-0.28,20410,21730,1400-10-26,2022-01-16
608,فلات,گروه صنايع معادن فلات ايرانيان,86,253269,2226108180,9020,8750,8860,-160,-1.77,8970,-50,-0.55,8750,9290,1400-10-26,2022-01-16
609,سجامح,ح.مجتمع سيمان غرب آسيا,85,923832,652332864,724,704,704,-20,-2.76,706,-18,-2.49,703,729,1400-10-26,2022-01-16
610,اخزا005,اسنادخزانه-م5بودجه00-030626,85,178397,99350240360,555330,557020,558820,3490,0.63,556910,1580,0.28,547430,558820,1400-10-26,2022-01-16
611,بمپنا,توليد برق عسلويه  مپنا,84,519231,2817314890,5690,5460,5510,-180,-3.16,5650,-40,-0.7,5410,5540,1400-10-26,2022-01-16
612,نيرو,نيرو سرمايه,82,75626,2315875000,31450,31100,30550,-900,-2.86,31250,-200,-0.64,30550,31100,1400-10-26,2022-01-16
613,شپاس,نفت پاسارگاد,81,141729,2094081190,15090,14810,14970,-120,-0.8,15040,-50,-0.33,14360,14990,1400-10-26,2022-01-16
614,گنگين,اقتصادي نگين گردشگري ايرانيان,81,1888223,56489536100,29650,30100,29950,300,1.01,29900,250,0.84,29500,30100,1400-10-26,2022-01-16
615,لوتوس,تامين سرمايه لوتوس پارسيان,79,1650492,9437303270,5720,5720,5720,0,0,5720,0,0,5620,5740,1400-10-26,2022-01-16
616,فبيرا,بسته‌ بندي‌ ايران‌,78,1533076,2548167249,1712,1667,1661,-51,-2.98,1699,-13,-0.76,1661,1674,1400-10-26,2022-01-16
617,شمواد,توليد مواداوليه الياف مصنوعي,78,73937,3696850000,49050,50000,50000,950,1.94,49750,700,1.43,50000,50000,1400-10-26,2022-01-16
618,دشيمي,شيمي‌ داروئي‌ داروپخش‌,77,121225,2514549100,21070,20910,21030,-40,-0.19,21010,-60,-0.28,20600,21100,1400-10-26,2022-01-16
619,اخزا917,اسنادخزانه-م17بودجه99-010226,77,368023,343815423160,933350,931150,935000,1650,0.18,934220,870,0.09,931150,935000,1400-10-26,2022-01-16
620,مارون,پتروشيمي مارون,76,26137,4344070550,172700,168200,168050,-4650,-2.69,172400,-300,-0.17,165550,168200,1400-10-26,2022-01-16
621,كشرق,صنعتي و معدني شمال شرق شاهرود,76,53985,3660644000,67800,66950,68300,500,0.74,67800,0,0,65100,68300,1400-10-26,2022-01-16
622,تيپيكو,سرمايه گذاري دارويي تامين,76,167244,2999376400,18320,17800,18000,-320,-1.75,18310,-10,-0.05,17800,18240,1400-10-26,2022-01-16
623,دفرا,فرآورده‌هاي‌ تزريقي‌ ايران‌,76,116598,1568547210,13730,13150,13650,-80,-0.58,13700,-30,-0.22,13130,13700,1400-10-26,2022-01-16
624,دسبحا,گروه دارويي سبحان,75,703455,12387903080,18520,17730,17600,-920,-4.97,18030,-490,-2.65,17600,17890,1400-10-26,2022-01-16
625,حبندر,دريايي و کشتيراني خط دريابندر,75,584095,8504423200,14140,14560,14560,420,2.97,14470,330,2.33,14560,14560,1400-10-26,2022-01-16
626,خفناور,مهندسي صنعتي روان فن آور,74,217078,6392947100,30350,29450,29450,-900,-2.97,29450,-900,-2.97,29450,29450,1400-10-26,2022-01-16
627,كخاكح,ح . صنايع‌خاك‌چيني‌ايران‌,74,224467,1965353980,9140,9000,8950,-190,-2.08,8760,-380,-4.16,8600,9000,1400-10-26,2022-01-16
628,شستان,پتروشيمي گلستان,74,2464309,9857236000,3922,4000,4000,78,1.99,4000,78,1.99,4000,4000,1400-10-26,2022-01-16
629,سجام,مجتمع سيمان غرب آسيا,73,904111,1790876954,2034,2000,2009,-25,-1.23,2024,-10,-0.49,1973,2020,1400-10-26,2022-01-16
630,ما,بيمه  ما,72,299771,1371331998,4723,4700,4685,-38,-0.8,4709,-14,-0.3,4515,4700,1400-10-26,2022-01-16
631,شزنگ,تجهيزنيروي‌زنگان‌,72,22626,2344053600,106800,103600,103600,-3200,-3,106000,-800,-0.75,103600,103600,1400-10-26,2022-01-16
632,اخزا003,اسنادخزانه-م3بودجه00-030418,71,104363,60699081120,579960,580850,582390,2430,0.42,581610,1650,0.28,580600,582390,1400-10-26,2022-01-16
633,كفرا,فراورده‌ هاي‌ نسوزايران‌,71,457290,3265685380,7350,7130,7130,-220,-2.99,7300,-50,-0.68,7090,7360,1400-10-26,2022-01-16
634,غناب,روغن‌ نباتي‌ ناب,71,32088,4798760400,142450,149550,149550,7100,4.98,145700,3250,2.28,149550,149550,1400-10-26,2022-01-16
635,تكنو,تكنوتار,71,298346,1742645890,6140,5850,5840,-300,-4.89,6100,-40,-0.65,5840,5860,1400-10-26,2022-01-16
636,اخزا004,اسنادخزانه-م4بودجه00-030522,71,169136,96255111230,568040,569070,570000,1960,0.35,569100,1060,0.19,568010,570000,1400-10-26,2022-01-16
637,دحاوي,الحاوي,70,271930,1141938094,4237,4110,4123,-114,-2.69,4233,-4,-0.09,4110,4364,1400-10-26,2022-01-16
638,وامين,س. امين توان آفرين ساز,69,113735,1395583410,12450,12320,12390,-60,-0.48,12440,-10,-0.08,12110,12440,1400-10-26,2022-01-16
639,بايكا,كارخانجات كابلسازي ‌ايران‌,69,93871,1342916090,14690,14250,14250,-440,-3,14640,-50,-0.34,14250,14580,1400-10-26,2022-01-16
640,كاسپين,داروسازي كاسپين تامين,68,106486,2249607100,21850,21350,21350,-500,-2.29,21750,-100,-0.46,21000,21450,1400-10-26,2022-01-16
641,قشهد,شهد,68,177767,2556358960,14960,14410,14400,-560,-3.74,14860,-100,-0.67,14220,14600,1400-10-26,2022-01-16
642,ويسا,سرمايه گذاري ايساتيس پويا,68,1300229,9950046070,7680,7760,7590,-90,-1.17,7650,-30,-0.39,7450,7760,1400-10-26,2022-01-16
643,ضسپا1111,اختيارخ خساپا-1400-1400/11/20,68,4050,1118491000,282,267,285,3,1.06,276,-6,-2.13,265,300,1400-10-26,2022-01-16
644,ماني,صندوق س. با درآمد ثابت ماني,67,1425072,15440174063,10828,10835,10835,7,0.06,10835,7,0.06,10834,10835,1400-10-26,2022-01-16
645,سكرد,سيمان كردستان,66,296590,1348597152,4643,4436,4560,-83,-1.79,4634,-9,-0.19,4436,4648,1400-10-26,2022-01-16
646,وتوشه,سرمايه‌ گذاري‌ پارس‌ توشه‌,66,384360,1965286410,5170,5200,5150,-20,-0.39,5160,-10,-0.19,5070,5250,1400-10-26,2022-01-16
647,وارس,سرمايه گذاري ارس صبا,64,620678,6920559700,10830,11150,11150,320,2.95,11040,210,1.94,11150,11150,1400-10-26,2022-01-16
648,فيروزه,صندوق شاخص30 شركت فيروزه- سهام,64,38795,6143541160,159560,158560,160000,440,0.28,158360,-1200,-0.75,157960,160000,1400-10-26,2022-01-16
649,دارو,كارخانجات‌داروپخش‌,63,52791,1531308740,29660,29000,29410,-250,-0.84,29600,-60,-0.2,28410,29600,1400-10-26,2022-01-16
650,داسوه,داروسازي‌ اسوه‌,63,230013,5417569510,24370,23600,23900,-470,-1.93,24060,-310,-1.27,23440,24000,1400-10-26,2022-01-16
651,سكارون,سيمان كارون,63,332699,11943894100,34900,35900,35900,1000,2.87,35900,1000,2.87,35900,35900,1400-10-26,2022-01-16
652,رتكو,كنترل‌خوردگي‌تكين‌كو,62,193936,1294796230,7010,6900,6780,-230,-3.28,6980,-30,-0.43,6660,6900,1400-10-26,2022-01-16
653,خبنيان,بنيان ديزل,62,197368,266841536,1393,1352,1352,-41,-2.94,1392,-1,-0.07,1352,1352,1400-10-26,2022-01-16
654,سيدكو,سرمايه گذاري توسعه صنايع سيمان,62,290483,1619780530,5760,5760,5610,-150,-2.6,5740,-20,-0.35,5500,5760,1400-10-26,2022-01-16
655,سكه0112پ03,تمام سكه طرح جديد0112سامان,62,21300,25311986500,1186775,1189000,1190006,3231,0.27,1188356,1581,0.13,1184000,1193000,1400-10-26,2022-01-16
656,تكنار,مجتمع معادن مس تكنار,61,128758,6210523150,49600,48200,48150,-1450,-2.92,48700,-900,-1.81,48150,48950,1400-10-26,2022-01-16
657,وثنو,سرمايه گذاري ساختماني نوين,61,627006,2537287192,4171,4050,4046,-125,-3,4138,-33,-0.79,4046,4062,1400-10-26,2022-01-16
658,مداران,داده‌پردازي‌ايران‌,60,103107,1492563420,15070,14410,14400,-670,-4.45,15010,-60,-0.4,14390,14960,1400-10-26,2022-01-16
659,اوصتا,صندوق انديشه ورزان صباتامين -د,59,1298414,27562644797,21218,21227,21228,10,0.05,21228,10,0.05,21227,21228,1400-10-26,2022-01-16
660,سيلام,سيمان‌ ايلام‌,58,447880,2736546800,6780,6110,6110,-670,-9.88,6640,-140,-2.06,6110,6110,1400-10-26,2022-01-16
661,دسينا,داروسازي‌ سينا,57,270865,5373908110,20380,20300,19860,-520,-2.55,20180,-200,-0.98,19410,20300,1400-10-26,2022-01-16
662,كفرآور,فرآورده هاي سيمان شرق,57,390986,7478725820,19700,19160,19110,-590,-2.99,19270,-430,-2.18,19110,19450,1400-10-26,2022-01-16
663,ضسپا1113,اختيارخ خساپا-1800-1400/11/20,56,2183,156948000,71,71,75,4,5.63,72,1,1.41,65,89,1400-10-26,2022-01-16
664,اخزا008,اسنادخزانه-م8بودجه00-030919,55,31505,16694199030,529670,532480,530980,1310,0.25,529890,220,0.04,529830,532480,1400-10-26,2022-01-16
665,پدرخش,درخشان‌ تهران‌,53,621478,4319272100,6620,6950,6950,330,4.98,6710,90,1.36,6950,6950,1400-10-26,2022-01-16
666,ضملت1133,اختيارخ وبملت-3000-1400/11/13,52,1543,324420000,226,220,218,-8,-3.54,210,-16,-7.08,180,234,1400-10-26,2022-01-16
667,سمتاز,سيمان ممتازان كرمان,52,211886,2922210730,14210,13970,13790,-420,-2.96,14080,-130,-0.91,13790,13970,1400-10-26,2022-01-16
668,زعف0110پ16,زعفران0110نگين بيرجند(پ),51,52609,18761736452,361257,356102,350000,-11257,-3.12,356626,-4631,-1.28,350000,361000,1400-10-26,2022-01-16
669,گكيش,توريستي ورفاهي آبادگران كيش,51,174622,3275908720,19340,18760,18760,-580,-3,19140,-200,-1.03,18760,18760,1400-10-26,2022-01-16
670,قپيرا,فرآورده‌هاي‌غدايي‌وقندپيرانشهر,51,99170,784521840,8070,7900,8080,10,0.12,8060,-10,-0.12,7700,8110,1400-10-26,2022-01-16
671,اخزا903,اسنادخزانه-م3بودجه99-011110,49,40563,32900056430,809940,809000,811900,1960,0.24,811090,1150,0.14,807050,815000,1400-10-26,2022-01-16
672,ضملت1134,اختيارخ وبملت-3500-1400/11/13,49,2209,54612000,32,25,28,-4,-12.5,25,-7,-21.88,22,40,1400-10-26,2022-01-16
673,اخزا905,اسنادخزانه-م5بودجه99-020218,49,40134,30507703800,758740,766490,761680,2940,0.39,760150,1410,0.19,759600,766490,1400-10-26,2022-01-16
674,سهگمت,سيمان‌هگمتان‌,49,43941,894268120,20490,20040,20180,-310,-1.51,20480,-10,-0.05,20040,20920,1400-10-26,2022-01-16
675,زعف0110پ20,زعفران0110نگين وحدت جام(پ),48,12288,4403888774,362262,355001,350000,-12262,-3.38,358389,-3873,-1.07,349500,365000,1400-10-26,2022-01-16
676,وثوق,سرمايه گذاري وثوق امين,47,331663,2872201580,8920,8660,8660,-260,-2.91,8840,-80,-0.9,8660,8660,1400-10-26,2022-01-16
677,لخانه,لوازم‌ خانگي‌ پارس‌,47,188154,2782797660,15560,14790,14790,-770,-4.95,15330,-230,-1.48,14790,14790,1400-10-26,2022-01-16
678,سايرا,ايرانيت‌,45,124019,3162543000,26000,25500,25500,-500,-1.92,25700,-300,-1.15,25500,25550,1400-10-26,2022-01-16
679,اخزا902,اسنادخزانه-م2بودجه99-011019,43,84647,69324515150,818200,818590,818710,510,0.06,818980,780,0.1,816210,822500,1400-10-26,2022-01-16
680,زعف0110پ05,زعفران0110نگين زرين(پ),43,11440,4118994868,369997,360002,355000,-14997,-4.05,360052,-9945,-2.69,354000,362990,1400-10-26,2022-01-16
681,غشوكو,شوكو پارس,42,124605,933691820,7600,7580,7380,-220,-2.89,7590,-10,-0.13,7380,7710,1400-10-26,2022-01-16
682,سمايه,بانك سرمايه,41,1069803,4499591418,4336,4206,4206,-130,-3,4275,-61,-1.41,4206,4206,1400-10-26,2022-01-16
683,ضخود2021,اختيارخ خودرو-3500-1401/02/07,41,2582,105005000,41,40,40,-1,-2.44,41,0,0,39,50,1400-10-26,2022-01-16
684,وايرا,سرمايه گذاري صنايع ايران,40,526546,2196070916,4277,4240,4159,-118,-2.76,4253,-24,-0.56,4159,4240,1400-10-26,2022-01-16
685,يارا,صندوق س. آريا-د,40,107637,1076370000,10000,10000,10000,0,0,10000,0,0,10000,10000,1400-10-26,2022-01-16
686,داريك,صندوق س.اعتماد داريك-د,40,1066067,12950587916,12143,12148,12150,7,0.06,12148,5,0.04,12148,12150,1400-10-26,2022-01-16
687,وبرق,س.کارکنان صنعت برق زنجان وقزوي,39,16486,1380702500,86300,83750,83750,-2550,-2.95,86000,-300,-0.35,83750,83750,1400-10-26,2022-01-16
688,سكه0011پ02,تمام سكه طرح جديد0011ملت,39,31200,37118881100,1184974,1190989,1189300,4326,0.37,1189708,4734,0.4,1187067,1193000,1400-10-26,2022-01-16
689,اگ010518,گام بانك تجارت0105,38,380000,330947210000,1000000,870710,878000,-122000,-12.2,870914,-129086,-12.91,870121,878000,1400-10-26,2022-01-16
690,سشمال,سيمان‌ شمال‌,38,193990,1431500800,7480,7230,7400,-80,-1.07,7470,-10,-0.13,7230,7430,1400-10-26,2022-01-16
691,سباقر,سيمان باقران,38,448528,5135645600,11800,11450,11450,-350,-2.97,11610,-190,-1.61,11450,11450,1400-10-26,2022-01-16
692,ركيش,كارت اعتباري ايران كيش,38,173593,1072170440,6230,6040,6120,-110,-1.77,6230,0,0,6040,6230,1400-10-26,2022-01-16
693,اخزا914,اسنادخزانه-م14بودجه99-021025,38,255314,169405081380,662060,664490,663000,940,0.14,663520,1460,0.22,661010,664980,1400-10-26,2022-01-16
694,سكه0012پ04,تمام سكه طرح جديد0012صادرات,37,15800,18787573800,1183618,1189999,1193000,9382,0.79,1189087,5469,0.46,1185000,1193999,1400-10-26,2022-01-16
695,صايند,صندوق س. گنجينه آينده روشن-د,37,319310,3202605350,10029,10029,10029,0,0,10030,1,0.01,10029,10031,1400-10-26,2022-01-16
696,زرين,صندوق س. سهام زرين كوروش-س,37,121143,1475091050,12232,12250,12180,-52,-0.43,12176,-56,-0.46,12052,12250,1400-10-26,2022-01-16
697,افرا,افرانت,37,175532,3396544200,20350,19350,19350,-1000,-4.91,20100,-250,-1.23,19350,19350,1400-10-26,2022-01-16
698,اخزا909,اسنادخزانه-م9بودجه99-020316,36,244252,182868735640,745600,745890,748600,3000,0.4,748690,3090,0.41,745800,750000,1400-10-26,2022-01-16
699,ثزاگرس,سرمايه گذاري توسعه عمران زاگرس,35,62368,1874234200,30950,31050,30050,-900,-2.91,30800,-150,-0.48,30050,31100,1400-10-26,2022-01-16
700,غپونه,نوش پونه مشهد,35,41865,481844320,11520,11470,11690,170,1.48,11520,0,0,11460,11760,1400-10-26,2022-01-16
701,وزمين,بانك ايران زمين,34,426052,3576396030,8250,8410,8360,110,1.33,8290,40,0.48,8260,8410,1400-10-26,2022-01-16
702,معيار ,سرمايه گذاري معيار صنعت پارس,34,18104,712787900,40240,39150,39450,-790,-1.96,40200,-40,-0.1,39050,41350,1400-10-26,2022-01-16
703,زعف0110پ09,زعفران0110نگين نوين(پ),33,6815,2439703464,362772,360000,350000,-12772,-3.52,357990,-4782,-1.32,350000,360001,1400-10-26,2022-01-16
704,فكمند,گسترش قطعه سازي كمند,33,79443,2681201250,34750,33750,33750,-1000,-2.88,34450,-300,-0.86,33750,33750,1400-10-26,2022-01-16
705,دقاضي,داروسازي شهيد قاضي,32,23076,599331550,26200,26950,26050,-150,-0.57,26200,0,0,25500,26950,1400-10-26,2022-01-16
706,ثاصفا,شركت‌ ساختمان‌ اصفهان‌,32,261806,2102302180,8270,8030,8030,-240,-2.9,8190,-80,-0.97,8030,8030,1400-10-26,2022-01-16
707,ثاژن,سخت آژند,32,67296,269888813,3992,3930,3970,-22,-0.55,3993,1,0.03,3930,4071,1400-10-26,2022-01-16
708,اخزا910,اسنادخزانه-م10بودجه99-020807,31,30030,20607900380,685840,680070,686910,1070,0.16,686240,400,0.06,680070,687980,1400-10-26,2022-01-16
709,وبازار,صندوق س شاخصي بازارآشنا,31,119282,1337387180,11260,11190,11260,0,0,11210,-50,-0.44,11150,11260,1400-10-26,2022-01-16
710,آساس,صندوق س.آسمان آرماني سهام-س,31,13938,2224903538,162004,160828,160000,-2004,-1.24,159629,-2375,-1.47,159164,160900,1400-10-26,2022-01-16
711,اخزا911,اسنادخزانه-م11بودجه99-020906,31,42444,28652731660,673880,675970,676100,2220,0.33,675070,1190,0.18,673010,676890,1400-10-26,2022-01-16
712,سكه0111پ05,تمام سكه طرح جديد0111آينده,30,27500,32675913600,1183904,1190000,1193500,9596,0.81,1188215,4311,0.36,1184000,1193899,1400-10-26,2022-01-16
713,وآفري,بيمه كارآفرين,29,2024909,8202961730,4053,3980,4080,27,0.67,4052,-1,-0.02,3980,4080,1400-10-26,2022-01-16
714,كمنگنز,معادن‌منگنزايران‌,29,200297,1874779920,8920,9360,9360,440,4.93,8970,50,0.56,9360,9360,1400-10-26,2022-01-16
715,فالوم,آلومتك‌,28,135482,2231388540,16970,16470,16470,-500,-2.95,16850,-120,-0.71,16470,16470,1400-10-26,2022-01-16
716,ارمغان,ص سرمايه گذاري ارمغان ايرانيان,28,239378,2406207052,10043,10050,10058,15,0.15,10052,9,0.09,10049,10058,1400-10-26,2022-01-16
717,زعف0110پ08,زعفران0110نگين روستا(پ),27,6763,2394489565,361550,379997,348800,-12750,-3.53,354057,-7493,-2.07,347500,379997,1400-10-26,2022-01-16
718,ثغرب,شركت سرمايه گذاري مسكن شمالغرب,27,636023,2210179925,3657,3475,3475,-182,-4.98,3629,-28,-0.77,3475,3475,1400-10-26,2022-01-16
719,ثنظام,س. ساختماني نظام مهندسي ايران,27,44805,604419450,14190,13490,13490,-700,-4.93,13490,-700,-4.93,13490,13490,1400-10-26,2022-01-16
720,زعف0110پ10,زعفران0110نگين طلاي سرخ(پ),27,6985,2503822140,369520,370000,351222,-18298,-4.95,358457,-11063,-2.99,351016,370000,1400-10-26,2022-01-16
721,كصدف,كاشي صدف سرام استقلال آباده,26,310200,6715830000,21050,21650,21650,600,2.85,21450,400,1.9,21650,21650,1400-10-26,2022-01-16
722,گوهر2,صندوق سكه طلاي كيان,25,250000,250000,58666,1,1,-58665,-100,1,-58665,-100,1,1,1400-10-26,2022-01-16
723,طخود2018,اختيارف خودرو-2000-1401/02/07,24,693,110093000,165,169,144,-21,-12.73,159,-6,-3.64,112,175,1400-10-26,2022-01-16
724,قنيشا,قند  نيشابور,24,58753,2435899380,43640,41460,41460,-2180,-5,43270,-370,-0.85,41460,41460,1400-10-26,2022-01-16
725,دارا,صندوق س. دارا الگوريتم-د,23,429021,4335052896,10097,10104,10104,7,0.07,10105,8,0.08,10103,10110,1400-10-26,2022-01-16
726,داريوش,صندوق س. ثروت داريوش -س,23,72161,669199356,9330,9260,9340,10,0.11,9274,-56,-0.6,9200,9340,1400-10-26,2022-01-16
727,خعمرا,توسعه و عمران شهرستان نائين,23,272424,1754410560,6140,6440,6440,300,4.89,6190,50,0.81,6440,6440,1400-10-26,2022-01-16
728,كخاك,صنايع‌خاك‌چيني‌ايران‌,23,43447,560673020,13390,12800,13060,-330,-2.46,13370,-20,-0.15,12800,13100,1400-10-26,2022-01-16
729,ضمخا1035,اختيارخ اخابر-7000-1400/10/26,23,717,15851000,17,3,21,4,23.53,22,5,29.41,2,100,1400-10-26,2022-01-16
730,اخزا901,اسنادخزانه-م1بودجه99-010621,22,8958,7835580150,873150,871000,879450,6300,0.72,874700,1550,0.18,871000,879490,1400-10-26,2022-01-16
731,حرهشا,رهشاد سپاهان (سهامي عام,22,24584,1886822000,79100,76750,76750,-2350,-2.97,78350,-750,-0.95,76750,76750,1400-10-26,2022-01-16
732,فسا,پتروشيمي فسا,22,494238,420596538,877,851,851,-26,-2.96,876,-1,-0.11,851,851,1400-10-26,2022-01-16
733,هپارس102,اختيارف ت پارس-157010-01/02/05,22,150000,150000,1,1,1,0,0,1,0,0,1,1,1400-10-26,2022-01-16
734,ضملت1135,اختيارخ وبملت-4000-1400/11/13,22,539,2689000,5,5,9,4,80,5,0,0,4,9,1400-10-26,2022-01-16
735,سپيدما2,صندوق س. سپيد دماوند-د,21,131000000,131000000,11694,1,1,-11693,-99.99,1,-11693,-99.99,1,1,1400-10-26,2022-01-16
736,برن0104پ01,برنج طارم0104تجارت مازندران(پ),21,500,282508734,567731,561101,568000,269,0.05,565017,-2714,-0.48,560000,570000,1400-10-26,2022-01-16
737,اراد50,مرابحه عام دولت5-ش.خ0302,21,234000,234001492000,1000000,1000010,1000000,0,0,1000010,10,0,1000000,1000010,1400-10-26,2022-01-16
738,كبورس,كارگزاران بورس اوراق بهادار,20,1882866,16286790900,9100,8650,8650,-450,-4.95,8950,-150,-1.65,8650,8650,1400-10-26,2022-01-16
739,ضصاد1114,اختيارخ وبصادر-2500-1400/11/06,20,577,577000,1,1,1,0,0,1,0,0,1,1,1400-10-26,2022-01-16
740,هكشو208,اختيارف ت پاكشو10000-02/08/29,20,635000,441960000,692,696,696,4,0.58,696,4,0.58,696,696,1400-10-26,2022-01-16
741,تشتاد,صنايع توليدي اشتاد ايران‌,19,142764,653380636,4717,4579,4576,-141,-2.99,4707,-10,-0.21,4576,4579,1400-10-26,2022-01-16
742,ولتجار,واسپاري تجارت وسرمايه ايرانيان,19,106936,260362224,2509,2434,2434,-75,-2.99,2507,-2,-0.08,2434,2450,1400-10-26,2022-01-16
743,زعف0110پ21,زعفران0110نگين ملل(پ),19,7971,2849776957,366155,357001,352004,-14151,-3.86,357518,-8637,-2.36,352004,361000,1400-10-26,2022-01-16
744,اخزا815,اسنادخزانه-م15بودجه98-010406,18,3728,3396903870,909510,908520,912000,2490,0.27,911190,1680,0.18,908520,912000,1400-10-26,2022-01-16
745,الماس,صندوق س.امين تدبيرگران فردا-س,18,3253,312216804,96957,95910,96966,9,0.01,95978,-979,-1.01,95900,96990,1400-10-26,2022-01-16
746,افق ملت,صندوق س در سهام افق ملت,18,3160,421695530,134770,133420,133420,-1350,-1,133450,-1320,-0.98,133000,134000,1400-10-26,2022-01-16
747,گنجين,صندوق س. گنجينه يكم آويد-د,18,106025,1547652771,14596,14597,14597,1,0.01,14597,1,0.01,14597,14598,1400-10-26,2022-01-16
748,كباده,توليد خاك نسوزاستقلال آباده,18,49035,1676997000,33250,34200,34200,950,2.86,33400,150,0.45,34200,34200,1400-10-26,2022-01-16
749,آكورد2,صندوق س. آرمان آتي كوثر-د,18,1800000,1800000,36301,1,1,-36300,-100,1,-36300,-100,1,1,1400-10-26,2022-01-16
750,اخزا814,اسنادخزانه-م14بودجه98-010318,17,9523,8796668970,923630,923630,924000,370,0.04,923730,100,0.01,923000,924000,1400-10-26,2022-01-16
751,دمعيار,صندوق س. توازن معيار-د,17,113129,1105395178,9800,9765,9784,-16,-0.16,9771,-29,-0.3,9760,9784,1400-10-26,2022-01-16
752,ساروج,بين المللي ساروج بوشهر,17,266057,4235690170,16360,15580,16150,-210,-1.28,16230,-130,-0.79,15550,16180,1400-10-26,2022-01-16
753,فراز,صندوق س.سهام فراز داريك-س,16,385986,5497898244,14243,14244,14244,1,0.01,14244,1,0.01,14243,14246,1400-10-26,2022-01-16
754,اخزا908,اسنادخزانه-م8بودجه99-020606,16,67051,47757949320,711000,708250,712100,1100,0.15,712260,1260,0.18,708250,714000,1400-10-26,2022-01-16
755,ضفلا1164,اختيارخ فولاد-12000-1400/11/24,16,274,27359000,128,112,100,-28,-21.88,100,-28,-21.88,84,112,1400-10-26,2022-01-16
756,كيان2,صندوق س. با درآمد ثابت كيان,16,1600000,1600000,32611,1,1,-32610,-100,1,-32610,-100,1,1,1400-10-26,2022-01-16
757,ضسپا3013,اختيارخ خساپا-1600-1401/03/25,16,1204,377185000,1,330,340,339,33900,313,312,31200,300,340,1400-10-26,2022-01-16
758,خاتم2,صندوق س خاتم ايساتيس پويا-ثابت,15,14800000,14800000,12654,1,1,-12653,-99.99,1,-12653,-99.99,1,1,1400-10-26,2022-01-16
759,ضفلا1163,اختيارخ فولاد-10000-1400/11/24,15,182,101383000,660,800,579,-81,-12.27,557,-103,-15.61,500,800,1400-10-26,2022-01-16
760,اخزا812,اسنادخزانه-م12بودجه98-001111,15,11650,11548663430,991170,992000,991850,680,0.07,991300,130,0.01,990300,992990,1400-10-26,2022-01-16
761,زير0103پ01,زيره سبز0103كيميابذر(پ),15,100,100000000,1010000,1000000,1000000,-10000,-0.99,1000000,-10000,-0.99,1000000,1000000,1400-10-26,2022-01-16
762,سفاسي,شركت فارسيت اهواز,14,52479,172498473,3460,3287,3287,-173,-5,3457,-3,-0.09,3287,3287,1400-10-26,2022-01-16
763,آتيمس,صندوق س.آرمان آتيه درخشان مس-س,13,3137,549684120,175981,175100,176497,516,0.29,175226,-755,-0.43,175000,176497,1400-10-26,2022-01-16
764,لپيام,گسترش صنايع پيام,13,101798,2611118700,26400,25650,25650,-750,-2.84,26200,-200,-0.76,25650,25650,1400-10-26,2022-01-16
765,ضصاد1112,اختيارخ وبصادر-1800-1400/11/06,13,88,12342000,152,145,144,-8,-5.26,140,-12,-7.89,100,160,1400-10-26,2022-01-16
766,فن آوا,گروه فن آوا,13,25217,253935190,10380,10070,10070,-310,-2.99,10370,-10,-0.1,10070,10070,1400-10-26,2022-01-16
767,كرونا2,تامين مالي جمعي صرفا اهداي سود,13,4086,40860000,10000,10000,10000,0,0,10000,0,0,10000,10000,1400-10-26,2022-01-16
768,اخزا813,اسنادخزانه-م13بودجه98-010219,13,1064,999030140,938660,937220,939000,340,0.04,938940,280,0.03,937220,939000,1400-10-26,2022-01-16
769,ولانا,شركت ليزينگ آريا دانا,13,24604,261540520,10950,10630,10630,-320,-2.92,10930,-20,-0.18,10630,10630,1400-10-26,2022-01-16
770,پارتا,مجتمع‌صنعتي‌آرتاويل‌تاير,13,103039,1878400970,18790,18230,18230,-560,-2.98,18720,-70,-0.37,18230,18230,1400-10-26,2022-01-16
771,طسپا1112,اختيارف خساپا-1600-1400/11/20,12,519,31099000,57,50,55,-2,-3.51,60,3,5.26,50,70,1400-10-26,2022-01-16
772,اخزا904,اسنادخزانه-م4بودجه99-011215,12,7465,5927210100,794040,794040,794500,460,0.06,794000,-40,-0.01,793500,794500,1400-10-26,2022-01-16
773,سپرمي,پرميت‌,12,25000,312000000,12360,12480,12480,120,0.97,12380,20,0.16,12480,12480,1400-10-26,2022-01-16
774,سحرا021,سلف موازي برق نيروي برق حرارتي,11,945200,307117789600,322277,325064,319798,-2479,-0.77,324924,2647,0.82,319798,325064,1400-10-26,2022-01-16
775,صبا1404,اجاصبابدون ضامن بارتبه اعتباري,10,500000,500000000000,1000910,1000000,1000000,-910,-0.09,1000000,-910,-0.09,1000000,1000000,1400-10-26,2022-01-16
776,اخزا817,اسنادخزانه-م17بودجه98-010512,10,2486,2220090890,892520,893100,893000,480,0.05,893040,520,0.06,893000,896970,1400-10-26,2022-01-16
777,سلار,شركت سيمان لارستان,10,10632,228588000,22150,21500,21500,-650,-2.93,22150,0,0,21500,21500,1400-10-26,2022-01-16
778,حگردش,ريل گردش ايرانيان,10,52295,194275925,3910,3715,3715,-195,-4.99,3906,-4,-0.1,3715,3715,1400-10-26,2022-01-16
779,ضذوب3002,اختيارخ ذوب-3000-1401/03/04,10,115,84450000,890,790,750,-140,-15.73,734,-156,-17.53,700,790,1400-10-26,2022-01-16
780,ضذوب3001,اختيارخ ذوب-2500-1401/03/04,9,80,86900000,1300,1150,1100,-200,-15.38,1086,-214,-16.46,1040,1150,1400-10-26,2022-01-16
781,وتعاون,بيمه تعاون,9,55303,87821164,1671,1588,1588,-83,-4.97,1670,-1,-0.06,1588,1588,1400-10-26,2022-01-16
782,اخزا918,اسنادخزانه-م18بودجه99-010323,8,1010,929281000,916450,918010,920990,4540,0.5,920080,3630,0.4,918010,921000,1400-10-26,2022-01-16
783,نتوس,پشم‌ بافي‌ توس,8,20788,227212840,11500,10930,10930,-570,-4.96,11490,-10,-0.09,10930,10930,1400-10-26,2022-01-16
784,سيناد,صندوق س.سپهرسودمند سينا-د,8,191318,1921003315,10029,10039,10043,14,0.14,10041,12,0.12,10039,10043,1400-10-26,2022-01-16
785,اطلس2,صندوق س.توسعه اندوخته آينده-س,8,80000,80000,233901,1,1,-233900,-100,1,-233900,-100,1,1,1400-10-26,2022-01-16
786,شگويات.ف0104,اختيارف.تبعي شگويا010408,8,10000,248000,1,1,35,34,3400,25,24,2400,1,35,1400-10-26,2022-01-16
787,اخزا816,اسنادخزانه-م16بودجه98-010503,8,26716,24061800000,898590,900000,901500,2910,0.32,900650,2060,0.23,900000,901500,1400-10-26,2022-01-16
788,ضمخا1034,اختيارخ اخابر-6000-1400/10/26,8,24,18470000,885,750,890,5,0.56,770,-115,-12.99,635,890,1400-10-26,2022-01-16
789,زگلدشتح,ح.كشت و دام گلدشت نمونه اصفهان,8,46120,323256000,7170,7520,7000,-170,-2.37,7010,-160,-2.23,7000,7520,1400-10-26,2022-01-16
790,ضجار2011,اختيارخ وتجارت-1600-1401/02/21,7,238,109226000,489,451,470,-19,-3.89,459,-30,-6.13,450,470,1400-10-26,2022-01-16
791,اخزا009,اسناد خزانه-م9بودجه00-031101,7,2611,1383019090,523490,523450,529980,6490,1.24,529690,6200,1.18,523450,529990,1400-10-26,2022-01-16
792,ثجوان,تامين مسكن جوانان,7,14635,63398820,4560,4332,4332,-228,-5,4558,-2,-0.04,4332,4332,1400-10-26,2022-01-16
793,طفلا1164,اختيارف فولاد-12000-1400/11/24,7,14,20200000,1500,1500,1400,-100,-6.67,1443,-57,-3.8,1400,1500,1400-10-26,2022-01-16
794,اگ0105182,گام بانك تجارت0105,7,5490000,4781790000000,1000000,871000,871000,-129000,-12.9,871000,-129000,-12.9,871000,871000,1400-10-26,2022-01-16
795,ضسپا3012,اختيارخ خساپا-1400-1401/03/25,7,330,158400000,540,480,480,-60,-11.11,480,-60,-11.11,480,480,1400-10-26,2022-01-16
796,كارا2,صندوق س. كارا -د,6,56800000,56800000,10573,1,1,-10572,-99.99,1,-10572,-99.99,1,1,1400-10-26,2022-01-16
797,نخو0102پ01,نخود متوسط0102شيري(پ),6,117,38732068,331021,331000,334500,3479,1.05,331043,22,0.01,330958,334500,1400-10-26,2022-01-16
798,ضمخا1036,اختيارخ اخابر-8000-1400/10/26,6,56,846000,1,1,1,0,0,15,14,1400,1,80,1400-10-26,2022-01-16
799,ثهام,صندوق س ثروت هامرز-سهام,6,4414,46435610,10450,10450,10470,20,0.19,10520,70,0.67,10450,10550,1400-10-26,2022-01-16
800,بذر,صندوق س بذر اميد آفرين-سهام,6,1042,96566770,94170,92670,92670,-1500,-1.59,92670,-1500,-1.59,92670,92680,1400-10-26,2022-01-16
801,ضفلا1165,اختيارخ فولاد-14000-1400/11/24,6,261,12976000,70,50,49,-21,-30,50,-20,-28.57,36,50,1400-10-26,2022-01-16
802,كهربا2,صندوق س.پشتوانه سكه طلا كهربا,6,6500000,6500000,10103,1,1,-10102,-99.99,1,-10102,-99.99,1,1,1400-10-26,2022-01-16
803,ضجار2013,اختيارخ وتجارت-2000-1401/02/21,6,164,40943000,266,226,281,15,5.64,250,-16,-6.02,226,300,1400-10-26,2022-01-16
804,ويستا,صندوق س. ويستا -س,6,20134,203554740,10132,10110,10110,-22,-0.22,10110,-22,-0.22,10110,10110,1400-10-26,2022-01-16
805,اخزا818,اسنادخزانه-م18بودجه98-010614,6,638,561399600,877950,876750,879990,2040,0.23,879940,1990,0.23,876750,879990,1400-10-26,2022-01-16
806,ثروتم,صندوق س. ثروت آفرين پارسيان-س,5,2400,199051460,82000,82755,83487,1487,1.81,82938,938,1.14,82755,83487,1400-10-26,2022-01-16
807,تملي708,تسهيلات مسكن ب. ملي-آبان97,5,28,19917320,682100,716205,647995,-34105,-5,711333,29233,4.29,647995,716205,1400-10-26,2022-01-16
808,كمان,س.خ.كمان كاريزما 35% تاديه,5,200000,77283800000,386194,386419,386419,225,0.06,386419,225,0.06,386419,386419,1400-10-26,2022-01-16
809,سنوين,سرمايه گذاري اقتصاد نوين,5,28993,154532690,5490,5330,5330,-160,-2.91,5490,0,0,5330,5330,1400-10-26,2022-01-16
810,طخود2016,اختيارف خودرو-1600-1401/02/07,5,100,4000000,55,40,40,-15,-27.27,40,-15,-27.27,40,40,1400-10-26,2022-01-16
811,هنوري102,اختيارف ت نوري59561-01/02/15,5,80061,80061,1,1,1,0,0,1,0,0,1,1,1400-10-26,2022-01-16
812,نهال2,صندوق س. طلاي سرخ نوويرا,5,500000,500000,18619,1,1,-18618,-99.99,1,-18618,-99.99,1,1,1400-10-26,2022-01-16
813,تملي711,تسهيلات مسكن ب. ملي-بهمن97,5,29,25235749,896474,941296,851651,-44823,-5,870198,-26276,-2.93,851651,941296,1400-10-26,2022-01-16
814,مثقال2,صندوق س.پشتوانه طلاي زرين آگاه,5,600000,600000,9448,1,1,-9447,-99.99,1,-9447,-99.99,1,1,1400-10-26,2022-01-16
815,ضمخا2016,اختيارخ اخابر-9000-1401/02/28,4,100,30000000,120,300,300,180,150,300,180,150,300,300,1400-10-26,2022-01-16
816,وسصفا,شركت س استان اصفهان,4,29086,20156598,729,693,693,-36,-4.94,729,0,0,693,693,1400-10-26,2022-01-16
817,ضملي1159,اختيارخ فملي-5000-1400/11/03,4,9,34400000,1940,1900,1900,-40,-2.06,1911,-29,-1.49,1900,1950,1400-10-26,2022-01-16
818,وسخراج,شركت س استان خراسان جنوبي,4,12955,25767495,2209,1989,1989,-220,-9.96,2209,0,0,1989,1989,1400-10-26,2022-01-16
819,وسخوز,شركت س استان خوزستان,4,121134,73043802,634,603,603,-31,-4.89,634,0,0,603,603,1400-10-26,2022-01-16
820,طملت1133,اختيارف وبملت-3000-1400/11/13,4,128,6240000,40,49,50,10,25,49,9,22.5,40,50,1400-10-26,2022-01-16
821,تماوند2,تامين سرمايه دماوند,4,70371592,427652504670,5970,5990,6120,150,2.51,6077,107,1.79,5900,6120,1400-10-26,2022-01-16
822,ثنام,س ساختماني ب نام آوران مهندسي,4,7350,59314500,8310,8070,8070,-240,-2.89,8310,0,0,8070,8070,1400-10-26,2022-01-16
823,اخزا821,اسنادخزانه-م21بودجه98-020906,4,5516,3734002360,673490,674210,676950,3460,0.51,676940,3450,0.51,674210,676950,1400-10-26,2022-01-16
824,ثبات2,صندوق س. ثبات ويستا -د,4,32000000,32000000,10759,1,1,-10758,-99.99,1,-10758,-99.99,1,1,1400-10-26,2022-01-16
825,آسام,صندوق س.آرمان سپهر آشنا-م,4,9010,1046025000,116624,116010,116100,-524,-0.45,116096,-528,-0.45,116010,116100,1400-10-26,2022-01-16
826,قشرين,قند شيرين خراسان,4,37000,200170000,5570,5410,5410,-160,-2.87,5570,0,0,5410,5410,1400-10-26,2022-01-16
827,دفاراح,ح . داروسازي‌ فارابي‌,4,4854,47794600,10000,9900,9800,-200,-2,9850,-150,-1.5,9800,9900,1400-10-26,2022-01-16
828,ضفلا1162,اختيارخ فولاد-9000-1400/11/24,4,38,37055000,1450,1000,1185,-265,-18.28,975,-475,-32.76,900,1185,1400-10-26,2022-01-16
829,ضبدر1165,اختيارخ شبندر-8000-1400/11/13,4,190,3920000,57,20,24,-33,-57.89,21,-36,-63.16,20,25,1400-10-26,2022-01-16
830,ونچر,ص.ج.فيروزه40%تاديه,4,3000,1275000000,430000,425000,425000,-5000,-1.16,425000,-5000,-1.16,425000,425000,1400-10-26,2022-01-16
831,اوج,صندوق س.اوج دماوند-س,4,3154,31546817,10002,10002,10002,0,0,10002,0,0,10002,10003,1400-10-26,2022-01-16
832,عيار2,صندوق سكه طلاي مفيد,4,40000,40000,30020,1,1,-30019,-100,1,-30019,-100,1,1,1400-10-26,2022-01-16
833,ضشنا2013,اختيارخ شپنا-4500-1401/02/25,4,6,9410000,2000,1595,1500,-500,-25,1568,-432,-21.6,1500,1610,1400-10-26,2022-01-16
834,ثمين,صندوق س. ثروت افزون ثمين-س,4,2500,25000000,10060,10000,10000,-60,-0.6,10000,-60,-0.6,10000,10000,1400-10-26,2022-01-16
835,ضملت3010,اختيارخ وبملت-2500-1401/03/18,3,3,3431000,1350,1160,1111,-239,-17.7,1144,-206,-15.26,1111,1160,1400-10-26,2022-01-16
836,پادا,صندوق س.پاداش سرمايه پارس-س,3,1350,140025000,104216,104000,103700,-516,-0.5,103722,-494,-0.47,103700,104000,1400-10-26,2022-01-16
837,ضملي1160,اختيارخ فملي-6000-1400/11/03,3,14,25200000,886,900,900,14,1.58,900,14,1.58,900,900,1400-10-26,2022-01-16
838,تملي807,تسهيلات مسكن ب. ملي-مهر98,3,28,17170916,584045,613247,613247,29202,5,613247,29202,5,613247,613247,1400-10-26,2022-01-16
839,ضداريوش904,اختيارخ داريوش-11500-14010915,3,39,56460000,1700,1450,1440,-260,-15.29,1448,-252,-14.82,1440,1450,1400-10-26,2022-01-16
840,طفلا1163,اختيارف فولاد-10000-1400/11/24,3,3,499000,100,399,50,-50,-50,166,66,66,50,399,1400-10-26,2022-01-16
841,افران2,صندوق س افرا نماد پايدار-ثابت,3,9000000,9000000,15254,1,1,-15253,-99.99,1,-15253,-99.99,1,1,1400-10-26,2022-01-16
842,تملي804,تسهيلات مسكن ب. ملي-تير98,3,24,16727728,687311,652946,719010,31699,4.61,696989,9678,1.41,652946,719010,1400-10-26,2022-01-16
843,اگ010155,گام بانك اقتصاد نوين0101,3,21000,19834500000,944300,944500,944500,200,0.02,944500,200,0.02,944500,944500,1400-10-26,2022-01-16
844,ضپال2007,اختيارخ اپال-32000-1401/02/12,3,123,10435000,92,84,91,-1,-1.09,85,-7,-7.61,84,91,1400-10-26,2022-01-16
845,اراد42,مرابحه عام دولت4-ش.خ 0106,3,1100,1079044000,989930,940440,985000,-4930,-0.5,980950,-8980,-0.91,940440,985000,1400-10-26,2022-01-16
846,ضملت1132,اختيارخ وبملت-2500-1400/11/13,3,7,4384000,702,601,778,76,10.83,626,-76,-10.83,601,778,1400-10-26,2022-01-16
847,وحافظ,بيمه حافظ,3,40418,261908640,6680,6480,6480,-200,-2.99,6670,-10,-0.15,6480,6480,1400-10-26,2022-01-16
848,كابگن,توليدي و صنعتي آبگينه‌,3,3121,21815790,6860,6990,6990,130,1.9,6990,130,1.9,6990,6990,1400-10-26,2022-01-16
849,ضپاس2011,اختيارخ وپارس-1600-1401/02/28,2,100,40700000,535,404,410,-125,-23.36,407,-128,-23.93,404,410,1400-10-26,2022-01-16
850,طخود2019,اختيارف خودرو-2500-1401/02/07,2,5,2250000,555,450,450,-105,-18.92,450,-105,-18.92,450,450,1400-10-26,2022-01-16
851,آسام2,صندوق س.آرمان سپهر آشنا-م,2,200000,200000,116624,1,1,-116623,-100,1,-116623,-100,1,1,1400-10-26,2022-01-16
852,فبستم,صنايع ‌بسته‌بندي‌ مشهد,2,100,113800,1105,1138,1138,33,2.99,1138,33,2.99,1138,1138,1400-10-26,2022-01-16
853,ضشنا2011,اختيارخ شپنا-3500-1401/02/25,2,11,27550000,2688,2550,2500,-188,-6.99,2505,-183,-6.81,2500,2550,1400-10-26,2022-01-16
854,غشوكوح,ح . شوكو پارس,2,201100,1045720000,4900,5200,5200,300,6.12,5200,300,6.12,5200,5200,1400-10-26,2022-01-16
855,ضملت3009,اختيارخ وبملت-2000-1401/03/18,2,6,8780000,1729,1530,1450,-279,-16.14,1463,-266,-15.38,1450,1530,1400-10-26,2022-01-16
856,ضصاد1111,اختيارخ وبصادر-1600-1400/11/06,2,2,797000,346,399,398,52,15.03,398,52,15.03,398,399,1400-10-26,2022-01-16
857,اراد61,مرابحه عام دولت61-ش.خ0309,2,10000,10000000000,1000000,1000000,1000000,0,0,1000000,0,0,1000000,1000000,1400-10-26,2022-01-16
858,ضمخا1037,اختيارخ اخابر-9000-1400/10/26,2,32,32000,1,1,1,0,0,1,0,0,1,1,1400-10-26,2022-01-16
859,ضبدر1163,اختيارخ شبندر-6000-1400/11/13,2,10,5630000,581,512,614,33,5.68,563,-18,-3.1,512,614,1400-10-26,2022-01-16
860,ياقوت2,صندوق س ياقوت آگاه-ثابت,2,10670000,10670000,13992,1,1,-13991,-99.99,1,-13991,-99.99,1,1,1400-10-26,2022-01-16
861,ولقمان,سرمايه گذاري لقمان,2,6156,16294932,2728,2647,2647,-81,-2.97,2728,0,0,2647,2647,1400-10-26,2022-01-16
862,خفولا,خدمات فني فولاد يزد,2,768,14976000,20100,19500,19500,-600,-2.99,19500,-600,-2.99,19500,19500,1400-10-26,2022-01-16
863,وسالت,بانك قرض الحسنه رسالت,2,14024,21751224,1506,1551,1551,45,2.99,1551,45,2.99,1551,1551,1400-10-26,2022-01-16
864,پا ه 18,بار پايه هفته 18,2,14000,7280000,526,520,520,-6,-1.14,520,-6,-1.14,520,520,1400-10-26,2022-01-16
865,اوج4,صندوق س.اوج دماوند-س,2,15000000,150030000000,10002,10002,10002,0,0,10002,0,0,10002,10002,1400-10-26,2022-01-16
866,شسم,توليد سموم‌ علف‌ كش,2,2,232300,110650,116150,116150,5500,4.97,116150,5500,4.97,116150,116150,1400-10-26,2022-01-16
867,ضملي1163,اختيارخ فملي-9000-1400/11/03,2,8,16000,21,1,1,-20,-95.24,1,-20,-95.24,1,1,1400-10-26,2022-01-16
868,اخزا907,اسنادخزانه-م7بودجه99-020704,2,3480,2432796400,698590,699080,699070,480,0.07,699080,490,0.07,699070,699080,1400-10-26,2022-01-16
869,كايتا,ايتالران‌,2,2,20640,10020,10320,10320,300,2.99,10320,300,2.99,10320,10320,1400-10-26,2022-01-16
870,جهرم,پتروشيمي جهرم,2,9440,11488480,1254,1217,1217,-37,-2.95,1217,-37,-2.95,1217,1217,1400-10-26,2022-01-16
871,وبهمن2,سرمايه‌گذاري‌بهمن‌,2,43000000,577490000000,13710,13430,13430,-280,-2.04,13430,-280,-2.04,13430,13430,1400-10-26,2022-01-16
872,ضبدر1164,اختيارخ شبندر-7000-1400/11/13,1,15,1125000,81,75,75,-6,-7.41,75,-6,-7.41,75,75,1400-10-26,2022-01-16
873,آوا2,صندوق س.سهام آواي معيار-س,1,200000,200000,7631,1,1,-7630,-99.99,1,-7630,-99.99,1,1,1400-10-26,2022-01-16
874,دامين2,داروسازي‌ امين‌,1,39199799,85847559810,2283,2190,2190,-93,-4.07,2190,-93,-4.07,2190,2190,1400-10-26,2022-01-16
875,ضكاريس902,اختيارخ كاريس-14000-14010930,1,1,2000000,2990,2000,2000,-990,-33.11,2000,-990,-33.11,2000,2000,1400-10-26,2022-01-16
876,شتولي,تولي‌پرس‌,1,265,5035000,19750,19000,19000,-750,-3.8,19000,-750,-3.8,19000,19000,1400-10-26,2022-01-16
877,طجار2011,اختيارف وتجارت-1600-1401/02/21,1,55,2750000,60,50,50,-10,-16.67,50,-10,-16.67,50,50,1400-10-26,2022-01-16
878,ضسپا3010,اختيارخ خساپا-1000-1401/03/25,1,1,805000,1,805,805,804,80400,805,804,80400,805,805,1400-10-26,2022-01-16
879,اراد354,مرابحه عام دولت3-ش.خ 0103,1,2000000,1978920000000,986500,989460,989460,2960,0.3,989460,2960,0.3,989460,989460,1400-10-26,2022-01-16
880,اراد45,مرابحه عام دولت4-ش.خ 0107,1,2000,1924300000,968500,962150,962150,-6350,-0.66,962150,-6350,-0.66,962150,962150,1400-10-26,2022-01-16
881,اراد85,مرابحه عام دولت85-ش.خ010704,1,2000,1955500000,968000,977750,977750,9750,1.01,977750,9750,1.01,977750,977750,1400-10-26,2022-01-16
882,فن آواح2,ح.گروه فن آوا,1,10000000,92000000000,9300,9200,9200,-100,-1.08,9200,-100,-1.08,9200,9200,1400-10-26,2022-01-16
883,كمند4,صندوق س. با درآمد ثابت كمند,1,142595790,1434941434770,10058,10063,10063,5,0.05,10063,5,0.05,10063,10063,1400-10-26,2022-01-16
884,طجار2013,اختيارف وتجارت-2000-1401/02/21,1,100,21000000,170,210,210,40,23.53,210,40,23.53,210,210,1400-10-26,2022-01-16
885,صنفت3122,صكوك منفعت نفت312-6ماهه 18/5%,1,2990000,2990000000000,990000,1000000,1000000,10000,1.01,1000000,10000,1.01,1000000,1000000,1400-10-26,2022-01-16
886,تسه00092,امتيازتسهيلات مسكن آذر 1400,1,78,780,1264223,10,10,-1264213,-100,10,-1264213,-100,10,10,1400-10-26,2022-01-16
887,صخود041,ص مرابحه خودرو041- 3ماهه 18%,1,1000,1015000000,1000000,1015000,1015000,15000,1.5,1015000,15000,1.5,1015000,1015000,1400-10-26,2022-01-16
888,آگاس2,صندوق س.هستي بخش آگاه-س,1,100000,100000,74314,1,1,-74313,-100,1,-74313,-100,1,1,1400-10-26,2022-01-16
889,صفارس307,صكوك اجاره فارس307- 3ماهه18%,1,500,501000000,991000,1002000,1002000,11000,1.11,1002000,11000,1.11,1002000,1002000,1400-10-26,2022-01-16
890,تملي709,تسهيلات مسكن ب. ملي-آذر97,1,7,3325000,500000,475000,475000,-25000,-5,475000,-25000,-5,475000,475000,1400-10-26,2022-01-16
891,طخود2017,اختيارف خودرو-1800-1401/02/07,1,60,3600000,70,60,60,-10,-14.29,60,-10,-14.29,60,60,1400-10-26,2022-01-16
892,اراد84,مرابحه عام دولت84-ش.خ030624,1,1000,985000000,981000,985000,985000,4000,0.41,985000,4000,0.41,985000,985000,1400-10-26,2022-01-16
893,سخند,صندوق س.سپهرخبرگان نفت-د,1,510,5127540,10049,10054,10054,5,0.05,10054,5,0.05,10054,10054,1400-10-26,2022-01-16
894,اراد424,مرابحه عام دولت4-ش.خ 0106,1,3000000,2976411000000,989930,992137,992137,2207,0.22,992137,2207,0.22,992137,992137,1400-10-26,2022-01-16
895,ضكاريس903,اختيارخ كاريس-16000-14010930,1,2,3064000,1551,1532,1532,-19,-1.23,1532,-19,-1.23,1532,1532,1400-10-26,2022-01-16
896,شكف,كف,1,70,5043500,73500,72050,72050,-1450,-1.97,72050,-1450,-1.97,72050,72050,1400-10-26,2022-01-16
897,ضپنا2012,اختيارخ رمپنا-12000-1401/02/07,1,1,5850000,5820,5850,5850,30,0.52,5850,30,0.52,5850,5850,1400-10-26,2022-01-16
898,ضملي3014,اختيارخ فملي-8000-1401/03/02,1,10,5000000,500,500,500,0,0,500,0,0,500,500,1400-10-26,2022-01-16
899,ملت2,بيمه ملت,1,144529590,180661987500,1242,1250,1250,8,0.64,1250,8,0.64,1250,1250,1400-10-26,2022-01-16
900,فولاد2,فولاد مباركه اصفهان,1,8000000,80000000000,10050,10000,10000,-50,-0.5,10000,-50,-0.5,10000,10000,1400-10-26,2022-01-16
901,وصندوق2,سرمايه‌گذاري‌صندوق‌بازنشستگي‌,1,3000000,34320000000,11460,11440,11440,-20,-0.17,11440,-20,-0.17,11440,11440,1400-10-26,2022-01-16
902,دشيري,شيرين دارو,1,56,6146000,113100,109750,109750,-3350,-2.96,113100,0,0,109750,109750,1400-10-26,2022-01-16
903,پابهمن,بار پايه بهمن,1,4000,2080000,369,520,520,151,40.92,520,151,40.92,520,520,1400-10-26,2022-01-16
904,داريوش2,صندوق س. ثروت داريوش -س,1,100000,100000,9330,1,1,-9329,-99.99,1,-9329,-99.99,1,1,1400-10-26,2022-01-16
905,فنرژي,گسترش صنايع انرژي آذرآب,1,559,5003050,9130,8950,8950,-180,-1.97,8950,-180,-1.97,8950,8950,1400-10-26,2022-01-16
906,ساذري,آذريت‌,1,800,5464000,7040,6830,6830,-210,-2.98,7040,0,0,6830,6830,1400-10-26,2022-01-16
907,آتيمس2,صندوق س.آرمان آتيه درخشان مس-س,1,20000,20000,175981,1,1,-175980,-100,1,-175980,-100,1,1,1400-10-26,2022-01-16
908,امين يكم4,صندوق درآمد ثابت امين يكم فردا,1,100000000,1012300000000,10119,10123,10123,4,0.04,10123,4,0.04,10123,10123,1400-10-26,2022-01-16
909,كهرام,توليدي گرانيت بهسرام,1,58,5037300,88600,86850,86850,-1750,-1.98,88600,0,0,86850,86850,1400-10-26,2022-01-16
910,ضشنا2015,اختيارخ شپنا-6000-1401/02/25,1,30,18030000,800,601,601,-199,-24.88,601,-199,-24.88,601,601,1400-10-26,2022-01-16
911,ضفرابورس1200,اختيارخ فرابورس-19000-14001218,1,2,1800000,1100,900,900,-200,-18.18,900,-200,-18.18,900,900,1400-10-26,2022-01-16
912,سبرق021,سلف موازي برق صادراتي گيلان021,1,250000,48275000000,192500,193100,193100,600,0.31,193100,600,0.31,193100,193100,1400-10-26,2022-01-16
913,تبريز304,مشاركت ش تبريز304-3ماهه18%,1,10000,10000000000,1000000,1000000,1000000,0,0,1000000,0,0,1000000,1000000,1400-10-26,2022-01-16
914,ميدكو2,توسعه معادن وص.معدني خاورميانه,1,3300000,151800000000,46000,46000,46000,0,0,46000,0,0,46000,46000,1400-10-26,2022-01-16
915,فارس2,صنايع پتروشيمي خليج فارس,1,17764026,179771943120,10120,10120,10120,0,0,10120,0,0,10120,10120,1400-10-26,2022-01-16
916,سپيدما4,صندوق س. سپيد دماوند-د,1,85461000,999979161000,11694,11701,11701,7,0.06,11701,7,0.06,11701,11701,1400-10-26,2022-01-16
917,ضاريان1204,اختيارخ آريان-18000-14001211,1,10,2220000,40,222,222,182,455,222,182,455,222,222,1400-10-26,2022-01-16
918,حرهشا4,رهشاد سپاهان (سهامي عام,1,450000,35257500000,79100,78350,78350,-750,-0.95,78350,-750,-0.95,78350,78350,1400-10-26,2022-01-16
919,ضجار2014,اختيارخ وتجارت-2500-1401/02/21,1,10,1190000,104,119,119,15,14.42,119,15,14.42,119,119,1400-10-26,2022-01-16
920,اراد914,مرابحه عام دولت91-ش.خ010525,1,2357900,2279690814900,995000,966831,966831,-28169,-2.83,966831,-28169,-2.83,966831,966831,1400-10-26,2022-01-16
921,سرو2,صندوق س سروسودمند مدبران-سهام,1,240000,240000,66000,1,1,-65999,-100,1,-65999,-100,1,1,1400-10-26,2022-01-16
922,ضجار2009,اختيارخ وتجارت-1200-1401/02/21,1,1,860000,930,860,860,-70,-7.53,860,-70,-7.53,860,860,1400-10-26,2022-01-16
923,ضپاس2009,اختيارخ وپارس-1200-1401/02/28,1,15,11100000,945,740,740,-205,-21.69,740,-205,-21.69,740,740,1400-10-26,2022-01-16
924,صپا ه 18,بار پايه هفته 18صنعتي,1,3700,1924000,570,520,520,-50,-8.77,520,-50,-8.77,520,520,1400-10-26,2022-01-16
925,نگين,ص.س. زمين و ساختمان نگين شهرري,1,300,15549000,51830,51830,51830,0,0,51830,0,0,51830,51830,1400-10-26,2022-01-16
926,صنفت312,صكوك منفعت نفت312-6ماهه 18/5%,1,10000,10000000000,990000,1000000,1000000,10000,1.01,1000000,10000,1.01,1000000,1000000,1400-10-26,2022-01-16
927,وشمال,س. چشم انداز توسعه شمال,1,81,5050350,63600,62350,62350,-1250,-1.97,62350,-1250,-1.97,62350,62350,1400-10-26,2022-01-16
928,ضسپا1110,اختيارخ خساپا-1200-1400/11/20,1,100,50000000,555,500,500,-55,-9.91,500,-55,-9.91,500,500,1400-10-26,2022-01-16
929,ضپنا2011,اختيارخ رمپنا-10000-1401/02/07,1,3,22800000,7500,7600,7600,100,1.33,7600,100,1.33,7600,7600,1400-10-26,2022-01-16
930,کمبهمن,کم باري بهمن,1,1000,460000,250000,460,460,-249540,-99.82,460,-249540,-99.82,460,460,1400-10-26,2022-01-16
931,صپابهمن,بار پايه صنعتي بهمن,1,3000,1572000,570,524,524,-46,-8.07,524,-46,-8.07,524,524,1400-10-26,2022-01-16
932,ضملت1131,اختيارخ وبملت-2000-1400/11/13,1,1,950000,1200,950,950,-250,-20.83,950,-250,-20.83,950,950,1400-10-26,2022-01-16
933,اراد854,مرابحه عام دولت85-ش.خ010704,1,2998000,2931294500000,968000,977750,977750,9750,1.01,977750,9750,1.01,977750,977750,1400-10-26,2022-01-16
934,اراد454,مرابحه عام دولت4-ش.خ 0107,1,736573,702513127907,968500,953759,953759,-14741,-1.52,953759,-14741,-1.52,953759,953759,1400-10-26,2022-01-16
935,كارا4,صندوق س. كارا -د,1,50000000,529000000000,10573,10580,10580,7,0.07,10580,7,0.07,10580,10580,1400-10-26,2022-01-16
936,سفارود,كارخانه فارسيت درود,1,1000,11770000,12010,11770,11770,-240,-2,11770,-240,-2,11770,11770,1400-10-26,2022-01-16
937,اراد63,مرابحه عام دولت63-ش.خ0309,1,1000,1045000000,1035000,1045000,1045000,10000,0.97,1045000,10000,0.97,1045000,1045000,1400-10-26,2022-01-16
938,فسديد,لوله‌وتجهيزات‌ سديد - ورشكسته,1,60,5250000,89250,87500,87500,-1750,-1.96,87500,-1750,-1.96,87500,87500,1400-10-26,2022-01-16
939,ضپنا2017,اختيارخ رمپنا-24000-1401/02/07,1,14,28000,1,2,2,1,100,2,1,100,2,2,1400-10-26,2022-01-16
940,كشم0101پ01,كشمش سبز0101خليل آباد(پ),1,15,9367500,656565,624500,624500,-32065,-4.88,624500,-32065,-4.88,624500,624500,1400-10-26,2022-01-16
941,كهمدا2,شيشه‌ همدان‌,1,4500000,43380000000,9810,9640,9640,-170,-1.73,9640,-170,-1.73,9640,9640,1400-10-26,2022-01-16
942,صنفت03122,صكوك منفعت نفت0312-6ماهه 18/5%,1,270000,270000000000,1000000,1000000,1000000,0,0,1000000,0,0,1000000,1000000,1400-10-26,2022-01-16
943,اخزا9034,اسنادخزانه-م3بودجه99-011110,1,1300000,1052922000000,809940,809940,809940,0,0,809940,0,0,809940,809940,1400-10-26,2022-01-16
