,نماد,نام,تعداد,حجم,ارزش,دیروز,اولین,آخرین معامله - مقدار,آخرین معامله - تغییر,آخرین معامله - درصد,قیمت پایانی - مقدار,قیمت پایانی - تغییر,قیمت پایانی - درصد,کمترین,بیشترین,تاریخ,gregorian_date
0,توسن,توسعه سامانه ي نرم افزاري نگين,66491,29739502,404706495497,13080,13650,13734,654,5,13608,528,4.04,13103,13734,1400-7-20,2021-10-12
1,فجهان,مجتمع جهان فولاد سيرجان,37363,228733098,1391632602325,5933,5932,6229,296,4.99,6084,151,2.55,5710,6229,1400-7-20,2021-10-12
2,پالايش,صندوق پالايشي يكم-سهام,30830,27243977,2002523700990,77190,75060,72900,-4290,-5.56,73500,-3690,-4.78,72850,75190,1400-7-20,2021-10-12
3,فسبزوار,پارس فولاد سبزوار,30751,23053843,818819670370,35400,35020,36010,610,1.72,35520,120,0.34,34210,36980,1400-7-20,2021-10-12
4,دي,بانك دي,28890,991292694,971431051718,1020,1001,975,-45,-4.41,980,-40,-3.92,969,1005,1400-7-20,2021-10-12
5,كيمياتك,آريان كيميا تك,18611,9695547,287875454810,31170,30500,29630,-1540,-4.94,29690,-1480,-4.75,29620,31170,1400-7-20,2021-10-12
6,شستا,سرمايه گذاري تامين اجتماعي,17960,98011403,1219476865790,12990,12900,12350,-640,-4.93,12440,-550,-4.23,12350,12900,1400-7-20,2021-10-12
7,شبندر,پالايش نفت بندرعباس,14894,242604435,1599714337110,6920,6770,6590,-330,-4.77,6590,-330,-4.77,6580,6800,1400-7-20,2021-10-12
8,شپنا,پالايش نفت اصفهان,14842,167276299,2224953080860,13980,13510,13290,-690,-4.94,13300,-680,-4.86,13290,13560,1400-7-20,2021-10-12
9,دارا يكم,صندوق واسطه گري مالي يكم-سهام,14184,6581318,767787866840,121220,119980,115960,-5260,-4.34,116660,-4560,-3.76,115660,119980,1400-7-20,2021-10-12
10,بركت,گروه دارويي بركت,14041,37534292,1140159579070,31850,31850,30260,-1590,-4.99,30380,-1470,-4.62,30260,32170,1400-7-20,2021-10-12
11,لپارس,پارس‌ الكتريك‌,13472,12071580,2116830824960,172450,174450,164010,-8440,-4.89,175360,2910,1.69,163830,181070,1400-7-20,2021-10-12
12,خودرو,ايران‌ خودرو,12490,411410456,717413969280,1831,1795,1740,-91,-4.97,1744,-87,-4.75,1740,1814,1400-7-20,2021-10-12
13,خساپا,سايپا,10728,358134304,583745997772,1710,1690,1625,-85,-4.97,1630,-80,-4.68,1625,1690,1400-7-20,2021-10-12
14,فولاد,فولاد مباركه اصفهان,10131,67893378,683649281270,10310,10150,10080,-230,-2.23,10070,-240,-2.33,9990,10250,1400-7-20,2021-10-12
15,مديريت,س. و خدمات مديريت صند. ب كشوري,9958,31753079,283284153819,9339,9250,8873,-466,-4.99,8921,-418,-4.48,8873,9280,1400-7-20,2021-10-12
16,كمند,صندوق س. با درآمد ثابت كمند,7585,308170806,3090246708978,10023,10028,10028,5,0.05,10028,5,0.05,10027,10029,1400-7-20,2021-10-12
17,فملي,ملي‌ صنايع‌ مس‌ ايران‌,7392,52736470,656424050190,12790,12660,12400,-390,-3.05,12450,-340,-2.66,12350,12770,1400-7-20,2021-10-12
18,امين,تامين سرمايه امين,7331,3420869,36375276750,10500,10550,10790,290,2.76,10600,100,0.95,10550,10800,1400-7-20,2021-10-12
19,نوري,پتروشيمي نوري,6802,3883866,407110943610,109310,107720,103900,-5410,-4.95,104820,-4490,-4.11,103850,108900,1400-7-20,2021-10-12
20,وبملت,بانك ملت,6569,125652120,440127127150,3639,3630,3500,-139,-3.82,3503,-136,-3.74,3476,3630,1400-7-20,2021-10-12
21,زاگرس,پتروشيمي زاگرس,6560,4272536,1352820007153,305533,320809,317753,12220,4,316632,11099,3.63,306975,320809,1400-7-20,2021-10-12
22,تپكو,توليدتجهيزات‌سنگين‌هپكو,6515,163790127,431885973717,2564,2640,2621,57,2.22,2637,73,2.85,2577,2640,1400-7-20,2021-10-12
23,سنير,سيمان‌ سفيد ني‌ريز,6323,4669106,590281697870,127880,134270,121490,-6390,-5,126420,-1460,-1.14,121490,134270,1400-7-20,2021-10-12
24,وسديد,گروه ‌صنعتي‌سديد,5900,117359093,125078690086,1117,1114,1062,-55,-4.92,1066,-51,-4.57,1062,1117,1400-7-20,2021-10-12
25,بوعلي,پتروشيمي بوعلي سينا,5617,2651197,190499802210,74140,73100,72160,-1980,-2.67,71850,-2290,-3.09,70700,73930,1400-7-20,2021-10-12
26,آريا,پليمر آريا ساسول,5474,2333843,252760797194,113149,112000,108200,-4949,-4.37,108302,-4847,-4.28,107492,112300,1400-7-20,2021-10-12
27,صبا,سرمايه گذاري صبا تامين,5353,46521035,286615785627,6430,6397,6120,-310,-4.82,6161,-269,-4.18,6109,6397,1400-7-20,2021-10-12
28,چكاپا,گروه صنايع كاغذ پارس,5350,108027499,377898851973,3340,3507,3507,167,5,3498,158,4.73,3411,3507,1400-7-20,2021-10-12
29,وهامون,سرمايه گذاري هامون صبا,5287,37632979,112192069974,3132,3034,2981,-151,-4.82,2981,-151,-4.82,2976,3049,1400-7-20,2021-10-12
30,وتجارت,بانك تجارت,5279,128269636,258190679559,2096,2050,2000,-96,-4.58,2013,-83,-3.96,1992,2075,1400-7-20,2021-10-12
31,سپيد,سپيد ماكيان,5198,3515222,193691544880,57410,56880,54800,-2610,-4.55,55100,-2310,-4.02,54550,57120,1400-7-20,2021-10-12
32,كرمان,س. توسعه و عمران استان كرمان,5088,172764808,187724638332,1139,1117,1083,-56,-4.92,1087,-52,-4.57,1083,1138,1400-7-20,2021-10-12
33,خپارس,پارس‌ خودرو,4693,177791144,184593504954,1075,1065,1039,-36,-3.35,1038,-37,-3.44,1023,1070,1400-7-20,2021-10-12
34,شصدف,صنعتي دوده فام,4657,6099971,190717250833,31005,31900,32000,995,3.21,31265,260,0.84,29481,32380,1400-7-20,2021-10-12
35,خگستر,گسترش‌سرمايه‌گذاري‌ايران‌خودرو,4618,181259519,413031914034,2395,2330,2276,-119,-4.97,2279,-116,-4.84,2276,2389,1400-7-20,2021-10-12
36,غمينو,شركت صنايع غذايي مينو شرق,4563,53317985,357718588064,6412,6732,6732,320,4.99,6709,297,4.63,6421,6732,1400-7-20,2021-10-12
37,سپيدار,سپيدار سيستم آسيا,4254,2142671,36386326232,17648,18090,16960,-688,-3.9,16982,-666,-3.77,16800,18100,1400-7-20,2021-10-12
38,پترول,گ.س.وت.ص.پتروشيمي خليج فارس,4179,55942344,196918622759,3699,3571,3515,-184,-4.97,3520,-179,-4.84,3515,3625,1400-7-20,2021-10-12
39,كالا,بورس كالاي ايران,4026,21172436,735438568000,36460,35400,34640,-1820,-4.99,34740,-1720,-4.72,34640,35980,1400-7-20,2021-10-12
40,وبصادر,بانك صادرات ايران,3957,111561094,224528106045,2108,2061,2004,-104,-4.93,2013,-95,-4.51,2003,2080,1400-7-20,2021-10-12
41,ذوب,سهامي ذوب آهن  اصفهان,3749,47246788,182193153226,4031,3929,3836,-195,-4.84,3856,-175,-4.34,3830,3940,1400-7-20,2021-10-12
42,آبادا,توليد نيروي برق آبادان,3624,3418872,51588490570,15530,15900,15110,-420,-2.7,15090,-440,-2.83,14760,15900,1400-7-20,2021-10-12
43,هاي وب,داده گسترعصرنوين-هاي وب,3613,29531222,231396186100,8230,8230,7850,-380,-4.62,7840,-390,-4.74,7820,8230,1400-7-20,2021-10-12
44,خبهمن,گروه‌بهمن‌,3600,217460911,375862743805,1814,1751,1725,-89,-4.91,1728,-86,-4.74,1724,1780,1400-7-20,2021-10-12
45,ولكار,ليزينگ كارآفرين,3507,7544608,31654157013,4232,4100,4220,-12,-0.28,4196,-36,-0.85,4021,4260,1400-7-20,2021-10-12
46,كيان,صندوق س. با درآمد ثابت كيان,3415,28323683,877908661068,30978,30997,30994,16,0.05,30996,18,0.06,30993,30998,1400-7-20,2021-10-12
47,وگستر,گسترش سرمايه گذاري ايرانيان,3403,20915441,224215748937,10763,10450,10429,-334,-3.1,10720,-43,-0.4,10284,11140,1400-7-20,2021-10-12
48,شاروم,پتروشيمي اروميه,3375,3795501,61891549807,16985,17000,16136,-849,-5,16307,-678,-3.99,16136,17066,1400-7-20,2021-10-12
49,شگويا,پتروشيمي تندگويان,3371,16396382,185324996453,11800,11600,11300,-500,-4.24,11303,-497,-4.21,11210,11600,1400-7-20,2021-10-12
50,شسينا,صنايع‌شيميايي‌سينا,3353,3351512,334685963380,95770,100550,100550,4780,4.99,99860,4090,4.27,96010,100550,1400-7-20,2021-10-12
51,خنصير,مهندسي‌نصيرماشين‌,3329,18534155,422655997860,21810,22900,22900,1090,5,22800,990,4.54,22000,22900,1400-7-20,2021-10-12
52,وسپهر,سرمايه گذاري مالي سپهرصادرات,3310,10268321,71945178030,7176,7080,7002,-174,-2.42,7031,-145,-2.02,6940,7145,1400-7-20,2021-10-12
53,فارس,صنايع پتروشيمي خليج فارس,3296,28410067,377654699170,13770,13510,13160,-610,-4.43,13290,-480,-3.49,13150,13690,1400-7-20,2021-10-12
54,غكورش,صنعت غذايي كورش,3286,2561352,108106195450,43700,43120,42010,-1690,-3.87,42210,-1490,-3.41,41700,43410,1400-7-20,2021-10-12
55,وملي,گروه‌ صنعتي‌ ملي‌ (هلدينگ‌,3219,1318174,309838184110,245170,248900,232920,-12250,-5,235050,-10120,-4.13,232920,248900,1400-7-20,2021-10-12
56,ثبهساز,بهساز كاشانه تهران,3151,41608966,76818865154,1939,1889,1843,-96,-4.95,1846,-93,-4.8,1843,1939,1400-7-20,2021-10-12
57,غزر,صنعتي زر ماكارون,3146,5102509,56654471690,11650,11640,11080,-570,-4.89,11100,-550,-4.72,11070,11670,1400-7-20,2021-10-12
58,چخزر,صنايع چوب خزر كاسپين,3100,1343566,41586614794,32522,32200,30896,-1626,-5,30952,-1570,-4.83,30896,32200,1400-7-20,2021-10-12
59,لطيف,محصولات كاغذي لطيف,2988,583713,23836000067,42277,42670,40420,-1857,-4.39,40835,-1442,-3.41,40220,42670,1400-7-20,2021-10-12
60,شفن,پتروشيمي فناوران,2924,802668,353645828900,454080,460000,442500,-11580,-2.55,440590,-13490,-2.97,432500,460000,1400-7-20,2021-10-12
61,كمرجان,بازرگاني و توليدي مرجان كار,2904,1503234,132950285217,87859,89330,88600,741,0.84,88443,584,0.66,83700,92200,1400-7-20,2021-10-12
62,غگيلا,شيرپاستوريزه پگاه گيلان,2894,1823733,37694737377,19685,20669,20669,984,5,20669,984,5,20669,20669,1400-7-20,2021-10-12
63,سرو,صندوق س سروسودمند مدبران-سهام,2892,2334485,173880835920,77510,76190,73970,-3540,-4.57,74480,-3030,-3.91,73850,76190,1400-7-20,2021-10-12
64,ثاميد,توسعه و عمران اميد,2888,35980068,54464889702,1578,1550,1501,-77,-4.88,1514,-64,-4.06,1500,1580,1400-7-20,2021-10-12
65,شلرد,كود شيميايي اوره لردگان,2873,30232238,297131262504,9592,9879,9879,287,2.99,9828,236,2.46,9532,9879,1400-7-20,2021-10-12
66,وكبهمن,مديريت سرمايه گذاري كوثربهمن,2849,2246203,25333820926,11461,11352,11005,-456,-3.98,11279,-182,-1.59,10950,11790,1400-7-20,2021-10-12
67,فخوز,فولاد  خوزستان,2825,20298718,322016887490,16370,16200,15760,-610,-3.73,15860,-510,-3.12,15690,16490,1400-7-20,2021-10-12
68,قاسم,قاسم ايران,2814,32928126,164884519869,4863,5106,4880,17,0.35,5007,144,2.96,4760,5106,1400-7-20,2021-10-12
69,وغدير,سرمايه‌گذاري‌غدير(هلدينگ‌,2794,20847372,321711592570,16000,15700,15380,-620,-3.88,15430,-570,-3.56,15250,15900,1400-7-20,2021-10-12
70,شبريز,پالايش نفت تبريز,2744,12131120,488104144960,42290,40180,40180,-2110,-4.99,40240,-2050,-4.85,40180,41800,1400-7-20,2021-10-12
71,اعتماد,صندوق س.اعتماد آفرين پارسيان-د,2736,53114560,2086659915030,39264,39286,39288,24,0.06,39286,22,0.06,39285,39290,1400-7-20,2021-10-12
72,كزغال,زغال سنگ پروده طبس,2724,1664564,56183270368,35240,34550,33800,-1440,-4.09,33753,-1487,-4.22,33478,34730,1400-7-20,2021-10-12
73,فگستر,گسترش صنايع روي ايرانيان,2724,3053435,37612200621,12921,12841,12285,-636,-4.92,12318,-603,-4.67,12275,12870,1400-7-20,2021-10-12
74,كاما,باما,2656,19810392,186617578510,9890,9830,9400,-490,-4.95,9420,-470,-4.75,9400,9830,1400-7-20,2021-10-12
75,ديران,ايران‌دارو,2650,6991913,225867897280,31480,32400,32800,1320,4.19,32300,820,2.6,30800,32970,1400-7-20,2021-10-12
76,بپيوند,برق و انرژي پيوندگستر پارس,2645,5454275,56264344815,10839,10690,10298,-541,-4.99,10316,-523,-4.83,10298,10690,1400-7-20,2021-10-12
77,حگردش,ريل گردش ايرانيان,2625,46151211,139583016080,2950,3038,3038,88,2.98,3024,74,2.51,2900,3038,1400-7-20,2021-10-12
78,امين يكم,صندوق درآمد ثابت امين يكم فردا,2618,70881054,715896497156,10093,10103,10101,8,0.08,10100,7,0.07,10095,10105,1400-7-20,2021-10-12
79,رافزا,رايان هم افزا,2586,689049,51256001414,78008,76000,74990,-3018,-3.87,74387,-3621,-4.64,74108,76990,1400-7-20,2021-10-12
80,پارند,صندوق س. پارند پايدار سپهر,2580,106665290,1069847084535,10023,10030,10030,7,0.07,10030,7,0.07,10029,10031,1400-7-20,2021-10-12
81,سيتا,سرمايه گذاري سيمان تامين,2571,6806201,76224721970,11630,11540,11160,-470,-4.04,11200,-430,-3.7,11070,11540,1400-7-20,2021-10-12
82,سمگا,گروه سرمايه گذاري ميراث فرهنگي,2543,36631271,439936837162,11911,12120,12200,289,2.43,12010,99,0.83,11551,12340,1400-7-20,2021-10-12
83,تسه0006,امتيازتسهيلات مسكن شهريور1400,2524,115809,80385888892,730186,700099,693677,-36509,-5,694125,-36061,-4.94,693677,703000,1400-7-20,2021-10-12
84,فرابورس,فرابورس ايران,2514,11858641,293794807812,26051,25250,24749,-1302,-5,24775,-1276,-4.9,24749,25250,1400-7-20,2021-10-12
85,زملارد,كشاورزي و دامپروري ملارد شير,2454,1253261,28512125214,23915,23200,22730,-1185,-4.96,22750,-1165,-4.87,22720,23500,1400-7-20,2021-10-12
86,شغدير,پتروشيمي غدير,2453,3013985,327460306080,112290,113010,109830,-2460,-2.19,108650,-3640,-3.24,106680,113010,1400-7-20,2021-10-12
87,وپارس,بانك‌پارسيان‌,2393,89169608,217533774249,2536,2540,2425,-111,-4.38,2440,-96,-3.79,2410,2550,1400-7-20,2021-10-12
88,فتوسا,توليد و توسعه سرب روي ايرانيان,2366,2551713,31592925400,13015,13020,12365,-650,-4.99,12381,-634,-4.87,12365,13020,1400-7-20,2021-10-12
89,آپ,آسان پرداخت پرشين,2357,14874221,145854772540,10220,9950,9950,-270,-2.64,9810,-410,-4.01,9710,10130,1400-7-20,2021-10-12
90,شاوان,پالايش نفت لاوان,2339,2940709,411271104494,146565,145800,140620,-5945,-4.06,139854,-6711,-4.58,139237,145800,1400-7-20,2021-10-12
91,خاذين,سايپاآذين‌,2250,15126328,46960786727,3214,3214,3054,-160,-4.98,3105,-109,-3.39,3054,3264,1400-7-20,2021-10-12
92,ويسا,سرمايه گذاري ايساتيس پويا,2210,10733058,67903171629,6172,6357,6357,185,3,6327,155,2.51,6005,6357,1400-7-20,2021-10-12
93,غويتا,ويتانا,2187,14403347,99268050155,6822,7000,6844,22,0.32,6892,70,1.03,6701,7052,1400-7-20,2021-10-12
94,كوير,توليدي فولاد سپيد فراب كوير,2151,12477057,163432143860,13660,13410,13000,-660,-4.83,13100,-560,-4.1,12980,13770,1400-7-20,2021-10-12
95,ومعادن,توسعه‌معادن‌وفلزات‌,2136,26460524,269327663820,10430,10050,10370,-60,-0.58,10180,-250,-2.4,9910,10500,1400-7-20,2021-10-12
96,ثتران,سرمايه گذاري مسكن تهران,2135,26141535,116765578891,4632,4600,4401,-231,-4.99,4467,-165,-3.56,4401,4600,1400-7-20,2021-10-12
97,بترانس,ايران‌ ترانسفو,2126,53412359,122305970212,2407,2350,2287,-120,-4.99,2290,-117,-4.86,2287,2359,1400-7-20,2021-10-12
98,وسكرمان,س.سهام عدالت استان كرمان,2113,140530116,68955396442,503,504,492,-11,-2.19,491,-12,-2.39,482,505,1400-7-20,2021-10-12
99,تاپيكو,س. نفت و گاز و پتروشيمي تأمين,2007,18590051,261697747500,14680,14450,14010,-670,-4.56,14080,-600,-4.09,14000,14480,1400-7-20,2021-10-12
100,شپديس,پتروشيمي پرديس,2000,1401062,265677883860,190930,193950,190020,-910,-0.48,189630,-1300,-0.68,186000,193970,1400-7-20,2021-10-12
101,شسپا,نفت سپاهان,1987,32019702,106246830338,3461,3433,3300,-161,-4.65,3318,-143,-4.13,3290,3460,1400-7-20,2021-10-12
102,ثنور,سرمايه گذاري كوه نور,1962,24464854,198528747043,8276,8028,8237,-39,-0.47,8115,-161,-1.95,8028,8344,1400-7-20,2021-10-12
103,نطرين,عطرين نخ قم,1949,27461204,212265392016,7423,7250,7794,371,5,7730,307,4.14,7181,7794,1400-7-20,2021-10-12
104,تكشا,گسترش‌صنايع‌وخدمات‌كشاورزي‌,1944,5405298,210939263770,37810,38720,38920,1110,2.94,39020,1210,3.2,36000,39700,1400-7-20,2021-10-12
105,بميلا,توسعه بازرگاني آهن وفولادميلاد,1941,15324263,210104551991,13691,14375,13385,-306,-2.24,13711,20,0.15,13010,14375,1400-7-20,2021-10-12
106,ملت,بيمه ملت,1929,72868628,82868920104,1194,1172,1135,-59,-4.94,1137,-57,-4.77,1135,1172,1400-7-20,2021-10-12
107,شاراك,پتروشيمي شازند,1919,5391665,260326924370,49540,48000,48410,-1130,-2.28,48280,-1260,-2.54,47200,49200,1400-7-20,2021-10-12
108,لكما,كارخانجات‌مخابراتي‌ايران‌,1906,47407674,62873818850,1390,1350,1321,-69,-4.96,1326,-64,-4.6,1321,1380,1400-7-20,2021-10-12
109,گدنا,تهيه توزيع غذاي دنا آفرين فدك,1888,3127228,51251019509,17208,16690,16348,-860,-5,16389,-819,-4.76,16348,16970,1400-7-20,2021-10-12
110,فايرا,آلومينيوم‌ايران‌,1864,8616523,159097755420,18060,18190,18810,750,4.15,18460,400,2.21,18090,18850,1400-7-20,2021-10-12
111,دسانكو,داروسازي سبحان انكولوژي,1856,10741219,154703596859,14940,15003,14193,-747,-5,14403,-537,-3.59,14193,15289,1400-7-20,2021-10-12
112,ثنظام,س. ساختماني نظام مهندسي ايران,1840,4438301,120316501289,26770,27500,26181,-589,-2.2,27109,339,1.27,25968,27573,1400-7-20,2021-10-12
113,خراسان,پتروشيمي خراسان,1820,1898434,216361061440,113770,115000,115000,1230,1.08,113970,200,0.18,109810,116630,1400-7-20,2021-10-12
114,فجر,فولاد اميركبيركاشان,1817,4435270,111347417050,26230,26430,24930,-1300,-4.96,25100,-1130,-4.31,24920,26430,1400-7-20,2021-10-12
115,فردا,صندوق س آواي فرداي زاگرس-ثابت,1815,88103878,1021564527839,11588,11595,11595,7,0.06,11595,7,0.06,11594,11596,1400-7-20,2021-10-12
116,ماديرا,صنايع ماديران,1783,16709017,128791691047,8095,7950,7695,-400,-4.94,7708,-387,-4.78,7691,8090,1400-7-20,2021-10-12
117,غصينو,صنعتي مينو,1780,13183188,207334484416,16480,15656,16140,-340,-2.06,15727,-753,-4.57,15656,16600,1400-7-20,2021-10-12
118,پارسان,گسترش نفت و گاز پارسيان,1758,13901580,484806949940,36030,35500,34700,-1330,-3.69,34870,-1160,-3.22,34520,35990,1400-7-20,2021-10-12
119,كاوه,فولاد كاوه جنوب كيش,1729,6132734,103632000290,17350,17320,16930,-420,-2.42,16900,-450,-2.59,16800,17320,1400-7-20,2021-10-12
120,فروي,ذوب روي اصفهان,1694,3112404,86623172614,29252,29251,27790,-1462,-5,27832,-1420,-4.85,27790,29251,1400-7-20,2021-10-12
121,وسكرد,شركت س استان كردستان,1676,99104254,48650894241,509,487,485,-24,-4.72,491,-18,-3.54,484,501,1400-7-20,2021-10-12
122,حسير,ريل سير كوثر,1626,4939154,199309567031,40662,41698,40662,0,0,40353,-309,-0.76,39002,41698,1400-7-20,2021-10-12
123,فروس,فروسيليس‌ ايران‌,1623,15348606,115956239750,7630,7750,7720,90,1.18,7550,-80,-1.05,7320,7850,1400-7-20,2021-10-12
124,خاور,ايران خودرو ديزل,1598,18175749,127880065519,7371,7500,7003,-368,-4.99,7036,-335,-4.54,7003,7500,1400-7-20,2021-10-12
125,قثابت,قند ثابت‌ خراسان‌,1550,28575256,91141836615,3333,3300,3167,-166,-4.98,3190,-143,-4.29,3167,3301,1400-7-20,2021-10-12
126,آگاس,صندوق س.هستي بخش آگاه-س,1536,2004212,163592435786,83743,82700,80921,-2822,-3.37,81624,-2119,-2.53,80901,82700,1400-7-20,2021-10-12
127,كدما,معدني‌ دماوند,1533,905324,107884700190,125060,120000,118810,-6250,-5,119170,-5890,-4.71,118810,122380,1400-7-20,2021-10-12
128,وسكرشا,س.سهام عدالت استان كرمانشاه,1521,96804709,47257092736,501,501,488,-13,-2.59,488,-13,-2.59,480,501,1400-7-20,2021-10-12
129,كرازي,كارخانجات‌توليدي‌شيشه‌رازي‌,1520,56056653,74837627615,1402,1385,1332,-70,-4.99,1335,-67,-4.78,1332,1385,1400-7-20,2021-10-12
130,اپال,فرآوري معدني اپال كاني پارس,1508,2316379,44747374600,20040,19650,19290,-750,-3.74,19760,-280,-1.4,19150,19650,1400-7-20,2021-10-12
131,فاراك,ماشين‌ سازي‌ اراك‌,1481,64508083,103141671049,1676,1680,1593,-83,-4.95,1599,-77,-4.59,1593,1680,1400-7-20,2021-10-12
132,نمرينو,ايران‌ مرينوس‌,1475,979008,105199553860,108840,114280,103400,-5440,-5,107460,-1380,-1.27,103400,114280,1400-7-20,2021-10-12
133,كلر,كلر پارس,1466,1016305,127979468287,129878,129879,123400,-6478,-4.99,125926,-3952,-3.04,123385,130698,1400-7-20,2021-10-12
134,پيزد,مجتمع صنايع لاستيك يزد,1459,234958,13820596665,60776,58779,58265,-2511,-4.13,58846,-1930,-3.18,57738,60402,1400-7-20,2021-10-12
135,حفارس,حمل و نقل بين المللي خليج فارس,1457,24431587,101046514367,4048,4158,4064,16,0.4,4136,88,2.17,3900,4250,1400-7-20,2021-10-12
136,فاهواز,نورد و لوله اهواز,1441,18090017,119231811830,6590,6459,6525,-65,-0.99,6591,1,0.02,6459,6721,1400-7-20,2021-10-12
137,بجهرم,توسعه مولد نيروگاهي جهرم,1435,23894133,54200758231,2334,2310,2228,-106,-4.54,2268,-66,-2.83,2220,2370,1400-7-20,2021-10-12
138,فزرين,زرين معدن آسيا,1420,8100424,120392298383,15626,15579,14845,-781,-5,14862,-764,-4.89,14845,15579,1400-7-20,2021-10-12
139,اطلس,صندوق س.توسعه اندوخته آينده-س,1420,323732,81068718689,257706,255450,249390,-8316,-3.23,250419,-7287,-2.83,249001,257998,1400-7-20,2021-10-12
140,كرماشا,صنايع پتروشيمي كرمانشاه,1416,4309296,227621586440,52850,53900,53100,250,0.47,52820,-30,-0.06,51120,53990,1400-7-20,2021-10-12
141,ولساپا,ليزينگ رايان‌ سايپا,1410,45560670,112651026640,2591,2493,2462,-129,-4.98,2473,-118,-4.55,2462,2550,1400-7-20,2021-10-12
142,تملت,تامين سرمايه بانك ملت,1404,12960485,51725330412,4191,4180,3982,-209,-4.99,3991,-200,-4.77,3982,4191,1400-7-20,2021-10-12
143,شرنگي,شيميايي رنگين,1403,1123372,161657770891,140344,144500,147361,7017,5,143904,3560,2.54,133327,147361,1400-7-20,2021-10-12
144,دماوند,توليد نيروي برق دماوند,1390,4059599,94521342471,24015,24015,22832,-1183,-4.93,23283,-732,-3.05,22815,24240,1400-7-20,2021-10-12
145,وسپه,سرمايه‌گذاري‌ سپه‌,1380,16759991,131713561430,8190,8220,7810,-380,-4.64,7860,-330,-4.03,7790,8220,1400-7-20,2021-10-12
146,وبانك,سرمايه گذاري گروه توسعه ملي,1378,15005282,127926340860,8880,8760,8520,-360,-4.05,8530,-350,-3.94,8440,8900,1400-7-20,2021-10-12
147,ولپارس,ليزينگ پارسيان,1328,8785084,39075899460,4670,4650,4437,-233,-4.99,4448,-222,-4.75,4437,4650,1400-7-20,2021-10-12
148,شيران,س. صنايع‌شيميايي‌ايران,1326,3330633,76260435400,23910,23550,22780,-1130,-4.73,23030,-880,-3.68,22720,23560,1400-7-20,2021-10-12
149,حفاري,حفاري شمال,1313,12943859,72059261570,5840,5790,5550,-290,-4.97,5570,-270,-4.62,5550,5790,1400-7-20,2021-10-12
150,اخابر,مخابرات ايران,1311,12858932,100726771550,8190,8150,7810,-380,-4.64,7860,-330,-4.03,7790,8150,1400-7-20,2021-10-12
151,كچاد,معدني‌وصنعتي‌چادرملو,1306,4810522,128573008960,27600,27020,26540,-1060,-3.84,26730,-870,-3.15,26510,27500,1400-7-20,2021-10-12
152,غشصفا,شيرپاستوريزه‌پگاه‌اصفهان‌,1305,3490483,126437958680,37380,37850,37540,160,0.43,36220,-1160,-3.1,35520,37850,1400-7-20,2021-10-12
153,رمپنا,گروه مپنا (سهامي عام),1305,21363151,357548626260,17590,16850,16720,-870,-4.95,16740,-850,-4.83,16720,17700,1400-7-20,2021-10-12
154,غسالم,سالمين‌,1298,14816127,42854582569,3027,3025,2876,-151,-4.99,2892,-135,-4.46,2876,3025,1400-7-20,2021-10-12
155,ختور,رادياتور ايران‌,1274,6013253,127746199790,21370,21310,21330,-40,-0.19,21240,-130,-0.61,20500,22000,1400-7-20,2021-10-12
156,حپترو,حمل و نقل پتروشيمي( سهامي عام,1256,3106454,86612787840,26670,28000,27800,1130,4.24,27880,1210,4.54,27180,28000,1400-7-20,2021-10-12
157,وثخوز,سرمايه گذاري و توسعه خوزستان,1255,2351457,85073642693,36659,38491,35070,-1589,-4.33,36179,-480,-1.31,34827,38491,1400-7-20,2021-10-12
158,ونوين,بانك‌اقتصادنوين‌,1239,21716064,82448545548,3928,3994,3799,-129,-3.28,3797,-131,-3.34,3741,3994,1400-7-20,2021-10-12
159,آريان,سرمايه گذاري پارس آريان,1234,42859353,752040502753,17714,17714,17515,-199,-1.12,17547,-167,-0.94,17500,17714,1400-7-20,2021-10-12
160,سيمرغ,سيمرغ,1223,6666444,124153157150,19540,19130,18600,-940,-4.81,18620,-920,-4.71,18570,19130,1400-7-20,2021-10-12
161,شراز,پالايش نفت شيراز,1219,1860236,254410007120,143887,138310,137838,-6049,-4.2,136762,-7125,-4.95,136693,140969,1400-7-20,2021-10-12
162,خزاميا,زامياد,1219,17547771,112795053830,6750,6510,6440,-310,-4.59,6430,-320,-4.74,6420,6590,1400-7-20,2021-10-12
163,پارس,پتروشيمي پارس,1179,657277,130627797010,204420,204000,200930,-3490,-1.71,198740,-5680,-2.78,196150,204000,1400-7-20,2021-10-12
164,شكام,صنايع شيميايي كيمياگران امروز,1169,6524335,213587154895,31179,32737,32737,1558,5,32737,1558,5,32737,32737,1400-7-20,2021-10-12
165,ثشاهد,سرمايه‌ گذاري‌ شاهد,1157,4134976,55213023170,13790,14070,13110,-680,-4.93,13350,-440,-3.19,13110,14070,1400-7-20,2021-10-12
166,فاسمين,كالسيمين‌,1152,8656496,140508950640,16800,16510,16010,-790,-4.7,16230,-570,-3.39,15960,16750,1400-7-20,2021-10-12
167,پتاير,ايران‌ تاير,1152,23710684,59696607855,2643,2668,2511,-132,-4.99,2518,-125,-4.73,2511,2668,1400-7-20,2021-10-12
168,وسگيلا,شركت س استان گيلان,1145,81804979,39731720544,493,486,500,7,1.42,486,-7,-1.42,469,502,1400-7-20,2021-10-12
169,خچرخش,چرخشگر,1142,8149467,93636735430,11780,11210,11240,-540,-4.58,11490,-290,-2.46,11200,12100,1400-7-20,2021-10-12
170,حريل,ريل پردازسير,1134,17116833,62877282341,3846,3752,3654,-192,-4.99,3673,-173,-4.5,3654,3752,1400-7-20,2021-10-12
171,ضخود1052,اختيارخ خودرو-2000-1400/10/08,1118,41607,6736693000,213,192,162,-51,-23.94,162,-51,-23.94,152,192,1400-7-20,2021-10-12
172,غدام,خوراك‌  دام‌ پارس‌,1116,507176,84462483320,175080,172000,166330,-8750,-5,166530,-8550,-4.88,166330,172000,1400-7-20,2021-10-12
173,ميهن,بيمه ميهن,1104,12336255,34246522069,2782,2830,2717,-65,-2.34,2776,-6,-0.22,2643,2900,1400-7-20,2021-10-12
174,كگل,معدني و صنعتي گل گهر,1102,4860400,107432810530,22760,23080,21900,-860,-3.78,22150,-610,-2.68,21860,23080,1400-7-20,2021-10-12
175,وهنر,گروه توسعه هنر ايران,1095,15907273,66220604591,4368,4150,4150,-218,-4.99,4163,-205,-4.69,4150,4236,1400-7-20,2021-10-12
176,طلا,صندوق س.پشتوانه طلاي لوتوس,1092,1332874,107697967327,82290,81490,80446,-1844,-2.24,80801,-1489,-1.81,80300,81490,1400-7-20,2021-10-12
177,رانفور,خدمات‌انفورماتيك‌,1084,25893081,118855326923,4818,4720,4650,-168,-3.49,4590,-228,-4.73,4578,4776,1400-7-20,2021-10-12
178,توريل,توكاريل,1081,3510473,49817587864,14304,14870,13810,-494,-3.45,14191,-113,-0.79,13610,14870,1400-7-20,2021-10-12
179,ختوقا,قطعات‌ اتومبيل‌ ايران‌,1074,30218440,65340465376,2274,2210,2161,-113,-4.97,2162,-112,-4.93,2161,2211,1400-7-20,2021-10-12
180,آسيا,بيمه آسيا,1065,31382060,59691075459,1973,1979,1939,-34,-1.72,1902,-71,-3.6,1875,1979,1400-7-20,2021-10-12
181,زماهان,مجتمع توليد گوشت مرغ ماهان,1037,3921735,36771117795,9651,9650,9310,-341,-3.53,9376,-275,-2.85,9169,9985,1400-7-20,2021-10-12
182,هرمز,فولاد هرمزگان جنوب,1033,4984064,79523103617,16410,16400,15960,-450,-2.74,16094,-316,-1.93,15750,16410,1400-7-20,2021-10-12
183,دروز,داروسازي‌ روزدارو,1030,4210994,171976353270,39250,41210,41210,1960,4.99,40840,1590,4.05,37380,41210,1400-7-20,2021-10-12
184,غپينو,پارس‌ مينو,1010,20471670,80522813570,4133,4080,3960,-173,-4.19,3933,-200,-4.84,3927,4130,1400-7-20,2021-10-12
185,همراه,شركت ارتباطات سيار ايران,1009,6367002,56153822440,8950,9080,8720,-230,-2.57,8880,-70,-0.78,8550,9080,1400-7-20,2021-10-12
186,بكهنوج,توليد برق ماهتاب كهنوج,1008,32179519,40766480893,1329,1307,1263,-66,-4.97,1267,-62,-4.67,1263,1307,1400-7-20,2021-10-12
187,غگل,گلوكوزان‌,1003,12343023,39711940545,3377,3250,3209,-168,-4.97,3217,-160,-4.74,3209,3339,1400-7-20,2021-10-12
188,ومدير,گ.مديريت ارزش سرمايه ص ب كشوري,1002,9592541,43877520047,4810,4580,4570,-240,-4.99,4574,-236,-4.91,4570,4620,1400-7-20,2021-10-12
189,كبافق,معادن‌ بافق‌,977,1527365,56642462430,38620,38010,36800,-1820,-4.71,37090,-1530,-3.96,36690,38870,1400-7-20,2021-10-12
190,چافست,افست‌,973,2857293,33816196240,11500,12070,11920,420,3.65,11840,340,2.96,11550,12070,1400-7-20,2021-10-12
191,غفارس,شير پاستوريزه پگاه فارس,969,4151590,36225680678,9034,8900,8583,-451,-4.99,8726,-308,-3.41,8583,9250,1400-7-20,2021-10-12
192,ونيكي,سرمايه‌گذاري‌ ملي‌ايران‌,963,7389685,75724709350,10750,10470,10490,-260,-2.42,10250,-500,-4.65,10220,10790,1400-7-20,2021-10-12
193,بكام,كارخانجات توليدي شهيد قندي,957,16796732,39214226248,2449,2400,2327,-122,-4.98,2335,-114,-4.65,2327,2449,1400-7-20,2021-10-12
194,سلار,شركت سيمان لارستان,950,2934211,88484934448,29107,30562,30562,1455,5,30156,1049,3.6,27652,30562,1400-7-20,2021-10-12
195,كارين,صندوق س نگين سامان-ثابت,934,40377871,408398139197,10111,10114,10115,4,0.04,10114,3,0.03,10113,10116,1400-7-20,2021-10-12
196,قرن,پديده شيمي قرن,933,979329,26636586460,27720,28000,26660,-1060,-3.82,27200,-520,-1.88,26660,28500,1400-7-20,2021-10-12
197,بگيلان,توسعه مسير برق گيلان,931,1429187,24346315527,17904,17480,17009,-895,-5,17182,-722,-4.03,17009,17800,1400-7-20,2021-10-12
198,وصنعت,سرمايه گذاري توسعه صنعت وتجارت,928,16274991,98047484340,6310,6240,6090,-220,-3.49,6020,-290,-4.6,6000,6300,1400-7-20,2021-10-12
199,ثنوسا,نوسازي‌وساختمان‌تهران‌,917,10020788,75507364670,7880,8040,7490,-390,-4.95,7540,-340,-4.31,7490,8150,1400-7-20,2021-10-12
200,سبهان,سيمان‌ بهبهان‌,913,600662,31686534270,55200,55050,52450,-2750,-4.98,52750,-2450,-4.44,52440,55200,1400-7-20,2021-10-12
201,غديس,پاكديس,904,7972870,99362939926,13093,12822,12439,-654,-5,12463,-630,-4.81,12439,12980,1400-7-20,2021-10-12
202,غاذر,كشت‌وصنعت‌پياذر,900,2242365,55559353950,23750,24930,24930,1180,4.97,24780,1030,4.34,24020,24930,1400-7-20,2021-10-12
203,فالوم,آلومتك‌,896,3394548,97422835001,27898,28734,28700,802,2.87,28700,802,2.87,27116,28734,1400-7-20,2021-10-12
204,شلعاب,لعابيران‌,895,5304918,35446134050,7020,6810,6670,-350,-4.99,6680,-340,-4.84,6670,7000,1400-7-20,2021-10-12
205,ثزاگرس,سرمايه گذاري توسعه عمران زاگرس,892,2445580,96986245581,38076,39979,39979,1903,5,39658,1582,4.15,38100,39979,1400-7-20,2021-10-12
206,چكارن,كارتن‌ ايران‌,883,19191925,59078435767,3222,3199,3061,-161,-5,3078,-144,-4.47,3061,3249,1400-7-20,2021-10-12
207,فردا2,صندوق س آواي فرداي زاگرس-ثابت,882,88200000,88200000,11588,1,1,-11587,-99.99,1,-11587,-99.99,1,1,1400-7-20,2021-10-12
208,وتوصا,گروه س توسعه صنعتي ايران,874,8116470,73084856990,9440,9220,9010,-430,-4.56,9000,-440,-4.66,8970,9410,1400-7-20,2021-10-12
209,ولغدر,ليزينگ‌خودروغدير,856,3068447,42038361030,13880,14100,13900,20,0.14,13700,-180,-1.3,13190,14250,1400-7-20,2021-10-12
210,كيميا,معدني كيمياي زنجان گستران,851,4438130,67483423663,15774,15860,15298,-476,-3.02,15205,-569,-3.61,14986,15860,1400-7-20,2021-10-12
211,ضخود1053,اختيارخ خودرو-2500-1400/10/08,848,44306,2348743000,71,68,53,-18,-25.35,53,-18,-25.35,49,68,1400-7-20,2021-10-12
212,والبر,سرمايه‌ گذاري‌ البرز(هلدينگ‌,838,5556472,50862532150,9230,8940,9200,-30,-0.33,9150,-80,-0.87,8790,9390,1400-7-20,2021-10-12
213,البرز,بيمه البرز,826,24745311,57500353601,2423,2381,2302,-121,-4.99,2324,-99,-4.09,2302,2460,1400-7-20,2021-10-12
214,وپاسار,بانك  پاسارگاد,825,17769633,257987675000,14640,14640,14380,-260,-1.78,14520,-120,-0.82,14380,14650,1400-7-20,2021-10-12
215,ثفارس,عمران‌وتوسعه‌فارس‌,821,12904344,135902401920,10940,10840,10400,-540,-4.94,10530,-410,-3.75,10400,10940,1400-7-20,2021-10-12
216,وآذر,سرمايه‌گذاري‌توسعه‌آذربايجان‌,816,950508,47840233770,52360,52500,49750,-2610,-4.98,50330,-2030,-3.88,49750,53050,1400-7-20,2021-10-12
217,ثاخت,بين‌المللي‌توسعه‌ساختمان,813,18985754,40890334032,2259,2210,2147,-112,-4.96,2154,-105,-4.65,2147,2240,1400-7-20,2021-10-12
218,كسرا,سراميك‌هاي‌صنعتي‌اردكان‌,808,7969247,135417829220,17330,17590,16470,-860,-4.96,16990,-340,-1.96,16470,17590,1400-7-20,2021-10-12
219,وهور,مديريت انرژي اميد  تابان هور,804,24001915,34857065484,1525,1504,1449,-76,-4.98,1459,-66,-4.33,1449,1525,1400-7-20,2021-10-12
220,ميدكو,توسعه معادن وص.معدني خاورميانه,801,2534320,118632589150,47270,47270,46090,-1180,-2.5,46810,-460,-0.97,46000,47350,1400-7-20,2021-10-12
221,وثنو,سرمايه گذاري ساختماني نوين,800,9525018,51505308146,5295,5440,5420,125,2.36,5407,112,2.12,5137,5453,1400-7-20,2021-10-12
222,اوج,صندوق س.اوج دماوند-س,797,27079265,270792650000,10000,10000,10000,0,0,10000,0,0,10000,10000,1400-7-20,2021-10-12
223,تليسه,دامداري تليسه نمونه,795,13704029,36058009896,2765,2720,2627,-138,-4.99,2631,-134,-4.85,2627,2720,1400-7-20,2021-10-12
224,شفارا,پتروشيمي فارابي,787,8584421,70275267101,8050,7980,8291,241,2.99,8186,136,1.69,7809,8291,1400-7-20,2021-10-12
225,تاصيكو,سرمايه گذاري صدرتامين,783,7000112,64879089130,9660,9480,9320,-340,-3.52,9430,-230,-2.38,9180,9480,1400-7-20,2021-10-12
226,پدرخش,درخشان‌ تهران‌,781,1680162,42871002720,26790,26800,25460,-1330,-4.96,25520,-1270,-4.74,25460,26800,1400-7-20,2021-10-12
227,فولاژ,فولاد آلياژي ايران,776,4230550,70944012760,16690,16700,16850,160,0.96,16760,70,0.42,16500,16890,1400-7-20,2021-10-12
228,افران,صندوق س افرا نماد پايدار-ثابت,775,12228482,177068369211,14472,14482,14480,8,0.06,14480,8,0.06,14479,14483,1400-7-20,2021-10-12
229,فافق,صنايع مس افق كرمان,772,2043676,9899132026,4989,4840,4840,-149,-2.99,4844,-145,-2.91,4840,4900,1400-7-20,2021-10-12
230,رتاپ,تجارت الكترونيك  پارسيان,767,3505998,19721241210,5870,5800,5580,-290,-4.94,5630,-240,-4.09,5580,5820,1400-7-20,2021-10-12
231,حآسا,آسيا سير ارس,767,2470001,43516365407,18474,17830,17551,-923,-5,17618,-856,-4.63,17551,18550,1400-7-20,2021-10-12
232,شپترو,پتروشيمي آبادان,761,16980202,82377212635,4998,4900,4849,-149,-2.98,4851,-147,-2.94,4849,4910,1400-7-20,2021-10-12
233,فنرژي,گسترش صنايع انرژي آذرآب,754,2542215,32299342089,12474,12520,12723,249,2,12705,231,1.85,12452,12723,1400-7-20,2021-10-12
234,كنور,توسعه معدني و صنعتي صبانور,751,3475401,56127186180,16590,16060,16190,-400,-2.41,16290,-300,-1.81,16000,16500,1400-7-20,2021-10-12
235,دزهراوي,داروسازي‌زهراوي‌,745,4802430,27041912590,5880,5800,5610,-270,-4.59,5630,-250,-4.25,5590,5880,1400-7-20,2021-10-12
236,دانا,بيمه دانا,744,10332304,52320985280,5290,5240,5040,-250,-4.73,5060,-230,-4.35,5030,5240,1400-7-20,2021-10-12
237,كروي,توسعه‌ معادن‌ روي‌ ايران‌,741,1820810,45300818150,25860,26200,24610,-1250,-4.83,24880,-980,-3.79,24570,26600,1400-7-20,2021-10-12
238,فاذر,صنايع‌ آذرآب‌,741,21118771,24527380188,1211,1199,1151,-60,-4.95,1161,-50,-4.13,1151,1200,1400-7-20,2021-10-12
239,سصفها,سيمان‌اصفهان‌,739,947398,44315546690,47920,47990,46300,-1620,-3.38,46780,-1140,-2.38,45530,47990,1400-7-20,2021-10-12
240,فنورد,نوردوقطعات‌ فولادي‌,739,337213,63535704380,195920,198870,189000,-6920,-3.53,188410,-7510,-3.83,186130,198870,1400-7-20,2021-10-12
241,كهمدا,شيشه‌ همدان‌,738,6187821,59917124400,10090,10000,9590,-500,-4.96,9680,-410,-4.06,9590,10090,1400-7-20,2021-10-12
242,غپاك,لبنيات‌ پاك‌,732,1933798,32406142330,17580,16960,16710,-870,-4.95,16760,-820,-4.66,16710,17470,1400-7-20,2021-10-12
243,وپويا,سرمايه گذاري پويا,730,4438634,19144689450,4533,4411,4307,-226,-4.99,4313,-220,-4.85,4307,4533,1400-7-20,2021-10-12
244,غبهنوش,بهنوش‌ ايران‌,729,755952,44304847020,61420,60630,58350,-3070,-5,58610,-2810,-4.58,58350,60680,1400-7-20,2021-10-12
245,چدن,توليدي چدن سازان,725,7060097,24389110017,3622,3550,3441,-181,-5,3455,-167,-4.61,3441,3550,1400-7-20,2021-10-12
246,مرقام,ايران‌ارقام‌,723,3759100,51272996330,14300,14350,13590,-710,-4.97,13640,-660,-4.62,13590,14520,1400-7-20,2021-10-12
247,شجم,صنايع پتروشيمي تخت جمشيد,719,5381954,66866252169,12602,12230,12500,-102,-0.81,12424,-178,-1.41,11972,12690,1400-7-20,2021-10-12
248,فرآور,فرآوري‌موادمعدني‌ايران‌,718,1523681,44299808080,30550,30000,29030,-1520,-4.98,29070,-1480,-4.84,29030,30000,1400-7-20,2021-10-12
249,فسا,پتروشيمي فسا,715,14363514,18670636854,1285,1314,1323,38,2.96,1300,15,1.17,1247,1323,1400-7-20,2021-10-12
250,شبهرن,نفت‌ بهران‌,715,1932929,24270994240,13010,13000,12550,-460,-3.54,12830,-180,-1.38,12400,13000,1400-7-20,2021-10-12
251,شيراز,پتروشيمي‌شيراز,711,999569,90246554550,91030,91000,90380,-650,-0.71,90350,-680,-0.75,88530,92680,1400-7-20,2021-10-12
252,ارفع,شركت آهن و فولاد ارفع,711,3573006,53377194412,15556,15277,14901,-655,-4.21,15097,-459,-2.95,14850,15552,1400-7-20,2021-10-12
253,فسپا,گروه‌صنعتي‌سپاهان‌,704,2089054,40386904220,20270,19950,19260,-1010,-4.98,19330,-940,-4.64,19260,20220,1400-7-20,2021-10-12
254,ثعتما,س. ساختماني اعتماد گستر,701,1316539,45150754920,34968,34960,33919,-1049,-3,34295,-673,-1.92,33919,35940,1400-7-20,2021-10-12
255,كحافظح,ح . كاشي‌ وسراميك‌ حافظ‌,695,10749456,24675894655,2379,2350,2270,-109,-4.58,2296,-83,-3.49,2250,2425,1400-7-20,2021-10-12
256,شخارك,پتروشيمي‌ خارك‌,688,600900,34679214050,58630,58640,57570,-1060,-1.81,58310,-320,-0.55,57110,59000,1400-7-20,2021-10-12
257,شبصير,توليدات پتروشيمي قائد بصير,686,536008,57952984136,113034,113000,107383,-5651,-5,108120,-4914,-4.35,107383,113000,1400-7-20,2021-10-12
258,فپنتا,سپنتا,685,82802,37976238290,482390,471000,458280,-24110,-5,458640,-23750,-4.92,458280,471000,1400-7-20,2021-10-12
259,شپارس,بين‌ المللي‌ محصولات‌  پارس‌,684,4925145,51891173910,11010,11010,10470,-540,-4.9,10540,-470,-4.27,10460,11110,1400-7-20,2021-10-12
260,وبيمه,سرمايه‌ گذاري‌ صنعت‌ بيمه‌,683,19127126,31003262511,1704,1700,1619,-85,-4.99,1621,-83,-4.87,1619,1700,1400-7-20,2021-10-12
261,خكرمان,گروه اقتصادي كرمان خودرو,675,9441555,27369656504,2968,2940,2900,-68,-2.29,2899,-69,-2.32,2879,3041,1400-7-20,2021-10-12
262,ونيرو,سرمايه‌گذاري‌نيرو,671,11569155,27921092965,2524,2518,2398,-126,-4.99,2413,-111,-4.4,2398,2518,1400-7-20,2021-10-12
263,گشان,توسعه بين المللي پديده شانديز,667,1476803,28561896976,19893,19600,19297,-596,-3,19340,-553,-2.78,19297,19800,1400-7-20,2021-10-12
264,كنورح,ح توسعه معدني و صنعتي صبانور,667,5915964,82653229050,14040,13900,14040,0,0,13970,-70,-0.5,13860,14190,1400-7-20,2021-10-12
265,اپرداز,آتيه داده پرداز,666,1714363,36724590704,21572,21700,21300,-272,-1.26,21422,-150,-0.7,20494,21820,1400-7-20,2021-10-12
266,سدبير,س. تدبيرگران فارس وخوزستان,666,1460780,51553841828,36693,36694,35110,-1583,-4.31,35292,-1401,-3.82,34859,37660,1400-7-20,2021-10-12
267,گكوثر,هتل پارسيان كوثر اصفهان,661,13021035,23813047031,1902,1911,1828,-74,-3.89,1829,-73,-3.84,1807,1911,1400-7-20,2021-10-12
268,خمحركه,نيرو محركه‌,647,11089962,39584050691,3750,3650,3563,-187,-4.99,3569,-181,-4.83,3563,3700,1400-7-20,2021-10-12
269,ثبات,صندوق س. ثبات ويستا -د,647,51514224,524934314441,10183,10189,10193,10,0.1,10190,7,0.07,10188,10193,1400-7-20,2021-10-12
270,ودي,بيمه  دي,645,6043288,40208104089,6997,6960,6648,-349,-4.99,6653,-344,-4.92,6648,6960,1400-7-20,2021-10-12
271,كتوكا,توليدي و خدمات صنايع نسوز توكا,644,2802540,41721574328,15635,15000,14854,-781,-5,14887,-748,-4.78,14854,15400,1400-7-20,2021-10-12
272,ضخود1050,اختيارخ خودرو-1600-1400/10/08,641,27105,10079030000,443,404,375,-68,-15.35,372,-71,-16.03,360,409,1400-7-20,2021-10-12
273,پكوير,كوير تاير,641,3420563,41057298680,12610,12260,11980,-630,-5,12000,-610,-4.84,11980,12780,1400-7-20,2021-10-12
274,فباهنر,مس‌ شهيدباهنر,638,776009,20802666790,27500,26700,27070,-430,-1.56,26990,-510,-1.85,26400,27600,1400-7-20,2021-10-12
275,كلوند,كاشي‌ الوند,633,2024998,43597702620,22590,22470,21470,-1120,-4.96,21530,-1060,-4.69,21470,22470,1400-7-20,2021-10-12
276,سشرق,سيمان‌ شرق‌,632,6569592,54482059100,8550,8600,8370,-180,-2.11,8290,-260,-3.04,8150,8600,1400-7-20,2021-10-12
277,وساغربي,شركت س استان آذربايجان غربي,631,42077670,20735525422,494,483,500,6,1.21,493,-1,-0.2,478,502,1400-7-20,2021-10-12
278,غنوش,نوش‌ مازندران‌,625,1113344,40704359250,38310,37160,36400,-1910,-4.99,36560,-1750,-4.57,36400,37160,1400-7-20,2021-10-12
279,ساوه,سيمان ساوه,623,241191,12239915119,52238,51800,50421,-1817,-3.48,50962,-1276,-2.44,50320,52238,1400-7-20,2021-10-12
280,دكوثر,داروسازي‌ كوثر,620,8946903,35101083149,4111,3980,3925,-186,-4.52,3923,-188,-4.57,3906,4080,1400-7-20,2021-10-12
281,وسكاب,س.ص.بازنشستگي كاركنان بانكها,619,9611298,26869326886,2923,2899,2790,-133,-4.55,2796,-127,-4.34,2777,2900,1400-7-20,2021-10-12
282,وپست,پست بانك ايران,615,1955191,40946828840,21690,21050,20610,-1080,-4.98,20940,-750,-3.46,20610,21900,1400-7-20,2021-10-12
283,ستران,سيمان‌ تهران‌,613,2219889,49476106440,23440,22550,22270,-1170,-4.99,22290,-1150,-4.91,22270,22950,1400-7-20,2021-10-12
284,غگرجي,بيسكويت‌  گرجي‌,611,13019463,33264946981,2684,2620,2550,-134,-4.99,2555,-129,-4.81,2550,2724,1400-7-20,2021-10-12
285,رنيك,جنرال مكانيك,606,1945760,28456333381,15310,14950,14545,-765,-5,14625,-685,-4.47,14545,15000,1400-7-20,2021-10-12
286,شفارس,صنايع‌ شيميايي‌ فارس‌,601,16256540,26608904407,1714,1691,1629,-85,-4.96,1637,-77,-4.49,1629,1691,1400-7-20,2021-10-12
287,كترام,توليدي‌ كاشي‌ تكسرام‌,599,1263366,31303421610,25690,26350,24410,-1280,-4.98,24780,-910,-3.54,24410,26350,1400-7-20,2021-10-12
288,سپيدما,صندوق س. سپيد دماوند-د,596,27382028,307009203542,11206,11217,11212,6,0.05,11212,6,0.05,11212,11217,1400-7-20,2021-10-12
289,سفاسي,شركت فارسيت اهواز,595,6370784,28420583713,4682,4448,4448,-234,-5,4461,-221,-4.72,4448,4679,1400-7-20,2021-10-12
290,سفارس,سيمان فارس و خوزستان,591,5052825,94826623560,19730,18990,18750,-980,-4.97,18770,-960,-4.87,18750,18990,1400-7-20,2021-10-12
291,ارزش,صندوق س ارزش آفرين بيدار-سهام,589,4451258,44267566300,10280,10150,9800,-480,-4.67,9940,-340,-3.31,9800,10160,1400-7-20,2021-10-12
292,مبين,مبين انرژي خليج فارس,588,3714311,89868894140,25040,25300,23850,-1190,-4.75,24400,-640,-2.56,23790,25300,1400-7-20,2021-10-12
293,خزر,فنرسازي‌زر,585,1645588,26680766740,17000,16400,16150,-850,-5,16210,-790,-4.65,16150,16800,1400-7-20,2021-10-12
294,دتوزيع,توزيع دارو پخش,577,1480964,49220363687,34956,33654,33209,-1747,-5,33235,-1721,-4.92,33209,34600,1400-7-20,2021-10-12
295,وساخت,سرمايه‌ گذاري‌ ساختمان‌ايران‌,575,1115060,46821330210,44090,43020,41890,-2200,-4.99,41990,-2100,-4.76,41890,43300,1400-7-20,2021-10-12
296,بالاس,مهندسي ساختمان تاسيسات راه آهن,569,1309810,50696548673,40427,40391,38406,-2021,-5,38705,-1722,-4.26,38406,40391,1400-7-20,2021-10-12
297,سدور,سيمان‌ دورود,567,4064464,30524077340,7880,7990,7490,-390,-4.95,7510,-370,-4.7,7490,7990,1400-7-20,2021-10-12
298,سرچشمه,سرمايه گذاري مس سرچشمه,563,5662307,32277991175,5990,6001,5699,-291,-4.86,5701,-289,-4.82,5691,6001,1400-7-20,2021-10-12
299,وسينا,بانك سينا,560,35824968,87161435087,2558,2480,2432,-126,-4.93,2433,-125,-4.89,2431,2557,1400-7-20,2021-10-12
300,ساروم,سيمان‌اروميه‌,559,2003356,71272548390,36920,36700,35500,-1420,-3.85,35580,-1340,-3.63,35090,36700,1400-7-20,2021-10-12
301,كپارس,كاشي‌ پارس‌,554,358835,42686326170,119670,124000,116100,-3570,-2.98,118960,-710,-0.59,114250,124000,1400-7-20,2021-10-12
302,نوين,بيمه نوين,552,5162899,26042730583,5244,5121,5060,-184,-3.51,5044,-200,-3.81,5005,5290,1400-7-20,2021-10-12
303,پاسا,ايران‌ياساتايرورابر,551,2068888,37631074890,19100,18950,18150,-950,-4.97,18190,-910,-4.76,18150,18950,1400-7-20,2021-10-12
304,حشكوه,دليجان طلايي شكوه پارس,549,9802814,25651189429,2584,2629,2656,72,2.79,2617,33,1.28,2509,2661,1400-7-20,2021-10-12
305,حآفرين,ريل پرداز نو آفرين,549,3608704,15244828468,4302,4399,4170,-132,-3.07,4224,-78,-1.81,4117,4399,1400-7-20,2021-10-12
306,افق,فروشگاههاي زنجيره اي افق كوروش,548,1072599,57943871620,55020,54010,53780,-1240,-2.25,54130,-890,-1.62,53750,54980,1400-7-20,2021-10-12
307,وكار,بانك‌ كارآفرين‌,544,9686672,24384208825,2556,2590,2479,-77,-3.01,2532,-24,-0.94,2450,2590,1400-7-20,2021-10-12
308,قشكر,شكرشاهرود,544,10821953,30342023094,2906,2851,2780,-126,-4.34,2804,-102,-3.51,2770,2990,1400-7-20,2021-10-12
309,فافزا,فولاد افزا سپاهان,542,557086,28572863151,50006,51000,51506,1500,3,51290,1284,2.57,49372,51506,1400-7-20,2021-10-12
310,دكپسول,توليد ژلاتين كپسول ايران,540,577663,18850724008,34229,34200,32518,-1711,-5,32633,-1596,-4.66,32518,34200,1400-7-20,2021-10-12
311,بموتو,موتوژن‌,539,1074417,78501271070,76760,74100,72930,-3830,-4.99,73060,-3700,-4.82,72930,76490,1400-7-20,2021-10-12
312,چكاوه,صنايع‌كاغذسازي‌كاوه‌,531,3380173,47819789640,14780,14530,14390,-390,-2.64,14150,-630,-4.26,14050,14730,1400-7-20,2021-10-12
313,بساما,بيمه سامان,530,903148,21867400237,23570,24071,23890,320,1.36,24212,642,2.72,23280,24690,1400-7-20,2021-10-12
314,سخاش,سيمان‌خاش‌,527,331044,35614459680,113020,108450,107370,-5650,-5,107580,-5440,-4.81,107370,110000,1400-7-20,2021-10-12
315,ومهان,گروه توسعه مالي مهر آيندگان,527,1606423,23620660878,15263,14999,14727,-536,-3.51,15038,-225,-1.47,14540,15000,1400-7-20,2021-10-12
316,وكادو,تكادو,524,3554334,62657074581,18066,18210,17699,-367,-2.03,17628,-438,-2.42,17525,18599,1400-7-20,2021-10-12
317,وتوس,توسعه‌شهري‌توس‌گستر,524,2081778,27841175420,13920,14060,13230,-690,-4.96,13370,-550,-3.95,13230,14380,1400-7-20,2021-10-12
318,دلر,داروسازي‌ اكسير,524,1163869,49878362800,44410,42200,43280,-1130,-2.54,42860,-1550,-3.49,42200,44400,1400-7-20,2021-10-12
319,ضخود1049,اختيارخ خودرو-1400-1400/10/08,518,23245,12047987000,605,590,519,-86,-14.21,518,-87,-14.38,481,590,1400-7-20,2021-10-12
320,فلات,گروه صنايع معادن فلات ايرانيان,518,3636408,54276194227,15381,14950,14920,-461,-3,14926,-455,-2.96,14920,15459,1400-7-20,2021-10-12
321,قنيشا,قند  نيشابور,516,946142,35238530390,39090,39200,37140,-1950,-4.99,37240,-1850,-4.73,37140,39200,1400-7-20,2021-10-12
322,مدير,ص.س.مديريت ثروت ص.بازنشستگي-س,515,2978997,27878355542,9725,9602,9340,-385,-3.96,9358,-367,-3.77,9211,9602,1400-7-20,2021-10-12
323,خموتور,موتورسازان‌تراكتورسازي‌ايران‌,515,2597253,39217231580,15740,15500,14960,-780,-4.96,15100,-640,-4.07,14960,15500,1400-7-20,2021-10-12
324,ثعمرا,عمران و توسعه شاهد,515,3764843,33783979066,9315,9110,8850,-465,-4.99,8974,-341,-3.66,8850,9670,1400-7-20,2021-10-12
325,زكوثر,سرمايه گذاري كشاورزي كوثر,511,2200982,38104315710,18110,17450,17210,-900,-4.97,17310,-800,-4.42,17210,17950,1400-7-20,2021-10-12
326,سيستم,همكاران سيستم,510,4061675,23295094380,5980,5970,5730,-250,-4.18,5740,-240,-4.01,5690,5970,1400-7-20,2021-10-12
327,پاكشو,گروه صنعتي پاكشو,509,6617192,37290923140,5710,5750,5660,-50,-0.88,5680,-30,-0.53,5530,5750,1400-7-20,2021-10-12
328,وساپا,سرمايه‌گذاري‌ سايپا,509,5337440,23116946640,4540,4420,4320,-220,-4.85,4330,-210,-4.63,4320,4420,1400-7-20,2021-10-12
329,دتوليد,داروسازي توليد دارو,504,1807907,22545644179,13076,12850,12423,-653,-4.99,12471,-605,-4.63,12423,12851,1400-7-20,2021-10-12
330,مفاخر,توسعه فناوري اطلاعات خوارزمي,503,1281455,48804662177,40009,39900,38012,-1997,-4.99,38085,-1924,-4.81,38009,39900,1400-7-20,2021-10-12
331,وايران,ليزينگ ايرانيان,503,5892329,24650218500,4398,4270,4220,-178,-4.05,4183,-215,-4.89,4179,4384,1400-7-20,2021-10-12
332,ياقوت,صندوق س ياقوت آگاه-ثابت,501,4221477,56221478766,13303,13311,13326,23,0.17,13318,15,0.11,13310,13342,1400-7-20,2021-10-12
333,بنو,بيمه تجارت نو,500,2998896,34342941664,11543,11543,11250,-293,-2.54,11452,-91,-0.79,11100,11887,1400-7-20,2021-10-12
334,فمراد,آلومراد,499,1363533,23940641280,18460,18010,17540,-920,-4.98,17560,-900,-4.88,17540,18010,1400-7-20,2021-10-12
335,تابا,تابان نيرو سپاهان,498,913605,31794493872,35376,34500,34315,-1061,-3,34801,-575,-1.63,34315,36268,1400-7-20,2021-10-12
336,غچين,كشت‌ و صنعت‌ چين‌ چين,496,2656518,40533997520,15970,15600,15180,-790,-4.95,15260,-710,-4.45,15180,16100,1400-7-20,2021-10-12
337,اميد,تامين سرمايه اميد,496,7141998,44425525940,6220,6290,6130,-90,-1.45,6220,0,0,6130,6300,1400-7-20,2021-10-12
338,حتوكا,حمل‌ونقل‌توكا,496,2242785,33576597930,15710,15320,14930,-780,-4.96,14970,-740,-4.71,14930,15450,1400-7-20,2021-10-12
339,كحافظ,كاشي‌ وسراميك‌ حافظ‌,494,4269274,17145775377,4190,4250,3981,-209,-4.99,4016,-174,-4.15,3981,4299,1400-7-20,2021-10-12
340,تمحركه,ماشين سازي نيرو محركه,493,2766343,47658839480,16738,17240,17240,502,3,17228,490,2.93,16970,17240,1400-7-20,2021-10-12
341,كفپارس,فرآورده‌هاي‌ نسوز پارس‌,493,5146615,20588523384,4193,4100,3984,-209,-4.98,4000,-193,-4.6,3984,4188,1400-7-20,2021-10-12
342,ولشرق,ليزينگ ايران و شرق,492,4282522,24508663721,6014,6016,5714,-300,-4.99,5723,-291,-4.84,5714,6016,1400-7-20,2021-10-12
343,ثالوند,سرمايه گذاري مسكن الوند,491,1490324,21132889214,14799,14688,14060,-739,-4.99,14180,-619,-4.18,14060,14688,1400-7-20,2021-10-12
344,بهپاك,صنعتي بهپاك,488,6111331,33717962040,5780,5703,5564,-216,-3.74,5517,-263,-4.55,5491,5730,1400-7-20,2021-10-12
345,وشهر,بانك شهر,482,7791613,40338280521,5374,5300,5160,-214,-3.98,5177,-197,-3.67,5160,5400,1400-7-20,2021-10-12
346,شرانل,نفت ايرانول,480,747304,35244278570,49154,48003,47050,-2104,-4.28,47293,-1861,-3.79,46800,48500,1400-7-20,2021-10-12
347,درهآور,دارويي ره آورد تامين,478,874272,21545036574,25677,25700,24394,-1283,-5,24643,-1034,-4.03,24394,26070,1400-7-20,2021-10-12
348,ورنا,سرمايه‌گذاري‌ رنا(هلدينگ‌,478,7084300,21604164076,3192,3100,3033,-159,-4.98,3050,-142,-4.45,3033,3159,1400-7-20,2021-10-12
349,خاهن,آهنگري‌ تراكتورسازي‌ ايران‌,473,5486254,44675744860,8240,8100,8220,-20,-0.24,8140,-100,-1.21,8010,8340,1400-7-20,2021-10-12
350,وسبحان,سرمايه گذاري سبحان,473,9964122,30318916147,3148,3190,2991,-157,-4.99,3043,-105,-3.34,2991,3190,1400-7-20,2021-10-12
351,سمازن,سيمان‌مازندران‌,469,3891723,54122017550,14480,14770,13760,-720,-4.97,13910,-570,-3.94,13760,14780,1400-7-20,2021-10-12
352,زشگزا,شير و گوشت زاگرس شهركرد,467,3457952,19063446983,5779,5685,5491,-288,-4.98,5513,-266,-4.6,5491,5685,1400-7-20,2021-10-12
353,جم پيلن,پلي پروپيلن جم - جم پيلن,463,454119,51888531140,118530,119350,114600,-3930,-3.32,116110,-2420,-2.04,112650,119350,1400-7-20,2021-10-12
354,كاذر,فرآورده‌هاي‌نسوزآذر,462,1903867,28028922440,15210,15040,14450,-760,-5,14720,-490,-3.22,14450,15350,1400-7-20,2021-10-12
355,وتوكا,سرمايه‌گذاري‌توكافولاد(هلدينگ,461,2475470,21608525660,8980,8790,8710,-270,-3.01,8730,-250,-2.78,8600,8970,1400-7-20,2021-10-12
356,شوينده,مديريت صنعت شوينده ت.ص.بهشهر,453,2149740,44409759480,21710,21700,20630,-1080,-4.97,20660,-1050,-4.84,20630,22000,1400-7-20,2021-10-12
357,سصوفي,سيمان‌ صوفيان‌,452,1697490,28701544900,17380,17400,16700,-680,-3.91,16910,-470,-2.7,16520,17470,1400-7-20,2021-10-12
358,وصنا,گروه‌صنايع‌بهشهرايران‌,451,3503572,20702075260,6200,6200,5900,-300,-4.84,5910,-290,-4.68,5890,6250,1400-7-20,2021-10-12
359,تبرك,گروه كارخانجات صنعتي تبرك,450,1966163,20133567974,10753,10658,10216,-537,-4.99,10240,-513,-4.77,10216,10658,1400-7-20,2021-10-12
360,خپويش,سازه‌ پويش‌,448,243960,19630269610,79360,79540,80780,1420,1.79,80470,1110,1.4,79350,82440,1400-7-20,2021-10-12
361,جهرم,پتروشيمي جهرم,442,12177071,17507407591,1397,1437,1438,41,2.93,1438,41,2.93,1400,1438,1400-7-20,2021-10-12
362,تيپيكو,سرمايه گذاري دارويي تامين,439,2567431,53133696330,20970,20670,20620,-350,-1.67,20810,-160,-0.76,20250,21180,1400-7-20,2021-10-12
363,دتماد,توليدمواداوليه‌داروپخش‌,438,616599,28035207080,47250,47000,45600,-1650,-3.49,45470,-1780,-3.77,44890,47000,1400-7-20,2021-10-12
364,سپاها,سيمان‌سپاهان‌,438,4097466,35338031730,9040,9040,8600,-440,-4.87,8620,-420,-4.65,8590,9040,1400-7-20,2021-10-12
365,پخش,پخش البرز,438,1440919,38343246683,27701,27380,27290,-411,-1.48,26610,-1091,-3.94,26316,27800,1400-7-20,2021-10-12
366,دلقما,دارويي‌ لقمان‌,437,1461453,47589050520,34080,34670,32380,-1700,-4.99,32560,-1520,-4.46,32380,34670,1400-7-20,2021-10-12
367,شكلر,نيروكلر,437,867411,26714255090,32360,31780,30750,-1610,-4.98,30800,-1560,-4.82,30750,31780,1400-7-20,2021-10-12
368,هماي,صندوق س هماي آگاه-ثابت,436,6102465,61722956101,10107,10107,10115,8,0.08,10114,7,0.07,10107,10115,1400-7-20,2021-10-12
369,ومشان,س. فني و مهندسي مشانير,435,225972,14784332534,66771,65801,64768,-2003,-3,65426,-1345,-2.01,64768,68000,1400-7-20,2021-10-12
370,ثتوسا,س.توسعه و عمران استان اردبيل,435,794662,17817346042,22901,22216,22214,-687,-3,22421,-480,-2.1,22214,23580,1400-7-20,2021-10-12
371,اتكاي,بيمه اتكايي ايرانيان,434,6942560,60505808893,9054,9054,8602,-452,-4.99,8715,-339,-3.74,8602,9054,1400-7-20,2021-10-12
372,غشهداب,كشت و صنعت شهداب ناب خراسان,430,4921112,14497008938,3085,2970,2931,-154,-4.99,2946,-139,-4.51,2931,3061,1400-7-20,2021-10-12
373,واحيا,م .صنايع و معادن احياء سپاهان,425,685763,109946583834,165163,161500,160250,-4913,-2.97,160327,-4836,-2.93,160209,168000,1400-7-20,2021-10-12
374,ثباغ,شهر سازي و خانه سازي باغميشه,423,2612404,25844513873,10401,10020,9881,-520,-5,9893,-508,-4.88,9881,10318,1400-7-20,2021-10-12
375,پلاسك,پلاسكوكار,421,3608122,22121201600,6440,6440,6120,-320,-4.97,6130,-310,-4.81,6120,6440,1400-7-20,2021-10-12
376,آكورد,صندوق س. آرمان آتي كوثر-د,421,7938475,274805001511,34600,34617,34617,17,0.05,34617,17,0.05,34616,34623,1400-7-20,2021-10-12
377,وبوعلي,سرمايه‌گذاري‌بوعلي‌,418,3297395,13685658322,4319,4338,4104,-215,-4.98,4156,-163,-3.77,4104,4338,1400-7-20,2021-10-12
378,زمگسا,كشاورزي‌ ودامپروي‌ مگسال‌,418,1080239,20799175540,20230,19550,19220,-1010,-4.99,19250,-980,-4.84,19220,20000,1400-7-20,2021-10-12
379,تنوين,تامين سرمايه نوين,416,7602499,44246632820,6110,6120,5810,-300,-4.91,5820,-290,-4.75,5810,6120,1400-7-20,2021-10-12
380,وخاور,بانك خاورميانه,416,5218371,28820886100,5700,5570,5510,-190,-3.33,5610,-90,-1.58,5470,5660,1400-7-20,2021-10-12
381,غگلستا,شير پاستوريزه پگاه گلستان,415,1527441,18805204850,12905,12620,12260,-645,-5,12312,-593,-4.6,12260,12851,1400-7-20,2021-10-12
382,سخوز,سيمان خوزستان,415,1510051,35690873170,24850,24260,23630,-1220,-4.91,23640,-1210,-4.87,23610,24280,1400-7-20,2021-10-12
383,سفار,سيمان‌فارس‌,414,316780,23003671800,76290,75550,72480,-3810,-4.99,72620,-3670,-4.81,72480,75570,1400-7-20,2021-10-12
384,كمينا,شيشه سازي مينا,413,2601969,28865524666,10788,11000,11111,323,2.99,11094,306,2.84,10653,11111,1400-7-20,2021-10-12
385,وصندوق,سرمايه‌گذاري‌صندوق‌بازنشستگي‌,412,3618766,68021564450,19240,18650,18870,-370,-1.92,18980,-260,-1.35,18510,19200,1400-7-20,2021-10-12
386,ورازي,بيمه رازي,411,15206512,33157691372,2286,2173,2172,-114,-4.99,2180,-106,-4.64,2172,2279,1400-7-20,2021-10-12
387,كماسه,تامين‌ ماسه‌ ريخته‌گري‌,410,4756535,25382411010,5590,5400,5320,-270,-4.83,5340,-250,-4.47,5320,5570,1400-7-20,2021-10-12
388,غبهار,كشت وصنعت بهاران گلبهار خراسان,409,928791,13443589528,14712,15153,14271,-441,-3,14474,-238,-1.62,14271,15153,1400-7-20,2021-10-12
389,غپآذر,شير پگاه آذربايجان شرقي,408,559054,21622467939,39384,38522,38000,-1384,-3.51,38677,-707,-1.8,37415,41287,1400-7-20,2021-10-12
390,بشهاب,لامپ‌  پارس‌ شهاب‌,404,408326,42220751710,108680,103900,103250,-5430,-5,103400,-5280,-4.86,103250,107970,1400-7-20,2021-10-12
391,شپاكسا,پاكسان‌,402,974385,18713908850,20200,19700,19290,-910,-4.5,19210,-990,-4.9,19190,19700,1400-7-20,2021-10-12
392,تسه0004,امتيازتسهيلات مسكن تير1400,398,6163,4285795805,730319,766834,693804,-36515,-5,695407,-34912,-4.78,693804,766834,1400-7-20,2021-10-12
393,اعتلا,شركت سرمايه گذاري اعتلاء البرز,398,4647249,29809581669,6739,6621,6403,-336,-4.99,6414,-325,-4.82,6403,6621,1400-7-20,2021-10-12
394,وپترو,سرمايه‌گذاري صنايع پتروشيمي‌,398,2333061,29732708720,13310,13330,12650,-660,-4.96,12740,-570,-4.28,12650,13330,1400-7-20,2021-10-12
395,غبشهر,صنعتي‌ بهشهر,396,2144607,48088589100,23560,23750,22390,-1170,-4.97,22420,-1140,-4.84,22390,23750,1400-7-20,2021-10-12
396,كارين2,صندوق س نگين سامان-ثابت,395,39500000,39500000,10111,1,1,-10110,-99.99,1,-10110,-99.99,1,1,1400-7-20,2021-10-12
397,فن آوا,گروه فن آوا,390,2223899,49441878605,22628,23305,22470,-158,-0.7,22232,-396,-1.75,21950,23305,1400-7-20,2021-10-12
398,دامين,داروسازي‌ امين‌,388,4979156,16639734563,3445,3400,3290,-155,-4.5,3342,-103,-2.99,3273,3538,1400-7-20,2021-10-12
399,پرداخت,به پرداخت ملت,386,1487083,21271045880,14980,14500,14340,-640,-4.27,14300,-680,-4.54,14240,14560,1400-7-20,2021-10-12
400,خكمك,كمك‌فنرايندامين‌,386,2389117,39990351370,17610,16880,16730,-880,-5,16740,-870,-4.94,16730,17380,1400-7-20,2021-10-12
401,سمايه,بانك سرمايه,385,6720657,29956557599,4366,4390,4496,130,2.98,4457,91,2.08,4236,4496,1400-7-20,2021-10-12
402,قلرست,قند لرستان‌,385,1255557,25084498340,20970,20120,19930,-1040,-4.96,19980,-990,-4.72,19930,21180,1400-7-20,2021-10-12
403,دعبيد,لابراتوارداروسازي‌  دكترعبيدي‌,384,989644,22078781250,23410,23080,22240,-1170,-5,22810,-600,-2.56,22240,23100,1400-7-20,2021-10-12
404,سبجنو,سيمان‌ بجنورد,380,931057,34543419830,39030,38140,37100,-1930,-4.94,37100,-1930,-4.94,37080,38140,1400-7-20,2021-10-12
405,ونفت,سرمايه‌گذاري‌ صنعت‌ نفت‌,380,1982544,28868440230,15310,14900,14550,-760,-4.96,14560,-750,-4.9,14550,14960,1400-7-20,2021-10-12
406,ثشرق,سرمايه گذاري مسكن شمال شرق,379,5065930,25629434900,5300,5320,5040,-260,-4.91,5060,-240,-4.53,5040,5320,1400-7-20,2021-10-12
407,زنگان,صنعت روي زنگان,378,411429,26411917963,67538,65000,64162,-3376,-5,64196,-3342,-4.95,64162,65600,1400-7-20,2021-10-12
408,غمارگ,مارگارين‌,377,1653508,37560701090,23760,23800,22610,-1150,-4.84,22720,-1040,-4.38,22580,23800,1400-7-20,2021-10-12
409,سكه0012پ01,تمام سكه طرح جديد0012رفاه,375,97100,110723283400,1160027,1151000,1140000,-20027,-1.73,1140302,-19725,-1.7,1134050,1152000,1400-7-20,2021-10-12
410,كساوه,صنايع‌ كاشي‌ و سراميك‌ سينا,375,478818,23429103310,51340,50000,48780,-2560,-4.99,48930,-2410,-4.69,48780,51870,1400-7-20,2021-10-12
411,حسينا,توسعه خدمات دريايي وبندري سينا,373,326052,16170661234,50900,51122,50430,-470,-0.92,49595,-1305,-2.56,48513,52170,1400-7-20,2021-10-12
412,سيلام,سيمان‌ ايلام‌,372,2690856,17981938400,7020,7050,6670,-350,-4.99,6680,-340,-4.84,6670,7050,1400-7-20,2021-10-12
413,ولبهمن,شركت بهمن ليزينگ,372,6370055,42911385859,7015,7001,6668,-347,-4.95,6736,-279,-3.98,6665,7001,1400-7-20,2021-10-12
414,پكرمان,گروه‌ صنعتي‌ بارز,371,754948,17255126940,23940,23110,23000,-940,-3.93,23130,-810,-3.38,22750,23850,1400-7-20,2021-10-12
415,غشان,شيرپاستوريزه‌پگاه‌خراسان‌,369,2592487,11412238318,4627,4617,4396,-231,-4.99,4437,-190,-4.11,4396,4617,1400-7-20,2021-10-12
416,قنقش,قند نقش جهان,368,498964,49611033867,101063,103081,102900,1837,1.82,99428,-1635,-1.62,99042,103081,1400-7-20,2021-10-12
417,لابسا,آبسال‌,366,597879,20751750530,35590,34730,34330,-1260,-3.54,34710,-880,-2.47,34160,35990,1400-7-20,2021-10-12
418,ثامان,سامان‌ گستراصفهان‌,365,1704520,20002407700,12330,12040,11720,-610,-4.95,11730,-600,-4.87,11720,12530,1400-7-20,2021-10-12
419,ساينا,صنايع بهداشتي ساينا,363,368978,45281359279,129011,122561,122561,-6450,-5,122721,-6290,-4.88,122561,125300,1400-7-20,2021-10-12
420,پرديس,سرمايه گذاري پرديس,360,6178383,33259379550,5660,5530,5380,-280,-4.95,5380,-280,-4.95,5380,5530,1400-7-20,2021-10-12
421,تسه0005,امتيازتسهيلات مسكن مرداد 1400,359,5770,4022720056,733450,700000,696778,-36672,-5,697178,-36272,-4.95,696778,702111,1400-7-20,2021-10-12
422,شكربن,كربن‌ ايران‌,358,428033,50148524920,123070,123870,116920,-6150,-5,117160,-5910,-4.8,116920,123870,1400-7-20,2021-10-12
423,خكاوه,سايپا ديزل,357,7080829,23245096094,3448,3320,3276,-172,-4.99,3283,-165,-4.79,3276,3325,1400-7-20,2021-10-12
424,فلامي,لاميران‌,355,830637,17606226170,22250,21730,21140,-1110,-4.99,21200,-1050,-4.72,21140,21730,1400-7-20,2021-10-12
425,وملل,اعتباري ملل,355,1743645,18704774192,11227,11000,10839,-388,-3.46,11009,-218,-1.94,10666,11050,1400-7-20,2021-10-12
426,كاسپين,داروسازي كاسپين تامين,355,1198408,32404813946,27730,27320,27100,-630,-2.27,27040,-690,-2.49,26492,27490,1400-7-20,2021-10-12
427,وساشرقي,شركت س استان آذربايجان شرقي,354,17960917,8886098618,506,485,500,-6,-1.19,504,-2,-0.4,485,500,1400-7-20,2021-10-12
428,خشرق,الكتريك‌ خودرو شرق‌,352,1395687,19956291580,15000,15180,14250,-750,-5,14300,-700,-4.67,14250,15180,1400-7-20,2021-10-12
429,فسرب,ملي‌ سرب‌وروي‌ ايران‌,352,340890,24637583720,75930,73400,72140,-3790,-4.99,72270,-3660,-4.82,72140,73670,1400-7-20,2021-10-12
430,ددام,داروسازي زاگرس فارمد پارس,349,2682045,35620373830,13900,13600,13210,-690,-4.96,13280,-620,-4.46,13210,13660,1400-7-20,2021-10-12
431,سقاين,سيمان‌ قائن‌,349,457441,25979993080,57220,58970,57220,0,0,56790,-430,-0.75,54360,60010,1400-7-20,2021-10-12
432,جم,پتروشيمي جم,347,1868306,93367091800,51070,50000,49960,-1110,-2.17,50010,-1060,-2.08,49600,51390,1400-7-20,2021-10-12
433,بنيرو,نيروترانس‌,347,4948418,10785946613,2288,2250,2174,-114,-4.98,2201,-87,-3.8,2174,2251,1400-7-20,2021-10-12
434,دبالك,مواد اوليه دارويي البرز بالك,343,1505549,16415817864,11458,11393,10886,-572,-4.99,10904,-554,-4.84,10886,11410,1400-7-20,2021-10-12
435,كوثر,بيمه كوثر,342,2234357,24923987269,11648,11300,11066,-582,-5,11223,-425,-3.65,11066,11849,1400-7-20,2021-10-12
436,دسبحان,سبحان دارو,342,1496292,26321905360,18480,18280,17600,-880,-4.76,17590,-890,-4.82,17560,18280,1400-7-20,2021-10-12
437,سامان,بانك سامان,341,7576607,56500252249,7684,7502,7454,-230,-2.99,7457,-227,-2.95,7454,7730,1400-7-20,2021-10-12
438,قصفها,قنداصفهان‌,340,224802,22598658150,105220,100570,99960,-5260,-5,100530,-4690,-4.46,99960,104000,1400-7-20,2021-10-12
439,تكمبا,كمباين‌ سازي‌ ايران‌,338,3341817,16657395140,5240,5060,4980,-260,-4.96,4980,-260,-4.96,4980,5060,1400-7-20,2021-10-12
440,ختراك,ريخته‌گري‌ تراكتورسازي‌ ايران‌,337,2968401,40210874900,14210,14000,13500,-710,-5,13550,-660,-4.64,13500,14000,1400-7-20,2021-10-12
441,زدشت,كشت و صنعت دشت خرم دره,336,968412,15518965181,16862,16023,16019,-843,-5,16025,-837,-4.96,16019,16140,1400-7-20,2021-10-12
442,شپاس,نفت پاسارگاد,335,957983,20190887561,22111,22250,21006,-1105,-5,21079,-1032,-4.67,21006,22490,1400-7-20,2021-10-12
443,ساربيل,سيمان آرتا اردبيل,335,424398,15567213590,38460,37050,37200,-1260,-3.28,36680,-1780,-4.63,36540,38080,1400-7-20,2021-10-12
444,كپشير,پشم‌شيشه‌ايران‌,335,1565118,23156311040,15510,14920,14740,-770,-4.96,14800,-710,-4.58,14740,15340,1400-7-20,2021-10-12
445,شفا,سرمايه گذاري شفادارو,333,955512,35725182120,39080,37420,37130,-1950,-4.99,37390,-1690,-4.32,37130,40580,1400-7-20,2021-10-12
446,دسبحا,گروه دارويي سبحان,325,1899498,38354483110,21170,20300,20120,-1050,-4.96,20190,-980,-4.63,20120,21140,1400-7-20,2021-10-12
447,ولتجار,واسپاري تجارت وسرمايه ايرانيان,324,4773971,17418717949,3736,3624,3689,-47,-1.26,3649,-87,-2.33,3624,3800,1400-7-20,2021-10-12
448,خرينگ,رينگ‌سازي‌مشهد,324,564307,17687850920,32940,31700,31300,-1640,-4.98,31340,-1600,-4.86,31300,31700,1400-7-20,2021-10-12
449,شدوص,دوده‌ صنعتي‌ پارس‌,323,1193812,23972030820,20920,21100,20010,-910,-4.35,20080,-840,-4.02,19900,21100,1400-7-20,2021-10-12
450,فولاي,صنايع فولاد آلياژي يزد,322,758423,14137577148,19606,18900,18626,-980,-5,18641,-965,-4.92,18626,18900,1400-7-20,2021-10-12
451,كطبس,ذغال‌سنگ‌ نگين‌ ط‌بس‌,321,484206,27087835070,58510,56850,55600,-2910,-4.97,55940,-2570,-4.39,55590,58000,1400-7-20,2021-10-12
452,لازما,كارخانه هاي صنعتي آزمايش,318,2590928,68239272975,27127,26728,26999,-128,-0.47,26338,-789,-2.91,26314,27129,1400-7-20,2021-10-12
453,كمنگنز,معادن‌منگنزايران‌,315,245042,16772077860,71370,69980,67900,-3470,-4.86,68450,-2920,-4.09,67900,70000,1400-7-20,2021-10-12
454,ثرود,سرمايه‌گذاري مسكن زاينده رود,315,1779457,17631670944,10280,10007,9766,-514,-5,9908,-372,-3.62,9766,10404,1400-7-20,2021-10-12
455,دجابر,داروسازي‌ جابرابن‌حيان‌,313,2235953,29808267440,13990,13500,13300,-690,-4.93,13330,-660,-4.72,13300,13520,1400-7-20,2021-10-12
456,تپمپي,پمپ‌ سازي‌ ايران‌,312,1242626,24875257200,20980,20290,19940,-1040,-4.96,20020,-960,-4.58,19940,20580,1400-7-20,2021-10-12
457,درازك,دارويي‌ رازك‌,312,590040,22181679960,39170,39030,38550,-620,-1.58,37590,-1580,-4.03,37220,39030,1400-7-20,2021-10-12
458,سكرما,سيمان‌ كرمان‌,312,1311020,18429551040,14370,13820,14350,-20,-0.14,14060,-310,-2.16,13820,14550,1400-7-20,2021-10-12
459,غشاذر,پگاه‌آذربايجان‌غربي‌,312,2247515,13124811570,6070,5860,5770,-300,-4.94,5860,-210,-3.46,5770,6050,1400-7-20,2021-10-12
460,وتوسم,سرمايه‌گذاري‌توسعه‌ملي‌,311,1562331,11931254780,7870,8000,7800,-70,-0.89,7680,-190,-2.41,7480,8000,1400-7-20,2021-10-12
461,آوا,صندوق س.سهام آواي معيار-س,310,2940381,23211988929,8109,7870,7901,-208,-2.57,7894,-215,-2.65,7750,7998,1400-7-20,2021-10-12
462,دشيمي,شيمي‌ داروئي‌ داروپخش‌,310,945344,22805924900,25340,24580,24080,-1260,-4.97,24120,-1220,-4.81,24080,25190,1400-7-20,2021-10-12
463,ثاباد,توريستي ورفاهي آبادگران ايران,310,371139,17329564570,48850,47820,46410,-2440,-4.99,46690,-2160,-4.42,46410,49970,1400-7-20,2021-10-12
464,كاردان,صندوق س تجارت شاخصي كاردان,309,190543,37942184210,205640,201590,198400,-7240,-3.52,199130,-6510,-3.17,197900,201870,1400-7-20,2021-10-12
465,تايرا,تراكتورسازي‌ايران‌,309,1285144,35291315990,28860,27800,27420,-1440,-4.99,27460,-1400,-4.85,27420,28600,1400-7-20,2021-10-12
466,كامياب,صندوق س. كامياب آشنا-د,308,3688336,39370654274,10668,10675,10675,7,0.07,10674,6,0.06,10670,10675,1400-7-20,2021-10-12
467,غگلپا,شير پاستوريزه پگاه گلپايگان,307,353187,21615706969,64196,61510,60987,-3209,-5,61202,-2994,-4.66,60987,65998,1400-7-20,2021-10-12
468,ثغرب,شركت سرمايه گذاري مسكن شمالغرب,307,2776834,13715435199,5170,5100,4912,-258,-4.99,4939,-231,-4.47,4912,5250,1400-7-20,2021-10-12
469,بفجر,فجر انرژي خليج فارس,307,1235979,40720124250,34260,33620,32720,-1540,-4.5,33640,-620,-1.81,32550,33900,1400-7-20,2021-10-12
470,كخاك,صنايع‌خاك‌چيني‌ايران‌,305,1070937,30634964190,30090,29160,28590,-1500,-4.99,28610,-1480,-4.92,28590,29840,1400-7-20,2021-10-12
471,سدشت,صنايع سيمان دشتستان,304,357430,14116353700,41400,39350,39330,-2070,-5,39960,-1440,-3.48,39330,40580,1400-7-20,2021-10-12
472,كيسون,شركت كيسون,301,4869539,42750123350,9048,8810,8777,-271,-3,8779,-269,-2.97,8777,8999,1400-7-20,2021-10-12
473,لخزر,پارس‌ خزر,300,141039,20364276220,151960,150000,144370,-7590,-4.99,144390,-7570,-4.98,144370,150000,1400-7-20,2021-10-12
474,تسه0003,امتيازتسهيلات مسكن خرداد1400,297,4795,3356891781,736370,699555,699552,-36818,-5,700082,-36288,-4.93,699552,730000,1400-7-20,2021-10-12
475,جوين,كشت و صنعت جوين,295,9866060,31596693987,3301,3230,3202,-99,-3,3203,-98,-2.97,3202,3240,1400-7-20,2021-10-12
476,تصميم,صندوق س با درآمد ثابت تصميم,293,1421838,25086991088,17627,17639,17645,18,0.1,17644,17,0.1,17639,17645,1400-7-20,2021-10-12
477,كسرام,پارس‌ سرام‌,290,3266548,15583872850,5010,4800,4760,-250,-4.99,4770,-240,-4.79,4760,4980,1400-7-20,2021-10-12
478,وآوا,سرمايه گذاري آوا نوين,289,3053977,12444598985,4277,4221,4064,-213,-4.98,4086,-191,-4.47,4064,4223,1400-7-20,2021-10-12
479,تسه9908,امتياز تسهيلات مسكن آبان99,287,15689,10887759964,730359,693888,693842,-36517,-5,693974,-36385,-4.98,693842,718800,1400-7-20,2021-10-12
480,فوكا,فولاد كاويان,287,2269980,34368060874,15555,15650,15089,-466,-3,15161,-394,-2.53,15089,15650,1400-7-20,2021-10-12
481,سبزوا,سيمان لار سبزوار,284,2510297,7925437387,3320,3158,3154,-166,-5,3218,-102,-3.07,3154,3239,1400-7-20,2021-10-12
482,كسعدي,كاشي‌ سعدي‌,282,1487024,17159058790,12130,11610,11530,-600,-4.95,11540,-590,-4.86,11530,11900,1400-7-20,2021-10-12
483,غشوكو,شوكو پارس,282,2161427,23010947020,11194,10640,10635,-559,-4.99,10646,-548,-4.9,10635,11179,1400-7-20,2021-10-12
484,دارو,كارخانجات‌داروپخش‌,282,572700,15834999750,29010,28660,27600,-1410,-4.86,27710,-1300,-4.48,27560,28660,1400-7-20,2021-10-12
485,معيار ,سرمايه گذاري معيار صنعت پارس,281,300388,14216819349,47540,48490,46700,-840,-1.77,47328,-212,-0.45,46684,48490,1400-7-20,2021-10-12
486,دقاضي,داروسازي شهيد قاضي,280,415653,13496039413,32637,32530,32300,-337,-1.03,32469,-168,-0.51,31658,33500,1400-7-20,2021-10-12
487,وثوق,سرمايه گذاري وثوق امين,279,2342116,31597142959,14188,13482,13479,-709,-5,13491,-697,-4.91,13479,13938,1400-7-20,2021-10-12
488,كقزوي,شيشه‌ قزوين‌,278,3261678,26323885286,8282,8100,8199,-83,-1,8071,-211,-2.55,8034,8280,1400-7-20,2021-10-12
489,قشهد,شهد,278,1123486,16935467930,15840,15110,15050,-790,-4.99,15070,-770,-4.86,15050,15500,1400-7-20,2021-10-12
490,فنوال,نورد آلومينيوم‌,276,616887,15911708560,26900,26010,25560,-1340,-4.98,25790,-1110,-4.13,25560,27300,1400-7-20,2021-10-12
491,افرا,افرانت,275,531365,10605141894,20973,20000,19925,-1048,-5,20111,-862,-4.11,19925,20587,1400-7-20,2021-10-12
492,ماني,صندوق س. با درآمد ثابت ماني,271,6177245,63625457176,10294,10300,10299,5,0.05,10300,6,0.06,10299,10301,1400-7-20,2021-10-12
493,دحاوي,الحاوي,269,3323871,18729596303,5912,5740,5617,-295,-4.99,5635,-277,-4.69,5617,5770,1400-7-20,2021-10-12
494,وحكمت,بيمه حكمت صبا,269,4254915,16042100334,3851,3964,3736,-115,-2.99,3770,-81,-2.1,3736,3964,1400-7-20,2021-10-12
495,تاپكيش,تجارت الكترونيك پارسيان كيش,268,2046202,33541962312,17222,17000,16361,-861,-5,16392,-830,-4.82,16361,17430,1400-7-20,2021-10-12
496,سباقر,سيمان باقران,266,1556008,27522140663,18224,17800,17678,-546,-3,17688,-536,-2.94,17678,17980,1400-7-20,2021-10-12
497,زبينا,كشاورزي و دامپروري بينالود,262,4712669,11678093010,2584,2589,2455,-129,-4.99,2489,-95,-3.68,2455,2600,1400-7-20,2021-10-12
498,زگلدشت,كشت و دام گلدشت نمونه اصفهان,261,1079290,10232316409,9969,9850,9471,-498,-5,9604,-365,-3.66,9471,9930,1400-7-20,2021-10-12
499,تماوند,تامين سرمايه دماوند,260,6100176,42024669995,7102,6889,6889,-213,-3,6889,-213,-3,6889,6941,1400-7-20,2021-10-12
500,دابور,داروسازي‌ ابوريحان‌,258,651598,17131489530,27520,27100,26170,-1350,-4.91,26290,-1230,-4.47,26150,27280,1400-7-20,2021-10-12
501,واميد,گروه مديريت سرمايه گذاري اميد,255,1460426,18384039580,12630,12470,12630,0,0,12620,-10,-0.08,12470,12810,1400-7-20,2021-10-12
502,بخاور,بيمه زندگي خاورميانه,255,2949520,13803968462,4909,4782,4665,-244,-4.97,4680,-229,-4.66,4664,4898,1400-7-20,2021-10-12
503,كفرا,فراورده‌ هاي‌ نسوزايران‌,254,592346,12218941600,21660,20650,20580,-1080,-4.99,20830,-830,-3.83,20580,21080,1400-7-20,2021-10-12
504,ما,بيمه  ما,253,2412932,16978514800,7400,7060,7030,-370,-5,7040,-360,-4.86,7030,7190,1400-7-20,2021-10-12
505,سفانو,سيمان فارس نو,253,746626,17111566580,24050,24460,22850,-1200,-4.99,22920,-1130,-4.7,22850,24460,1400-7-20,2021-10-12
506,وتوشه,سرمايه‌ گذاري‌ پارس‌ توشه‌,253,2975946,19224380090,6670,6460,6420,-250,-3.75,6460,-210,-3.15,6390,6760,1400-7-20,2021-10-12
507,داسوه,داروسازي‌ اسوه‌,252,512222,12991916920,26390,25510,25090,-1300,-4.93,25410,-980,-3.71,25080,26890,1400-7-20,2021-10-12
508,ضخود1054,اختيارخ خودرو-3000-1400/10/08,252,14811,405992000,34,37,27,-7,-20.59,27,-7,-20.59,26,37,1400-7-20,2021-10-12
509,تسه0002,امتيازتسهيلاتمسكن ارديبهشت1400,251,3487,2435481056,735065,698444,698312,-36753,-5,698446,-36619,-4.98,698312,700000,1400-7-20,2021-10-12
510,كي بي سي,شركت كي بي سي,251,1057389,21193035253,21085,20135,20033,-1052,-4.99,20043,-1042,-4.94,20031,20724,1400-7-20,2021-10-12
511,غالبر,لبنيات‌ كالبر,250,1535687,18499967030,12650,12110,12020,-630,-4.98,12050,-600,-4.74,12020,12490,1400-7-20,2021-10-12
512,پلوله,گازلوله‌,248,413920,13114467889,32211,32999,31245,-966,-3,31684,-527,-1.64,31245,33177,1400-7-20,2021-10-12
513,غشهد,شهد ايران ‌,248,1729621,8567787040,5200,5180,4940,-260,-5,5050,-150,-2.88,4940,5250,1400-7-20,2021-10-12
514,سكارون,سيمان كارون,245,193989,12857175553,68183,68999,66138,-2045,-3,66278,-1905,-2.79,66138,68999,1400-7-20,2021-10-12
515,ثمسكن,سرمايه‌گذاري‌ مسكن‌,244,4788234,21417144743,4703,4621,4468,-235,-5,4473,-230,-4.89,4468,4621,1400-7-20,2021-10-12
516,زفكا,كشت و دامداري فكا,243,1463398,11082949935,7941,7850,7544,-397,-5,7634,-307,-3.87,7544,7850,1400-7-20,2021-10-12
517,سهرمز,سيمان‌هرمزگان‌,242,233342,3651646940,16220,15600,15820,-400,-2.47,16070,-150,-0.92,15600,16000,1400-7-20,2021-10-12
518,فاما,صنعتي‌ آما,241,1358011,22048400480,17080,16230,16230,-850,-4.98,16240,-840,-4.92,16230,16390,1400-7-20,2021-10-12
519,بكاب,صنايع‌جوشكاب‌يزد,241,82475,14178104030,180490,173120,171470,-9020,-5,171910,-8580,-4.75,171470,175900,1400-7-20,2021-10-12
520,وارس,سرمايه گذاري ارس صبا,240,471011,5670626234,12271,12470,11909,-362,-2.95,12132,-139,-1.13,11903,12470,1400-7-20,2021-10-12
521,لوتوسح,ح . تامين سرمايه لوتوس پارسيان,240,1902528,7930645420,4250,4240,4180,-70,-1.65,4170,-80,-1.88,4100,4250,1400-7-20,2021-10-12
522,وبشهر,توسعه‌ صنايع‌ بهشهر(هلدينگ,239,2494564,31035487180,12910,12320,12400,-510,-3.95,12560,-350,-2.71,12270,12800,1400-7-20,2021-10-12
523,آساميد,صندوق س.مشترك آسمان اميد -د,238,6939942,91354701356,13157,13163,13164,7,0.05,13164,7,0.05,13163,13169,1400-7-20,2021-10-12
524,كميناح,ح . شيشه سازي مينا,237,1365454,10746057670,7998,7765,8000,2,0.03,7870,-128,-1.6,7759,8150,1400-7-20,2021-10-12
525,سكرد,سيمان كردستان,236,1106689,6341471560,5950,5660,5690,-260,-4.37,5850,-100,-1.68,5660,6000,1400-7-20,2021-10-12
526,ومعلم,بيمه معلم,235,2425241,7997625511,3456,3460,3284,-172,-4.98,3367,-89,-2.58,3284,3498,1400-7-20,2021-10-12
527,حخزر,كشتيراني درياي خزر,234,424660,8234323016,20116,19120,19700,-416,-2.07,19697,-419,-2.08,19111,20109,1400-7-20,2021-10-12
528,دفارا,داروسازي‌ فارابي‌,234,528890,8674225040,17230,16770,16380,-850,-4.93,16710,-520,-3.02,16370,16770,1400-7-20,2021-10-12
529,غمهرا,توليدي‌مهرام‌,232,192703,9839903760,53600,52200,50920,-2680,-5,51840,-1760,-3.28,50920,52200,1400-7-20,2021-10-12
530,كاريس,صندوق س.سپهر كاريزما-س,230,1112707,15350623005,14218,14150,13653,-565,-3.97,13796,-422,-2.97,13650,14150,1400-7-20,2021-10-12
531,اوان,مبين وان كيش,229,502587,13040407172,27241,26510,25879,-1362,-5,25947,-1294,-4.75,25879,27300,1400-7-20,2021-10-12
532,ولصنم,ليزينگ‌صنعت‌ومعدن‌,229,1794786,9974782440,5840,5550,5550,-290,-4.97,5620,-220,-3.77,5550,5770,1400-7-20,2021-10-12
533,تسه9912,امتياز تسهيلات مسكن اسفند99,229,5153,3589524599,732535,695955,696001,-36534,-4.99,696589,-35946,-4.91,695909,720000,1400-7-20,2021-10-12
534,آبين,كشت و صنعت آبشيرين,227,4099453,8520412038,2133,2100,2070,-63,-2.95,2082,-51,-2.39,2070,2127,1400-7-20,2021-10-12
535,خاتم,صندوق س خاتم ايساتيس پويا-ثابت,226,1673835,20288745093,12114,12120,12121,7,0.06,12121,7,0.06,12120,12123,1400-7-20,2021-10-12
536,قشير,قند شيروان قوچان و بجنورد,226,1107322,23865198020,22628,21700,21497,-1131,-5,21552,-1076,-4.76,21497,22275,1400-7-20,2021-10-12
537,چفيبر,فيبر ايران‌,225,1011381,6981284860,7220,7050,6860,-360,-4.99,7060,-160,-2.22,6860,7250,1400-7-20,2021-10-12
538,فجام,جام‌دارو,225,1871304,11375288960,6380,6170,6070,-310,-4.86,6110,-270,-4.23,6070,6210,1400-7-20,2021-10-12
539,خوساز,محورسازان‌ايران‌خودرو,223,2884377,23816173750,8670,8270,8240,-430,-4.96,8260,-410,-4.73,8240,8700,1400-7-20,2021-10-12
540,ساراب,سيمان‌ داراب‌,223,638332,11050959020,17990,18300,17140,-850,-4.72,17460,-530,-2.95,17110,18300,1400-7-20,2021-10-12
541,لبوتان,گروه‌صنعتي‌بوتان‌,222,225209,11821800790,55220,52550,52460,-2760,-5,53030,-2190,-3.97,52460,53030,1400-7-20,2021-10-12
542,خفنر,فنرسازي‌خاور,222,1262125,9798738200,8160,7760,7760,-400,-4.9,7890,-270,-3.31,7760,7930,1400-7-20,2021-10-12
543,كشرق,صنعتي و معدني شمال شرق شاهرود,222,205511,15762811231,77630,75111,77600,-30,-0.04,76701,-929,-1.2,75110,78798,1400-7-20,2021-10-12
544,واعتبار,سرمايه گذاري اعتبار ايران,222,874238,6023009860,7120,7280,6910,-210,-2.95,7020,-100,-1.4,6770,7280,1400-7-20,2021-10-12
545,ضشنا8004,اختيارخ شپنا-10800-1400/08/16,221,1707,4419521000,3365,2950,2500,-865,-25.71,2589,-776,-23.06,2420,2950,1400-7-20,2021-10-12
546,كپرور,فرآوري زغال سنگ پروده طبس,216,318604,11149406029,36644,36110,34812,-1832,-5,35306,-1338,-3.65,34812,36800,1400-7-20,2021-10-12
547,بمپنا,توليد برق عسلويه  مپنا,216,2310039,13199234990,6007,5910,5707,-300,-4.99,5788,-219,-3.65,5707,5910,1400-7-20,2021-10-12
548,وسين,بيمه سينا,216,3743747,12743737561,3501,3550,3410,-91,-2.6,3404,-97,-2.77,3396,3550,1400-7-20,2021-10-12
549,لسرما,سرما آفرين‌,215,670749,13315696810,20550,19800,19530,-1020,-4.96,19850,-700,-3.41,19530,21200,1400-7-20,2021-10-12
550,گوهران,سرمايه گذاري توسعه گوهران اميد,214,909291,4488835969,5013,4962,4851,-162,-3.23,4989,-24,-0.48,4850,5079,1400-7-20,2021-10-12
551,ثپرديس,سرمايه گذاري مسكن پرديس,212,3951063,23621683940,6289,6120,5975,-314,-4.99,5979,-310,-4.93,5975,6160,1400-7-20,2021-10-12
552,دشيري,شيرين دارو,211,53338,8692640085,163587,159821,162321,-1266,-0.77,163045,-542,-0.33,158680,168274,1400-7-20,2021-10-12
553,تسه9911,امتياز تسهيلات مسكن بهمن99,211,5964,4155349556,733401,696788,696731,-36670,-5,696739,-36662,-5,696731,697000,1400-7-20,2021-10-12
554,فسازان,غلتك سازان سپاهان,209,642176,19248947790,30970,30990,29430,-1540,-4.97,29970,-1000,-3.23,29430,30990,1400-7-20,2021-10-12
555,سپ,پرداخت الكترونيك سامان كيش,209,779998,24879282160,33550,32390,31880,-1670,-4.98,32910,-640,-1.91,31880,32390,1400-7-20,2021-10-12
556,حپارسا,توسعه حمل و نقل ريلي پارسيان,208,673389,22770153919,35380,35700,34399,-981,-2.77,33814,-1566,-4.43,33611,36200,1400-7-20,2021-10-12
557,هجرت,پخش هجرت,207,432545,13540017230,32923,31620,31277,-1646,-5,31343,-1580,-4.8,31277,32499,1400-7-20,2021-10-12
558,قمرو,قند مرودشت‌,206,244608,7011650870,29830,28620,28740,-1090,-3.65,29230,-600,-2.01,28340,30150,1400-7-20,2021-10-12
559,قيستو,شركت قند بيستون,205,1083518,22269338718,21566,20489,20488,-1078,-5,20553,-1013,-4.7,20488,21566,1400-7-20,2021-10-12
560,سپاس,صندوق س. پاداش سهامداري-ثابت,204,4461969,44753885439,10021,10028,10031,10,0.1,10030,9,0.09,10027,10031,1400-7-20,2021-10-12
561,واتي,سرمايه‌ گذاري‌ آتيه‌ دماوند,204,1421952,15006757330,11030,10610,10480,-550,-4.99,10650,-380,-3.45,10480,11110,1400-7-20,2021-10-12
562,وحافظح,ح . بيمه حافظ,202,876350,3535295512,4081,4010,3992,-89,-2.18,4034,-47,-1.15,3989,4100,1400-7-20,2021-10-12
563,ولانا,شركت ليزينگ آريا دانا,201,333508,6149834259,18875,18450,18309,-566,-3,18585,-290,-1.54,18309,19149,1400-7-20,2021-10-12
564,سهگمت,سيمان‌هگمتان‌,199,614944,14116880450,24020,22940,23000,-1020,-4.25,22960,-1060,-4.41,22840,23080,1400-7-20,2021-10-12
565,فيروزه,صندوق شاخص30 شركت فيروزه- سهام,197,122868,21302350350,178870,178100,173070,-5800,-3.24,173380,-5490,-3.07,170000,178100,1400-7-20,2021-10-12
566,شكبير,پتروشيمي اميركبير,197,195887,18674401554,98189,96530,95450,-2739,-2.79,97636,-553,-0.56,95244,96620,1400-7-20,2021-10-12
567,لوتوس,تامين سرمايه لوتوس پارسيان,197,1486675,8207976360,5730,5550,5600,-130,-2.27,5680,-50,-0.87,5450,5610,1400-7-20,2021-10-12
568,عيار,صندوق سكه طلاي مفيد,196,135769,3920904548,29482,29080,28950,-532,-1.8,28879,-603,-2.05,28601,29517,1400-7-20,2021-10-12
569,خديزل,بهمن  ديزل,196,137996,7283856109,54029,55458,53144,-885,-1.64,53599,-430,-0.8,52408,55458,1400-7-20,2021-10-12
570,دپارس,پارس‌ دارو,195,322565,10569911410,34400,33270,32680,-1720,-5,33170,-1230,-3.58,32680,33880,1400-7-20,2021-10-12
571,ريشمك,توليد و صادرات ريشمك,193,352118,12635754430,37773,35885,35885,-1888,-5,35885,-1888,-5,35885,35885,1400-7-20,2021-10-12
572,خمحور,توليدمحورخودرو,192,2368815,8211202781,3616,3624,3436,-180,-4.98,3519,-97,-2.68,3436,3624,1400-7-20,2021-10-12
573,فخاس,فولاد خراسان,188,1441854,36840613070,26890,26280,25550,-1340,-4.98,26370,-520,-1.93,25550,26280,1400-7-20,2021-10-12
574,زشريف,كشت وصنعت شريف آباد,187,1444139,6429585605,4674,4467,4441,-233,-4.99,4569,-105,-2.25,4441,4785,1400-7-20,2021-10-12
575,آرمان,بيمه آرمان,184,780205,5125881915,6461,6268,6638,177,2.74,6516,55,0.85,6268,6654,1400-7-20,2021-10-12
576,شگل,گلتاش‌,184,645693,4773103240,7500,7400,7350,-150,-2,7460,-40,-0.53,7220,7620,1400-7-20,2021-10-12
577,فنفتح,ح . صنايع تجهيزات نفت,184,571080,7072825800,12768,12385,12385,-383,-3,12385,-383,-3,12385,12385,1400-7-20,2021-10-12
578,ركيش,كارت اعتباري ايران كيش,183,924955,6271272520,7110,7100,6770,-340,-4.78,6990,-120,-1.69,6760,7100,1400-7-20,2021-10-12
579,سپر,صندوق س سپر سرمايه بيدار- ثابت,182,2917836,37670264599,12904,12909,12911,7,0.05,12910,6,0.05,12905,12928,1400-7-20,2021-10-12
580,بزاگرس,نيروگاه زاگرس كوثر,181,1973428,9030582094,4813,4620,4573,-240,-4.99,4656,-157,-3.26,4573,4660,1400-7-20,2021-10-12
581,قجام,فرآوردههاي غذايي وقندتربت‌جام‌,180,1980419,12310284504,6095,6216,6216,121,1.99,6216,121,1.99,6216,6216,1400-7-20,2021-10-12
582,ضسپا8041,اختيارخ خساپا-1600-1400/08/26,180,6406,1033276000,223,200,154,-69,-30.94,161,-62,-27.8,150,200,1400-7-20,2021-10-12
583,قپيرا,فرآورده‌هاي‌غدايي‌وقندپيرانشهر,180,637992,5412658210,8280,8450,8510,230,2.78,8350,70,0.85,8340,8600,1400-7-20,2021-10-12
584,رتكو,كنترل‌خوردگي‌تكين‌كو,179,456137,4898606640,11240,11290,10710,-530,-4.72,11060,-180,-1.6,10680,11290,1400-7-20,2021-10-12
585,ثاصفا,شركت‌ ساختمان‌ اصفهان‌,177,424487,6103631604,14961,15500,14213,-748,-5,14576,-385,-2.57,14213,15500,1400-7-20,2021-10-12
586,سغرب,سيمان‌غرب‌,176,377084,7416783100,20500,20720,19480,-1020,-4.98,20020,-480,-2.34,19480,20720,1400-7-20,2021-10-12
587,كگهر,سنگ آهن گهرزمين,172,260372,11470358351,45185,45185,44570,-615,-1.36,45074,-111,-0.25,43300,45185,1400-7-20,2021-10-12
588,شپلي,پلي اكريل ايران,168,1001108,8742595404,8995,8728,8726,-269,-2.99,8811,-184,-2.05,8726,8929,1400-7-20,2021-10-12
589,اتكام,بيمه اتكايي امين,168,1660652,5912984040,3740,3680,3553,-187,-5,3664,-76,-2.03,3553,3680,1400-7-20,2021-10-12
590,تسه9902,امتياز تسهيلات مسكن ارديبهشت99,165,3283,2276034321,729550,693080,693073,-36477,-5,693279,-36271,-4.97,693073,695000,1400-7-20,2021-10-12
591,كگاز,شيشه‌ و گاز,165,893632,17516211590,20590,20000,19570,-1020,-4.95,19600,-990,-4.81,19570,20300,1400-7-20,2021-10-12
592,وزمين,بانك ايران زمين,164,887988,9122851162,10358,10450,9944,-414,-4,10311,-47,-0.45,9944,10470,1400-7-20,2021-10-12
593,غپونه,نوش پونه مشهد,164,986924,12849047625,13400,13015,13014,-386,-2.88,13019,-381,-2.84,12998,13362,1400-7-20,2021-10-12
594,كساپا,سايپاشيشه‌,160,658304,14523165330,23220,22060,22060,-1160,-5,22060,-1160,-5,22060,22950,1400-7-20,2021-10-12
595,مداران,داده‌پردازي‌ايران‌,155,877879,13920021670,16670,16460,15840,-830,-4.98,15860,-810,-4.86,15840,16460,1400-7-20,2021-10-12
596,تشتاد,صنايع توليدي اشتاد ايران‌,155,1436448,8565997257,6141,6018,5957,-184,-3,5985,-156,-2.54,5957,6041,1400-7-20,2021-10-12
597,وپسا,س. پتروشيمي ساختمان  خليج فارس,154,3734875,6885524645,1898,1880,1842,-56,-2.95,1858,-40,-2.11,1842,1900,1400-7-20,2021-10-12
598,شاملا,معدني‌ املاح‌  ايران‌,151,401775,13175298680,34390,33570,32680,-1710,-4.97,32890,-1500,-4.36,32680,33620,1400-7-20,2021-10-12
599,لخانه,لوازم‌ خانگي‌ پارس‌,150,350286,7012734763,20615,20440,19997,-618,-3,20171,-444,-2.15,19997,21040,1400-7-20,2021-10-12
600,قزوين,كارخانجات‌ قند قزوين‌,148,223184,6838206200,32110,31000,30510,-1600,-4.98,31390,-720,-2.24,30510,31000,1400-7-20,2021-10-12
601,سخزر,سيمان‌ خزر,147,717735,17041976060,24980,25000,23740,-1240,-4.96,23740,-1240,-4.96,23740,25000,1400-7-20,2021-10-12
602,مارون,پتروشيمي مارون,145,46295,8418131720,184759,184000,183400,-1359,-0.74,184508,-251,-0.14,180984,185000,1400-7-20,2021-10-12
603,نهال,صندوق س. طلاي سرخ نوويرا,144,533630,5919432329,11497,11600,11001,-496,-4.31,11093,-404,-3.51,11001,11600,1400-7-20,2021-10-12
604,سرود,سيمان‌شاهرود,144,697642,16565413020,24970,23990,23750,-1220,-4.89,23740,-1230,-4.93,23730,23990,1400-7-20,2021-10-12
605,تكنو,تكنوتار,143,680465,7156730110,11050,11200,10500,-550,-4.98,10770,-280,-2.53,10500,11200,1400-7-20,2021-10-12
606,خريخت,صنايع‌ريخته‌گري‌ايران‌,142,1964086,7874743086,4211,4167,4001,-210,-4.99,4093,-118,-2.8,4001,4167,1400-7-20,2021-10-12
607,خبازرس,بازرسي مهندسي و صنعتي ايران,142,250340,6335800035,26054,25400,25273,-781,-3,25575,-479,-1.84,25273,25784,1400-7-20,2021-10-12
608,ولراز,ليزينگ رازي,141,307678,7589075048,25416,24700,24654,-762,-3,24666,-750,-2.95,24654,25180,1400-7-20,2021-10-12
609,گوهر,صندوق سكه طلاي كيان,140,159694,9132843998,58028,57500,56950,-1078,-1.86,57190,-838,-1.44,56950,57500,1400-7-20,2021-10-12
610,سشمال,سيمان‌ شمال‌,140,1251499,10490202030,8810,8840,8400,-410,-4.65,8470,-340,-3.86,8370,8840,1400-7-20,2021-10-12
611,كيان2,صندوق س. با درآمد ثابت كيان,140,14000000,14000000,30978,1,1,-30977,-100,1,-30977,-100,1,1,1400-7-20,2021-10-12
612,دالبر,البرزدارو,139,809669,11551598120,14780,14400,14050,-730,-4.94,14440,-340,-2.3,14050,14790,1400-7-20,2021-10-12
613,زكشت,كشاورزي مكانيزه اصفهان كشت,139,328359,6852240170,21947,21300,20850,-1097,-5,21388,-559,-2.55,20850,21300,1400-7-20,2021-10-12
614,صايند,صندوق س. گنجينه آينده روشن-د,138,862460,8670689470,10061,10077,10066,5,0.05,10053,-8,-0.08,10045,10077,1400-7-20,2021-10-12
615,كصدف,كاشي صدف سرام استقلال آباده,136,308691,7290955286,24272,24300,23544,-728,-3,23823,-449,-1.85,23544,24300,1400-7-20,2021-10-12
616,قچار,فراوردههاي غذايي وقند چهارمحال,133,641254,7265984872,11840,11900,11248,-592,-5,11555,-285,-2.41,11248,11900,1400-7-20,2021-10-12
617,ولملت,واسپاري ملت,131,2533506,15841084840,6570,6400,6250,-320,-4.87,6250,-320,-4.87,6250,6400,1400-7-20,2021-10-12
618,حبندر,دريايي و کشتيراني خط دريابندر,131,372918,12070236906,31425,32367,32367,942,3,32367,942,3,32367,32367,1400-7-20,2021-10-12
619,دبالكح,ح.مواد اوليه دارويي البرز بالك,130,564194,4528763685,8429,8240,8008,-421,-4.99,8027,-402,-4.77,8008,8240,1400-7-20,2021-10-12
620,پسهند,صنايع‌ لاستيكي‌  سهند,128,231580,6231435950,28120,27800,26720,-1400,-4.98,27560,-560,-1.99,26720,27800,1400-7-20,2021-10-12
621,زرين,صندوق س. سهام زرين كوروش-س,128,271350,3614060361,13586,13470,13200,-386,-2.84,13319,-267,-1.97,13151,13589,1400-7-20,2021-10-12
622,ضسپا8043,اختيارخ خساپا-2000-1400/08/26,126,7114,200035000,41,35,28,-13,-31.71,28,-13,-31.71,21,35,1400-7-20,2021-10-12
623,فراز,صندوق س.سهام فراز داريك-س,124,1938077,27391579861,14158,14001,14158,0,0,14133,-25,-0.18,14001,14163,1400-7-20,2021-10-12
624,دارا,صندوق س. دارا الگوريتم-د,123,3030600,30397740788,10029,10022,10030,1,0.01,10030,1,0.01,10022,10040,1400-7-20,2021-10-12
625,فنفت,صنايع تجهيزات نفت,120,342349,5454154810,16768,15930,15930,-838,-5,16273,-495,-2.95,15930,16489,1400-7-20,2021-10-12
626,وبهمن,سرمايه‌گذاري‌بهمن‌,120,576211,9663390480,17530,17000,17000,-530,-3.02,17130,-400,-2.28,16660,17480,1400-7-20,2021-10-12
627,زپارس,ملي كشت و صنعت و دامپروري پارس,120,138792,13319513170,100880,95960,95840,-5040,-5,96270,-4610,-4.57,95840,98580,1400-7-20,2021-10-12
628,اتكامح,ح . بيمه اتكايي امين,119,1403511,3017448741,2287,2211,2158,-129,-5.64,2150,-137,-5.99,2100,2274,1400-7-20,2021-10-12
629,سحرخيز,صندوق س. گروه زعفران سحرخيز,118,156371,1626987708,10384,10258,10630,246,2.37,10405,21,0.2,10250,10700,1400-7-20,2021-10-12
630,فبيرا,بسته‌ بندي‌ ايران‌,118,1968795,3746591550,1960,1921,1902,-58,-2.96,1937,-23,-1.17,1902,1921,1400-7-20,2021-10-12
631,وپخش,داروپخش‌ (هلدينگ‌,117,495954,15677931200,32100,31700,31140,-960,-2.99,31930,-170,-0.53,31120,31900,1400-7-20,2021-10-12
632,وتعاون,بيمه  تعاون,116,2516042,5314515557,2171,2189,2106,-65,-2.99,2140,-31,-1.43,2106,2189,1400-7-20,2021-10-12
633,وآتوس,س.آرين توسكا قيمت اسمي 350ريال,115,254454,5880185223,24274,23065,23061,-1213,-5,23286,-988,-4.07,23061,23900,1400-7-20,2021-10-12
634,وايرا,سرمايه گذاري صنايع ايران,114,823152,5184951828,6434,6469,6350,-84,-1.31,6362,-72,-1.12,6241,6469,1400-7-20,2021-10-12
635,سمتاز,سيمان ممتازان كرمان,112,289928,5172360490,18379,17830,17828,-551,-3,18075,-304,-1.65,17828,17980,1400-7-20,2021-10-12
636,وامين,س. امين توان آفرين ساز,111,815448,10462062946,12835,12840,12850,15,0.12,12834,-1,-0.01,12750,12910,1400-7-20,2021-10-12
637,اخزا910,اسنادخزانه-م10بودجه99-020807,110,189443,123450249429,651417,654994,651400,-17,0,651648,231,0.04,648001,654994,1400-7-20,2021-10-12
638,دسينا,داروسازي‌ سينا,110,404319,7734822440,19970,19500,18980,-990,-4.96,19510,-460,-2.3,18980,19500,1400-7-20,2021-10-12
639,آساس,صندوق س.آسمان آرماني سهام-س,109,30173,5201413495,177317,176500,171851,-5466,-3.08,172386,-4931,-2.78,171500,176500,1400-7-20,2021-10-12
640,دكيمي,كيميدارو,107,268930,5642779100,21940,22290,20850,-1090,-4.97,21530,-410,-1.87,20850,22290,1400-7-20,2021-10-12
641,ضسپا8042,اختيارخ خساپا-1800-1400/08/26,106,4765,316666000,90,85,68,-22,-24.44,66,-24,-26.67,60,85,1400-7-20,2021-10-12
642,ضخود1051,اختيارخ خودرو-1800-1400/10/08,105,3461,907014000,320,271,261,-59,-18.44,262,-58,-18.13,250,289,1400-7-20,2021-10-12
643,تسه0001,امتيازتسهيلات مسكن فروردين1400,102,2324,1642853199,744059,710000,706857,-37202,-5,706908,-37151,-4.99,706857,710000,1400-7-20,2021-10-12
644,پارسيان,بيمه پارسيان,99,646396,7150695600,11630,11350,11050,-580,-4.99,11450,-180,-1.55,11050,11350,1400-7-20,2021-10-12
645,وآرين,شركت توسعه اقتصادي آرين,98,1264196,3272691420,2665,2635,2586,-79,-2.96,2638,-27,-1.01,2586,2698,1400-7-20,2021-10-12
646,ارمغان,ص سرمايه گذاري ارمغان ايرانيان,98,699011,7009139690,10030,10023,10023,-7,-0.07,10027,-3,-0.03,10019,10033,1400-7-20,2021-10-12
647,اخزا006,اسنادخزانه-م6بودجه00-030723,97,574856,304612594400,529372,529952,529900,528,0.1,529894,522,0.1,528500,530449,1400-7-20,2021-10-12
648,وتعاونح,ح . بيمه  تعاون,95,3917317,2666068187,699,690,679,-20,-2.86,681,-18,-2.58,679,690,1400-7-20,2021-10-12
649,لپيام,گسترش صنايع پيام,94,145149,6628664532,47080,45668,45668,-1412,-3,46116,-964,-2.05,45668,45668,1400-7-20,2021-10-12
650,سنوين,سرمايه گذاري اقتصاد نوين,94,294848,2327219043,8016,8100,7950,-66,-0.82,7987,-29,-0.36,7776,8100,1400-7-20,2021-10-12
651,وليز,ليزينگ‌ايران‌,93,1537687,3456720376,2141,2248,2248,107,5,2164,23,1.07,2248,2248,1400-7-20,2021-10-12
652,گنگين,اقتصادي نگين گردشگري ايرانيان,93,961078,22333179048,23929,23213,23212,-717,-3,23375,-554,-2.32,23212,23646,1400-7-20,2021-10-12
653,زر,صندوق س.پشتوانه سكه طلاي زر,89,28750,1407329817,50069,49800,49080,-989,-1.98,48951,-1118,-2.23,48600,49800,1400-7-20,2021-10-12
654,تكنار,مجتمع معادن مس تكنار,86,35870,2318283593,66617,64620,64619,-1998,-3,66115,-502,-0.75,64619,66399,1400-7-20,2021-10-12
655,قتربت,قند تربت حيدريه,85,13292,641764344,46876,48282,48282,1406,3,46962,86,0.18,48282,48282,1400-7-20,2021-10-12
656,اخزا008,اسنادخزانه-م8بودجه00-030919,83,269834,139009281432,513518,512926,512925,-593,-0.12,515166,1648,0.32,512925,517000,1400-7-20,2021-10-12
657,كفرآور,فرآورده هاي سيمان شرق,83,705993,10840608015,15829,15360,15355,-474,-2.99,15355,-474,-2.99,15355,15370,1400-7-20,2021-10-12
658,بالبر,كابل‌ البرز,83,244397,7187161320,30850,30140,29310,-1540,-4.99,30050,-800,-2.59,29310,30140,1400-7-20,2021-10-12
659,آ س پ,آ.س.پ,82,289427,2865037873,10420,9899,9899,-521,-5,10305,-115,-1.1,9899,9899,1400-7-20,2021-10-12
660,نيرو,نيرو سرمايه,82,112306,4851561788,44474,43694,43140,-1334,-3,43824,-650,-1.46,43140,44989,1400-7-20,2021-10-12
661,اخزا002,اسنادخزانه-م2بودجه00-031024,81,105489,53074962562,503277,503030,503000,-277,-0.06,503133,-144,-0.03,502648,504106,1400-7-20,2021-10-12
662,بسويچ,پارس‌سويچ‌,80,200034,3697342290,19450,18500,18480,-970,-4.99,19210,-240,-1.23,18480,18630,1400-7-20,2021-10-12
663,تسه9812,امتياز تسهيلات مسكن اسفند98,78,620,434825784,736374,700000,705000,-31374,-4.26,701332,-35042,-4.76,699556,705000,1400-7-20,2021-10-12
664,تسه9901,امتياز تسهيلات مسكن فروردين99,74,561,397108591,741779,704691,740000,-1779,-0.24,707858,-33921,-4.57,704691,740000,1400-7-20,2021-10-12
665,فكمند,گسترش قطعه سازي كمند,74,131062,4589117774,35843,34920,34768,-1075,-3,35462,-381,-1.06,34768,36780,1400-7-20,2021-10-12
666,تسه9910,امتياز تسهيلات مسكن دي99,74,4344,3024479642,732887,696243,696243,-36644,-5,696243,-36644,-5,696243,696244,1400-7-20,2021-10-12
667,سكه0012پ04,تمام سكه طرح جديد0012صادرات,73,69600,79249479700,1157583,1139001,1138011,-19572,-1.69,1138642,-18941,-1.64,1130611,1149900,1400-7-20,2021-10-12
668,داوه,داروسازي آوه سينا,73,240400,3774319133,16501,15690,15676,-825,-5,16301,-200,-1.21,15676,16019,1400-7-20,2021-10-12
669,وآفري,بيمه كارآفرين,72,945317,3127044295,3386,3317,3285,-101,-2.98,3367,-19,-0.56,3285,3420,1400-7-20,2021-10-12
670,ضجار7038,اختيارخ وتجارت-1797-1400/07/21,71,1281,191692000,279,181,209,-70,-25.09,150,-129,-46.24,132,209,1400-7-20,2021-10-12
671,ضجار7039,اختيارخ وتجارت-1997-1400/07/21,69,2217,28631000,92,41,10,-82,-89.13,13,-79,-85.87,5,41,1400-7-20,2021-10-12
672,اخزا901,اسنادخزانه-م1بودجه99-010621,68,43778,36353647740,829145,828552,831400,2255,0.27,830409,1264,0.15,828552,831998,1400-7-20,2021-10-12
673,واحصا,احياء صنايع خراسان,68,74149,3685650194,48259,49706,49706,1447,3,48764,505,1.05,49706,49706,1400-7-20,2021-10-12
674,سكه0011پ02,تمام سكه طرح جديد0011ملت,67,9500,10788474700,1160315,1138100,1140000,-20315,-1.75,1135629,-24686,-2.13,1130100,1141800,1400-7-20,2021-10-12
675,تسه9903,امتياز تسهيلات مسكن خرداد99,66,560,393713040,740062,703059,703059,-37003,-5,703059,-37003,-5,703059,703059,1400-7-20,2021-10-12
676,وبازار,صندوق س شاخصي بازارآشنا,65,434851,5271888310,12530,12320,12050,-480,-3.83,12120,-410,-3.27,12020,12330,1400-7-20,2021-10-12
677,آتيمس,صندوق س.آرمان آتيه درخشان مس-س,64,15695,2985545541,194000,193552,188020,-5980,-3.08,190223,-3777,-1.95,188019,193552,1400-7-20,2021-10-12
678,شصفها,پتروشيمي‌ اصفهان‌,63,70157,9564994909,142017,136337,136337,-5680,-4,138696,-3321,-2.34,136337,136337,1400-7-20,2021-10-12
679,ضشنا8005,اختيارخ شپنا-12800-1400/08/16,62,535,626450000,1676,1505,1100,-576,-34.37,1171,-505,-30.13,1100,1505,1400-7-20,2021-10-12
680,اخزا909,اسنادخزانه-م9بودجه99-020316,60,220243,157611214874,715292,714411,715750,458,0.06,715624,332,0.05,714311,716111,1400-7-20,2021-10-12
681,تسه9907,امتياز تسهيلات مسكن مهر99,58,751,523640007,733954,697257,697257,-36697,-5,697257,-36697,-5,697257,697257,1400-7-20,2021-10-12
682,ضشنا8006,اختيارخ شپنا-14800-1400/08/16,58,695,248963000,637,510,365,-272,-42.7,358,-279,-43.8,274,510,1400-7-20,2021-10-12
683,اخزا914,اسنادخزانه-م14بودجه99-021025,58,154126,96040178266,623019,623823,623000,-19,0,623128,109,0.02,621777,623823,1400-7-20,2021-10-12
684,ضصاد8033,اختيارخ وبصادر-2489-1400/08/12,57,3147,59164000,28,20,13,-15,-53.57,19,-9,-32.14,12,20,1400-7-20,2021-10-12
685,ضملت8042,اختيارخ وبملت-3934-1400/08/19,56,2556,181363000,120,61,99,-21,-17.5,71,-49,-40.83,60,99,1400-7-20,2021-10-12
686,افق ملت,صندوق س در سهام افق ملت,55,26889,3947348110,148870,150000,145500,-3370,-2.26,146800,-2070,-1.39,145500,150000,1400-7-20,2021-10-12
687,ضملت8043,اختيارخ وبملت-4434-1400/08/19,53,2700,92668000,43,45,39,-4,-9.3,34,-9,-20.93,16,45,1400-7-20,2021-10-12
688,اخزا902,اسنادخزانه-م2بودجه99-011019,53,117349,91413315245,778491,778491,779002,511,0.07,778987,496,0.06,777555,779350,1400-7-20,2021-10-12
689,فيروزا,صندوق بادرآمد ثابت فيروزه آسيا,52,302864,7612381943,25130,25100,25140,10,0.04,25135,5,0.02,25100,25148,1400-7-20,2021-10-12
690,صخابر102,صكوك اجاره مخابرات-3 ماهه 16%,51,250700,245686000000,976892,980000,980000,3108,0.32,980000,3108,0.32,980000,980000,1400-7-20,2021-10-12
691,ماني2,صندوق س. با درآمد ثابت ماني,50,5000000,5000000,10294,1,1,-10293,-99.99,1,-10293,-99.99,1,1,1400-7-20,2021-10-12
692,سكه0112پ03,تمام سكه طرح جديد0112سامان,49,5600,6367727600,1158628,1139999,1135101,-23527,-2.03,1137094,-21534,-1.86,1131001,1184000,1400-7-20,2021-10-12
693,وگردش,بانك گردشگري,46,1412177,15721766541,11477,11133,11133,-344,-3,11396,-81,-0.71,11133,11133,1400-7-20,2021-10-12
694,اخزا908,اسنادخزانه-م8بودجه99-020606,45,113349,76681474894,675652,675798,676351,699,0.1,676508,856,0.13,675798,676551,1400-7-20,2021-10-12
695,كهربا,صندوق س.پشتوانه سكه طلا كهربا,42,111812,1132330801,10238,10189,10110,-128,-1.25,10127,-111,-1.08,10109,10189,1400-7-20,2021-10-12
696,تسه9809,امتياز تسهيلات مسكن آذر98,41,761,540415354,747512,710140,710137,-37375,-5,710138,-37374,-5,710137,710141,1400-7-20,2021-10-12
697,گنجين,صندوق س. گنجينه يكم آويد-د,40,504703,7013655265,13885,13889,13897,12,0.09,13897,12,0.09,13889,13898,1400-7-20,2021-10-12
698,گپارس,امور رفاهي كارگزاران پارس,40,13787,2044250195,152855,148290,148270,-4585,-3,151877,-978,-0.64,148270,148500,1400-7-20,2021-10-12
699,اخزا721,اسنادخزانه-م21بودجه97-000728,39,21672,21558588586,994016,995780,995000,984,0.1,994767,751,0.08,994054,995780,1400-7-20,2021-10-12
700,ضملت8041,اختيارخ وبملت-3434-1400/08/19,38,1543,378754000,384,400,258,-126,-32.81,245,-139,-36.2,199,400,1400-7-20,2021-10-12
701,اخزا903,اسنادخزانه-م3بودجه99-011110,38,73143,56230684648,768959,768263,768966,7,0,768777,-182,-0.02,768263,769000,1400-7-20,2021-10-12
702,الماس,صندوق س.امين تدبيرگران فردا-س,38,14836,1735363699,120213,120200,116500,-3713,-3.09,116970,-3243,-2.7,116500,122990,1400-7-20,2021-10-12
703,اخزا001,اسنادخزانه-م1بودجه00-030821,37,141619,73902686600,521620,521703,520000,-1620,-0.31,521842,222,0.04,520000,522822,1400-7-20,2021-10-12
704,شزنگ,تجهيزنيروي‌زنگان‌,37,47957,5624301046,120905,117278,117278,-3627,-3,118660,-2245,-1.86,117278,117278,1400-7-20,2021-10-12
705,اخزا911,اسنادخزانه-م11بودجه99-020906,37,150319,96388786326,640362,641543,640000,-362,-0.06,641228,866,0.14,640000,642000,1400-7-20,2021-10-12
706,اوصتا,صندوق انديشه ورزان صباتامين -د,37,303826,6118387531,20134,20139,20139,5,0.02,20138,4,0.02,20137,20139,1400-7-20,2021-10-12
707,ضپال2007,اختيارخ اپال-32000-1401/02/12,36,451,256222000,693,581,560,-133,-19.19,568,-125,-18.04,500,679,1400-7-20,2021-10-12
708,ضسپا8044,اختيارخ خساپا-2500-1400/08/26,34,1160,8271000,8,5,7,-1,-12.5,7,-1,-12.5,5,10,1400-7-20,2021-10-12
709,سخند,صندوق س.سپهرخبرگان نفت-د,34,60380,602651780,9985,10006,10000,15,0.15,9981,-4,-0.04,9959,10006,1400-7-20,2021-10-12
710,ضفلا7003,اختيارخ فولاد-8160-1400/07/25,32,403,998093614,2112,1509,1800,-312,-14.77,1767,-345,-16.34,840,1919,1400-7-20,2021-10-12
711,ضملي1159,اختيارخ فملي-5000-1400/11/03,30,521,2014500000,3921,3999,3600,-321,-8.19,3867,-54,-1.38,3600,3999,1400-7-20,2021-10-12
712,صنوين,صندوق سرمايه‌گذاري صنوين-مختلط,30,7835,776972860,99700,99240,98220,-1480,-1.48,99170,-530,-0.53,98090,99330,1400-7-20,2021-10-12
713,داريك,صندوق س.اعتماد داريك-د,30,386327,4497172546,11634,11640,11640,6,0.05,11641,7,0.06,11640,11642,1400-7-20,2021-10-12
714,زعف0008پ20,زعفران0008نگين وحدت جام(پ),28,56104,8821312985,158093,157499,158000,-93,-0.06,157231,-862,-0.55,156000,159000,1400-7-20,2021-10-12
715,تسه9906,امتياز تسهيلات مسكن شهريور99,27,339,237930540,738800,701860,701860,-36940,-5,701860,-36940,-5,701860,701860,1400-7-20,2021-10-12
716,تپولا,مهندسي مرآت پولاد,27,536176,11361569440,21845,21190,21190,-655,-3,21190,-655,-3,21190,21190,1400-7-20,2021-10-12
717,ضفلا1163,اختيارخ فولاد-10000-1400/11/24,26,905,1741019000,2126,1999,1900,-226,-10.63,1924,-202,-9.5,1710,1999,1400-7-20,2021-10-12
718,اخزا004,اسنادخزانه-م4بودجه00-030522,26,102767,56401561088,549119,549800,548989,-130,-0.02,548829,-290,-0.05,548000,549800,1400-7-20,2021-10-12
719,ثهام,صندوق س ثروت هامرز-سهام,24,67030,785336645,11650,11660,11740,90,0.77,11716,66,0.57,11625,11810,1400-7-20,2021-10-12
720,ساروج,بين المللي ساروج بوشهر,23,116744,1925826787,16988,17225,16486,-502,-2.96,16889,-99,-0.58,16479,17225,1400-7-20,2021-10-12
721,زعف0008پ08,زعفران0008نگين روستا(پ),22,11710,1809743195,154215,153000,155000,785,0.51,154547,332,0.22,153000,155961,1400-7-20,2021-10-12
722,ضسپا8040,اختيارخ خساپا-1400-1400/08/26,22,288,86909000,381,340,310,-71,-18.64,302,-79,-20.73,256,340,1400-7-20,2021-10-12
723,پادا,صندوق س.پاداش سرمايه پارس-س,22,3706,417669075,116025,115800,112999,-3026,-2.61,112701,-3324,-2.86,111300,115800,1400-7-20,2021-10-12
724,اخزا815,اسنادخزانه-م15بودجه98-010406,22,9235,8010683598,866275,853003,870000,3725,0.43,867426,1151,0.13,853003,870000,1400-7-20,2021-10-12
725,ضپاس7029,اختيارخ وپارس-2500-1400/07/28,21,616,34841000,88,42,72,-16,-18.18,57,-31,-35.23,41,75,1400-7-20,2021-10-12
726,اخزا820,اسنادخزانه-م20بودجه98-020806,21,15068,9824231637,651185,635000,652000,815,0.13,651993,808,0.12,635000,652800,1400-7-20,2021-10-12
727,ثجوان,تامين مسكن جوانان,20,106315,707101065,6856,6651,6651,-205,-2.99,6840,-16,-0.23,6651,6651,1400-7-20,2021-10-12
728,تسه9810,امتياز تسهيلات مسكن دي98,20,457,329501620,753910,741500,716215,-37695,-5,721010,-32900,-4.36,716215,763000,1400-7-20,2021-10-12
729,اخزا007,اسنادخزانه-م7بودجه00-030912,18,122582,63167515432,514684,515005,515000,316,0.06,515308,624,0.12,515000,515500,1400-7-20,2021-10-12
730,هبساز103,اختيارف ت ثبهساز-2346-01/03/18,18,179257,22048611,105,123,123,18,17.14,123,18,17.14,123,123,1400-7-20,2021-10-12
731,تسه9811,امتياز تسهيلات مسكن بهمن98,18,169,123626458,762844,737500,724702,-38142,-5,731517,-31327,-4.11,724702,737500,1400-7-20,2021-10-12
732,سكه0111پ05,تمام سكه طرح جديد0111آينده,18,3300,3740288600,1163176,1130000,1138000,-25176,-2.16,1133421,-29755,-2.56,1130000,1141000,1400-7-20,2021-10-12
733,ضمخا1037,اختيارخ اخابر-9000-1400/10/26,17,37,21600000,982,500,600,-382,-38.9,584,-398,-40.53,500,600,1400-7-20,2021-10-12
734,سيناد,صندوق س.سپهرسودمند سينا-د,17,224566,2287928963,10182,10188,10188,6,0.06,10188,6,0.06,10188,10189,1400-7-20,2021-10-12
735,صايپا012,صكوك مرابحه سايپا012-3ماهه 16%,17,85000,85000170000,1000002,1000002,1000002,0,0,1000002,0,0,1000002,1000002,1400-7-20,2021-10-12
736,دمعيار,صندوق س. توازن معيار-د,16,426835,4312516825,10095,10100,10100,5,0.05,10103,8,0.08,10100,10105,1400-7-20,2021-10-12
737,اخزا821,اسنادخزانه-م21بودجه98-020906,16,6050,3872722205,641146,642000,640030,-1116,-0.17,640119,-1027,-0.16,640025,642000,1400-7-20,2021-10-12
738,تسه9808,امتياز تسهيلات مسكن آبان98,15,498,351635808,743258,706096,706096,-37162,-5,706096,-37162,-5,706096,706096,1400-7-20,2021-10-12
739,ثروتم,صندوق س. ثروت آفرين پارسيان-س,15,33440,2912192240,89643,88804,87593,-2050,-2.29,87087,-2556,-2.85,86905,88805,1400-7-20,2021-10-12
740,آكورد2,صندوق س. آرمان آتي كوثر-د,14,1400000,1400000,34600,1,1,-34599,-100,1,-34599,-100,1,1,1400-7-20,2021-10-12
741,غشوكوح,ح . شوكو پارس,14,477750,4031732250,8700,8439,8439,-261,-3,8439,-261,-3,8439,8439,1400-7-20,2021-10-12
742,اخزا812,اسنادخزانه-م12بودجه98-001111,14,5297,4968367928,940126,934001,939150,-976,-0.1,937959,-2167,-0.23,934001,941000,1400-7-20,2021-10-12
743,اخزا905,اسنادخزانه-م5بودجه99-020218,14,34714,25273545765,727240,726313,727563,323,0.04,728050,810,0.11,726313,728500,1400-7-20,2021-10-12
744,ضفلا1164,اختيارخ فولاد-12000-1400/11/24,13,605,637117000,1000,1000,1050,50,5,1053,53,5.3,999,1100,1400-7-20,2021-10-12
745,ضملت8044,اختيارخ وبملت-4934-1400/08/19,13,370,4300000,10,14,13,3,30,12,2,20,7,14,1400-7-20,2021-10-12
746,آسام,صندوق س.آرمان سپهر آشنا-م,13,7290,897193100,125122,125000,123000,-2122,-1.7,123072,-2050,-1.64,123000,125000,1400-7-20,2021-10-12
747,اخزا818,اسنادخزانه-م18بودجه98-010614,13,38000,31834305476,835000,837666,838000,3000,0.36,837745,2745,0.33,837666,838000,1400-7-20,2021-10-12
748,اطلس2,صندوق س.توسعه اندوخته آينده-س,12,120000,120000,257706,1,1,-257705,-100,1,-257705,-100,1,1,1400-7-20,2021-10-12
749,ضملي1161,اختيارخ فملي-7000-1400/11/03,12,750,966465000,1400,1222,1248,-152,-10.86,1289,-111,-7.93,1200,1300,1400-7-20,2021-10-12
750,اخزا907,اسنادخزانه-م7بودجه99-020704,12,29633,19696770007,664476,664693,664689,213,0.03,664690,214,0.03,664689,664695,1400-7-20,2021-10-12
751,اخزا808,اسنادخزانه-م8بودجه98-000817,12,3394,3342916946,984041,984500,984999,958,0.1,984949,908,0.09,984500,984999,1400-7-20,2021-10-12
752,اخزا817,اسنادخزانه-م17بودجه98-010512,11,3515,2992804270,849998,849998,852000,2002,0.24,851438,1440,0.17,849998,853999,1400-7-20,2021-10-12
753,اراد50,مرابحه عام دولت5-ش.خ0302,11,112300,112300000000,1000001,1000000,1000000,-1,0,1000000,-1,0,1000000,1000000,1400-7-20,2021-10-12
754,سپرمي,پرميت‌,11,57025,579716150,10066,10166,10166,100,0.99,10098,32,0.32,10166,10166,1400-7-20,2021-10-12
755,شساخت,مهندسي و ساختمان صنايع نفت,11,4533,201007319,45714,44343,44343,-1371,-3,45708,-6,-0.01,44343,44344,1400-7-20,2021-10-12
756,زعف0008پ16,زعفران0008نگين بيرجند(پ),10,13463,2128446491,156638,158000,158000,1362,0.87,158096,1458,0.93,158000,164337,1400-7-20,2021-10-12
757,سفارود,كارخانه فارسيت درود,10,8054,127019634,16428,15771,15771,-657,-4,16411,-17,-0.1,15771,15771,1400-7-20,2021-10-12
758,امين يكم2,صندوق درآمد ثابت امين يكم فردا,10,10000000,10000000,10093,1,1,-10092,-99.99,1,-10092,-99.99,1,1,1400-7-20,2021-10-12
759,خعمرا,توسعه و عمران شهرستان نائين,10,322564,1265096008,3808,3922,3922,114,2.99,3822,14,0.37,3922,3922,1400-7-20,2021-10-12
760,طخود1051,اختيارف خودرو-1800-1400/10/08,10,123,18639000,129,140,160,31,24.03,152,23,17.83,140,160,1400-7-20,2021-10-12
761,ضفلا1162,اختيارخ فولاد-9000-1400/11/24,10,104,253892000,2719,2499,2200,-519,-19.09,2441,-278,-10.22,2200,2600,1400-7-20,2021-10-12
762,برن0104پ01,برنج طارم0104تجارت مازندران(پ),9,586,232300400,396440,395000,396500,60,0.02,396417,-23,-0.01,395000,399000,1400-7-20,2021-10-12
763,بذر,صندوق س بذر اميد آفرين-سهام,9,3244,319922240,102100,99390,98110,-3990,-3.91,98620,-3480,-3.41,97970,99980,1400-7-20,2021-10-12
764,ضپاس7030,اختيارخ وپارس-3000-1400/07/28,9,330,567000,9,2,1,-8,-88.89,2,-7,-77.78,1,2,1400-7-20,2021-10-12
765,صفارس147,صكوك اجاره فارس147- 3ماهه18%,9,50000,50000000000,1044733,1000000,1000000,-44733,-4.28,1000000,-44733,-4.28,1000000,1000000,1400-7-20,2021-10-12
766,سجام,مجتمع سيمان غرب آسيا,9,34727,128420446,3812,3698,3698,-114,-2.99,3810,-2,-0.05,3698,3698,1400-7-20,2021-10-12
767,اخزا814,اسنادخزانه-م14بودجه98-010318,9,7546,6613074025,876530,876111,876150,-380,-0.04,876368,-162,-0.02,876111,876700,1400-7-20,2021-10-12
768,ضجار7037,اختيارخ وتجارت-1597-1400/07/21,9,365,151553000,434,399,360,-74,-17.05,415,-19,-4.38,343,430,1400-7-20,2021-10-12
769,ضمخا7066,اختيارخ اخابر-11700-1400/07/28,9,208,471000,6,1,3,-3,-50,2,-4,-66.67,1,11,1400-7-20,2021-10-12
770,هاميد104,اختيارف ت ثاميد-2050-01/04/20,9,200000,43600000,208,218,218,10,4.81,218,10,4.81,218,218,1400-7-20,2021-10-12
771,وسرضوي,س.سهام عدالت استان خراسان رضوي,8,169500,117972000,732,696,696,-36,-4.92,732,0,0,696,696,1400-7-20,2021-10-12
772,ضجار1022,اختيارخ وتجارت-2000-1400/10/15,8,736,286304000,405,389,389,-16,-3.95,389,-16,-3.95,389,389,1400-7-20,2021-10-12
773,ضفلا7004,اختيارخ فولاد-9586-1400/07/25,8,124,64291514,894,340,500,-394,-44.07,370,-524,-58.61,340,500,1400-7-20,2021-10-12
774,ضشنا1049,اختيارخ شپنا-6540-1400/10/19,8,151,323845000,3778,1500,2800,-978,-25.89,2145,-1633,-43.22,1500,2845,1400-7-20,2021-10-12
775,اخزا809,اسنادخزانه-م9بودجه98-000923,8,3212,3098892310,964011,964000,964000,-11,0,964786,775,0.08,963760,965500,1400-7-20,2021-10-12
776,ضفار8051,اختيارخ فارس-8400-1400/08/05,8,28,94010000,3200,3250,3800,600,18.75,3357,157,4.91,3201,3800,1400-7-20,2021-10-12
777,زعف0008پ05,زعفران0008نگين زرين(پ),8,2132,334699560,156322,154001,157698,1376,0.88,156989,667,0.43,154001,157780,1400-7-20,2021-10-12
778,اخزا723,اسنادخزانه-م23بودجه97-000824,8,5610,5507165232,980042,987999,981000,958,0.1,981669,1627,0.17,980200,988000,1400-7-20,2021-10-12
779,ضپنا1031,اختيارخ رمپنا-13850-1400/10/08,8,235,1016750000,1,4350,4300,4299,429900,4327,4326,432600,4300,4550,1400-7-20,2021-10-12
780,اراد61,مرابحه عام دولت61-ش.خ0309,7,95000,95000000000,1000000,1000000,1000000,0,0,1000000,0,0,1000000,1000000,1400-7-20,2021-10-12
781,ضفلا7002,اختيارخ فولاد-6733-1400/07/25,7,23,101699678,3630,3009,3300,-330,-9.09,3154,-476,-13.11,3000,3300,1400-7-20,2021-10-12
782,تملي809,تسهيلات مسكن ب. ملي-آذر98,7,92,70492895,730111,766616,761505,31394,4.3,766227,36116,4.95,761505,766616,1400-7-20,2021-10-12
783,اخزا003,اسنادخزانه-م3بودجه00-030418,7,11399,6391478646,560376,560699,560724,348,0.06,560705,329,0.06,560699,560724,1400-7-20,2021-10-12
784,طلا2,صندوق س.پشتوانه طلاي لوتوس,6,600000,600000,82290,1,1,-82289,-100,1,-82289,-100,1,1,1400-7-20,2021-10-12
785,ضسپا8039,اختيارخ خساپا-1200-1400/08/26,6,55,26111000,575,401,451,-124,-21.57,475,-100,-17.39,401,500,1400-7-20,2021-10-12
786,اخزا917,اسنادخزانه-م17بودجه99-010226,6,95080,84337265000,886000,887001,887203,1203,0.14,887014,1014,0.11,887000,890000,1400-7-20,2021-10-12
787,اخزا813,اسنادخزانه-م13بودجه98-010219,6,3487,3106491625,890058,890002,891221,1163,0.13,890878,820,0.09,890001,892500,1400-7-20,2021-10-12
788,وسنا,سرمايه گذاري نيروگاهي ايران,6,5275,71212500,13917,13500,13500,-417,-3,13915,-2,-0.01,13500,13500,1400-7-20,2021-10-12
789,ضملت1136,اختيارخ وبملت-4500-1400/11/13,6,242,59864000,308,250,182,-126,-40.91,247,-61,-19.81,182,250,1400-7-20,2021-10-12
790,اخزا918,اسنادخزانه-م18بودجه99-010323,6,18059,15802568764,875333,874444,888444,13111,1.5,875052,-281,-0.03,872788,888444,1400-7-20,2021-10-12
791,ضپاس1011,اختيارخ وپارس-2000-1400/10/22,5,148,94900000,800,700,600,-200,-25,641,-159,-19.88,600,700,1400-7-20,2021-10-12
792,ضفار8050,اختيارخ فارس-7400-1400/08/05,5,27,136350000,5359,5150,5000,-359,-6.7,5050,-309,-5.77,5000,5150,1400-7-20,2021-10-12
793,تسه9905,امتياز تسهيلات مسكن مرداد99,5,16,11354608,747013,709663,709663,-37350,-5,709663,-37350,-5,709663,709663,1400-7-20,2021-10-12
794,گكيش,توريستي ورفاهي آبادگران كيش,5,30370,1221056220,41449,40206,40206,-1243,-3,41292,-157,-0.38,40206,40206,1400-7-20,2021-10-12
795,اخزا811,اسنادخزانه-م11بودجه98-001013,5,158,150890210,954015,955000,955000,985,0.1,955001,986,0.1,955000,955010,1400-7-20,2021-10-12
796,کم ه 4,کم باري هفته 4,4,54000,29160000,540,540,540,0,0,540,0,0,540,540,1400-7-20,2021-10-12
797,هماي2,صندوق س هماي آگاه-ثابت,4,4266000,4266000,10107,1,1,-10106,-99.99,1,-10106,-99.99,1,1,1400-7-20,2021-10-12
798,سخواف,سيمان مجد خواف,4,4938,50495988,10542,10226,10226,-316,-3,10540,-2,-0.02,10226,10226,1400-7-20,2021-10-12
799,ضشنا1051,اختيارخ شپنا-8719-1400/10/19,4,75,74500000,1392,1100,900,-492,-35.34,993,-399,-28.66,900,1100,1400-7-20,2021-10-12
800,وجامي,سرمايه گذاري جامي,4,93697,962174493,10586,10269,10269,-317,-2.99,10554,-32,-0.3,10269,10269,1400-7-20,2021-10-12
801,عيار2,صندوق سكه طلاي مفيد,4,40000,40000,29482,1,1,-29481,-100,1,-29481,-100,1,1,1400-7-20,2021-10-12
802,ضذوب905,اختيارخ ذوب-5000-14000917,4,400,80000000,205,200,200,-5,-2.44,200,-5,-2.44,200,200,1400-7-20,2021-10-12
803,طفلا1162,اختيارف فولاد-9000-1400/11/24,4,21,4750000,220,200,250,30,13.64,226,6,2.73,200,250,1400-7-20,2021-10-12
804,ضصاد1113,اختيارخ وبصادر-2000-1400/11/06,4,202,80598000,456,399,399,-57,-12.5,399,-57,-12.5,399,399,1400-7-20,2021-10-12
805,تملي706,تسهيلات مسكن ب. ملي-شهريور97,4,32,19931264,653372,620704,625000,-28372,-4.34,622852,-30520,-4.67,620704,625000,1400-7-20,2021-10-12
806,تسه9909,امتياز تسهيلات مسكن آذر99,4,467,330026565,743889,706695,706695,-37194,-5,706695,-37194,-5,706695,706695,1400-7-20,2021-10-12
807,اخزا906,اسنادخزانه-م6بودجه99-020321,4,68,48418956,712944,712001,712101,-843,-0.12,712043,-901,-0.13,712001,712112,1400-7-20,2021-10-12
808,زعف0008پ12,زعفران0008پوشالمعمول سحرخيز(پ),3,400,51200000,125975,128000,128000,2025,1.61,128000,2025,1.61,128000,128000,1400-7-20,2021-10-12
809,اراد72,مرابحه عام دولت72-ش.خ0311,3,45300,41030613500,920865,880745,930000,9135,0.99,905753,-15112,-1.64,880745,930000,1400-7-20,2021-10-12
810,ضصاد8030,اختيارخ وبصادر-1589-1400/08/12,3,14,5624000,512,350,401,-111,-21.68,402,-110,-21.48,401,402,1400-7-20,2021-10-12
811,پست0008پ08,پسته فندقي32-30مه ولات0008(پ),3,62,112530000,1825000,1815000,1815000,-10000,-0.55,1815000,-10000,-0.55,1815000,1815000,1400-7-20,2021-10-12
812,ضمخا7077,اختيارخ اخابر-6700-1400/07/28,3,61,75080000,1359,1300,1100,-259,-19.06,1231,-128,-9.42,1100,1300,1400-7-20,2021-10-12
813,شپديس2,پتروشيمي پرديس,3,4000000,763720000000,190930,190930,190930,0,0,190930,0,0,190930,190930,1400-7-20,2021-10-12
814,وسصفا,شركت س استان اصفهان,3,34365,23849310,730,694,694,-36,-4.93,730,0,0,694,694,1400-7-20,2021-10-12
815,ضذوب904,اختيارخ ذوب-4500-14000917,3,104,12600000,350,120,150,-200,-57.14,121,-229,-65.43,120,150,1400-7-20,2021-10-12
816,طخود1050,اختيارف خودرو-1600-1400/10/08,3,27,1352000,46,50,50,4,8.7,50,4,8.7,50,52,1400-7-20,2021-10-12
817,ضپيك1030,اختيارخ تاپيكو-12000-00/10/15,3,12,43350000,3820,3700,3550,-270,-7.07,3612,-208,-5.45,3550,3700,1400-7-20,2021-10-12
818,تملي704,تسهيلات مسكن ب. ملي-تير97,3,82,51688700,663500,630350,630350,-33150,-5,630350,-33150,-5,630350,630350,1400-7-20,2021-10-12
819,ضصاد8031,اختيارخ وبصادر-1789-1400/08/12,3,151,27198000,343,150,199,-144,-41.98,180,-163,-47.52,170,200,1400-7-20,2021-10-12
820,تملي703,تسهيلات مسكن ب. ملي-خرداد97,3,13,7953800,640106,608200,620000,-20106,-3.14,611831,-28275,-4.42,608200,620000,1400-7-20,2021-10-12
821,ساذري,آذريت‌,3,10420,94634440,8818,9082,9082,264,2.99,8820,2,0.02,9082,9082,1400-7-20,2021-10-12
822,افران2,صندوق س افرا نماد پايدار-ثابت,3,3370000,3370000,14472,1,1,-14471,-99.99,1,-14471,-99.99,1,1,1400-7-20,2021-10-12
823,ضمخا7080,اختيارخ اخابر-5700-1400/07/28,3,22,39840000,2009,2040,1800,-209,-10.4,1811,-198,-9.86,1800,2040,1400-7-20,2021-10-12
824,ضملي1160,اختيارخ فملي-6000-1400/11/03,3,21,46151000,2474,2051,2200,-274,-11.08,2198,-276,-11.16,2051,2210,1400-7-20,2021-10-12
825,ضپنا8002,اختيارخ رمپنا-13850-1400/08/05,3,4,10000000,5314,2500,2500,-2814,-52.95,2500,-2814,-52.95,2500,2500,1400-7-20,2021-10-12
826,ضذوب903,اختيارخ ذوب-4000-14000917,2,38,30155000,800,555,800,0,0,794,-6,-0.75,555,800,1400-7-20,2021-10-12
827,آوا2,صندوق س.سهام آواي معيار-س,2,2800000,2800000,8109,1,1,-8108,-99.99,1,-8108,-99.99,1,1,1400-7-20,2021-10-12
828,دزهراويح,ح . ‌داروسازي‌زهراوي‌,2,2330,10077000,4410,4350,4300,-110,-2.49,4320,-90,-2.04,4300,4350,1400-7-20,2021-10-12
829,اخزا9172,اسنادخزانه-م17بودجه99-010226,2,2225000,1973687500000,886000,887000,887500,1500,0.17,887051,1051,0.12,887000,887500,1400-7-20,2021-10-12
830,اخزا816,اسنادخزانه-م16بودجه98-010503,2,140,118315820,858858,841001,855393,-3465,-0.4,845113,-13745,-1.6,841001,855393,1400-7-20,2021-10-12
831,ضمخا7076,اختيارخ اخابر-9700-1400/07/28,2,13,89000,7,5,7,0,0,7,0,0,5,7,1400-7-20,2021-10-12
832,اراد444,مرابحه عام دولت4-ش.خ 0007,2,4000000,4001014000000,1020000,1000352,1000155,-19845,-1.95,1000253,-19747,-1.94,1000155,1000352,1400-7-20,2021-10-12
833,ضپاس1010,اختيارخ وپارس-1800-1400/10/22,2,66,52800000,1,800,800,799,79900,800,799,79900,800,800,1400-7-20,2021-10-12
834,شتولي,تولي‌پرس‌,2,543,11216208,21077,20656,20656,-421,-2,21076,-1,0,20656,20656,1400-7-20,2021-10-12
835,مي ه 4,ميان باري هفته 4,2,181000,115297000,354,637,637,283,79.94,637,283,79.94,637,637,1400-7-20,2021-10-12
836,سمگا2,گروه سرمايه گذاري ميراث فرهنگي,2,15000000,180000000000,11911,12000,12000,89,0.75,12000,89,0.75,12000,12000,1400-7-20,2021-10-12
837,ضبدر8079,اختيارخ شبندر-6011-1400/08/30,2,4,19274660,1332,1100,1005,-327,-24.55,1029,-303,-22.75,1005,1100,1400-7-20,2021-10-12
838,زاگرس2,پتروشيمي زاگرس,2,2000000,629398000000,305533,314699,314699,9166,3,314699,9166,3,314699,314699,1400-7-20,2021-10-12
839,اراد774,مرابحه عام دولت77-ش.خ000812,2,4719000,4659653700000,1000000,987495,987300,-12700,-1.27,987424,-12576,-1.26,987300,987495,1400-7-20,2021-10-12
840,ضشگويا1204,اختيارخ شگويا-14000-14001222,2,10,17000000,2000,1700,1700,-300,-15,1700,-300,-15,1700,1700,1400-7-20,2021-10-12
841,زير0103پ02,زيره سبز0103 دانش(پ),2,140,147000000,1000000,1050000,1050000,50000,5,1050000,50000,5,1050000,1050000,1400-7-20,2021-10-12
842,زعف0008پ19,زعفران0008نگين تروند قاينات(پ),2,2139,334769180,157000,156500,156990,-10,-0.01,156507,-493,-0.31,156500,156990,1400-7-20,2021-10-12
843,داراب,پتروشيمي داراب,2,4000,8896000,2292,2224,2224,-68,-2.97,2292,0,0,2224,2224,1400-7-20,2021-10-12
844,اراد384,مرابحه عام دولت3-ش.خ 0105,2,2300000,2240501300000,1009000,974217,974045,-34955,-3.46,974131,-34869,-3.46,974045,974217,1400-7-20,2021-10-12
845,اراد864,مرابحه عام دولت86-ش.خ020404,2,60000000,56659440000000,936100,949201,939447,3347,0.36,944324,8224,0.88,939447,949201,1400-7-20,2021-10-12
846,وملت,سرمايه گذاري ملت,2,4850,15267800,3212,3148,3148,-64,-1.99,3212,0,0,3148,3148,1400-7-20,2021-10-12
847,صپا ه 4,بار پايه هفته 4صنعتي,2,11000,6820000,720,620,620,-100,-13.89,620,-100,-13.89,620,620,1400-7-20,2021-10-12
848,اپرداز2,آتيه داده پرداز,2,11000000,236280000000,21572,21480,21480,-92,-0.43,21480,-92,-0.43,21480,21480,1400-7-20,2021-10-12
849,ضمخا7079,اختيارخ اخابر-4700-1400/07/28,2,2,5700000,3009,2900,2800,-209,-6.95,2850,-159,-5.28,2800,2900,1400-7-20,2021-10-12
850,وسالت,بانك قرض الحسنه رسالت,2,10092,11131476,1051,1103,1103,52,4.95,1051,0,0,1103,1103,1400-7-20,2021-10-12
851,اراد404,مرابحه عام دولت4-ش.خ 0207,2,14000000,13281324000000,1000000,948732,948600,-51400,-5.14,948666,-51334,-5.13,948600,948732,1400-7-20,2021-10-12
852,اخزا904,اسنادخزانه-م4بودجه99-011215,2,550,415805000,754509,755600,756100,1591,0.21,756009,1500,0.2,755600,756100,1400-7-20,2021-10-12
853,ضفلا7005,اختيارخ فولاد-11013-1400/07/25,2,14,925320,55,10,50,-5,-9.09,47,-8,-14.55,10,50,1400-7-20,2021-10-12
854,ضصاد8034,اختيارخ وبصادر-2989-1400/08/12,2,37,37000,7,1,1,-6,-85.71,1,-6,-85.71,1,1,1400-7-20,2021-10-12
855,ضصاد8032,اختيارخ وبصادر-1989-1400/08/12,2,51,7651000,201,151,150,-51,-25.37,150,-51,-25.37,150,151,1400-7-20,2021-10-12
856,ثقزوي,شركت عمران و سازندگي قزوين,1,207,5952492,29645,28756,28756,-889,-3,29644,-1,0,28756,28756,1400-7-20,2021-10-12
857,هنوري102,اختيارف ت نوري59561-01/02/15,1,200,200,1,1,1,0,0,1,0,0,1,1,1400-7-20,2021-10-12
858,مكرما034,مشاركت ش كرمانشاه034-3ماهه18%,1,1000,1010000000,1000000,1010000,1010000,10000,1,1010000,10000,1,1010000,1010000,1400-7-20,2021-10-12
859,گواهي ظرفيت,گواهي ظرفيت نقدي,1,2400000,65498400000,25992,27291,27291,1299,5,26117,125,0.48,27291,27291,1400-7-20,2021-10-12
860,اراد22,مرابحه عام دولت2-ش.خ لوتوس0212,1,15000,15000000000,985000,1000000,1000000,15000,1.52,1000000,15000,1.52,1000000,1000000,1400-7-20,2021-10-12
861,افاد53,منفعت دولت5-ش.خاص كاريزما0108,1,1000,965000000,975000,965000,965000,-10000,-1.03,965000,-10000,-1.03,965000,965000,1400-7-20,2021-10-12
862,فبستم,صنايع ‌بسته‌بندي‌ مشهد,1,14454,12040182,794,833,833,39,4.91,794,0,0,833,833,1400-7-20,2021-10-12
863,وحافظ,بيمه حافظ,1,650,6638450,10528,10213,10213,-315,-2.99,10528,0,0,10213,10213,1400-7-20,2021-10-12
864,ضملت1131,اختيارخ وبملت-2000-1400/11/13,1,30,54000000,1983,1800,1800,-183,-9.23,1800,-183,-9.23,1800,1800,1400-7-20,2021-10-12
865,ضپاس7028,اختيارخ وپارس-2000-1400/07/28,1,100,35000000,428,350,350,-78,-18.22,350,-78,-18.22,350,350,1400-7-20,2021-10-12
866,مكرج112,مشاركت شهرداري كرج-3ماهه18%,1,500,500000000,980000,1000000,1000000,20000,2.04,1000000,20000,2.04,1000000,1000000,1400-7-20,2021-10-12
867,ضفلا7006,اختيارخ فولاد-12440-1400/07/25,1,18,25236,8,1,1,-7,-87.5,1,-7,-87.5,1,1,1400-7-20,2021-10-12
868,صايپا112,صكوك مرابحه سايپا112-3ماهه 16%,1,1000,990000000,971750,990000,990000,18250,1.88,990000,18250,1.88,990000,990000,1400-7-20,2021-10-12
869,ضفار8052,اختيارخ فارس-9400-1400/08/05,1,50,125000000,4956,2500,2500,-2456,-49.56,2500,-2456,-49.56,2500,2500,1400-7-20,2021-10-12
870,ضجار1021,اختيارخ وتجارت-1800-1400/10/15,1,100,37000000,500,370,370,-130,-26,370,-130,-26,370,370,1400-7-20,2021-10-12
871,جم2,پتروشيمي جم,1,20000000,1012000000000,51070,50600,50600,-470,-0.92,50600,-470,-0.92,50600,50600,1400-7-20,2021-10-12
872,مي ر 35,ميان باري روز 35,1,50000,31850000,700,637,637,-63,-9,637,-63,-9,637,637,1400-7-20,2021-10-12
873,پست0008پ04,پسته فندقي32-30سبزدانه0008(پ),1,3,5448000,1870000,1816000,1816000,-54000,-2.89,1816000,-54000,-2.89,1816000,1816000,1400-7-20,2021-10-12
874,ضمخا7075,اختيارخ اخابر-8700-1400/07/28,1,2,20000,84,10,10,-74,-88.1,10,-74,-88.1,10,10,1400-7-20,2021-10-12
875,پا ه 4,بار پايه هفته 4,1,105000,62370000,581,594,594,13,2.24,594,13,2.24,594,594,1400-7-20,2021-10-12
876,مي ر36,ميان باري روز36,1,50000,31850000,700,637,637,-63,-9,637,-63,-9,637,637,1400-7-20,2021-10-12
877,سنفت009,سلف موازي استاندارد سنفت009,1,11470,19017260000,1658000,1658000,1658000,0,0,1658000,0,0,1658000,1658000,1400-7-20,2021-10-12
878,ضغدر8056,اختيارخ وغدير-8000-1400/08/26,1,1,7600000,8400,7600,7600,-800,-9.52,7600,-800,-9.52,7600,7600,1400-7-20,2021-10-12
879,تملي806,تسهيلات مسكن ب. ملي-شهريور98,1,13,10660507,863198,820039,820039,-43159,-5,820039,-43159,-5,820039,820039,1400-7-20,2021-10-12
880,زعف0008پ10,زعفران0008نگين طلاي سرخ(پ),1,146,23880490,157956,163565,163565,5609,3.55,163565,5609,3.55,163565,163565,1400-7-20,2021-10-12
881,ضسپا8045,اختيارخ خساپا-3000-1400/08/26,1,10,250000,4,25,25,21,525,25,21,525,25,25,1400-7-20,2021-10-12
882,آساميد4,صندوق س.مشترك آسمان اميد -د,1,15500000,204119500000,13157,13169,13169,12,0.09,13169,12,0.09,13169,13169,1400-7-20,2021-10-12
883,ضفلا1160,اختيارخ فولاد-7000-1400/11/24,1,1,3501000,4474,3501,3501,-973,-21.75,3501,-973,-21.75,3501,3501,1400-7-20,2021-10-12
884,هفارس104,اختيارف ت فارس-11832-01/04/12,1,3000,3000,1,1,1,0,0,1,0,0,1,1,1400-7-20,2021-10-12
885,اخزا0022,اسنادخزانه-م2بودجه00-031024,1,255788,129684516000,503277,507000,507000,3723,0.74,507000,3723,0.74,507000,507000,1400-7-20,2021-10-12
886,ضملت1132,اختيارخ وبملت-2500-1400/11/13,1,30,40500000,1500,1350,1350,-150,-10,1350,-150,-10,1350,1350,1400-7-20,2021-10-12
887,ضفار8047,اختيارخ فارس-4400-1400/08/05,1,1,8000000,8530,8000,8000,-530,-6.21,8000,-530,-6.21,8000,8000,1400-7-20,2021-10-12
888,سرو2,صندوق س سروسودمند مدبران-سهام,1,90000,90000,77510,1,1,-77509,-100,1,-77509,-100,1,1,1400-7-20,2021-10-12
889,سحرا021,سلف موازي برق نيروي برق حرارتي,1,200,62679200,310480,313396,313396,2916,0.94,313396,2916,0.94,313396,313396,1400-7-20,2021-10-12
890,مي ر 34,ميان باري روز 34,1,50000,31850000,700,637,637,-63,-9,637,-63,-9,637,637,1400-7-20,2021-10-12
891,ضجار1020,اختيارخ وتجارت-1600-1400/10/15,1,100,55000000,650,550,550,-100,-15.38,550,-100,-15.38,550,550,1400-7-20,2021-10-12
892,طخود1049,اختيارف خودرو-1400-1400/10/08,1,13,390000,20,30,30,10,50,30,10,50,30,30,1400-7-20,2021-10-12
893,ضپاس1012,اختيارخ وپارس-2500-1400/10/22,1,1,220000,500,220,220,-280,-56,220,-280,-56,220,220,1400-7-20,2021-10-12
894,حاريا,كشتيراني آريا,1,720,10787040,15606,14982,14982,-624,-4,15605,-1,-0.01,14982,14982,1400-7-20,2021-10-12
895,خفناور,مهندسي صنعتي روان فن آور,1,200,8356000,43072,41780,41780,-1292,-3,43071,-1,0,41780,41780,1400-7-20,2021-10-12
896,ضپنا8004,اختيارخ رمپنا-17850-1400/08/05,1,5,12500000,200,2500,2500,2300,1150,2500,2300,1150,2500,2500,1400-7-20,2021-10-12
897,ضخود1055,اختيارخ خودرو-3500-1400/10/08,1,26,650000,29,25,25,-4,-13.79,25,-4,-13.79,25,25,1400-7-20,2021-10-12
898,سايرا,ايرانيت‌,1,200,7199000,36729,35995,35995,-734,-2,36728,-1,0,35995,35995,1400-7-20,2021-10-12
899,جم پيلن2,پلي پروپيلن جم - جم پيلن,1,3000000,354000000000,118530,118000,118000,-530,-0.45,118000,-530,-0.45,118000,118000,1400-7-20,2021-10-12
900,طمخا7072,اختيارف اخابر-27700-1400/07/28,1,1,21870000,21450,21870,21870,420,1.96,21870,420,1.96,21870,21870,1400-7-20,2021-10-12
901,صخود412,ص مرابحه خودرو412- 3ماهه 18%,1,6,5999988,990001,999998,999998,9997,1.01,999998,9997,1.01,999998,999998,1400-7-20,2021-10-12
902,اراد314,مرابحه عام دولت3-ش.خ 0208,1,735000,668850000000,900000,910000,910000,10000,1.11,910000,10000,1.11,910000,910000,1400-7-20,2021-10-12
903,ضپنا8006,اختيارخ رمپنا-23850-1400/08/05,1,10,600000,60,60,60,0,0,60,0,0,60,60,1400-7-20,2021-10-12
904,ضشنا8002,اختيارخ شپنا-7800-1400/08/16,1,30,162000000,6227,5400,5400,-827,-13.28,5400,-827,-13.28,5400,5400,1400-7-20,2021-10-12
905,مي ر 33,ميان باري روز 33,1,50000,31850000,345,637,637,292,84.64,637,292,84.64,637,637,1400-7-20,2021-10-12
906,دومينو4,اجاره دومينو14040208,1,504,482408640,1000000,957160,957160,-42840,-4.28,957160,-42840,-4.28,957160,957160,1400-7-20,2021-10-12
907,صخود041,ص مرابحه خودرو041- 3ماهه 18%,1,8,7920000,1010000,990000,990000,-20000,-1.98,990000,-20000,-1.98,990000,990000,1400-7-20,2021-10-12
908,آگاس2,صندوق س.هستي بخش آگاه-س,1,1000000,1000000,83743,1,1,-83742,-100,1,-83742,-100,1,1,1400-7-20,2021-10-12
909,ضصاد1110,اختيارخ وبصادر-1400-1400/11/06,1,80,64000000,1,800,800,799,79900,800,799,79900,800,800,1400-7-20,2021-10-12
910,طمخا7068,اختيارف اخابر-15700-1400/07/28,1,2,14600000,7000,7300,7300,300,4.29,7300,300,4.29,7300,7300,1400-7-20,2021-10-12
911,اراد46,مرابحه عام دولت4-ش.خ 0302,1,25000,25000000000,1000000,1000000,1000000,0,0,1000000,0,0,1000000,1000000,1400-7-20,2021-10-12
912,دامين2,داروسازي‌ امين‌,1,15679875,52527581250,3445,3350,3350,-95,-2.76,3350,-95,-2.76,3350,3350,1400-7-20,2021-10-12
913,ضپنا8000,اختيارخ رمپنا-9850-1400/08/05,1,3,20400000,7900,6800,6800,-1100,-13.92,6800,-1100,-13.92,6800,6800,1400-7-20,2021-10-12
914,ضپال2006,اختيارخ اپال-28000-1401/02/12,1,10,10500000,1397,1050,1050,-347,-24.84,1050,-347,-24.84,1050,1050,1400-7-20,2021-10-12
915,شگويات.ف0104,اختيارف.تبعي شگويا010408,1,10000,10000,1,1,1,0,0,1,0,0,1,1,1400-7-20,2021-10-12
916,اعتماد4,صندوق س.اعتماد آفرين پارسيان-د,1,5284520,207840171600,39264,39330,39330,66,0.17,39330,66,0.17,39330,39330,1400-7-20,2021-10-12
