,نماد,نام,تعداد,حجم,ارزش,دیروز,اولین,آخرین معامله - مقدار,آخرین معامله - تغییر,آخرین معامله - درصد,قیمت پایانی - مقدار,قیمت پایانی - تغییر,قیمت پایانی - درصد,کمترین,بیشترین,تاریخ,gregorian_date
0,پالايش,صندوق پالايشي يكم-سهام,23974,23004377,1617157962580,72240,71600,69300,-2940,-4.07,70300,-1940,-2.69,69060,71680,1400-2-27,2021-05-17
1,خساپا,سايپا,17970,808766074,1546349294018,1943,1980,1846,-97,-4.99,1912,-31,-1.6,1846,2009,1400-2-27,2021-05-17
2,دارا يكم,صندوق واسطه گري مالي يكم-سهام,17248,11499835,1489136921770,131670,132400,127500,-4170,-3.17,129490,-2180,-1.66,127000,132870,1400-2-27,2021-05-17
3,خودرو,ايران‌ خودرو,16783,709214458,1425391796661,2041,2079,1939,-102,-5,2010,-31,-1.52,1939,2109,1400-2-27,2021-05-17
4,كزغال,زغال سنگ پروده طبس,15171,9537278,309616123549,31220,31940,32591,1371,4.39,32464,1244,3.98,31790,32750,1400-2-27,2021-05-17
5,فملي,ملي‌ صنايع‌ مس‌ ايران‌,11043,70169908,891445891020,13060,12600,12680,-380,-2.91,12700,-360,-2.76,12420,13050,1400-2-27,2021-05-17
6,فگستر,گسترش صنايع روي ايرانيان,10141,2476294,17707978394,6811,7151,7151,340,4.99,7151,340,4.99,7151,7151,1400-2-27,2021-05-17
7,اپال,فرآوري معدني اپال كاني پارس,9681,11376479,204793857680,17640,17970,18290,650,3.68,18000,360,2.04,17640,18340,1400-2-27,2021-05-17
8,شستا,سرمايه گذاري تامين اجتماعي,8433,29278539,308798506760,10880,10790,10400,-480,-4.41,10550,-330,-3.03,10340,10900,1400-2-27,2021-05-17
9,بوعلي,پتروشيمي بوعلي سينا,8415,4770255,218730767310,44250,44350,45000,750,1.69,45850,1600,3.62,44350,46460,1400-2-27,2021-05-17
10,شپنا,پالايش نفت اصفهان,8341,71955462,753475895680,10870,10650,10330,-540,-4.97,10470,-400,-3.68,10330,10810,1400-2-27,2021-05-17
11,بركت,گروه دارويي بركت,7749,22931320,599206422120,27150,27050,25800,-1350,-4.97,26130,-1020,-3.76,25800,27380,1400-2-27,2021-05-17
12,امينح,ح . تامين سرمايه امين,7685,5693504,27257453176,4757,4770,4801,44,0.92,4787,30,0.63,4757,4810,1400-2-27,2021-05-17
13,خگستر,گسترش‌سرمايه‌گذاري‌ايران‌خودرو,7443,235702652,532924481827,2293,2330,2179,-114,-4.97,2261,-32,-1.4,2179,2369,1400-2-27,2021-05-17
14,شتران,پالايش نفت تهران,6258,50914608,396439633680,8110,7980,7710,-400,-4.93,7790,-320,-3.95,7710,8050,1400-2-27,2021-05-17
15,فولاد,فولاد مباركه اصفهان,6055,41101240,512407923680,12740,12570,12230,-510,-4,12470,-270,-2.12,12200,12700,1400-2-27,2021-05-17
16,وتجارت,بانك تجارت,6051,151181248,364006713806,2456,2461,2349,-107,-4.36,2408,-48,-1.95,2338,2508,1400-2-27,2021-05-17
17,ثاميد,توسعه و عمران اميد,5842,56595731,72598922866,1336,1317,1270,-66,-4.94,1283,-53,-3.97,1270,1330,1400-2-27,2021-05-17
18,كرمان,س. توسعه و عمران استان كرمان,5192,155040497,163094492937,1089,1105,1035,-54,-4.96,1052,-37,-3.4,1035,1105,1400-2-27,2021-05-17
19,وسپهر,سرمايه گذاري مالي سپهرصادرات,5122,13219658,120220677496,9095,9094,9094,-1,-0.01,9094,-1,-0.01,9094,9096,1400-2-27,2021-05-17
20,خبهمن,گروه‌بهمن‌,4874,216097855,281184553466,1345,1350,1278,-67,-4.98,1301,-44,-3.27,1278,1360,1400-2-27,2021-05-17
21,كاما,باما,4517,27136781,286285335860,10870,11150,10330,-540,-4.97,10550,-320,-2.94,10330,11220,1400-2-27,2021-05-17
22,وبصادر,بانك صادرات ايران,4403,112192740,240684799140,2191,2172,2104,-87,-3.97,2145,-46,-2.1,2082,2240,1400-2-27,2021-05-17
23,شبندر,پالايش نفت بندرعباس,4395,22102668,477284183210,22380,21500,21270,-1110,-4.96,21590,-790,-3.53,21270,22290,1400-2-27,2021-05-17
24,وپارس,بانك‌پارسيان‌,4256,166505414,430069468455,2565,2586,2590,25,0.97,2583,18,0.7,2550,2620,1400-2-27,2021-05-17
25,امين يكم,صندوق درآمد ثابت امين يكم فردا,4210,160042912,1625401908605,10149,10155,10155,6,0.06,10156,7,0.07,10148,10159,1400-2-27,2021-05-17
26,وكبهمن,مديريت سرمايه گذاري كوثربهمن,4188,2435119,25570793889,10711,10650,10450,-261,-2.44,10501,-210,-1.96,10260,10712,1400-2-27,2021-05-17
27,ذوب,سهامي ذوب آهن  اصفهان,4184,64948364,212772767756,3376,3330,3208,-168,-4.98,3276,-100,-2.96,3208,3370,1400-2-27,2021-05-17
28,فارس,صنايع پتروشيمي خليج فارس,4125,33261148,309300055590,9220,9380,9400,180,1.95,9300,80,0.87,8980,9580,1400-2-27,2021-05-17
29,خزاميا,زامياد,4110,40468328,318196160850,8160,8110,7760,-400,-4.9,7860,-300,-3.68,7760,8270,1400-2-27,2021-05-17
30,وپاسار,بانك  پاسارگاد,3962,54686382,940680152480,17110,17200,17210,100,0.58,17200,90,0.53,17190,17250,1400-2-27,2021-05-17
31,بپيوند,برق و انرژي پيوندگستر پارس,3849,2683933,29598044680,10970,11300,10940,-30,-0.27,11028,58,0.53,10651,11300,1400-2-27,2021-05-17
32,پترول,گ.س.وت.ص.پتروشيمي خليج فارس,3820,24025783,211246964480,8890,8900,8630,-260,-2.92,8790,-100,-1.12,8550,8980,1400-2-27,2021-05-17
33,امين,تامين سرمايه امين,3675,2036468,14230375950,6980,6900,6990,10,0.14,6980,0,0,6850,7000,1400-2-27,2021-05-17
34,فروي,ذوب روي اصفهان,3489,3545279,174529681570,50861,49460,48318,-2543,-5,49229,-1632,-3.21,48318,51800,1400-2-27,2021-05-17
35,ساراب,سيمان‌ داراب‌,3127,12366960,272259462540,21310,21530,22230,920,4.32,22020,710,3.33,21000,22370,1400-2-27,2021-05-17
36,كماسه,تامين‌ ماسه‌ ريخته‌گري‌,3026,5717373,171856532240,30840,29310,29300,-1540,-4.99,30060,-780,-2.53,29300,31900,1400-2-27,2021-05-17
37,سيتا,سرمايه گذاري سيمان تامين,2999,4837458,72564865870,15000,15000,15000,0,0,15000,0,0,15000,15010,1400-2-27,2021-05-17
38,حكشتي,كشتيراني جمهوري اسلامي ايران,2896,11940063,188660039010,16510,16000,15690,-820,-4.97,15800,-710,-4.3,15690,16400,1400-2-27,2021-05-17
39,كمند,صندوق س. با درآمد ثابت كمند,2887,109335717,1100660171311,10061,10067,10068,7,0.07,10067,6,0.06,10066,10069,1400-2-27,2021-05-17
40,ونيكي,سرمايه‌گذاري‌ ملي‌ايران‌,2771,25178798,212612686700,8070,8200,8470,400,4.96,8440,370,4.58,8170,8470,1400-2-27,2021-05-17
41,وپست,پست بانك ايران,2745,12310048,262394100450,20580,20880,20860,280,1.36,21320,740,3.6,20500,21600,1400-2-27,2021-05-17
42,بگيلان,توسعه مسير برق گيلان,2652,445119,8514357398,19804,19150,19090,-714,-3.61,19629,-175,-0.88,19020,19550,1400-2-27,2021-05-17
43,ميدكو,هلدينگ صنايع  معدني خاورميانه,2562,5944469,222542161971,35753,36820,37497,1744,4.88,37437,1684,4.71,36105,37540,1400-2-27,2021-05-17
44,ولساپا,ليزينگ رايان‌ سايپا,2439,51322041,144014833535,2883,2801,2750,-133,-4.61,2806,-77,-2.67,2739,2934,1400-2-27,2021-05-17
45,وخارزم,سرمايه گذاري خوارزمي,2309,26334093,108502020296,4280,4201,4066,-214,-5,4120,-160,-3.74,4066,4340,1400-2-27,2021-05-17
46,كيان,صندوق س. با درآمد ثابت كيان,2290,56237945,1600208076136,28445,28448,28460,15,0.05,28454,9,0.03,28447,28461,1400-2-27,2021-05-17
47,نوري,پتروشيمي نوري,2256,2468214,149576615060,59660,58500,59700,40,0.07,60600,940,1.58,58500,61480,1400-2-27,2021-05-17
48,پيزد,مجتمع صنايع لاستيك يزد,2152,181899,10011476597,57125,56010,54269,-2856,-5,55575,-1550,-2.71,54269,57000,1400-2-27,2021-05-17
49,فجر,فولاد اميركبيركاشان,2047,2159788,142405302190,66440,67800,65500,-940,-1.41,65930,-510,-0.77,64870,67800,1400-2-27,2021-05-17
50,وغدير,سرمايه‌گذاري‌غدير(هلدينگ‌,2043,16947737,166255436540,10120,9800,9630,-490,-4.84,9810,-310,-3.06,9620,10100,1400-2-27,2021-05-17
51,وبانك,سرمايه گذاري گروه توسعه ملي,2030,19444832,135662665180,7140,6920,7000,-140,-1.96,6980,-160,-2.24,6820,7140,1400-2-27,2021-05-17
52,آبادا,توليد نيروي برق آبادان,2021,1259817,13131443900,10940,10440,10400,-540,-4.94,10420,-520,-4.75,10400,10870,1400-2-27,2021-05-17
53,شگويا,پتروشيمي تندگويان,1958,11803280,103423838002,9036,9000,8585,-451,-4.99,8762,-274,-3.03,8585,9030,1400-2-27,2021-05-17
54,تاپيكو,س. نفت و گاز و پتروشيمي تأمين,1884,13519581,138371672310,10080,10120,10100,20,0.2,10230,150,1.49,10000,10450,1400-2-27,2021-05-17
55,تملت,تامين سرمايه بانك ملت,1861,23200914,114536435624,4912,4912,5050,138,2.81,4937,25,0.51,4791,5060,1400-2-27,2021-05-17
56,فخوز,فولاد  خوزستان,1810,10368758,156072769830,15320,15150,15200,-120,-0.78,15050,-270,-1.76,14800,15300,1400-2-27,2021-05-17
57,غگل,گلوكوزان‌,1797,17395377,45496173823,2694,2651,2560,-134,-4.97,2615,-79,-2.93,2560,2740,1400-2-27,2021-05-17
58,واعتبار,سرمايه گذاري اعتبار ايران,1647,11354321,109815745930,9450,9030,9360,-90,-0.95,9670,220,2.33,9030,9920,1400-2-27,2021-05-17
59,ومعادنح,ح . توسعه‌معادن‌وفلزات‌,1578,17395417,104004103910,6070,5830,5940,-130,-2.14,5980,-90,-1.48,5830,6100,1400-2-27,2021-05-17
60,ارفع,شركت آهن و فولاد ارفع,1553,8382950,123166636211,14503,14503,14525,22,0.15,14693,190,1.31,14301,14899,1400-2-27,2021-05-17
61,اعتماد,صندوق س.اعتماد آفرين پارسيان-د,1511,32838790,1197340777710,36444,36461,36463,19,0.05,36461,17,0.05,36460,36465,1400-2-27,2021-05-17
62,ختوقا,قطعات‌ اتومبيل‌ ايران‌,1493,24511515,54422841723,2313,2330,2198,-115,-4.97,2220,-93,-4.02,2198,2330,1400-2-27,2021-05-17
63,اخابر,مخابرات ايران,1468,13674920,110276047630,8390,8210,7980,-410,-4.89,8060,-330,-3.93,7980,8330,1400-2-27,2021-05-17
64,وساپا,سرمايه‌گذاري‌ سايپا,1444,19430896,94658270018,5090,4970,4836,-254,-4.99,4872,-218,-4.28,4836,5070,1400-2-27,2021-05-17
65,ورنا,سرمايه‌گذاري‌ رنا(هلدينگ‌,1433,31644316,156507061950,5180,5180,4930,-250,-4.83,4950,-230,-4.44,4930,5260,1400-2-27,2021-05-17
66,سرچشمه,سرمايه گذاري مس سرچشمه,1413,10611876,68125970444,6249,6282,6430,181,2.9,6420,171,2.74,6274,6560,1400-2-27,2021-05-17
67,ماديرا,صنايع ماديران,1380,7291176,53831886776,7497,7497,7155,-342,-4.56,7383,-114,-1.52,7130,7660,1400-2-27,2021-05-17
68,كچاد,معدني‌وصنعتي‌چادرملو,1369,6295828,140425322890,22550,22000,21980,-570,-2.53,22300,-250,-1.11,21770,22830,1400-2-27,2021-05-17
69,صبا,سرمايه گذاري صبا تامين,1354,3300886,24355750348,7515,7335,7294,-221,-2.94,7487,-28,-0.37,7251,7570,1400-2-27,2021-05-17
70,آسيا,بيمه آسيا,1303,18073396,33124139796,1849,1900,1784,-65,-3.52,1833,-16,-0.87,1772,1918,1400-2-27,2021-05-17
71,وخارزمح,ح.سرمايه گذاري خوارزمي,1301,6593420,18597125118,2947,2880,2750,-197,-6.68,2821,-126,-4.28,2750,2989,1400-2-27,2021-05-17
72,شپلي,پلي اكريل ايران,1295,25723083,203987905587,7781,7936,7936,155,1.99,7930,149,1.91,7773,7936,1400-2-27,2021-05-17
73,سپ,پرداخت الكترونيك سامان كيش,1287,3198268,79567434800,25360,26600,24100,-1260,-4.97,24880,-480,-1.89,24100,26620,1400-2-27,2021-05-17
74,بجهرم,توسعه مولد نيروگاهي جهرم,1273,16359071,35706498447,2275,2200,2163,-112,-4.92,2183,-92,-4.04,2162,2294,1400-2-27,2021-05-17
75,افران,صندوق س افرا نماد پايدار-ثابت,1254,52229129,696086980609,13321,13327,13329,8,0.06,13328,7,0.05,13327,13335,1400-2-27,2021-05-17
76,سخزر,سيمان‌ خزر,1248,3501862,65913164910,19430,18500,18480,-950,-4.89,18820,-610,-3.14,18460,19990,1400-2-27,2021-05-17
77,هرمز,فولاد هرمزگان جنوب,1240,4802469,75662132675,15757,15980,15765,8,0.05,15756,-1,-0.01,15230,16029,1400-2-27,2021-05-17
78,واميد,گروه مديريت سرمايه گذاري اميد,1215,29164331,327475512630,11800,11210,11980,180,1.53,11230,-570,-4.83,11210,11980,1400-2-27,2021-05-17
79,تسه0001,امتيازتسهيلات مسكن فروردين1400,1214,26433,15909663157,585064,600000,555811,-29253,-5,601886,16822,2.88,555811,613900,1400-2-27,2021-05-17
80,حفاري,حفاري شمال,1189,12873166,75482657980,6010,5860,5910,-100,-1.66,5860,-150,-2.5,5780,6010,1400-2-27,2021-05-17
81,ولپارس,ليزينگ پارسيان,1159,3078420,13822105800,4726,4490,4490,-236,-4.99,4490,-236,-4.99,4490,4490,1400-2-27,2021-05-17
82,شپترو,پتروشيمي آبادان,1125,17403366,80268755192,4678,4680,4538,-140,-2.99,4612,-66,-1.41,4538,4790,1400-2-27,2021-05-17
83,لوتوس,تامين سرمايه لوتوس پارسيان,1114,18395816,134141682130,7660,7280,7310,-350,-4.57,7290,-370,-4.83,7280,7400,1400-2-27,2021-05-17
84,كاوه,فولاد كاوه جنوب كيش,1100,6871871,134087676900,20140,19760,19300,-840,-4.17,19510,-630,-3.13,19140,20280,1400-2-27,2021-05-17
85,خمحركه,نيرو محركه‌,1090,10951694,44265310071,4231,4060,4020,-211,-4.99,4042,-189,-4.47,4020,4195,1400-2-27,2021-05-17
86,فنورد,نوردوقطعات‌ فولادي‌,1085,493027,84218837620,163200,168400,171360,8160,5,170820,7620,4.67,163290,171360,1400-2-27,2021-05-17
87,سدور,سيمان‌ دورود,1083,7688512,88517891350,19370,12000,11400,-7970,-41.15,11510,-7860,-40.58,11400,12000,1400-2-27,2021-05-17
88,شبريز,پالايش نفت تبريز,1082,1891257,47401194960,25970,24810,24680,-1290,-4.97,25520,-450,-1.73,24680,25930,1400-2-27,2021-05-17
89,گكوثر,هتل پارسيان كوثر اصفهان,1078,25861914,56257337041,2160,2148,2110,-50,-2.31,2175,15,0.69,2070,2249,1400-2-27,2021-05-17
90,ومعادن,توسعه‌معادن‌وفلزات‌,1066,7726458,61404135980,8060,7870,7880,-180,-2.23,8000,-60,-0.74,7800,8070,1400-2-27,2021-05-17
91,سرو,صندوق س سروسودمند مدبران-سهام,1048,864685,54337219620,63700,63980,62110,-1590,-2.5,62840,-860,-1.35,62000,63980,1400-2-27,2021-05-17
92,قشرين,قند شيرين خراسان,1045,5536583,65509565092,11682,12032,11561,-121,-1.04,11832,150,1.28,11350,12032,1400-2-27,2021-05-17
93,ونوين,بانك‌اقتصادنوين‌,1029,11792901,48928853401,4204,4170,4121,-83,-1.97,4151,-53,-1.26,4110,4249,1400-2-27,2021-05-17
94,شيران,س. صنايع‌شيميايي‌ايران,1010,2752647,58852499390,21470,21440,20980,-490,-2.28,21410,-60,-0.28,20800,21790,1400-2-27,2021-05-17
95,سشمال,سيمان‌ شمال‌,1008,5150902,46904657350,8720,8310,9150,430,4.93,9110,390,4.47,8310,9150,1400-2-27,2021-05-17
96,خاور,ايران خودرو ديزل,990,11941046,56734995036,4832,4900,4688,-144,-2.98,4751,-81,-1.68,4688,4945,1400-2-27,2021-05-17
97,خصدرا,صنعتي‌ دريايي‌ ايران‌,951,22862632,53367943431,2402,2330,2330,-72,-3,2334,-68,-2.83,2330,2398,1400-2-27,2021-05-17
98,فباهنرح,ح . مس‌ شهيدباهنر,914,2326159,35555977800,15770,15350,15020,-750,-4.76,15290,-480,-3.04,14860,15850,1400-2-27,2021-05-17
99,وساغربي,شركت س استان آذربايجان غربي,909,70132580,51337048560,770,732,732,-38,-4.94,732,-38,-4.94,732,732,1400-2-27,2021-05-17
100,وثوق,سرمايه گذاري وثوق امين,907,1589808,26655137351,16946,17400,16438,-508,-3,16766,-180,-1.06,16438,17400,1400-2-27,2021-05-17
101,فنوال,نورد آلومينيوم‌,895,1263156,35767181060,28300,28130,28380,80,0.28,28320,20,0.07,27770,28800,1400-2-27,2021-05-17
102,وگردش,بانك گردشگري,882,3418208,52438062790,15331,15331,15350,19,0.12,15337,6,0.04,14920,15650,1400-2-27,2021-05-17
103,پرداخت,به پرداخت ملت,873,6953329,155978143200,23330,23330,22170,-1160,-4.97,22430,-900,-3.86,22170,23330,1400-2-27,2021-05-17
104,وسكرد,شركت س استان كردستان,866,41018615,23327031821,594,574,565,-29,-4.88,569,-25,-4.21,565,589,1400-2-27,2021-05-17
105,شرنگي,شيميايي رنگين,861,633792,166804387121,270271,262163,262163,-8108,-3,263185,-7086,-2.62,262163,278379,1400-2-27,2021-05-17
106,تاصيكو,سرمايه گذاري صدرتامين,861,8632272,86235964140,10060,10000,9900,-160,-1.59,10010,-50,-0.5,9800,10070,1400-2-27,2021-05-17
107,ما,بيمه  ما,854,6753327,57255426370,8290,8670,8620,330,3.98,8480,190,2.29,8250,8670,1400-2-27,2021-05-17
108,كگل,معدني و صنعتي گل گهر,841,5821715,81742956110,14370,14040,13920,-450,-3.13,14150,-220,-1.53,13810,14440,1400-2-27,2021-05-17
109,رمپنا,گروه مپنا (سهامي عام),837,4792074,67027420100,14480,14400,13810,-670,-4.63,14200,-280,-1.93,13760,14590,1400-2-27,2021-05-17
110,البرز,بيمه البرز,837,19831774,69638238641,3671,3570,3500,-171,-4.66,3511,-160,-4.36,3488,3630,1400-2-27,2021-05-17
111,زاگرس,پتروشيمي زاگرس,824,528514,113151765724,212390,214280,210000,-2390,-1.13,214094,1704,0.8,207000,216000,1400-2-27,2021-05-17
112,قرن,پديده شيمي قرن,819,1735804,105320954750,61380,61960,60950,-430,-0.7,60680,-700,-1.14,58530,61960,1400-2-27,2021-05-17
113,آگاس,صندوق س.هستي بخش آگاه-س,804,888504,56174805960,64335,64800,62901,-1434,-2.23,63224,-1111,-1.73,62900,64800,1400-2-27,2021-05-17
114,سامان,بانك سامان,802,8079110,75097058239,9056,9327,9223,167,1.84,9295,239,2.64,9151,9327,1400-2-27,2021-05-17
115,تسه9912,امتياز تسهيلات مسكن اسفند99,802,18501,11097114328,585204,580000,600000,14796,2.53,599812,14608,2.5,580000,614464,1400-2-27,2021-05-17
116,رانفور,خدمات‌انفورماتيك‌,784,5396185,32796627530,6250,6070,5950,-300,-4.8,6170,-80,-1.28,5940,6260,1400-2-27,2021-05-17
117,سفارس,سيمان فارس و خوزستان,744,3703504,57181791570,15510,15750,15080,-430,-2.77,15440,-70,-0.45,15010,15850,1400-2-27,2021-05-17
118,وشهر,بانك شهر,739,9502519,47589601259,5158,5000,5004,-154,-2.99,5008,-150,-2.91,4952,5200,1400-2-27,2021-05-17
119,وسينا,بانك سينا,725,19117442,49656908516,2601,2650,2510,-91,-3.5,2597,-4,-0.15,2507,2689,1400-2-27,2021-05-17
120,آوا,صندوق س.سهام آواي معيار-س,709,6348195,42051330192,6699,6750,6600,-99,-1.48,6624,-75,-1.12,6565,6750,1400-2-27,2021-05-17
121,ضسپا3003,اختيارخ خساپا-2000-1400/03/26,707,29046,1930461000,96,105,49,-47,-48.96,66,-30,-31.25,47,105,1400-2-27,2021-05-17
122,ومهان,گروه توسعه مالي مهر آيندگان,706,3660720,45587078962,12490,12500,12450,-40,-0.32,12456,-34,-0.27,12300,12681,1400-2-27,2021-05-17
123,شلرد,كود شيميايي اوره لردگان,704,7034355,43338091654,6342,6330,6152,-190,-3,6161,-181,-2.85,6152,6330,1400-2-27,2021-05-17
124,بپاس,بيمه پاسارگاد,697,884722,79347672905,88551,89500,89705,1154,1.3,89437,886,1,89500,89900,1400-2-27,2021-05-17
125,جوين,كشت و صنعت جوين,679,6896789,31524117831,4558,4558,4605,47,1.03,4571,13,0.29,4558,4663,1400-2-27,2021-05-17
126,وسيستا,شركت س استان سيستان وبلوچستان,671,44095076,28485419096,680,646,646,-34,-5,656,-24,-3.53,646,646,1400-2-27,2021-05-17
127,فاسمين,كالسيمين‌,667,2839149,39273049590,14190,13910,13750,-440,-3.1,13830,-360,-2.54,13610,14190,1400-2-27,2021-05-17
128,ونفت,سرمايه‌گذاري‌ صنعت‌ نفت‌,652,2280427,32627018820,14550,14270,14020,-530,-3.64,14310,-240,-1.65,13840,14690,1400-2-27,2021-05-17
129,وصنا,گروه‌صنايع‌بهشهرايران‌,647,4200896,20909058890,5260,5040,4920,-340,-6.46,4980,-280,-5.32,4850,5170,1400-2-27,2021-05-17
130,شسپا,نفت سپاهان,639,3080443,47163098520,15530,15200,15220,-310,-2,15350,-180,-1.16,15100,15600,1400-2-27,2021-05-17
131,وصنعت,سرمايه گذاري توسعه صنعت وتجارت,637,7308521,40184522650,5510,5540,5510,0,0,5500,-10,-0.18,5430,5630,1400-2-27,2021-05-17
132,سشرق,سيمان‌ شرق‌,629,4763032,26182184410,5690,5570,5410,-280,-4.92,5500,-190,-3.34,5410,5750,1400-2-27,2021-05-17
133,خكرمان,گروه اقتصادي كرمان خودرو,625,11728670,39039880727,3409,3410,3307,-102,-2.99,3329,-80,-2.35,3307,3479,1400-2-27,2021-05-17
134,كنور,توسعه معدني و صنعتي صبانور,625,836880,41704575320,49210,50810,49840,630,1.28,49650,440,0.89,48700,50810,1400-2-27,2021-05-17
135,فباهنر,مس‌ شهيدباهنر,618,1975602,44992825670,23380,23000,22380,-1000,-4.28,22770,-610,-2.61,22360,23620,1400-2-27,2021-05-17
136,شصدف,صنعتي دوده فام,616,21993,738414975,31977,33575,33575,1598,5,32051,74,0.23,33575,33575,1400-2-27,2021-05-17
137,واميدح,ح.گروه مديريت سرمايه گذار اميد,612,2808842,20464625530,7410,7010,7410,0,0,7290,-120,-1.62,6800,7580,1400-2-27,2021-05-17
138,ورازي,بيمه رازي,608,8398015,64071332219,8011,8150,7611,-400,-4.99,7629,-382,-4.77,7611,8150,1400-2-27,2021-05-17
139,سمازن,سيمان‌مازندران‌,599,3143372,36808194870,12130,11820,11530,-600,-4.95,11710,-420,-3.46,11530,12190,1400-2-27,2021-05-17
140,پاكشو,گروه صنعتي پاكشو,592,4853249,29294736460,6230,6030,6010,-220,-3.53,6180,-50,-0.8,5920,6230,1400-2-27,2021-05-17
141,همراه,شركت ارتباطات سيار ايران,591,1298320,28510382570,22400,22000,21960,-440,-1.96,22270,-130,-0.58,21800,22400,1400-2-27,2021-05-17
142,ضشنا2001,اختيارخ شپنا-10000-1400/02/27,585,22858,1435987000,516,252,3,-513,-99.42,63,-453,-87.79,2,390,1400-2-27,2021-05-17
143,كگلح,ح . معدني و صنعتي گل گهر,568,1922025,21423557740,11390,11170,11090,-300,-2.63,11150,-240,-2.11,10970,11500,1400-2-27,2021-05-17
144,شغدير,پتروشيمي غدير,556,1405522,91309469530,64520,63000,65130,610,0.95,64960,440,0.68,63000,65560,1400-2-27,2021-05-17
145,وساخت,سرمايه‌ گذاري‌ ساختمان‌ايران‌,550,699992,29519226630,43510,44000,41340,-2170,-4.99,42170,-1340,-3.08,41340,44000,1400-2-27,2021-05-17
146,ضخود7075,اختيارخ خودرو-2000-1400/07/07,549,21996,4740746000,244,245,190,-54,-22.13,216,-28,-11.48,188,269,1400-2-27,2021-05-17
147,والبر,سرمايه‌ گذاري‌ البرز(هلدينگ‌,544,2699582,36370320750,14140,13870,13440,-700,-4.95,13470,-670,-4.74,13440,13870,1400-2-27,2021-05-17
148,سقاين,سيمان‌ قائن‌,540,595602,33291395960,58720,55790,55790,-2930,-4.99,55900,-2820,-4.8,55790,58380,1400-2-27,2021-05-17
149,فسپا,گروه‌صنعتي‌سپاهان‌,523,1159911,39318209980,35430,33750,33660,-1770,-5,33900,-1530,-4.32,33660,35400,1400-2-27,2021-05-17
150,شبهرن,نفت‌ بهران‌,517,1317623,14864782110,11330,11280,11070,-260,-2.29,11320,-10,-0.09,11070,11450,1400-2-27,2021-05-17
151,افق,فروشگاههاي زنجيره اي افق كوروش,517,378083,25364207140,68460,68600,66850,-1610,-2.35,68030,-430,-0.63,66540,68600,1400-2-27,2021-05-17
152,پارند,صندوق س. پارند پايدار سپهر,517,13101769,147114859324,11230,11227,11230,0,0,11229,-1,-0.01,11226,11239,1400-2-27,2021-05-17
153,دكپسول,توليد ژلاتين كپسول ايران,511,639533,19827280522,32037,31000,30436,-1601,-5,31003,-1034,-3.23,30436,32800,1400-2-27,2021-05-17
154,وتوكا,سرمايه‌گذاري‌توكافولاد(هلدينگ,509,3636701,35767254800,10190,9760,9690,-500,-4.91,9840,-350,-3.43,9690,10270,1400-2-27,2021-05-17
155,طلا,صندوق س.پشتوانه طلاي لوتوس,504,357567,25677180998,73824,72300,71770,-2054,-2.78,71811,-2013,-2.73,71600,72300,1400-2-27,2021-05-17
156,تسه9908,امتياز تسهيلات مسكن آبان99,504,12083,7202588345,583124,570000,570225,-12899,-2.21,596093,12969,2.22,570000,609999,1400-2-27,2021-05-17
157,آكورد,صندوق س. آرمان آتي كوثر-د,502,14519522,466331484438,32101,32118,32118,17,0.05,32118,17,0.05,32116,32121,1400-2-27,2021-05-17
158,سكه0012پ01,تمام سكه طرح جديد0012رفاه,501,182700,182968922000,1024873,998996,1002000,-22873,-2.23,1001472,-23401,-2.28,992223,1009999,1400-2-27,2021-05-17
159,تسه9911,امتياز تسهيلات مسكن بهمن99,495,9867,5893837149,583373,570000,558000,-25373,-4.35,597328,13955,2.39,558000,610000,1400-2-27,2021-05-17
160,فپنتا,سپنتا,492,86686,30527922770,366960,352000,353000,-13960,-3.8,352170,-14790,-4.03,348620,364510,1400-2-27,2021-05-17
161,پارس,پتروشيمي پارس,490,617146,89806741880,144780,146170,144610,-170,-0.12,145430,650,0.45,144500,147290,1400-2-27,2021-05-17
162,سخوز,سيمان خوزستان,484,1319328,28728317550,21030,22000,21400,370,1.76,21770,740,3.52,21400,22070,1400-2-27,2021-05-17
163,فايرا,آلومينيوم‌ايران‌,483,2806120,51416230950,18400,18150,18350,-50,-0.27,18340,-60,-0.33,17980,18530,1400-2-27,2021-05-17
164,حتايد,تايدواترخاورميانه,480,2079749,47771620740,24020,23460,22940,-1080,-4.5,22970,-1050,-4.37,22820,23990,1400-2-27,2021-05-17
165,سيستم,همكاران سيستم,471,698003,16253172490,24130,24200,22930,-1200,-4.97,23290,-840,-3.48,22930,24930,1400-2-27,2021-05-17
166,فولاژ,فولاد آلياژي ايران,470,1405711,20742261340,15190,14450,14520,-670,-4.41,15060,-130,-0.86,14450,15300,1400-2-27,2021-05-17
167,گوهران,سرمايه گذاري توسعه گوهران اميد,462,1070332,7497264748,6981,6860,7014,33,0.47,6993,12,0.17,6860,7115,1400-2-27,2021-05-17
168,وكار,بانك‌ كارآفرين‌,461,7945673,22201111758,2780,2825,2770,-10,-0.36,2787,7,0.25,2724,2880,1400-2-27,2021-05-17
169,كروي,توسعه‌ معادن‌ روي‌ ايران‌,456,1364779,29862846550,22960,21840,21820,-1140,-4.97,21880,-1080,-4.7,21820,22680,1400-2-27,2021-05-17
170,ضسپا3002,اختيارخ خساپا-1800-1400/03/26,455,21271,2483391000,200,210,105,-95,-47.5,117,-83,-41.5,93,212,1400-2-27,2021-05-17
171,پرديس,سرمايه گذاري پرديس,451,3319198,15734712700,4900,4690,4810,-90,-1.84,4740,-160,-3.27,4670,4890,1400-2-27,2021-05-17
172,خمحور,توليدمحورخودرو,448,476272,27144387750,59750,56770,56770,-2980,-4.99,56990,-2760,-4.62,56770,59750,1400-2-27,2021-05-17
173,واتي,سرمايه‌ گذاري‌ آتيه‌ دماوند,434,4513418,42518257700,9540,9120,9490,-50,-0.52,9420,-120,-1.26,9120,9600,1400-2-27,2021-05-17
174,شجم,صنايع پتروشيمي تخت جمشيد,427,2964081,26985790037,9340,9105,9060,-280,-3,9104,-236,-2.53,9060,9289,1400-2-27,2021-05-17
175,وسكاب,س.ص.بازنشستگي كاركنان بانكها,427,2247316,10800015807,4871,4875,4830,-41,-0.84,4824,-47,-0.96,4715,4930,1400-2-27,2021-05-17
176,سپاها,سيمان‌سپاهان‌,423,2114076,15003296630,7410,7140,7040,-370,-4.99,7100,-310,-4.18,7040,7380,1400-2-27,2021-05-17
177,آساميد2,صندوق س.مشترك آسمان اميد -د,413,41300000,41300000,12021,1,1,-12020,-99.99,1,-12020,-99.99,1,1,1400-2-27,2021-05-17
178,شپديس,پتروشيمي پرديس,409,296841,28103361120,94360,93950,93640,-720,-0.76,94450,90,0.1,93560,95370,1400-2-27,2021-05-17
179,پكرمان,گروه‌ صنعتي‌ بارز,409,1045436,23720783270,23800,22620,22610,-1190,-5,22690,-1110,-4.66,22610,23790,1400-2-27,2021-05-17
180,دعبيد,لابراتوارداروسازي‌  دكترعبيدي‌,408,645149,16006520540,24290,24900,24820,530,2.18,24480,190,0.78,24180,25290,1400-2-27,2021-05-17
181,شفن,پتروشيمي فناوران,403,87448,26208611690,301920,290100,297930,-3990,-1.32,301330,-590,-0.2,290100,304870,1400-2-27,2021-05-17
182,بموتو,موتوژن‌,401,632273,31041362050,51360,50000,48800,-2560,-4.98,49090,-2270,-4.42,48800,51000,1400-2-27,2021-05-17
183,غسالم,سالمين‌,395,3099932,10194351338,3454,3284,3282,-172,-4.98,3324,-130,-3.76,3282,3380,1400-2-27,2021-05-17
184,پارسان,گسترش نفت و گاز پارسيان,385,1858305,33439978770,18160,17610,17900,-260,-1.43,18110,-50,-0.28,17610,18200,1400-2-27,2021-05-17
185,وسگيلا,شركت س استان گيلان,383,29050708,19812582856,717,682,682,-35,-4.88,700,-17,-2.37,682,682,1400-2-27,2021-05-17
186,ياقوت,صندوق س ياقوت آگاه-ثابت,381,10326342,127582853882,12355,12355,12356,1,0.01,12355,0,0,12355,12357,1400-2-27,2021-05-17
187,مدير,ص.س.مديريت ثروت ص.بازنشستگي-س,380,1421829,11033984949,7916,7900,7705,-211,-2.67,7760,-156,-1.97,7700,7910,1400-2-27,2021-05-17
188,گشان,توسعه بين المللي پديده شانديز,377,1186662,27707371038,22451,23349,23349,898,4,23349,898,4,23349,23349,1400-2-27,2021-05-17
189,وسلرستا,شركت س استان لرستان,375,40015032,34212852360,900,855,855,-45,-5,855,-45,-5,855,855,1400-2-27,2021-05-17
190,ثمسكن,سرمايه‌گذاري‌ مسكن‌,365,4011832,17277204869,4499,4302,4275,-224,-4.98,4307,-192,-4.27,4275,4500,1400-2-27,2021-05-17
191,بفجر,فجر انرژي خليج فارس,361,750041,16657815040,21770,22020,22250,480,2.2,21900,130,0.6,21900,22600,1400-2-27,2021-05-17
192,تسه9910,امتياز تسهيلات مسكن دي99,357,5719,3422248173,584355,590000,589000,4645,0.79,598400,14045,2.4,580009,613572,1400-2-27,2021-05-17
193,ارزش,صندوق س ارزش آفرين بيدار-سهام,355,2590744,23011336790,8970,8980,8860,-110,-1.23,8880,-90,-1,8820,8980,1400-2-27,2021-05-17
194,تسه9909,امتياز تسهيلات مسكن آذر99,349,6270,3746017822,583926,585000,590555,6629,1.14,597451,13525,2.32,577099,612990,1400-2-27,2021-05-17
195,شاراك,پتروشيمي شازند,346,760299,19101496080,25370,25030,24900,-470,-1.85,25310,-60,-0.24,24820,25290,1400-2-27,2021-05-17
196,جم پيلن,پلي پروپيلن جم - جم پيلن,346,592668,41556142010,71190,70980,70060,-1130,-1.59,70400,-790,-1.11,68260,71910,1400-2-27,2021-05-17
197,زگلدشتح,ح.كشت و دام گلدشت نمونه اصفهان,346,1285549,7532001220,5917,5980,5800,-117,-1.98,5859,-58,-0.98,5744,6000,1400-2-27,2021-05-17
198,خريخت,صنايع‌ريخته‌گري‌ايران‌,343,3725939,9441390686,2639,2630,2508,-131,-4.96,2564,-75,-2.84,2508,2658,1400-2-27,2021-05-17
199,شپاكسا,پاكسان‌,343,764834,17799007320,24320,24610,23110,-1210,-4.98,23270,-1050,-4.32,23110,24630,1400-2-27,2021-05-17
200,وتوس,توسعه‌شهري‌توس‌گستر,334,1002659,13508342390,13230,13300,13370,140,1.06,13440,210,1.59,13300,13800,1400-2-27,2021-05-17
201,سيدكو,سرمايه گذاري توسعه صنايع سيمان,330,2838377,16340648070,5800,5900,5700,-100,-1.72,5760,-40,-0.69,5640,5950,1400-2-27,2021-05-17
202,واحيا,م .صنايع و معادن احياء سپاهان,329,336148,50093734306,151548,151000,149990,-1558,-1.03,149426,-2122,-1.4,147002,152980,1400-2-27,2021-05-17
203,خديزل,بهمن  ديزل,326,409831,16389822266,40900,41799,38855,-2045,-5,39992,-908,-2.22,38855,41799,1400-2-27,2021-05-17
204,وپترو,سرمايه‌گذاري صنايع پتروشيمي‌,325,924162,11058053450,12380,12020,11770,-610,-4.93,12030,-350,-2.83,11770,12890,1400-2-27,2021-05-17
205,وثنو,سرمايه گذاري ساختماني نوين,323,3354610,14704157685,4513,4510,4379,-134,-2.97,4383,-130,-2.88,4378,4510,1400-2-27,2021-05-17
206,تنوين,تامين سرمايه نوين,322,4378758,31905347150,7280,7310,7280,0,0,7280,0,0,7260,7400,1400-2-27,2021-05-17
207,دالبر,البرزدارو,309,1041060,13601196160,13730,13050,13120,-610,-4.44,13170,-560,-4.08,13050,13650,1400-2-27,2021-05-17
208,وحكمت,بيمه حكمت صبا,305,5107949,15791129909,3181,3150,3100,-81,-2.55,3091,-90,-2.83,3086,3222,1400-2-27,2021-05-17
209,شخارك,پتروشيمي‌ خارك‌,298,259752,10956240230,42520,42700,41890,-630,-1.48,42480,-40,-0.09,41650,42700,1400-2-27,2021-05-17
210,پارتا,مجتمع‌صنعتي‌آرتاويل‌تاير,291,408328,12946325023,31831,32673,32320,489,1.54,31773,-58,-0.18,30877,32673,1400-2-27,2021-05-17
211,شرانل,نفت ايرانول,291,3281731,130789397549,39851,39851,40030,179,0.45,39854,3,0.01,39391,40100,1400-2-27,2021-05-17
212,تايرا,تراكتورسازي‌ايران‌,286,447379,11002164360,25650,24380,24390,-1260,-4.91,25280,-370,-1.44,24370,25730,1400-2-27,2021-05-17
213,وسپه,سرمايه‌گذاري‌ سپه‌,283,2224485,14036237280,6580,6340,6260,-320,-4.86,6450,-130,-1.98,6260,6500,1400-2-27,2021-05-17
214,خفولا,خدمات فني فولاد يزد,282,504869,22407600827,43091,44383,44383,1292,3,44383,1292,3,44383,44383,1400-2-27,2021-05-17
215,حسينا,توسعه خدمات دريايي وبندري سينا,281,192296,10788352708,57882,57500,54988,-2894,-5,56574,-1308,-2.26,54988,57501,1400-2-27,2021-05-17
216,كرماشا,صنايع پتروشيمي كرمانشاه,281,643128,20266206780,32330,31980,31290,-1040,-3.22,31960,-370,-1.14,31040,31980,1400-2-27,2021-05-17
217,تصميم,صندوق س با درآمد ثابت تصميم,280,1049235,17173186404,16357,16367,16371,14,0.09,16367,10,0.06,16364,16373,1400-2-27,2021-05-17
218,سپاس,صندوق س. پاداش سهامداري-ثابت,279,11245398,113191298643,10060,10066,10069,9,0.09,10066,6,0.06,10065,10069,1400-2-27,2021-05-17
219,تماوند,تامين سرمايه دماوند,270,2262905,11238994584,5064,4914,4913,-151,-2.98,4985,-79,-1.56,4913,5100,1400-2-27,2021-05-17
220,شلعابح,ح . لعابيران‌,258,2613388,17695303920,7500,8000,6750,-750,-10,6770,-730,-9.73,6750,8000,1400-2-27,2021-05-17
221,ضخود7074,اختيارخ خودرو-1800-1400/07/07,257,12396,3423751000,336,300,263,-73,-21.73,276,-60,-17.86,258,340,1400-2-27,2021-05-17
222,بساما,بيمه سامان,256,497380,9955324862,20670,21115,19899,-771,-3.73,20274,-396,-1.92,19637,21449,1400-2-27,2021-05-17
223,تسه9803,امتياز تسهيلات مسكن خرداد98,253,4777,2812537982,569076,568623,596846,27770,4.88,588767,19691,3.46,568623,597520,1400-2-27,2021-05-17
224,شبصير,توليدات پتروشيمي قائد بصير,250,194918,12264845122,64768,63010,62500,-2268,-3.5,63193,-1575,-2.43,62414,64768,1400-2-27,2021-05-17
225,سرود,سيمان‌شاهرود,248,995526,16710621890,16730,16900,16690,-40,-0.24,16790,60,0.36,16400,17090,1400-2-27,2021-05-17
226,ضخود7077,اختيارخ خودرو-3000-1400/07/07,245,15495,887982000,69,67,49,-20,-28.99,57,-12,-17.39,46,74,1400-2-27,2021-05-17
227,تماوندح,ح . تامين سرمايه دماوند,243,3980130,13788024336,3566,3460,3460,-106,-2.97,3464,-102,-2.86,3460,3550,1400-2-27,2021-05-17
228,مبين,مبين انرژي خليج فارس,238,1909002,30241060330,15740,16030,15600,-140,-0.89,15770,30,0.19,15580,16040,1400-2-27,2021-05-17
229,پارسيان,بيمه پارسيان,238,5388220,47674966420,8750,8990,8550,-200,-2.29,8850,100,1.14,8550,9300,1400-2-27,2021-05-17
230,وتوسم,سرمايه‌گذاري‌توسعه‌ملي‌,231,1090104,7467340320,7110,7110,6810,-300,-4.22,6970,-140,-1.97,6800,7110,1400-2-27,2021-05-17
231,شاوان,پالايش نفت لاوان,231,140837,10522322342,78386,75400,74470,-3916,-5,77255,-1131,-1.44,74467,78016,1400-2-27,2021-05-17
232,جم,پتروشيمي جم,227,261528,8982729180,34710,34010,34020,-690,-1.99,34680,-30,-0.09,33750,35000,1400-2-27,2021-05-17
233,كاريس,صندوق س.سپهر كاريزما-س,222,1112336,11685031452,10719,10690,10411,-308,-2.87,10505,-214,-2,10410,10749,1400-2-27,2021-05-17
234,تيپيكو,سرمايه گذاري دارويي تامين,221,195662,6487141370,34080,33670,33260,-820,-2.41,33980,-100,-0.29,33010,33780,1400-2-27,2021-05-17
235,تسه9907,امتياز تسهيلات مسكن مهر99,220,3817,2279424615,583349,570000,595000,11651,2,597177,13828,2.37,570000,609989,1400-2-27,2021-05-17
236,فسازان,غلتك سازان سپاهان,219,629063,20211924940,32500,31800,32120,-380,-1.17,32130,-370,-1.14,31800,33200,1400-2-27,2021-05-17
237,بميلا,توسعه بازرگاني آهن وفولادميلاد,217,1889351,24657861851,13448,13051,13045,-403,-3,13051,-397,-2.95,13045,13200,1400-2-27,2021-05-17
238,تسه9902,امتياز تسهيلات مسكن ارديبهشت99,212,5078,3030821934,582192,570000,590000,7808,1.34,596853,14661,2.52,560000,611301,1400-2-27,2021-05-17
239,وسهمدا,شركت س استان همدان,209,15000000,12690000000,890,846,846,-44,-4.94,876,-14,-1.57,846,846,1400-2-27,2021-05-17
240,كاردان,صندوق س تجارت شاخصي كاردان,208,55739,8032704430,146350,146700,143980,-2370,-1.62,144110,-2240,-1.53,142000,146700,1400-2-27,2021-05-17
241,درازك,دارويي‌ رازك‌,199,240758,6600007230,28260,27050,27350,-910,-3.22,27860,-400,-1.42,27050,28490,1400-2-27,2021-05-17
242,شوينده,مديريت صنعت شوينده ت.ص.بهشهر,195,536237,11888113820,23200,23500,22040,-1160,-5,22280,-920,-3.97,22040,23500,1400-2-27,2021-05-17
243,وصندوق,سرمايه‌گذاري‌صندوق‌بازنشستگي‌,194,536328,7242076000,13950,13450,13330,-620,-4.44,13920,-30,-0.22,13260,13990,1400-2-27,2021-05-17
244,ضخود4002,اختيارخ خودرو-1800-1400/04/02,189,9219,2204604000,268,280,212,-56,-20.9,239,-29,-10.82,194,280,1400-2-27,2021-05-17
245,شساخت,مهندسي و ساختمان صنايع نفت,188,388353,16650531715,43583,42276,42276,-1307,-3,43310,-273,-0.63,42276,43649,1400-2-27,2021-05-17
246,عيار,صندوق سكه طلاي مفيد,187,133710,3393690165,26128,25990,25395,-733,-2.81,25381,-747,-2.86,25230,25990,1400-2-27,2021-05-17
247,كگهر,سنگ آهن گهرزمين,178,141252,5903272017,42614,41510,41251,-1363,-3.2,42573,-41,-0.1,41023,42990,1400-2-27,2021-05-17
248,ثباغ,شهر سازي و خانه سازي باغميشه,178,453389,6036579979,13908,13300,13213,-695,-5,13641,-267,-1.92,13213,14390,1400-2-27,2021-05-17
249,تسه9810,امتياز تسهيلات مسكن دي98,175,3937,2341303147,576880,555855,600000,23120,4.01,594692,17812,3.09,555855,605724,1400-2-27,2021-05-17
250,پتاير,ايران‌ تاير,172,5783432,19958623832,3632,3451,3451,-181,-4.98,3451,-181,-4.98,3451,3451,1400-2-27,2021-05-17
251,دسبحانح,ح. سبحان دارو,171,224384,2392804990,10940,10700,10670,-270,-2.47,10660,-280,-2.56,10500,11000,1400-2-27,2021-05-17
252,كيان2,صندوق س. با درآمد ثابت كيان,170,17000000,17000000,28445,1,1,-28444,-100,1,-28444,-100,1,1,1400-2-27,2021-05-17
253,زر,صندوق س.پشتوانه سكه طلاي زر,169,88816,3803724805,44191,42099,42750,-1441,-3.26,42827,-1364,-3.09,42099,43098,1400-2-27,2021-05-17
254,كارين,صندوق س نگين سامان-ثابت,165,6001696,60946317889,10148,10152,10155,7,0.07,10155,7,0.07,10151,10155,1400-2-27,2021-05-17
255,ضسپا3004,اختيارخ خساپا-2500-1400/03/26,162,9166,123730000,24,22,10,-14,-58.33,13,-11,-45.83,9,22,1400-2-27,2021-05-17
256,آپ,آسان پرداخت پرشين,160,564467,8839553220,17390,15660,15660,-1730,-9.95,16470,-920,-5.29,15660,15660,1400-2-27,2021-05-17
257,كوير,توليدي فولاد سپيد فراب كوير,159,4242437,71697185300,17780,16900,16900,-880,-4.95,16920,-860,-4.84,16900,16900,1400-2-27,2021-05-17
258,وبشهر,توسعه‌ صنايع‌ بهشهر(هلدينگ,155,1461350,13855116210,9580,9230,9520,-60,-0.63,9540,-40,-0.42,9230,9770,1400-2-27,2021-05-17
259,شيراز,پتروشيمي‌شيراز,154,67146,3370742640,50560,51000,50560,0,0,50550,-10,-0.02,49560,51190,1400-2-27,2021-05-17
260,وخاور,بانك خاورميانه,154,1012794,8428947760,8340,8270,8340,0,0,8340,0,0,8270,8350,1400-2-27,2021-05-17
261,اخزا910,اسنادخزانه-م10بودجه99-020807,152,255167,154782785890,603749,602110,603113,-636,-0.11,606594,2845,0.47,573562,611240,1400-2-27,2021-05-17
262,اخزا903,اسنادخزانه-م3بودجه99-011110,150,183460,129091185740,703258,698032,703250,-8,0,703648,390,0.06,698032,706000,1400-2-27,2021-05-17
263,سحرخيز,صندوق س. گروه زعفران سحرخيز,142,318751,2684802956,8420,8479,8393,-27,-0.32,8423,3,0.04,8250,8810,1400-2-27,2021-05-17
264,سكرما,سيمان‌ كرمان‌,142,507190,6761448900,14000,14100,13300,-700,-5,13660,-340,-2.43,13300,14100,1400-2-27,2021-05-17
265,زپارس,ملي كشت و صنعت و دامپروري پارس,141,133119,16430543270,123960,123960,120000,-3960,-3.19,123430,-530,-0.43,118780,126790,1400-2-27,2021-05-17
266,آريان,سرمايه گذاري پارس آريان,140,4225593,45678660330,10296,10810,10810,514,4.99,10570,274,2.66,10810,10810,1400-2-27,2021-05-17
267,گوهر,صندوق سكه طلاي كيان,140,85293,4191829109,50536,49200,49000,-1536,-3.04,49146,-1390,-2.75,49000,49900,1400-2-27,2021-05-17
268,قيستو,شركت قند بيستون,139,1366013,24264536705,18501,17761,17761,-740,-4,17763,-738,-3.99,17761,18000,1400-2-27,2021-05-17
269,تسه9906,امتياز تسهيلات مسكن شهريور99,138,1379,823344030,582582,610000,595500,12918,2.22,597059,14477,2.48,579222,610000,1400-2-27,2021-05-17
270,وسبحان,سرمايه گذاري سبحان,135,6819414,16693925472,2576,2448,2448,-128,-4.97,2448,-128,-4.97,2448,2448,1400-2-27,2021-05-17
271,اطلس,صندوق س.توسعه اندوخته آينده-س,133,36114,7168037325,200042,200000,198848,-1194,-0.6,198484,-1558,-0.78,197521,200999,1400-2-27,2021-05-17
272,سجام,مجتمع سيمان غرب آسيا,130,809903,3183790960,4042,3921,4000,-42,-1.04,4004,-38,-0.94,3921,4080,1400-2-27,2021-05-17
273,سباقر,سيمان باقران,130,531799,7839057034,15189,14735,14734,-455,-3,14824,-365,-2.4,14734,15225,1400-2-27,2021-05-17
274,ضشنا2000,اختيارخ شپنا-9000-1400/02/27,130,2375,2393910000,1546,1001,900,-646,-41.79,1008,-538,-34.8,828,1250,1400-2-27,2021-05-17
275,تسه9904,امتياز تسهيلات مسكن تير99,126,1298,775679718,581755,580111,602000,20245,3.48,597596,15841,2.72,567622,608500,1400-2-27,2021-05-17
276,فردا,صندوق س آواي فرداي زاگرس-ثابت,125,3910654,41839615901,10693,10699,10699,6,0.06,10699,6,0.06,10698,10700,1400-2-27,2021-05-17
277,ارمغان,ص سرمايه گذاري ارمغان ايرانيان,122,1830114,18412851333,10056,10057,10064,8,0.08,10061,5,0.05,10057,10064,1400-2-27,2021-05-17
278,فروس,فروسيليس‌ ايران‌,119,378219,1796540250,5270,4750,4750,-520,-9.87,5200,-70,-1.33,4750,4750,1400-2-27,2021-05-17
279,دپارس,پارس‌ دارو,117,124281,5238001490,44340,42130,42130,-2210,-4.98,43620,-720,-1.62,42130,42900,1400-2-27,2021-05-17
280,سصوفي,سيمان‌ صوفيان‌,117,558190,7256470000,13680,13000,13000,-680,-4.97,13300,-380,-2.78,13000,13000,1400-2-27,2021-05-17
281,كدما,معدني‌ دماوند,113,110811,9382367370,89120,84670,84670,-4450,-4.99,85960,-3160,-3.55,84670,84670,1400-2-27,2021-05-17
282,شصفها,پتروشيمي‌ اصفهان‌,113,81008,9821243815,122393,124500,122793,400,0.33,121613,-780,-0.64,119946,124500,1400-2-27,2021-05-17
283,سمتاز,سيمان ممتازان كرمان,112,65230,1543123930,23963,23963,23285,-678,-2.83,23916,-47,-0.2,23260,24469,1400-2-27,2021-05-17
284,تسه9905,امتياز تسهيلات مسكن مرداد99,111,872,521252211,580865,581200,597000,16135,2.78,597766,16901,2.91,580000,609690,1400-2-27,2021-05-17
285,كخاك,صنايع‌خاك‌چيني‌ايران‌,110,62694,2240621590,37470,36000,35730,-1740,-4.64,37290,-180,-0.48,35600,38600,1400-2-27,2021-05-17
286,اتكاي,بيمه اتكايي ايرانيان,108,146899,2326924567,16282,17070,15900,-382,-2.35,16241,-41,-0.25,15482,17070,1400-2-27,2021-05-17
287,خاتم,صندوق س خاتم ايساتيس پويا-ثابت,107,2558920,28444602669,11111,11111,11118,7,0.06,11116,5,0.05,11111,11120,1400-2-27,2021-05-17
288,مارون,پتروشيمي مارون,107,51855,7447304188,147253,141560,143800,-3453,-2.34,146975,-278,-0.19,141350,144509,1400-2-27,2021-05-17
289,فخاس,فولاد خراسان,105,519262,12239650640,24810,23570,23570,-1240,-5,24650,-160,-0.64,23570,23780,1400-2-27,2021-05-17
290,تسه9903,امتياز تسهيلات مسكن خرداد99,105,1039,622525858,577312,606177,593300,15988,2.77,599159,21847,3.78,563682,606177,1400-2-27,2021-05-17
291,خراسان,پتروشيمي خراسان,102,74129,5026989000,68040,67370,66000,-2040,-3,68020,-20,-0.03,66000,68980,1400-2-27,2021-05-17
292,وتوصا,گروه س توسعه صنعتي ايران,101,1749035,16808226350,10110,9610,9610,-500,-4.95,9610,-500,-4.95,9610,9610,1400-2-27,2021-05-17
293,شنفت,نفت‌ پارس‌,100,97335,4474909950,46970,46980,45550,-1420,-3.02,46870,-100,-0.21,45500,47500,1400-2-27,2021-05-17
294,آكورد2,صندوق س. آرمان آتي كوثر-د,100,10000000,10000000,32101,1,1,-32100,-100,1,-32100,-100,1,1,1400-2-27,2021-05-17
295,اتكام,شركت بيمه اتكايي امين,99,553496,2418552866,4598,4370,4369,-229,-4.98,4558,-40,-0.87,4369,4450,1400-2-27,2021-05-17
296,حفارس,حمل و نقل بين المللي خليج فارس,97,457057,1982713266,4820,4338,4338,-482,-10,4749,-71,-1.47,4338,4338,1400-2-27,2021-05-17
297,خودكفا,اقتصادي و خودكفايي آزادگان,97,516101,8661206982,17665,16782,16782,-883,-5,17452,-213,-1.21,16782,16782,1400-2-27,2021-05-17
298,دلر,داروسازي‌ اكسير,95,76491,2340522420,31640,30110,31090,-550,-1.74,31460,-180,-0.57,30060,32790,1400-2-27,2021-05-17
299,بخاور,بيمه زندگي خاورميانه,95,616846,3784369015,6389,6071,6070,-319,-4.99,6318,-71,-1.11,6070,6350,1400-2-27,2021-05-17
300,ثفارس,عمران‌وتوسعه‌فارس‌,94,375915,3371957550,9960,8970,8970,-990,-9.94,9710,-250,-2.51,8970,8970,1400-2-27,2021-05-17
301,اخزا902,اسنادخزانه-م2بودجه99-011019,89,120610,85814411649,711310,710000,711201,-109,-0.02,711503,193,0.03,708486,714000,1400-2-27,2021-05-17
302,تسه9804,امتياز تسهيلات مسكن تير98,88,1687,1006146945,578101,582900,597000,18899,3.27,596412,18311,3.17,582900,600010,1400-2-27,2021-05-17
303,ضجار7040,اختيارخ وتجارت-2497-1400/07/21,88,2927,697285000,261,230,200,-61,-23.37,238,-23,-8.81,200,295,1400-2-27,2021-05-17
304,فيروزه,صندوق شاخص30 شركت فيروزه- سهام,86,59089,7599257000,129810,131900,128510,-1300,-1,128610,-1200,-0.92,128510,131900,1400-2-27,2021-05-17
305,اوصتا,صندوق انديشه ورزان صباتامين -د,86,481707,8984213149,18640,18660,18650,10,0.05,18651,11,0.06,18650,18660,1400-2-27,2021-05-17
306,لبوتان,گروه‌صنعتي‌بوتان‌,86,99389,5402659930,57210,54360,54360,-2850,-4.98,56200,-1010,-1.77,54350,55000,1400-2-27,2021-05-17
307,سپر,صندوق س سپر سرمايه بيدار- ثابت,83,2765491,32679590589,11811,11816,11816,5,0.04,11817,6,0.05,11816,11817,1400-2-27,2021-05-17
308,تسه9806,امتياز تسهيلات مسكن شهريور98,81,1323,789096716,583107,562122,602770,19663,3.37,596445,13338,2.29,562122,608900,1400-2-27,2021-05-17
309,سپيدما,صندوق س. سپيد دماوند-د,81,2823534,29172789516,10321,10330,10330,9,0.09,10332,11,0.11,10330,10336,1400-2-27,2021-05-17
310,تسه9812,امتياز تسهيلات مسكن اسفند98,80,640,381511588,576211,570209,590134,13923,2.42,596112,19901,3.45,570209,605021,1400-2-27,2021-05-17
311,آساس,صندوق س.آسمان آرماني سهام-س,80,21563,3493580568,162903,163100,162000,-903,-0.55,162017,-886,-0.54,161400,163100,1400-2-27,2021-05-17
312,ضخود7076,اختيارخ خودرو-2500-1400/07/07,78,2447,302648000,146,146,115,-31,-21.23,124,-22,-15.07,101,146,1400-2-27,2021-05-17
313,كسرام,پارس‌ سرام‌,78,197809,1479611320,8310,7480,7480,-830,-9.99,8220,-90,-1.08,7480,7480,1400-2-27,2021-05-17
314,ختراك,ريخته‌گري‌ تراكتورسازي‌ ايران‌,74,1564703,23001134100,15470,14700,14700,-770,-4.98,14700,-770,-4.98,14700,14700,1400-2-27,2021-05-17
315,هنوري102,اختيارف ت نوري59561-01/02/15,74,169313,196403080,860,1160,1160,300,34.88,1160,300,34.88,1160,1160,1400-2-27,2021-05-17
316,شراز,پالايش نفت شيراز,74,12429,1221487981,103399,98291,98230,-5169,-5,103244,-155,-0.15,98230,99500,1400-2-27,2021-05-17
317,شلعاب,لعابيران‌,73,219824,2815945440,13480,12810,12810,-670,-4.97,13270,-210,-1.56,12810,12810,1400-2-27,2021-05-17
318,تسه9809,امتياز تسهيلات مسكن آذر98,73,766,453899561,576956,570569,588501,11545,2,592558,15602,2.7,570569,605803,1400-2-27,2021-05-17
319,تسه9808,امتياز تسهيلات مسكن آبان98,73,1402,838572871,575092,556666,603844,28752,5,598126,23034,4.01,556666,603846,1400-2-27,2021-05-17
320,اخزا808,اسنادخزانه-م8بودجه98-000817,72,5642,5109296663,905411,905000,906484,1073,0.12,905583,172,0.02,905000,906484,1400-2-27,2021-05-17
321,نهال,صندوق س. طلاي سرخ نوويرا,66,140091,1220219664,8632,8688,8700,68,0.79,8710,78,0.9,8560,8938,1400-2-27,2021-05-17
322,دزهراوي,داروسازي‌زهراوي‌,66,240785,1637338000,7150,6800,6800,-350,-4.9,7100,-50,-0.7,6800,6800,1400-2-27,2021-05-17
323,فاراك,ماشين‌ سازي‌ اراك‌,65,563752,1204174272,2248,2136,2136,-112,-4.98,2238,-10,-0.44,2136,2136,1400-2-27,2021-05-17
324,تسه9811,امتياز تسهيلات مسكن بهمن98,62,523,311608597,574526,560012,600000,25474,4.43,595810,21284,3.7,560012,603252,1400-2-27,2021-05-17
325,وبازار,صندوق س شاخصي بازارآشنا,60,430272,3915714200,9120,9100,9100,-20,-0.22,9100,-20,-0.22,9100,9120,1400-2-27,2021-05-17
326,تسه9901,امتياز تسهيلات مسكن فروردين99,60,484,291817687,583843,570000,609990,26147,4.48,602929,19086,3.27,570000,610000,1400-2-27,2021-05-17
327,سكه0011پ02,تمام سكه طرح جديد0011ملت,60,8800,8819614300,1026983,1000000,1006500,-20483,-1.99,1002229,-24754,-2.41,992300,1009800,1400-2-27,2021-05-17
328,افق ملت,صندوق س در سهام افق ملت,58,85649,10568876860,124320,124000,123000,-1320,-1.06,123400,-920,-0.74,123000,124000,1400-2-27,2021-05-17
329,غالبر,لبنيات‌ كالبر,57,146596,2665115280,20190,18180,18180,-2010,-9.96,19790,-400,-1.98,18180,18180,1400-2-27,2021-05-17
330,اراد35,مرابحه عام دولت3-ش.خ 0103,55,1025000,972852525000,950148,948900,949000,-1148,-0.12,949124,-1024,-0.11,948900,950500,1400-2-27,2021-05-17
331,تليسه,دامداري تليسه نمونه,54,231926,951128526,4316,4101,4101,-215,-4.98,4302,-14,-0.32,4101,4101,1400-2-27,2021-05-17
332,تسه9807,امتياز تسهيلات مسكن مهر98,54,752,454946193,577585,606464,606454,28869,5,604982,27397,4.74,548800,606464,1400-2-27,2021-05-17
333,ثاخت,بين‌المللي‌توسعه‌ساختمان,53,390287,890244647,2401,2281,2281,-120,-5,2393,-8,-0.33,2281,2281,1400-2-27,2021-05-17
334,ضپاس2001,اختيارخ وپارس-2500-1400/02/29,51,2461,143315000,83,80,53,-30,-36.14,58,-25,-30.12,40,89,1400-2-27,2021-05-17
335,شكبير,پتروشيمي اميركبير,51,89653,7367465015,82594,81630,81010,-1584,-1.92,82563,-31,-0.04,81010,84140,1400-2-27,2021-05-17
336,دارا,صندوق س. دارا الگوريتم-د,51,765989,7699911899,10047,10058,10050,3,0.03,10052,5,0.05,10043,10058,1400-2-27,2021-05-17
337,آساميد,صندوق س.مشترك آسمان اميد -د,50,1330598,16006379444,12021,12027,12027,6,0.05,12029,8,0.07,12027,12033,1400-2-27,2021-05-17
338,كالا,بورس كالاي ايران,49,55792,1658138240,31280,29720,29720,-1560,-4.99,31190,-90,-0.29,29720,29720,1400-2-27,2021-05-17
339,اخزا901,اسنادخزانه-م1بودجه99-010621,49,30485,23196936692,761378,759932,762101,723,0.09,760929,-449,-0.06,758000,762500,1400-2-27,2021-05-17
340,اخزا908,اسنادخزانه-م8بودجه99-020606,48,160318,100140846473,624053,623101,625000,947,0.15,624639,586,0.09,623100,625999,1400-2-27,2021-05-17
341,وارس,سرمايه گذاري ارس صبا,48,681086,10599060332,16043,15562,15562,-481,-3,15562,-481,-3,15562,15562,1400-2-27,2021-05-17
342,اخزا907,اسنادخزانه-م7بودجه99-020704,47,236041,144559649504,614912,600111,613999,-913,-0.15,612434,-2478,-0.4,600011,614980,1400-2-27,2021-05-17
343,سپيدار,سپيدار سيستم آسيا,46,54159,2962064028,57570,54692,54692,-2878,-5,56960,-610,-1.06,54692,54692,1400-2-27,2021-05-17
344,آتيمس,صندوق س.آرمان آتيه درخشان مس-س,46,12302,2100236280,172313,171000,171897,-416,-0.24,170723,-1590,-0.92,170000,172000,1400-2-27,2021-05-17
345,سبزوا,سيمان لار سبزوار,46,212628,661698336,3275,3112,3112,-163,-4.98,3267,-8,-0.24,3112,3112,1400-2-27,2021-05-17
346,تسه9805,امتياز تسهيلات مسكن مرداد98,46,669,397051422,582090,562010,595000,12910,2.22,593500,11410,1.96,562010,595722,1400-2-27,2021-05-17
347,فمراد,آلومراد,45,13700,1149841000,88340,83930,83930,-4410,-4.99,87960,-380,-0.43,83930,83930,1400-2-27,2021-05-17
348,ضملي3003,اختيارخ فملي-12000-1400/03/02,45,277,170692000,814,602,516,-298,-36.61,616,-198,-24.32,300,849,1400-2-27,2021-05-17
349,دانا,بيمه دانا,45,880524,5045402520,6030,5730,5730,-300,-4.98,5920,-110,-1.82,5730,5730,1400-2-27,2021-05-17
350,غگرجي,بيسكويت‌  گرجي‌,44,801721,12538916440,16460,15640,15640,-820,-4.98,15660,-800,-4.86,15640,15640,1400-2-27,2021-05-17
351,سكه0112پ03,تمام سكه طرح جديد0112سامان,44,14700,14691725000,1021084,1009995,1003100,-17984,-1.76,999437,-21647,-2.12,992400,1015000,1400-2-27,2021-05-17
352,اخزا814,اسنادخزانه-م14بودجه98-010318,43,136378,109724508948,804041,804100,805000,959,0.12,804562,521,0.06,800000,805999,1400-2-27,2021-05-17
353,كلوند,كاشي‌ الوند,43,76869,1601949960,21930,20840,20840,-1090,-4.97,21800,-130,-0.59,20840,20840,1400-2-27,2021-05-17
354,توريل,توكاريل,43,150465,2332357965,16316,15501,15501,-815,-5,16220,-96,-0.59,15501,15501,1400-2-27,2021-05-17
355,سكه0012پ04,تمام سكه طرح جديد0012صادرات,42,13100,13164429700,1023104,1000000,1006000,-17104,-1.67,1004918,-18186,-1.78,986005,1019000,1400-2-27,2021-05-17
356,معيار ,سرمايه گذاري معيار صنعت پارس,41,92674,5442187976,60540,58724,58724,-1816,-3,59492,-1048,-1.73,58724,58724,1400-2-27,2021-05-17
357,ساروج,بين المللي ساروج بوشهر,41,258507,4489774189,17407,17420,17600,193,1.11,17390,-17,-0.1,17021,17800,1400-2-27,2021-05-17
358,فيروزا,صندوق بادرآمد ثابت فيروزه آسيا,40,26503,608390812,22926,22930,22961,35,0.15,22956,30,0.13,22930,22992,1400-2-27,2021-05-17
359,اخزا817,اسنادخزانه-م17بودجه98-010512,40,10229,7951161240,777000,771005,780666,3666,0.47,777316,316,0.04,771005,782000,1400-2-27,2021-05-17
360,زعف0008پ08,زعفران0008نگين روستا(پ),40,8600,1022248500,119981,119000,118000,-1981,-1.65,118866,-1115,-0.93,118000,119299,1400-2-27,2021-05-17
361,وهور,مديريت انرژي اميد  تابان هور,39,695102,1319998698,1998,1899,1899,-99,-4.95,1995,-3,-0.15,1899,1899,1400-2-27,2021-05-17
362,وبيمه,سرمايه‌ گذاري‌ صنعت‌ بيمه‌,38,5029521,13378525860,2799,2660,2660,-139,-4.97,2669,-130,-4.64,2660,2660,1400-2-27,2021-05-17
363,شفارا,پتروشيمي فارابي,37,2057541,7545002847,3780,3667,3667,-113,-2.99,3687,-93,-2.46,3667,3667,1400-2-27,2021-05-17
364,اخزا909,اسنادخزانه-م9بودجه99-020316,35,81362,53309225643,655484,655000,653263,-2221,-0.34,655210,-274,-0.04,653050,656000,1400-2-27,2021-05-17
365,وپويا,سرمايه گذاري پويا,35,249601,1483129142,6254,5942,5942,-312,-4.99,6221,-33,-0.53,5942,5942,1400-2-27,2021-05-17
366,زرين,صندوق س. سهام زرين كوروش-س,35,629360,6161621115,9742,9800,9597,-145,-1.49,9790,48,0.49,9570,9800,1400-2-27,2021-05-17
367,اخزا914,اسنادخزانه-م14بودجه99-021025,35,26037,14985949290,574039,575004,577950,3911,0.68,575564,1525,0.27,575001,577950,1400-2-27,2021-05-17
368,چكاپا,گروه صنايع كاغذ پارس,34,147838,717014300,5100,4850,4850,-250,-4.9,5090,-10,-0.2,4850,4850,1400-2-27,2021-05-17
369,ضملي3004,اختيارخ فملي-14000-1400/03/02,34,1336,37430000,95,7,15,-80,-84.21,28,-67,-70.53,7,50,1400-2-27,2021-05-17
370,صنوين,صندوق سرمايه‌گذاري صنوين-مختلط,34,6725,700988170,104150,105480,103920,-230,-0.22,104240,90,0.09,103900,105900,1400-2-27,2021-05-17
371,ونيرو,سرمايه‌گذاري‌نيرو,33,402684,964830864,2522,2396,2396,-126,-5,2513,-9,-0.36,2396,2396,1400-2-27,2021-05-17
372,اخزا815,اسنادخزانه-م15بودجه98-010406,32,8551,6809513674,795351,793200,796189,838,0.11,796341,990,0.12,793200,802090,1400-2-27,2021-05-17
373,فرآور,فرآوري‌موادمعدني‌ايران‌,32,260004,7989922920,32340,30730,30730,-1610,-4.98,31370,-970,-3,30730,30730,1400-2-27,2021-05-17
374,بورس,بورس اوراق بهادار تهران,31,408747,12834655800,33050,31400,31400,-1650,-4.99,32630,-420,-1.27,31400,31400,1400-2-27,2021-05-17
375,ضشنا8002,اختيارخ شپنا-7800-1400/08/16,31,934,1763270000,2490,2400,1880,-610,-24.5,1888,-602,-24.18,1750,2400,1400-2-27,2021-05-17
376,فسرب,ملي‌ سرب‌وروي‌ ايران‌,29,33510,2336987400,73410,69740,69740,-3670,-5,72780,-630,-0.86,69740,69740,1400-2-27,2021-05-17
377,نوين,بيمه نوين,29,149013,831939579,5876,5583,5583,-293,-4.99,5859,-17,-0.29,5583,5583,1400-2-27,2021-05-17
378,مداران,داده‌پردازي‌ايران‌,29,555175,13246475500,25110,23860,23860,-1250,-4.98,23950,-1160,-4.62,23860,23860,1400-2-27,2021-05-17
379,وسديد,گروه ‌صنعتي‌سديد,29,516491,1436361471,2896,2781,2781,-115,-3.97,2891,-5,-0.17,2781,2781,1400-2-27,2021-05-17
380,تكمبا,كمباين‌ سازي‌ ايران‌,29,221807,1641371800,7780,7400,7400,-380,-4.88,7740,-40,-0.51,7400,7400,1400-2-27,2021-05-17
381,سدشت,صنايع سيمان دشتستان,28,25277,1676370640,69810,66320,66320,-3490,-5,69620,-190,-0.27,66320,66320,1400-2-27,2021-05-17
382,زعف0008پ05,زعفران0008نگين زرين(پ),28,13484,1606203525,119277,119700,119300,23,0.02,119119,-158,-0.13,118250,119700,1400-2-27,2021-05-17
383,كفپارس,فرآورده‌هاي‌ نسوز پارس‌,28,286314,876979782,3224,3063,3063,-161,-4.99,3214,-10,-0.31,3063,3063,1400-2-27,2021-05-17
384,انرژي3,سايراشخاص بورس انرژي,27,2485,585689650,248090,235690,235690,-12400,-5,247960,-130,-0.05,235690,235690,1400-2-27,2021-05-17
385,هفجر102,اختيارف ت بفجر8626-01/02/11,26,750000,32250000,212,43,43,-169,-79.72,43,-169,-79.72,43,43,1400-2-27,2021-05-17
386,ضمخا7075,اختيارخ اخابر-8700-1400/07/28,26,715,502460000,1138,800,1350,212,18.63,703,-435,-38.22,600,1350,1400-2-27,2021-05-17
387,سخاش,سيمان‌خاش‌,26,2537,330342770,137060,130210,130210,-6850,-5,136900,-160,-0.12,130210,130210,1400-2-27,2021-05-17
388,هپارس102,اختيارف ت پارس-157010-01/02/05,26,97672,185967488,2881,1904,1904,-977,-33.91,1904,-977,-33.91,1904,1904,1400-2-27,2021-05-17
389,وكادو,تكادو,26,679550,9988025900,15471,14698,14698,-773,-5,14698,-773,-5,14698,14698,1400-2-27,2021-05-17
390,فردا2,صندوق س آواي فرداي زاگرس-ثابت,25,2500000,2500000,10693,1,1,-10692,-99.99,1,-10692,-99.99,1,1,1400-2-27,2021-05-17
391,فراز,صندوق س.سهام فراز داريك-س,25,25732,265775952,10328,10328,10330,2,0.02,10329,1,0.01,10328,10340,1400-2-27,2021-05-17
392,ثبهساز,بهساز كاشانه تهران,25,95743,202879417,2230,2119,2119,-111,-4.98,2229,-1,-0.04,2119,2119,1400-2-27,2021-05-17
393,صايند,صندوق س. گنجينه آينده روشن-د,25,43860,423825640,9670,9655,9667,-3,-0.03,9663,-7,-0.07,9655,9699,1400-2-27,2021-05-17
394,وآيند,بانك  آينده,24,55006,862164044,16327,15674,15674,-653,-4,16321,-6,-0.04,15674,15674,1400-2-27,2021-05-17
395,پلوله,گازلوله‌,24,88638,2461299984,28626,27768,27768,-858,-3,28405,-221,-0.77,27768,27768,1400-2-27,2021-05-17
396,بكام,كارخانجات توليدي شهيد قندي,23,150777,560588886,3913,3718,3718,-195,-4.98,3905,-8,-0.2,3718,3718,1400-2-27,2021-05-17
397,ضشنا8003,اختيارخ شپنا-8800-1400/08/16,23,364,518764000,1643,1510,1202,-441,-26.84,1425,-218,-13.27,1202,1520,1400-2-27,2021-05-17
398,ثشاهد,سرمايه‌ گذاري‌ شاهد,23,19543,318355470,17140,16290,16290,-850,-4.96,17130,-10,-0.06,16290,16290,1400-2-27,2021-05-17
399,اخزا911,اسنادخزانه-م11بودجه99-020906,23,108831,64469158604,591534,592000,593500,1966,0.33,592379,845,0.14,592000,593500,1400-2-27,2021-05-17
400,فرابورس,فرابورس ايران,22,29773,880774659,31139,29583,29583,-1556,-5,31098,-41,-0.13,29583,29583,1400-2-27,2021-05-17
401,كپرور,فرآوري زغال سنگ پروده طبس,22,145450,4939772900,35749,33962,33962,-1787,-5,35118,-631,-1.77,33962,33962,1400-2-27,2021-05-17
402,درهآور,دارويي ره آورد تامين,21,29733,811354104,28724,27288,27288,-1436,-5,28636,-88,-0.31,27288,27288,1400-2-27,2021-05-17
403,دسينا,داروسازي‌ سينا,21,16230,353814000,22940,21800,21800,-1140,-4.97,22910,-30,-0.13,21800,21800,1400-2-27,2021-05-17
404,خوساز,محورسازان‌ايران‌خودرو,21,1011587,7141804220,7430,7060,7060,-370,-4.98,7230,-200,-2.69,7060,7060,1400-2-27,2021-05-17
405,اخزا820,اسنادخزانه-م20بودجه98-020806,20,7446,4527176001,608759,608000,608001,-758,-0.12,608001,-758,-0.12,608000,608010,1400-2-27,2021-05-17
406,غمارگ,مارگارين‌,20,22757,611253020,28270,26860,26860,-1410,-4.99,28200,-70,-0.25,26860,26860,1400-2-27,2021-05-17
407,دماوند,توليد نيروي برق دماوند,20,141494,4142802826,30820,29279,29279,-1541,-5,30721,-99,-0.32,29279,29279,1400-2-27,2021-05-17
408,غپينو,پارس‌ مينو,19,60975,346338000,5970,5680,5680,-290,-4.86,5960,-10,-0.17,5680,5680,1400-2-27,2021-05-17
409,ستران,سيمان‌ تهران‌,19,111119,2417949440,22900,21760,21760,-1140,-4.98,22720,-180,-0.79,21760,21760,1400-2-27,2021-05-17
410,ودي,بيمه  دي,19,33022,638513392,20353,19336,19336,-1017,-5,20319,-34,-0.17,19336,19336,1400-2-27,2021-05-17
411,فزرين,زرين معدن آسيا,18,24609,621844821,26598,25269,25269,-1329,-5,26539,-59,-0.22,25269,25269,1400-2-27,2021-05-17
412,ختور,رادياتور ايران‌,18,10877,202094660,19550,18580,18580,-970,-4.96,19540,-10,-0.05,18580,18580,1400-2-27,2021-05-17
413,باران,بيمه زندگي باران50%تاديه,18,454800,1807830000,3786,3975,3975,189,4.99,3818,32,0.85,3975,3975,1400-2-27,2021-05-17
414,اخزا821,اسنادخزانه-م21بودجه98-020906,18,1933,1147952628,593100,593700,595000,1900,0.32,593871,771,0.13,593100,595100,1400-2-27,2021-05-17
415,اخزا812,اسنادخزانه-م12بودجه98-001111,17,17365,15064791748,867425,863300,867425,0,0,867538,113,0.01,863300,873000,1400-2-27,2021-05-17
416,همبين102,اختيارف ت مبين17952-01/02/10,17,318208,186788096,629,587,587,-42,-6.68,587,-42,-6.68,587,587,1400-2-27,2021-05-17
417,وبهمن,سرمايه‌گذاري‌بهمن‌,17,167848,2185380960,13700,13020,13020,-680,-4.96,13600,-100,-0.73,13020,13020,1400-2-27,2021-05-17
418,ملت,بيمه ملت,17,224710,3285260200,15380,14620,14620,-760,-4.94,15230,-150,-0.98,14620,14620,1400-2-27,2021-05-17
419,زعف0008پ16,زعفران0008نگين بيرجند(پ),17,6226,731685629,118218,118001,117500,-718,-0.61,117521,-697,-0.59,116515,118001,1400-2-27,2021-05-17
420,چكارن,كارتن‌ ايران‌,17,211007,664039029,3312,3147,3147,-165,-4.98,3304,-8,-0.24,3147,3147,1400-2-27,2021-05-17
421,شكف,كف,17,29573,2925775182,100953,98934,98934,-2019,-2,100356,-597,-0.59,98934,98934,1400-2-27,2021-05-17
422,گنجين,صندوق س. گنجينه يكم آويد-د,17,62593,803694443,12830,12833,12840,10,0.08,12840,10,0.08,12833,12845,1400-2-27,2021-05-17
423,ولانا,شركت ليزينگ آريا دانا,16,15500,550343000,36604,35506,35506,-1098,-3,36538,-66,-0.18,35506,35506,1400-2-27,2021-05-17
424,وسهرمز,شركت س استان هرمزگان,16,323557,297995997,1000,921,921,-79,-7.9,921,-79,-7.9,921,921,1400-2-27,2021-05-17
425,كبافق,معادن‌ بافق‌,16,5805,263779200,47830,45440,45440,-2390,-5,47800,-30,-0.06,45440,45440,1400-2-27,2021-05-17
426,وملي,گروه‌ صنعتي‌ ملي‌ (هلدينگ‌,15,1355,215336600,167280,158920,158920,-8360,-5,167170,-110,-0.07,158920,158920,1400-2-27,2021-05-17
427,سغرب,سيمان‌غرب‌,15,75684,2128234080,29600,28120,28120,-1480,-5,29360,-240,-0.81,28120,28120,1400-2-27,2021-05-17
428,زدشت,كشت و صنعت دشت خرم دره,15,103294,2883245422,29382,27913,27913,-1469,-5,29084,-298,-1.01,27913,27913,1400-2-27,2021-05-17
429,اخزا904,اسنادخزانه-م4بودجه99-011215,15,103952,72114501608,689079,694000,691109,2030,0.29,693729,4650,0.67,691000,694000,1400-2-27,2021-05-17
430,گدنا,تهيه توزيع غذاي دنا آفرين فدك,15,3726,119958570,33889,32195,32195,-1694,-5,33875,-14,-0.04,32195,32195,1400-2-27,2021-05-17
431,ضپاس2000,اختيارخ وپارس-2000-1400/02/29,15,223,106656000,470,500,499,29,6.17,478,8,1.7,432,540,1400-2-27,2021-05-17
432,غزر,صنعتي زر ماكارون,15,4732,111675200,24840,23600,23600,-1240,-4.99,24840,0,0,23600,23600,1400-2-27,2021-05-17
433,شاروم,پتروشيمي اروميه,15,6775,123636975,19209,18249,18249,-960,-5,19201,-8,-0.04,18249,18249,1400-2-27,2021-05-17
434,فوكا,فولاد كاويان,15,34504,373367784,11390,10821,10821,-569,-5,11382,-8,-0.07,10821,10821,1400-2-27,2021-05-17
435,كرازي,كارخانجات‌توليدي‌شيشه‌رازي‌,15,17565,371851050,22280,21170,21170,-1110,-4.98,22250,-30,-0.13,21170,21170,1400-2-27,2021-05-17
436,چفيبر,فيبر ايران‌,15,209658,2757002700,13840,13150,13150,-690,-4.99,13710,-130,-0.94,13150,13150,1400-2-27,2021-05-17
437,خكاوه,سايپا ديزل,15,114539,390577990,3589,3410,3410,-179,-4.99,3582,-7,-0.2,3410,3410,1400-2-27,2021-05-17
438,تكشا,گسترش‌صنايع‌وخدمات‌كشاورزي‌,15,5990,237862900,41800,39710,39710,-2090,-5,41760,-40,-0.1,39710,39710,1400-2-27,2021-05-17
439,تملي703,تسهيلات مسكن ب. ملي-خرداد97,14,132,74874788,541786,568875,568875,27089,5,567233,25447,4.7,514697,568875,1400-2-27,2021-05-17
440,اخزا813,اسنادخزانه-م13بودجه98-010219,14,8727,7140202894,819768,816200,819000,-768,-0.09,818174,-1594,-0.19,816103,820000,1400-2-27,2021-05-17
441,ضبدر3003,اختيارخ شبندر-4270-1400/03/30,14,126,245416000,3000,2000,1658,-1342,-44.73,1948,-1052,-35.07,1658,2000,1400-2-27,2021-05-17
442,ضخود7072,اختيارخ خودرو-1400-1400/07/07,14,286,187431000,718,700,653,-65,-9.05,655,-63,-8.77,610,783,1400-2-27,2021-05-17
443,هاي وب,داده گسترعصرنوين-هاي وب,14,16639,164060540,10370,9860,9860,-510,-4.92,10370,0,0,9860,9860,1400-2-27,2021-05-17
444,الماس,صندوق س.امين تدبيرگران فردا-س,14,1530,161434182,106856,105001,105100,-1756,-1.64,105513,-1343,-1.26,105001,107400,1400-2-27,2021-05-17
445,فجام,جام‌دارو,14,500000,4715000000,9920,9430,9430,-490,-4.94,9750,-170,-1.71,9430,9430,1400-2-27,2021-05-17
446,قاسم,قاسم ايران,14,19957,247127531,13034,12383,12383,-651,-4.99,13023,-11,-0.08,12383,12383,1400-2-27,2021-05-17
447,فاما,صنعتي‌ آما,13,14265,227098800,16750,15920,15920,-830,-4.96,16740,-10,-0.06,15920,15920,1400-2-27,2021-05-17
448,قجام,فرآوردههاي غذايي وقندتربت‌جام‌,13,300000,4161300000,14154,13871,13871,-283,-2,13900,-254,-1.79,13871,13871,1400-2-27,2021-05-17
449,اراد50,مرابحه عام دولت5-ش.خ0302,13,202000,202000030500,1000000,1000000,1000001,1,0,1000000,0,0,1000000,1000001,1400-2-27,2021-05-17
450,ضشنا8004,اختيارخ شپنا-10800-1400/08/16,13,310,308950000,1290,1000,810,-480,-37.21,997,-293,-22.71,810,1000,1400-2-27,2021-05-17
451,سفانو,سيمان فارس نو,13,6185,188766200,32120,30520,30520,-1600,-4.98,32100,-20,-0.06,30520,30520,1400-2-27,2021-05-17
452,اخزا718,اسنادخزانه-م18بودجه97-000525,13,63650,60466565029,948296,946402,950001,1705,0.18,949985,1689,0.18,946402,950110,1400-2-27,2021-05-17
453,غدشت,دشت‌ مرغاب‌,12,41668,11344946360,286590,272270,272270,-14320,-5,275140,-11450,-4,272270,272270,1400-2-27,2021-05-17
454,اخزا905,اسنادخزانه-م5بودجه99-020218,12,65791,43762963207,664605,664202,664101,-504,-0.08,665182,577,0.09,663003,666221,1400-2-27,2021-05-17
455,كمنگنز,معادن‌منگنزايران‌,12,24729,2054238030,87440,83070,83070,-4370,-5,86810,-630,-0.72,83070,83070,1400-2-27,2021-05-17
456,ولتجار,واسپاري تجارت وسرمايه ايرانيان,12,601000,4556782000,7981,7582,7582,-399,-5,7784,-197,-2.47,7582,7582,1400-2-27,2021-05-17
457,دتماد,توليدمواداوليه‌داروپخش‌,12,5293,220771030,43900,41710,41710,-2190,-4.99,43870,-30,-0.07,41710,41710,1400-2-27,2021-05-17
458,خچرخش,چرخشگر,12,7562,98154760,13660,12980,12980,-680,-4.98,13650,-10,-0.07,12980,12980,1400-2-27,2021-05-17
459,غشهداب,كشت و صنعت شهداب ناب خراسان,12,43793,163260304,3924,3728,3728,-196,-4.99,3922,-2,-0.05,3728,3728,1400-2-27,2021-05-17
460,ضشنا8001,اختيارخ شپنا-6800-1400/08/16,11,293,848351000,3840,3050,2765,-1075,-27.99,2895,-945,-24.61,2765,3050,1400-2-27,2021-05-17
461,دامين,داروسازي‌ امين‌,11,41410,204979500,5210,4950,4950,-260,-4.99,5210,0,0,4950,4950,1400-2-27,2021-05-17
462,دمعيار,صندوق س. توازن معيار-د,11,226458,2295032372,10130,10135,10134,4,0.04,10134,4,0.04,10134,10140,1400-2-27,2021-05-17
463,برن0003پ01,برنج طارم0003تجارت مازندران(پ),11,5612,1547000190,283733,280000,276000,-7733,-2.73,275659,-8074,-2.85,275000,280000,1400-2-27,2021-05-17
464,اخزا809,اسنادخزانه-م9بودجه98-000923,11,3619,3215363099,887998,888000,888492,494,0.06,888467,469,0.05,886002,889000,1400-2-27,2021-05-17
465,كوثر,بيمه كوثر,11,112709,1568683862,14650,13918,13918,-732,-5,14618,-32,-0.22,13918,13918,1400-2-27,2021-05-17
466,وآرين,شركت توسعه اقتصادي آرين,11,20454,68827710,3469,3365,3365,-104,-3,3468,-1,-0.03,3365,3365,1400-2-27,2021-05-17
467,دسبحان,سبحان دارو,11,45113,766018740,17870,16980,16980,-890,-4.98,17820,-50,-0.28,16980,16980,1400-2-27,2021-05-17
468,ثروتم,صندوق س. ثروت آفرين پارسيان-س,11,24380,1808076720,75866,74859,73800,-2066,-2.72,74162,-1704,-2.25,73800,74859,1400-2-27,2021-05-17
469,اخزا811,اسنادخزانه-م11بودجه98-001013,11,17492,15340994965,876458,877000,877500,1042,0.12,877029,571,0.07,877000,877500,1400-2-27,2021-05-17
470,رافزا,رايان هم افزا,11,813,82215438,106448,101126,101126,-5322,-5,106417,-31,-0.03,101126,101126,1400-2-27,2021-05-17
471,كهمدا,شيشه‌ همدان‌,10,41441,392860680,9970,9480,9480,-490,-4.91,9960,-10,-0.1,9480,9480,1400-2-27,2021-05-17
472,سبجنو,سيمان‌ بجنورد,10,21430,871772400,42820,40680,40680,-2140,-5,42640,-180,-0.42,40680,40680,1400-2-27,2021-05-17
473,ضملي7004,اختيارخ فملي-13720-1400/07/11,10,42,59032000,1560,1260,1250,-310,-19.87,1406,-154,-9.87,1250,1590,1400-2-27,2021-05-17
474,لسرما,سرما آفرين‌,10,5522,119496080,22770,21640,21640,-1130,-4.96,22760,-10,-0.04,21640,21640,1400-2-27,2021-05-17
475,فلات,گروه صنايع معادن فلات ايرانيان,10,210000,3136140000,15395,14934,14934,-461,-2.99,15244,-151,-0.98,14934,14934,1400-2-27,2021-05-17
476,اخزا807,اسنادخزانه-م7بودجه98-000719,10,13940,12813830616,918445,919011,920313,1868,0.2,919213,768,0.08,919010,927000,1400-2-27,2021-05-17
477,دتوليد,داروسازي توليد دارو,10,25803,648145557,26441,25119,25119,-1322,-5,26381,-60,-0.23,25119,25119,1400-2-27,2021-05-17
478,سمگا,گروه سرمايه گذاري ميراث فرهنگي,10,6686,181692050,28605,27175,27175,-1430,-5,28600,-5,-0.02,27175,27175,1400-2-27,2021-05-17
479,اخزا720,اسنادخزانه-م20بودجه97-000324,10,25721,25360013189,984410,986020,985953,1543,0.16,985965,1555,0.16,985953,986020,1400-2-27,2021-05-17
480,سبهان,سيمان‌ بهبهان‌,10,12701,1713491910,142010,134910,134910,-7100,-5,141160,-850,-0.6,134910,134910,1400-2-27,2021-05-17
481,ضملي7002,اختيارخ فملي-9720-1400/07/11,9,41,156400000,4003,3800,3600,-403,-10.07,3815,-188,-4.7,3600,4000,1400-2-27,2021-05-17
482,طشنا2008,اختيارف شپنا-28000-1400/02/27,9,900,16110000000,17300,17900,17900,600,3.47,17900,600,3.47,17900,17900,1400-2-27,2021-05-17
483,اعتلا,شركت سرمايه گذاري اعتلاء البرز,9,24650,168852500,7210,6850,6850,-360,-4.99,7206,-4,-0.06,6850,6850,1400-2-27,2021-05-17
484,ضشنا2002,اختيارخ شپنا-12000-1400/02/27,9,450,450000,1,1,1,0,0,1,0,0,1,1,1400-2-27,2021-05-17
485,ضشنا2010,اختيارخ شپنا-8000-1400/02/27,9,147,288886000,3900,2001,1860,-2040,-52.31,1965,-1935,-49.62,1860,2001,1400-2-27,2021-05-17
486,اخزا723,اسنادخزانه-م23بودجه97-000824,9,8045,7253147158,899603,900601,902957,3354,0.37,901572,1969,0.22,900601,902957,1400-2-27,2021-05-17
487,خبازرس,بازرسي مهندسي و صنعتي ايران,9,34043,846036636,25620,24852,24852,-768,-3,25552,-68,-0.27,24852,24852,1400-2-27,2021-05-17
488,ضپاس7029,اختيارخ وپارس-2500-1400/07/28,9,55,14053000,287,290,255,-32,-11.15,256,-31,-10.8,225,290,1400-2-27,2021-05-17
489,لپارس,پارس‌ الكتريك‌,9,2521,216982470,90600,86070,86070,-4530,-5,90530,-70,-0.08,86070,86070,1400-2-27,2021-05-17
490,اخزا810,اسنادخزانه-م10بودجه98-001006,9,13193,11630402532,881591,877000,882082,491,0.06,881559,-32,0,877000,885799,1400-2-27,2021-05-17
491,سخند,صندوق س.سپهرخبرگان نفت-د,8,59460,594843810,10014,10002,10004,-10,-0.1,10004,-10,-0.1,10002,10005,1400-2-27,2021-05-17
492,آوا2,صندوق س.سهام آواي معيار-س,8,4600000,4600000,6699,1,1,-6698,-99.99,1,-6698,-99.99,1,1,1400-2-27,2021-05-17
493,غمينو,شركت صنايع غذايي مينو شرق,8,8312,78465280,9936,9440,9440,-496,-4.99,9933,-3,-0.03,9440,9440,1400-2-27,2021-05-17
494,غشهد,شهد ايران ‌,8,328283,2199496100,7050,6700,6700,-350,-4.96,6990,-60,-0.85,6700,6700,1400-2-27,2021-05-17
495,وسرمد,بيمه  سرمد,8,16347,96512688,6214,5904,5904,-310,-4.99,6211,-3,-0.05,5904,5904,1400-2-27,2021-05-17
496,ضخود7073,اختيارخ خودرو-1600-1400/07/07,8,247,112872000,534,536,435,-99,-18.54,457,-77,-14.42,433,536,1400-2-27,2021-05-17
497,قصفها,قنداصفهان‌,8,1103,163519750,156050,148250,148250,-7800,-5,155960,-90,-0.06,148250,148250,1400-2-27,2021-05-17
498,ولبهمن,شركت بهمن ليزينگ,8,139240,941540880,7117,6762,6762,-355,-4.99,7092,-25,-0.35,6762,6762,1400-2-27,2021-05-17
499,قشكر,شكرشاهرود,8,15719,55833888,3738,3552,3552,-186,-4.98,3737,-1,-0.03,3552,3552,1400-2-27,2021-05-17
500,سيمرغ,سيمرغ,8,4645,80497850,18240,17330,17330,-910,-4.99,18230,-10,-0.05,17330,17330,1400-2-27,2021-05-17
501,زعف0008پ19,زعفران0008نگين تروند قاينات(پ),7,1690,202424000,118954,119990,117500,-1454,-1.22,119778,824,0.69,117500,119990,1400-2-27,2021-05-17
502,بزاگرس,نيروگاه زاگرس كوثر,7,8236,55922440,7147,6790,6790,-357,-5,7146,-1,-0.01,6790,6790,1400-2-27,2021-05-17
503,شتوكا,توكا رنگ فولاد سپاهان,7,3817,177543938,48962,46514,46514,-2448,-5,48930,-32,-0.07,46514,46514,1400-2-27,2021-05-17
504,غويتا,ويتانا,7,2870,48959330,17956,17059,17059,-897,-5,17954,-2,-0.01,17059,17059,1400-2-27,2021-05-17
505,بذر,صندوق س بذر اميد آفرين-سهام,7,1185,108227300,91970,91500,91600,-370,-0.4,91330,-640,-0.7,90110,92300,1400-2-27,2021-05-17
506,لكما,كارخانجات‌مخابراتي‌ايران‌,7,28121,162933074,6098,5794,5794,-304,-4.99,6093,-5,-0.08,5794,5794,1400-2-27,2021-05-17
507,اخزا816,اسنادخزانه-م16بودجه98-010503,7,11686,9144106026,782561,780000,783001,440,0.06,782484,-77,-0.01,780000,784900,1400-2-27,2021-05-17
508,بمپنا,توليد برق عسلويه  مپنا,7,2062,135537322,69190,65731,65731,-3459,-5,69166,-24,-0.03,65731,65731,1400-2-27,2021-05-17
509,قثابت,قند ثابت‌ خراسان‌,7,6721,387667280,60710,57680,57680,-3030,-4.99,60620,-90,-0.15,57680,57680,1400-2-27,2021-05-17
510,ثرود,سرمايه‌گذاري مسكن زاينده رود,7,28935,577311120,21002,19952,19952,-1050,-5,20959,-43,-0.2,19952,19952,1400-2-27,2021-05-17
511,اميد,تامين سرمايه اميد,7,33302,241772520,7640,7260,7260,-380,-4.97,7640,0,0,7260,7260,1400-2-27,2021-05-17
512,اخزا716,اسنادخزانه-م16بودجه97-000407,7,1996,1948892206,978028,977000,976001,-2027,-0.21,976399,-1629,-0.17,975030,977000,1400-2-27,2021-05-17
513,ضفلا3004,اختيارخ فولاد-8560-1400/03/19,7,18,18067000,1421,1000,996,-425,-29.91,1004,-417,-29.35,996,1100,1400-2-27,2021-05-17
514,رتكو,كنترل‌خوردگي‌تكين‌كو,7,151619,2533553490,17580,16710,16710,-870,-4.95,17420,-160,-0.91,16710,16710,1400-2-27,2021-05-17
515,كسرا,سراميك‌هاي‌صنعتي‌اردكان‌,7,8671,158679300,19260,18300,18300,-960,-4.98,19250,-10,-0.05,18300,18300,1400-2-27,2021-05-17
516,پكوير,كوير تاير,7,67503,814761210,12700,12070,12070,-630,-4.96,12660,-40,-0.31,12070,12070,1400-2-27,2021-05-17
517,اخزا818,اسنادخزانه-م18بودجه98-010614,7,2588,1977436100,763963,766000,764000,37,0,764079,116,0.02,764000,766000,1400-2-27,2021-05-17
518,ساذري,آذريت‌,7,11319,68479950,5874,6050,6050,176,3,5875,1,0.02,6050,6050,1400-2-27,2021-05-17
519,خشرق,الكتريك‌ خودرو شرق‌,6,3782,53477480,14880,14140,14140,-740,-4.97,14880,0,0,14140,14140,1400-2-27,2021-05-17
520,نطرين,عطرين نخ قم,6,18161,207344137,12017,11417,11417,-600,-4.99,12008,-9,-0.07,11417,11417,1400-2-27,2021-05-17
521,ثنور,سرمايه گذاري كوه نور,6,63405,589539690,9585,9298,9298,-287,-2.99,9567,-18,-0.19,9298,9298,1400-2-27,2021-05-17
522,لابسا,آبسال‌,6,2751,129434550,49520,47050,47050,-2470,-4.99,49500,-20,-0.04,47050,47050,1400-2-27,2021-05-17
523,لخزر,پارس‌ خزر,6,2884,510785240,186430,177110,177110,-9320,-5,186100,-330,-0.18,177110,177110,1400-2-27,2021-05-17
524,كگاز,شيشه‌ و گاز,6,2776,49496080,18760,17830,17830,-930,-4.96,18760,0,0,17830,17830,1400-2-27,2021-05-17
525,كمينا,شيشه سازي مينا,6,2649,63019710,25042,23790,23790,-1252,-5,25034,-8,-0.03,23790,23790,1400-2-27,2021-05-17
526,زبينا,كشاورزي و دامپروري بينالود,6,13476,49982484,3904,3709,3709,-195,-4.99,3903,-1,-0.03,3709,3709,1400-2-27,2021-05-17
527,ديران,ايران‌دارو,6,6846,112822080,17340,16480,16480,-860,-4.96,17330,-10,-0.06,16480,16480,1400-2-27,2021-05-17
528,وپخش,داروپخش‌ (هلدينگ‌,6,356,33930360,100320,95310,95310,-5010,-4.99,100310,-10,-0.01,95310,95310,1400-2-27,2021-05-17
529,زفكا,كشت و دامداري فكا,6,12117,145331298,12625,11994,11994,-631,-5,12619,-6,-0.05,11994,11994,1400-2-27,2021-05-17
530,پست0008پ08,پسته فندقي32-30مه ولات0008(پ),6,67,106905268,1668330,1601746,1595000,-73330,-4.4,1595601,-72729,-4.36,1595000,1601746,1400-2-27,2021-05-17
531,وآوا,سرمايه گذاري آوا نوين,6,1382,11665462,8885,8441,8441,-444,-5,8885,0,0,8441,8441,1400-2-27,2021-05-17
532,زشگزا,شير و گوشت زاگرس شهركرد,6,6592,51391232,8206,7796,7796,-410,-5,8205,-1,-0.01,7796,7796,1400-2-27,2021-05-17
533,سهگمت,سيمان‌هگمتان‌,6,16034,377119680,24750,23520,23520,-1230,-4.97,24720,-30,-0.12,23520,23520,1400-2-27,2021-05-17
534,اخزا721,اسنادخزانه-م21بودجه97-000728,6,6165,5637245141,915393,914220,915845,452,0.05,914395,-998,-0.11,914220,915845,1400-2-27,2021-05-17
535,كيسون,شركت كيسون,6,18819,207046638,11460,11002,11002,-458,-4,11456,-4,-0.03,11002,11002,1400-2-27,2021-05-17
536,ضسپا3000,اختيارخ خساپا-1400-1400/03/26,6,212,90100000,590,400,420,-170,-28.81,425,-165,-27.97,400,599,1400-2-27,2021-05-17
537,رنيك,جنرال مكانيك,6,2328,49267464,22276,21163,21163,-1113,-5,22272,-4,-0.02,21163,21163,1400-2-27,2021-05-17
538,ضملي3000,اختيارخ فملي-8000-1400/03/02,6,50,215000000,4459,4300,4300,-159,-3.57,4300,-159,-3.57,4300,4300,1400-2-27,2021-05-17
539,شپاس,نفت پاسارگاد,6,103841,2086581054,21151,20094,20094,-1057,-5,21037,-114,-0.54,20094,20094,1400-2-27,2021-05-17
540,كيميا,معدني كيمياي زنجان گستران,6,5132,85637684,17565,16687,16687,-878,-5,17560,-5,-0.03,16687,16687,1400-2-27,2021-05-17
541,ضصاد3001,اختيارخ وبصادر-2000-1400/03/12,5,142,26500000,229,100,190,-39,-17.03,187,-42,-18.34,100,195,1400-2-27,2021-05-17
542,ضملي3002,اختيارخ فملي-10000-1400/03/02,5,114,282200000,2958,2500,2300,-658,-22.24,2475,-483,-16.33,2300,2500,1400-2-27,2021-05-17
543,خرينگ,رينگ‌سازي‌مشهد,5,1853,89592550,50890,48350,48350,-2540,-4.99,50870,-20,-0.04,48350,48350,1400-2-27,2021-05-17
544,فلوله,لوله‌وماشين‌سازي‌ايران‌,5,1666,34886040,22040,20940,20940,-1100,-4.99,22040,0,0,20940,20940,1400-2-27,2021-05-17
545,دسبحا,گروه دارويي سبحان,5,28270,500944400,18650,17720,17720,-930,-4.99,18630,-20,-0.11,17720,17720,1400-2-27,2021-05-17
546,سمايه,بانك سرمايه,5,9111,43915020,4969,4820,4820,-149,-3,4968,-1,-0.02,4820,4820,1400-2-27,2021-05-17
547,زشريف,كشت وصنعت شريف آباد,5,8711,43049762,5202,4942,4942,-260,-5,5201,-1,-0.02,4942,4942,1400-2-27,2021-05-17
548,زير0003پ01,زيره سبز0003كيميابذر(پ),5,129,68993637,546319,526000,570000,23681,4.33,534834,-11485,-2.1,520011,573713,1400-2-27,2021-05-17
549,اراد33,مرابحه عام دولت3-ش.خ 0303,5,5100,4453955000,875000,899930,884000,9000,1.03,873324,-1676,-0.19,860010,899930,1400-2-27,2021-05-17
550,حتوكا,حمل‌ونقل‌توكا,5,1335,27180600,21430,20360,20360,-1070,-4.99,21430,0,0,20360,20360,1400-2-27,2021-05-17
551,بنيرو,نيروترانس‌,5,3360,47947200,15020,14270,14270,-750,-4.99,15020,0,0,14270,14270,1400-2-27,2021-05-17
552,خمهر,مهركام‌پارس‌,5,21334,45761430,2257,2145,2145,-112,-4.96,2257,0,0,2145,2145,1400-2-27,2021-05-17
553,فسا,پتروشيمي فسا,5,269725,463117825,1770,1717,1717,-53,-2.99,1767,-3,-0.17,1717,1717,1400-2-27,2021-05-17
554,تكنو,تكنوتار,5,50490,1043123400,21740,20660,20660,-1080,-4.97,21660,-80,-0.37,20660,20660,1400-2-27,2021-05-17
555,ضپاس7028,اختيارخ وپارس-2000-1400/07/28,5,45,29240000,678,699,650,-28,-4.13,650,-28,-4.13,560,699,1400-2-27,2021-05-17
556,خعمرا,توسعه و عمران شهرستان نائين,5,3527,84482231,22813,23953,23953,1140,5,22822,9,0.04,23953,23953,1400-2-27,2021-05-17
557,خپويش,سازه‌ پويش‌,5,12128,695055680,60320,57310,57310,-3010,-4.99,60170,-150,-0.25,57310,57310,1400-2-27,2021-05-17
558,زگلدشت,كشت و دام گلدشت نمونه اصفهان,5,3794,50095976,13898,13204,13204,-694,-4.99,13896,-2,-0.01,13204,13204,1400-2-27,2021-05-17
559,نگين,ص.س. زمين و ساختمان نگين شهرري,5,547,26090960,47540,47540,47540,0,0,47700,160,0.34,47540,48320,1400-2-27,2021-05-17
560,داسوه,داروسازي‌ اسوه‌,5,5637,197351370,36850,35010,35010,-1840,-4.99,36820,-30,-0.08,35010,35010,1400-2-27,2021-05-17
561,فافزا,فولاد افزا سپاهان,5,1399,64945777,47858,46423,46423,-1435,-3,47848,-10,-0.02,46423,46423,1400-2-27,2021-05-17
562,اراد314,مرابحه عام دولت3-ش.خ 0208,5,17270000,15452343542000,950000,897115,875797,-74203,-7.81,894751,-55249,-5.82,862911,898600,1400-2-27,2021-05-17
563,اخزا806,اسنادخزانه-م6بودجه98-000519,5,1729,1646808200,952050,952050,953999,1949,0.2,952463,413,0.04,952050,953999,1400-2-27,2021-05-17
564,كپشير,پشم‌شيشه‌ايران‌,4,2000,75960000,39970,37980,37980,-1990,-4.98,39960,-10,-0.03,37980,37980,1400-2-27,2021-05-17
565,تبرك,گروه كارخانجات صنعتي تبرك,4,2074,38972534,19779,18791,18791,-988,-5,19777,-2,-0.01,18791,18791,1400-2-27,2021-05-17
566,لخانه,لوازم‌ خانگي‌ پارس‌,4,50500,1333301000,27791,26402,26402,-1389,-5,27596,-195,-0.7,26402,26402,1400-2-27,2021-05-17
567,صپاخرداد,بار پايه صنعتي خرداد,4,29100,19788000,660,680,680,20,3.03,680,20,3.03,680,680,1400-2-27,2021-05-17
568,وسفارس,شركت س استان فارس,4,66418,65023222,1030,979,979,-51,-4.95,1030,0,0,979,979,1400-2-27,2021-05-17
569,وسصفا,شركت س استان اصفهان,4,22300,22679100,1070,1017,1017,-53,-4.95,1070,0,0,1017,1017,1400-2-27,2021-05-17
570,وايرا,سرمايه گذاري صنايع ايران,4,1852,21455420,12194,11585,11585,-609,-4.99,12193,-1,-0.01,11585,11585,1400-2-27,2021-05-17
571,بالاس,مهندسي ساختمان تاسيسات راه آهن,4,1242,67964724,57602,54722,54722,-2880,-5,57588,-14,-0.02,54722,54722,1400-2-27,2021-05-17
572,اخزا722,اسنادخزانه-م22بودجه97-000428,4,1069,1029671983,964500,965202,968000,3500,0.36,963210,-1290,-0.13,963001,968000,1400-2-27,2021-05-17
573,حريل,ريل پردازسير,4,49143,256723032,5498,5224,5224,-274,-4.98,5493,-5,-0.09,5224,5224,1400-2-27,2021-05-17
574,غگلپا,شير پاستوريزه پگاه گلپايگان,4,702,43748640,65600,62320,62320,-3280,-5,65590,-10,-0.02,62320,62320,1400-2-27,2021-05-17
575,كساوه,صنايع‌ كاشي‌ و سراميك‌ سينا,4,3594,240690180,70490,66970,66970,-3520,-4.99,70430,-60,-0.09,66970,66970,1400-2-27,2021-05-17
576,عيار2,صندوق سكه طلاي مفيد,4,40000,40000,26128,1,1,-26127,-100,1,-26127,-100,1,1,1400-2-27,2021-05-17
577,دروز,داروسازي‌ روزدارو,4,6724,204947520,32080,30480,30480,-1600,-4.99,32050,-30,-0.09,30480,30480,1400-2-27,2021-05-17
578,غنوش,نوش‌ مازندران‌,4,408,21844320,56350,53540,53540,-2810,-4.99,56350,0,0,53540,53540,1400-2-27,2021-05-17
579,تملي805,تسهيلات مسكن ب. ملي-مرداد98,4,86,60984320,675353,709120,709120,33767,5,709120,33767,5,709120,709120,1400-2-27,2021-05-17
580,دلقما,دارويي‌ لقمان‌,4,2035,49938900,25830,24540,24540,-1290,-4.99,25830,0,0,24540,24540,1400-2-27,2021-05-17
581,شسينا,صنايع‌شيميايي‌سينا,4,277,34760730,132090,125490,125490,-6600,-5,132070,-20,-0.02,125490,125490,1400-2-27,2021-05-17
582,كحافظ,كاشي‌ وسراميك‌ حافظ‌,4,2334,26537580,11960,11370,11370,-590,-4.93,11960,0,0,11370,11370,1400-2-27,2021-05-17
583,اراد644,مرابحه عام دولتي64-ش.خ0111,4,25579727,24114341642900,944500,942821,942600,-1900,-0.2,942713,-1787,-0.19,942600,942821,1400-2-27,2021-05-17
584,غشان,شيرپاستوريزه‌پگاه‌خراسان‌,4,3390,23492700,7290,6930,6930,-360,-4.94,7290,0,0,6930,6930,1400-2-27,2021-05-17
585,اراد594,مرابحه عام دولتي5-ش.خ 0309,3,19000000,17761019500000,1000000,934874,934707,-65293,-6.53,934790,-65210,-6.52,934707,934874,1400-2-27,2021-05-17
586,ضغدر8055,اختيارخ وغدير-7000-1400/08/26,3,24,94800000,1,3950,3950,3949,394900,3950,3949,394900,3950,3950,1400-2-27,2021-05-17
587,شكربن,كربن‌ ايران‌,3,50000,3833500000,80700,76670,76670,-4030,-4.99,79570,-1130,-1.4,76670,76670,1400-2-27,2021-05-17
588,ضفار3001,اختيارخ فارس-9000-1400/03/05,3,12,4200000,481,350,350,-131,-27.23,350,-131,-27.23,350,350,1400-2-27,2021-05-17
589,ضغدر3001,اختيارخ وغدير-7200-1400/03/26,3,9,23850000,3225,2650,2650,-575,-17.83,2650,-575,-17.83,2650,2650,1400-2-27,2021-05-17
590,جهرم,پتروشيمي جهرم,3,25143,43245960,1773,1720,1720,-53,-2.99,1773,0,0,1720,1720,1400-2-27,2021-05-17
591,ضسپا8039,اختيارخ خساپا-1200-1400/08/26,3,22,17700000,900,815,700,-200,-22.22,805,-95,-10.56,700,815,1400-2-27,2021-05-17
592,زكوثر,سرمايه گذاري كشاورزي كوثر,3,3044,60819120,21030,19980,19980,-1050,-4.99,21030,0,0,19980,19980,1400-2-27,2021-05-17
593,ضمخا7070,اختيارخ اخابر-19700-1400/07/28,3,7,1422000,237,204,200,-37,-15.61,203,-34,-14.35,200,204,1400-2-27,2021-05-17
594,حآسا,آسيا سير ارس,3,2314,88082410,40068,38065,38065,-2003,-5,40056,-12,-0.03,38065,38065,1400-2-27,2021-05-17
595,گكيش,توريستي ورفاهي آبادگران كيش,3,3867,181582719,48409,46957,46957,-1452,-3,48382,-27,-0.06,46957,46957,1400-2-27,2021-05-17
596,شگل,گلتاش‌,3,1625,15535000,10060,9560,9560,-500,-4.97,10060,0,0,9560,9560,1400-2-27,2021-05-17
597,ضفلا7002,اختيارخ فولاد-6733-1400/07/25,3,35,135100000,3995,3800,4000,5,0.13,3860,-135,-3.38,3800,4000,1400-2-27,2021-05-17
598,ضسپا3001,اختيارخ خساپا-1600-1400/03/26,3,114,45002000,412,400,281,-131,-31.8,395,-17,-4.13,281,400,1400-2-27,2021-05-17
599,مرقام,ايران‌ارقام‌,3,3482,64277720,19430,18460,18460,-970,-4.99,19430,0,0,18460,18460,1400-2-27,2021-05-17
600,سيلام,سيمان‌ ايلام‌,3,1050,11014500,11040,10490,10490,-550,-4.98,11040,0,0,10490,10490,1400-2-27,2021-05-17
601,قزوين,كارخانجات‌ قند قزوين‌,3,608,22860800,39570,37600,37600,-1970,-4.98,39570,0,0,37600,37600,1400-2-27,2021-05-17
602,وآذر,سرمايه‌گذاري‌توسعه‌آذربايجان‌,3,1543,120523730,82220,78110,78110,-4110,-5,82180,-40,-0.05,78110,78110,1400-2-27,2021-05-17
603,كپارس,كاشي‌ پارس‌,3,637,90122760,148920,141480,141480,-7440,-5,148870,-50,-0.03,141480,141480,1400-2-27,2021-05-17
604,ومعلم,بيمه معلم,3,5000,23610000,4970,4722,4722,-248,-4.99,4970,0,0,4722,4722,1400-2-27,2021-05-17
605,پخش,پخش البرز,3,10400,308048000,31178,29620,29620,-1558,-5,31144,-34,-0.11,29620,29620,1400-2-27,2021-05-17
606,داريك,صندوق س.اعتماد داريك-د,3,1491,15779744,10582,10584,10583,1,0.01,10583,1,0.01,10583,10584,1400-2-27,2021-05-17
607,فكمند,گسترش قطعه سازي كمند,3,83670,1021861710,12336,12213,12213,-123,-1,12285,-51,-0.41,12213,12213,1400-2-27,2021-05-17
608,دتوزيعح,ح . توزيع دارو پخش,3,742,28870760,40821,39100,38780,-2041,-5,38909,-1912,-4.68,38780,39100,1400-2-27,2021-05-17
609,وهنر,گروه توسعه هنر ايران,3,80843,643591123,8207,7961,7961,-246,-3,8191,-16,-0.19,7961,7961,1400-2-27,2021-05-17
610,شسم,توليد سموم‌ علف‌ كش,3,847,79376605,91878,93715,93715,1837,2,91906,28,0.03,93715,93715,1400-2-27,2021-05-17
611,ضمخا7066,اختيارخ اخابر-11700-1400/07/28,3,21,13760000,471,840,452,-19,-4.03,655,184,39.07,452,840,1400-2-27,2021-05-17
612,افران2,صندوق س افرا نماد پايدار-ثابت,3,2800000,2800000,13321,1,1,-13320,-99.99,1,-13320,-99.99,1,1,1400-2-27,2021-05-17
613,ضصاد3002,اختيارخ وبصادر-2500-1400/03/12,3,65,1300000,50,20,20,-30,-60,20,-30,-60,20,20,1400-2-27,2021-05-17
614,ضمخا7076,اختيارخ اخابر-9700-1400/07/28,3,5,3420000,621,720,650,29,4.67,684,63,10.14,650,720,1400-2-27,2021-05-17
615,ضملي3001,اختيارخ فملي-9000-1400/03/02,3,13,35200000,4123,3000,1200,-2923,-70.89,2708,-1415,-34.32,1200,3000,1400-2-27,2021-05-17
616,خكار,ايركا پارت صنعت,3,1683,35023230,21900,20810,20810,-1090,-4.98,21900,0,0,20810,20810,1400-2-27,2021-05-17
617,خفناور,مهندسي صنعتي روان فن آور,2,624,29280576,48375,46924,46924,-1451,-3,48371,-4,-0.01,46924,46924,1400-2-27,2021-05-17
618,زعف0008پ20,زعفران0008نگين وحدت جام(پ),2,1160,135800000,117748,117000,117500,-248,-0.21,117069,-679,-0.58,117000,117500,1400-2-27,2021-05-17
619,تملي702,تسهيلات مسكن ب. ملي-ارديبهشت97,2,32,13039968,428946,407499,407499,-21447,-5,407499,-21447,-5,407499,407499,1400-2-27,2021-05-17
620,افرا,افرانت,2,2800,91148400,34266,32553,32553,-1713,-5,34255,-11,-0.03,32553,32553,1400-2-27,2021-05-17
621,تپكو,توليدتجهيزات‌سنگين‌هپكو,2,3000,15906000,5410,5302,5302,-108,-2,5410,0,0,5302,5302,1400-2-27,2021-05-17
622,وسقم,شركت س استان قم,2,10741,14392940,1410,1340,1340,-70,-4.96,1410,0,0,1340,1340,1400-2-27,2021-05-17
623,پاخرداد,بار پايه خرداد,2,61000,39860000,550,680,650,100,18.18,653,103,18.73,650,680,1400-2-27,2021-05-17
624,دقاضي,داروسازي شهيد قاضي,2,283,11871850,43247,41950,41950,-1297,-3,43246,-1,0,41950,41950,1400-2-27,2021-05-17
625,اپرداز,آتيه داده پرداز,2,7600,153527600,21264,20201,20201,-1063,-5,21253,-11,-0.05,20201,20201,1400-2-27,2021-05-17
626,قنيشا,قند  نيشابور,2,5000,305850000,64380,61170,61170,-3210,-4.99,64310,-70,-0.11,61170,61170,1400-2-27,2021-05-17
627,كتوكا,توليدي و خدمات صنايع نسوز توكا,2,366,11926110,34300,32585,32585,-1715,-5,34299,-1,0,32585,32585,1400-2-27,2021-05-17
628,اراد214,مرابحه عام دولت2ش.خ صادرات0212,2,27900000,26395616500000,1000000,946135,946010,-53990,-5.4,946079,-53921,-5.39,946010,946135,1400-2-27,2021-05-17
629,شپارس,بين‌ المللي‌ محصولات‌  پارس‌,2,5947,125243820,22160,21060,21060,-1100,-4.96,22150,-10,-0.05,21060,21060,1400-2-27,2021-05-17
630,وصندوق2,سرمايه‌گذاري‌صندوق‌بازنشستگي‌,2,11498258,156280768780,13950,13910,13300,-650,-4.66,13592,-358,-2.57,13300,13910,1400-2-27,2021-05-17
631,كي بي سي,شركت كي بي سي,2,408,10036800,25894,24600,24600,-1294,-5,25893,-1,0,24600,24600,1400-2-27,2021-05-17
632,غصينو,صنعتي مينو,2,170,10817270,66980,63631,63631,-3349,-5,66980,0,0,63631,63631,1400-2-27,2021-05-17
633,زقيام,كشت و دام قيام اصفهان,2,370,10105810,28750,27313,27313,-1437,-5,28749,-1,0,27313,27313,1400-2-27,2021-05-17
634,اراد65,مرابحه عام دولتي65-ش.خ0210,2,1500,1453999000,954828,968000,969999,15171,1.59,969333,14505,1.52,968000,969999,1400-2-27,2021-05-17
635,ضمخا7069,اختيارخ اخابر-17700-1400/07/28,2,3,606000,203,203,200,-3,-1.48,202,-1,-0.49,200,203,1400-2-27,2021-05-17
636,تابان042,اجاره تابان سپهر14031126,2,2000000,2003142000000,1010000,1003142,1000000,-10000,-0.99,1001571,-8429,-0.83,1000000,1003142,1400-2-27,2021-05-17
637,دتوزيع,توزيع دارو پخش,2,799,36955348,48686,46252,46252,-2434,-5,48682,-4,-0.01,46252,46252,1400-2-27,2021-05-17
638,ثقزوي,شركت عمران و سازندگي قزوين,2,900,27781200,31822,30868,30868,-954,-3,31819,-3,-0.01,30868,30868,1400-2-27,2021-05-17
639,اراد494,مرابحه عام دولت4-ش.خ 0206,2,21424000,20102739072000,1009900,938356,938300,-71600,-7.09,938328,-71572,-7.09,938300,938356,1400-2-27,2021-05-17
640,اراد554,مرابحه عام دولت5-ش.خ 0209,2,10763597,9157251267775,962501,854035,847470,-115031,-11.95,850761,-111740,-11.61,847470,854035,1400-2-27,2021-05-17
641,اراد704,مرابحه عام دولت70-ش.خ0112,2,34228000,32170897200000,943750,940000,939800,-3950,-0.42,939900,-3850,-0.41,939800,940000,1400-2-27,2021-05-17
642,نوآور4,ص.اعتبارسرمايه نوآفرين70%تاديه,2,39890,13961500000,342500,350000,350000,7500,2.19,350000,7500,2.19,350000,350000,1400-2-27,2021-05-17
643,اراد544,مرابحه عام دولت5-ش.خ 0109,2,15571000,14777481630000,1015000,949530,948000,-67000,-6.6,949039,-65961,-6.5,948000,949530,1400-2-27,2021-05-17
644,كطبس,ذغال‌سنگ‌ نگين‌ ط‌بس‌,2,102,7912140,81650,77570,77570,-4080,-5,81650,0,0,77570,77570,1400-2-27,2021-05-17
645,غديس,پاكديس,2,3140,40050700,13426,12755,12755,-671,-5,13424,-2,-0.01,12755,12755,1400-2-27,2021-05-17
646,اراد604,مرابحه عام دولتي6-ش.خ0210,2,6600000,6137782200000,947000,929234,930700,-16300,-1.72,929967,-17033,-1.8,929234,930700,1400-2-27,2021-05-17
647,كلر,كلر پارس,2,342,42159024,129760,123272,123272,-6488,-5,129743,-17,-0.01,123272,123272,1400-2-27,2021-05-17
648,وسخوز,شركت س استان خوزستان,2,16500,15213000,970,922,922,-48,-4.95,970,0,0,922,922,1400-2-27,2021-05-17
649,ثشرق,سرمايه گذاري مسكن شمال شرق,2,13418,87887900,6890,6550,6550,-340,-4.93,6890,0,0,6550,6550,1400-2-27,2021-05-17
650,ضجار7039,اختيارخ وتجارت-1997-1400/07/21,2,3,1550000,585,530,510,-75,-12.82,517,-68,-11.62,510,530,1400-2-27,2021-05-17
651,ضخود4000,اختيارخ خودرو-1400-1400/04/02,2,26,18980000,737,730,730,-7,-0.95,730,-7,-0.95,730,730,1400-2-27,2021-05-17
652,ساروم,سيمان‌اروميه‌,2,300,10101000,35440,33670,33670,-1770,-4.99,35440,0,0,33670,33670,1400-2-27,2021-05-17
653,خلنت,لنت‌ ترمزايران‌,2,226,13166760,61320,58260,58260,-3060,-4.99,61320,0,0,58260,58260,1400-2-27,2021-05-17
654,غبهنوش,بهنوش‌ ايران‌,2,174,11802420,71400,67830,67830,-3570,-5,71400,0,0,67830,67830,1400-2-27,2021-05-17
655,غفارس,شير پاستوريزه پگاه فارس,2,14689,255456399,18306,17391,17391,-915,-5,18290,-16,-0.09,17391,17391,1400-2-27,2021-05-17
656,آينده,بازرگاني آينده سازان بهشت پارس,2,532,10034584,19854,18862,18862,-992,-5,19853,-1,-0.01,18862,18862,1400-2-27,2021-05-17
657,وسمركز,شركت س استان مركزي,2,6166,8200780,1400,1330,1330,-70,-5,1400,0,0,1330,1330,1400-2-27,2021-05-17
658,بايكا,كارخانجات كابلسازي ‌ايران‌,2,250,10133250,41786,40533,40533,-1253,-3,41785,-1,0,40533,40533,1400-2-27,2021-05-17
659,زعف0008پ18,زعفران0008نگين بهرامن(پ),2,150,17490000,129618,116600,116600,-13018,-10.04,116600,-13018,-10.04,116600,116600,1400-2-27,2021-05-17
660,فلامي,لاميران‌,2,1049,44645440,44790,42560,42560,-2230,-4.98,44780,-10,-0.02,42560,42560,1400-2-27,2021-05-17
661,وليز,ليزينگ‌ايران‌,2,4600,41722000,9540,9070,9070,-470,-4.93,9540,0,0,9070,9070,1400-2-27,2021-05-17
662,فسديد,لوله‌وتجهيزات‌ سديد - ورشكسته,2,1560,172372200,112749,110495,110495,-2254,-2,112659,-90,-0.08,110495,110495,1400-2-27,2021-05-17
663,ضشنا8000,اختيارخ شپنا-5800-1400/08/16,2,21,83840000,3044,4000,3840,796,26.15,3992,948,31.14,3710,4000,1400-2-27,2021-05-17
664,ثنظام,س. ساختماني نظام مهندسي ايران,2,110,5060990,47431,46009,46009,-1422,-3,47430,-1,0,46009,46009,1400-2-27,2021-05-17
665,تپمپي,پمپ‌ سازي‌ ايران‌,2,1088,20062720,19410,18440,18440,-970,-5,19410,0,0,18440,18440,1400-2-27,2021-05-17
666,اراد584,مرابحه عام دولت5-ش.خ 0110,2,10214419,9654670489900,990000,945293,945100,-44900,-4.54,945200,-44800,-4.53,945100,945293,1400-2-27,2021-05-17
667,شدوص,دوده‌ صنعتي‌ پارس‌,2,252,5501160,22970,21830,21830,-1140,-4.96,22970,0,0,21830,21830,1400-2-27,2021-05-17
668,اراد834,مرابحه عام دولت83-ش.خ041220,2,21370000,19528078334000,1000000,913943,913669,-86331,-8.63,913808,-86192,-8.62,913669,913943,1400-2-27,2021-05-17
669,وسرضوي,س.سهام عدالت استان خراسان رضوي,2,15190,14871010,1030,979,979,-51,-4.95,1030,0,0,979,979,1400-2-27,2021-05-17
670,تكنار,مجتمع معادن مس تكنار,2,129,14686521,117370,113849,113849,-3521,-3,117365,-5,0,113849,113849,1400-2-27,2021-05-17
671,اخزا805,اسنادخزانه-م5بودجه98-000422,2,26,25198820,972000,968341,972000,0,0,969185,-2815,-0.29,968341,972000,1400-2-27,2021-05-17
672,آسام,صندوق س.آرمان سپهر آشنا-م,2,390,39811500,104513,102042,102210,-2303,-2.2,102081,-2432,-2.33,102042,102210,1400-2-27,2021-05-17
673,قشهد,شهد,2,2387,46307800,20420,19400,19400,-1020,-5,20420,0,0,19400,19400,1400-2-27,2021-05-17
674,غپاك,لبنيات‌ پاك‌,2,386,11217160,30580,29060,29060,-1520,-4.97,30580,0,0,29060,29060,1400-2-27,2021-05-17
675,دجابر,داروسازي‌ جابرابن‌حيان‌,2,781,14893670,20070,19070,19070,-1000,-4.98,20070,0,0,19070,19070,1400-2-27,2021-05-17
676,اخزا804,اسنادخزانه-م4بودجه98-000421,2,9,8756598,970000,968888,974989,4989,0.51,972955,2955,0.3,968888,974989,1400-2-27,2021-05-17
677,ركيش,كارت اعتباري ايران كيش,2,5751,129685050,23730,22550,22550,-1180,-4.97,23720,-10,-0.04,22550,22550,1400-2-27,2021-05-17
678,زعف0008پ10,زعفران0008نگين طلاي سرخ(پ),2,110,13475440,120975,124808,120200,-775,-0.64,122504,1529,1.26,120200,124808,1400-2-27,2021-05-17
679,كاسپين,داروسازي كاسپين تامين,2,430,10548760,25823,24532,24532,-1291,-5,25822,-1,0,24532,24532,1400-2-27,2021-05-17
680,خزر,فنرسازي‌زر,2,231,10441200,47570,45200,45200,-2370,-4.98,47570,0,0,45200,45200,1400-2-27,2021-05-17
681,ولشرق,ليزينگ ايران و شرق,2,21000,173880000,8715,8280,8280,-435,-4.99,8710,-5,-0.06,8280,8280,1400-2-27,2021-05-17
682,ياقوت2,صندوق س ياقوت آگاه-ثابت,1,16169000,16169000,12355,1,1,-12354,-99.99,1,-12354,-99.99,1,1,1400-2-27,2021-05-17
683,سنفت009,سلف موازي استاندارد سنفت009,1,46000,70438420000,1530472,1531270,1531270,798,0.05,1531270,798,0.05,1531270,1531270,1400-2-27,2021-05-17
684,اراد334,مرابحه عام دولت3-ش.خ 0303,1,1129000,1004810000000,875000,890000,890000,15000,1.71,890000,15000,1.71,890000,890000,1400-2-27,2021-05-17
685,ضغدر8056,اختيارخ وغدير-8000-1400/08/26,1,8,24800000,1,3100,3100,3099,309900,3100,3099,309900,3100,3100,1400-2-27,2021-05-17
686,تملي806,تسهيلات مسكن ب. ملي-شهريور98,1,20,10620960,558997,531048,531048,-27949,-5,531048,-27949,-5,531048,531048,1400-2-27,2021-05-17
687,كسعدي,كاشي‌ سعدي‌,1,268,5429680,21320,20260,20260,-1060,-4.97,21320,0,0,20260,20260,1400-2-27,2021-05-17
688,حخزر,كشتيراني درياي خزر,1,234,6311214,28390,26971,26971,-1419,-5,28389,-1,0,26971,26971,1400-2-27,2021-05-17
689,پارس2,پتروشيمي پارس,1,200000,29160000000,144780,145800,145800,1020,0.7,145800,1020,0.7,145800,145800,1400-2-27,2021-05-17
690,ضسپا8041,اختيارخ خساپا-1600-1400/08/26,1,1,350000,1,350,350,349,34900,350,349,34900,350,350,1400-2-27,2021-05-17
691,اخزا9042,اسنادخزانه-م4بودجه99-011215,1,128204,89303060280,689079,696570,696570,7491,1.09,696570,7491,1.09,696570,696570,1400-2-27,2021-05-17
692,ضسپا8043,اختيارخ خساپا-2000-1400/08/26,1,1,200000,1,200,200,199,19900,200,199,19900,200,200,1400-2-27,2021-05-17
693,ضفلا7003,اختيارخ فولاد-8160-1400/07/25,1,8,21200000,2500,2650,2650,150,6,2650,150,6,2650,2650,1400-2-27,2021-05-17
694,ساربيل,سيمان آرتا اردبيل,1,100,5079000,53460,50790,50790,-2670,-4.99,53460,0,0,50790,50790,1400-2-27,2021-05-17
695,اراد42,مرابحه عام دولت4-ش.خ 0106,1,1000,956649000,1006999,956649,956649,-50350,-5,956649,-50350,-5,956649,956649,1400-2-27,2021-05-17
696,كشم0006پ02,كشمش تيزابي0006تاكستان(پ),1,300,64950000,216473,216500,216500,27,0.01,216500,27,0.01,216500,216500,1400-2-27,2021-05-17
697,ضغدر3003,اختيارخ وغدير-9200-1400/03/26,1,10,10110000,1478,1011,1011,-467,-31.6,1011,-467,-31.6,1011,1011,1400-2-27,2021-05-17
698,شفا,سرمايه گذاري شفادارو,1,115,5028950,46030,43730,43730,-2300,-5,46030,0,0,43730,43730,1400-2-27,2021-05-17
699,سنوين,سرمايه گذاري اقتصاد نوين,1,2030,17997980,9140,8866,8866,-274,-3,9139,-1,-0.01,8866,8866,1400-2-27,2021-05-17
700,سرو2,صندوق س سروسودمند مدبران-سهام,1,100000,100000,63700,1,1,-63699,-100,1,-63699,-100,1,1,1400-2-27,2021-05-17
701,اراد344,مرابحه عام دولت3-ش.خ 0305,1,5360331,4672536208728,1000000,871688,871688,-128312,-12.83,871688,-128312,-12.83,871688,871688,1400-2-27,2021-05-17
702,تاپكيش,تجارت الكترونيك پارسيان كيش,1,11000,190146000,18195,17286,17286,-909,-5,18183,-12,-0.07,17286,17286,1400-2-27,2021-05-17
703,دسانكو,داروسازي سبحان انكولوژي,1,400,5613200,14771,14033,14033,-738,-5,14771,0,0,14033,14033,1400-2-27,2021-05-17
704,وسخراش,شركت س استان خراسان شمالي,1,6000,7812000,1370,1302,1302,-68,-4.96,1370,0,0,1302,1302,1400-2-27,2021-05-17
705,ضسپا8042,اختيارخ خساپا-1800-1400/08/26,1,1,250000,1,250,250,249,24900,250,249,24900,250,250,1400-2-27,2021-05-17
706,صخود041,ص مرابحه خودرو041- 3ماهه 18%,1,5,5050000,1000000,1010000,1010000,10000,1,1010000,10000,1,1010000,1010000,1400-2-27,2021-05-17
707,كايتا,ايتالران‌,1,30000,287280000,9298,9576,9576,278,2.99,9306,8,0.09,9576,9576,1400-2-27,2021-05-17
708,كشرق,صنعتي و معدني شمال شرق شاهرود,1,235,20538530,91997,87398,87398,-4599,-5,91990,-7,-0.01,87398,87398,1400-2-27,2021-05-17
709,ضسپا8046,اختيارخ خساپا-3500-1400/08/26,1,1,10000,1,10,10,9,900,10,9,900,10,10,1400-2-27,2021-05-17
710,خاذين,سايپاآذين‌,1,4500,20232000,4732,4496,4496,-236,-4.99,4732,0,0,4496,4496,1400-2-27,2021-05-17
711,وگستر,گسترش سرمايه گذاري ايرانيان,1,260,4676880,18934,17988,17988,-946,-5,18934,0,0,17988,17988,1400-2-27,2021-05-17
712,غچين,كشت‌ و صنعت‌ چين‌ چين,1,8000,150720000,19830,18840,18840,-990,-4.99,19820,-10,-0.05,18840,18840,1400-2-27,2021-05-17
713,ضترا3004,اختيارخ شتران-10000-1400/03/09,1,100,10000000,50,100,100,50,100,100,50,100,100,100,1400-2-27,2021-05-17
714,ضشنا2006,اختيارخ شپنا-20000-1400/02/27,1,11,11000,1,1,1,0,0,1,0,0,1,1,1400-2-27,2021-05-17
715,اراد53,مرابحه عام دولت5-ش.خ 0207,1,500,500000000,958293,1000000,1000000,41707,4.35,1000000,41707,4.35,1000000,1000000,1400-2-27,2021-05-17
716,تاپيكو2,س. نفت و گاز و پتروشيمي تأمين,1,49600000,499968000000,10080,10080,10080,0,0,10080,0,0,10080,10080,1400-2-27,2021-05-17
717,تمحركه,ماشين سازي نيرو محركه,1,290,6986100,24835,24090,24090,-745,-3,24834,-1,0,24090,24090,1400-2-27,2021-05-17
718,ضسپا3005,اختيارخ خساپا-3000-1400/03/26,1,50,750000,10,15,15,5,50,15,5,50,15,15,1400-2-27,2021-05-17
719,بپاس2,بيمه پاسارگاد,1,1090000,97237810000,88551,89209,89209,658,0.74,89209,658,0.74,89209,89209,1400-2-27,2021-05-17
720,ضخود4004,اختيارخ خودرو-2500-1400/04/02,1,1,50000,100,50,50,-50,-50,50,-50,-50,50,50,1400-2-27,2021-05-17
721,كترام,توليدي‌ كاشي‌ تكسرام‌,1,110,5067700,48490,46070,46070,-2420,-4.99,48490,0,0,46070,46070,1400-2-27,2021-05-17
722,وسنا,سرمايه گذاري نيروگاهي ايران,1,1308,19902528,15686,15216,15216,-470,-3,15686,0,0,15216,15216,1400-2-27,2021-05-17
723,صشستا3112,صكوك اجاره شستا311-بدون ضامن,1,500000,500000000000,1049534,1000000,1000000,-49534,-4.72,1000000,-49534,-4.72,1000000,1000000,1400-2-27,2021-05-17
724,وآفري,بيمه كارآفرين,1,2200,7081800,3318,3219,3219,-99,-2.98,3318,0,0,3219,3219,1400-2-27,2021-05-17
725,دكيمي,كيميدارو,1,500,14060000,29590,28120,28120,-1470,-4.97,29590,0,0,28120,28120,1400-2-27,2021-05-17
726,ضپيك7042,اختيارخ تاپيكو-8070-00/07/18,1,25,35000000,1150,1400,1400,250,21.74,1400,250,21.74,1400,1400,1400-2-27,2021-05-17
727,حسير,ريل سير كوثر,1,720,11901600,17400,16530,16530,-870,-5,17399,-1,-0.01,16530,16530,1400-2-27,2021-05-17
728,ثعمرا,عمران و توسعه شاهد,1,1300,16113500,13047,12395,12395,-652,-5,13046,-1,-0.01,12395,12395,1400-2-27,2021-05-17
729,داوه,داروسازي آوه سينا,1,262,5021230,20173,19165,19165,-1008,-5,20173,0,0,19165,19165,1400-2-27,2021-05-17
730,وحافظ,بيمه حافظ,1,158,10181046,65752,64437,64437,-1315,-2,65749,-3,0,64437,64437,1400-2-27,2021-05-17
731,تملي809,تسهيلات مسكن ب. ملي-آذر98,1,35,15165255,412660,433293,433293,20633,5,433293,20633,5,433293,433293,1400-2-27,2021-05-17
732,فملي2,ملي‌ صنايع‌ مس‌ ايران‌,1,38285000,500002100000,13060,13060,13060,0,0,13060,0,0,13060,13060,1400-2-27,2021-05-17
733,تملي710,تسهيلات مسكن ب. ملي-دي97,1,10,8968000,944000,896800,896800,-47200,-5,896800,-47200,-5,896800,896800,1400-2-27,2021-05-17
734,غدام,خوراك‌  دام‌ پارس‌,1,15,5613300,393910,374220,374220,-19690,-5,393900,-10,0,374220,374220,1400-2-27,2021-05-17
735,ضترا3001,اختيارخ شتران-7000-1400/03/09,1,100,105000000,1000,1050,1050,50,5,1050,50,5,1050,1050,1400-2-27,2021-05-17
736,زعف0008پ15,زعفران0008پوشالمعمول طلاسرخ(پ),1,20,1740000,86102,87000,87000,898,1.04,87000,898,1.04,87000,87000,1400-2-27,2021-05-17
737,تملي612,تسهيلات مسكن بانك ملي-اسفند96,1,2,1080000,562727,540000,540000,-22727,-4.04,540000,-22727,-4.04,540000,540000,1400-2-27,2021-05-17
738,زعف0008پ11,زعفران0008نگين سحرخيز(پ),1,2058,249429600,121370,121200,121200,-170,-0.14,121200,-170,-0.14,121200,121200,1400-2-27,2021-05-17
739,ضپيك7041,اختيارخ تاپيكو-7070-00/07/18,1,1,1400000,1837,1400,1400,-437,-23.79,1400,-437,-23.79,1400,1400,1400-2-27,2021-05-17
740,نكالا2,نهادهاي مالي بورس كالاي ايران,1,5000000,148600000000,31280,29720,29720,-1560,-4.99,29720,-1560,-4.99,29720,29720,1400-2-27,2021-05-17
741,وملت,سرمايه گذاري ملت,1,1700,7129800,4368,4194,4194,-174,-3.98,4368,0,0,4194,4194,1400-2-27,2021-05-17
742,ارفع2,شركت آهن و فولاد ارفع,1,23325267,341715161550,14503,14650,14650,147,1.01,14650,147,1.01,14650,14650,1400-2-27,2021-05-17
743,شرق1400,مشاركت ليزينگ ايران وشرق140010,1,31,30993800,999800,999800,999800,0,0,999800,0,0,999800,999800,1400-2-27,2021-05-17
744,مصفها203,مشاركت ش اصفهان203-3ماهه18%,1,300,291900000,1000000,973000,973000,-27000,-2.7,973000,-27000,-2.7,973000,973000,1400-2-27,2021-05-17
745,سپ2,پرداخت الكترونيك سامان كيش,1,49999000,1267974640000,25360,25360,25360,0,0,25360,0,0,25360,25360,1400-2-27,2021-05-17
746,وساربيل,شركت س استان اردبيل,1,10000,12160000,1280,1216,1216,-64,-5,1280,0,0,1216,1216,1400-2-27,2021-05-17
747,وپسا,س. پتروشيمي ساختمان  خليج فارس,1,1698,5004006,3007,2947,2947,-60,-2,3007,0,0,2947,2947,1400-2-27,2021-05-17
748,پسهند,صنايع‌ لاستيكي‌  سهند,1,200,7220000,37990,36100,36100,-1890,-4.97,37990,0,0,36100,36100,1400-2-27,2021-05-17
749,وسمازن,س.سهام عدالت استان مازندران,1,10000,9220000,970,922,922,-48,-4.95,970,0,0,922,922,1400-2-27,2021-05-17
750,شيراز2,پتروشيمي‌شيراز,1,1612600,81533056000,50560,50560,50560,0,0,50560,0,0,50560,50560,1400-2-27,2021-05-17
751,ضفلا3005,اختيارخ فولاد-9986-1400/03/19,1,20,1800000,150,90,90,-60,-40,90,-60,-40,90,90,1400-2-27,2021-05-17
752,وپاسار2,بانك  پاسارگاد,1,4700000,80229000000,17110,17070,17070,-40,-0.23,17070,-40,-0.23,17070,17070,1400-2-27,2021-05-17
753,ضملي7005,اختيارخ فملي-15720-1400/07/11,1,1,300000,999,300,300,-699,-69.97,300,-699,-69.97,300,300,1400-2-27,2021-05-17
754,زنگان,صنعت روي زنگان,1,53,5249120,104252,99040,99040,-5212,-5,104250,-2,0,99040,99040,1400-2-27,2021-05-17
755,كرماشا2,صنايع پتروشيمي كرمانشاه,1,2520208,80671858080,32330,32010,32010,-320,-0.99,32010,-320,-0.99,32010,32010,1400-2-27,2021-05-17
756,تشتاد,صنايع توليدي اشتاد ايران‌,1,400,6083600,15679,15209,15209,-470,-3,15679,0,0,15209,15209,1400-2-27,2021-05-17
757,دبالك,مواد اوليه دارويي البرز بالك,1,10000,197160000,20753,19716,19716,-1037,-5,20739,-14,-0.07,19716,19716,1400-2-27,2021-05-17
758,كمند2,صندوق س. با درآمد ثابت كمند,1,85500000,85500000,10061,1,1,-10060,-99.99,1,-10060,-99.99,1,1,1400-2-27,2021-05-17
759,قشير,قند شيروان قوچان و بجنورد,1,205,5000155,25674,24391,24391,-1283,-5,25674,0,0,24391,24391,1400-2-27,2021-05-17
760,سميعا002,سلف موازي استاندارد سميعا002,1,1000,1330165000,1296162,1330165,1330165,34003,2.62,1330165,34003,2.62,1330165,1330165,1400-2-27,2021-05-17
761,ضفار3000,اختيارخ فارس-8000-1400/03/05,1,50,25000000,1299,500,500,-799,-61.51,500,-799,-61.51,500,500,1400-2-27,2021-05-17
762,ضپنا8002,اختيارخ رمپنا-13850-1400/08/05,1,5,10000000,2484,2000,2000,-484,-19.48,2000,-484,-19.48,2000,2000,1400-2-27,2021-05-17
763,ضسپا8040,اختيارخ خساپا-1400-1400/08/26,1,10,5000000,1,500,500,499,49900,500,499,49900,500,500,1400-2-27,2021-05-17
764,اطلس2,صندوق س.توسعه اندوخته آينده-س,1,10000,10000,200042,1,1,-200041,-100,1,-200041,-100,1,1,1400-2-27,2021-05-17
765,بكاب,صنايع‌جوشكاب‌يزد,1,18,6153300,359840,341850,341850,-17990,-5,359830,-10,0,341850,341850,1400-2-27,2021-05-17
766,انرژي12,نهادهاي مالي بورس انرژي,1,1000000,235690000000,248090,235690,235690,-12400,-5,235690,-12400,-5,235690,235690,1400-2-27,2021-05-17
767,اوان,مبين وان كيش,1,5000,259320000,54593,51864,51864,-2729,-5,54543,-50,-0.09,51864,51864,1400-2-27,2021-05-17
768,ولصنم,ليزينگ‌صنعت‌ومعدن‌,1,480,5044800,11060,10510,10510,-550,-4.97,11060,0,0,10510,10510,1400-2-27,2021-05-17
769,دشيري,شيرين دارو,1,25,5718150,235800,228726,228726,-7074,-3,235796,-4,0,228726,228726,1400-2-27,2021-05-17
770,بالبر,كابل‌ البرز,1,2715,152311500,59050,56100,56100,-2950,-5,59020,-30,-0.05,56100,56100,1400-2-27,2021-05-17
771,افاد82,منفعت دولت8-ش.خاص لوتوس0205,1,5000,4568000000,896358,913600,913600,17242,1.92,913600,17242,1.92,913600,913600,1400-2-27,2021-05-17
772,نوري2,پتروشيمي نوري,1,1000000,59660000000,59660,59660,59660,0,0,59660,0,0,59660,59660,1400-2-27,2021-05-17
773,شكبير2,پتروشيمي اميركبير,1,3000000,247782000000,82594,82594,82594,0,0,82594,0,0,82594,82594,1400-2-27,2021-05-17
774,اخزا9082,اسنادخزانه-م8بودجه99-020606,1,167775,105958301250,624053,631550,631550,7497,1.2,631550,7497,1.2,631550,631550,1400-2-27,2021-05-17
775,شزنگ,تجهيزنيروي‌زنگان‌,1,22,5004098,234493,227459,227459,-7034,-3,234489,-4,0,227459,227459,1400-2-27,2021-05-17
776,غگلستا,شير پاستوريزه پگاه گلستان,1,196,5309640,28515,27090,27090,-1425,-5,28514,-1,0,27090,27090,1400-2-27,2021-05-17
777,صخود4012,ص مرابحه خودرو401- 3ماهه 18%,1,1100000,1056000000000,1000000,960000,960000,-40000,-4,960000,-40000,-4,960000,960000,1400-2-27,2021-05-17
778,كرمان00,رهني كرمان موتور14001130,1,2505,2630250000,1020000,1050000,1050000,30000,2.94,1050000,30000,2.94,1050000,1050000,1400-2-27,2021-05-17
779,كقزوي,شيشه‌ قزوين‌,1,620,6113820,10165,9861,9861,-304,-2.99,10165,0,0,9861,9861,1400-2-27,2021-05-17
780,اروند06,منفعت صبا اروند ملت 14001113,1,10000,10200000000,1010000,1020000,1020000,10000,0.99,1020000,10000,0.99,1020000,1020000,1400-2-27,2021-05-17
781,پست0008پ09,پسته بادامي30-28مه ولات0008(پ),1,17,25953050,1607000,1526650,1526650,-80350,-5,1526650,-80350,-5,1526650,1526650,1400-2-27,2021-05-17
782,سخواف,سيمان مجد خواف,1,2000,32554000,16780,16277,16277,-503,-3,16778,-2,-0.01,16277,16277,1400-2-27,2021-05-17
783,اخزا713,اسنادخزانه-م13بودجه97-000518,1,20,19077140,953057,953857,953857,800,0.08,953857,800,0.08,953857,953857,1400-2-27,2021-05-17
784,كباده,توليد خاك نسوزاستقلال آباده,1,4152,37451040,8758,9020,9020,262,2.99,8759,1,0.01,9020,9020,1400-2-27,2021-05-17
785,واحصا,احياء صنايع خراسان,1,78,5503446,72739,70557,70557,-2182,-3,72738,-1,0,70557,70557,1400-2-27,2021-05-17
786,ثپرديس,سرمايه گذاري مسكن پرديس,1,800,7720800,10158,9651,9651,-507,-4.99,10158,0,0,9651,9651,1400-2-27,2021-05-17
787,بتك,كارخانجات كابل سازي‌ تك‌,1,3340,118910680,34233,35602,35602,1369,4,34264,31,0.09,35602,35602,1400-2-27,2021-05-17
788,بنو,بيمه تجارت نو,1,1733,49782158,30237,28726,28726,-1511,-5,30235,-2,-0.01,28726,28726,1400-2-27,2021-05-17
789,پلاسك,پلاسكوكار,1,1246,8846600,7470,7100,7100,-370,-4.95,7470,0,0,7100,7100,1400-2-27,2021-05-17
790,وجامي,سرمايه گذاري جامي,1,360,5155200,15073,14320,14320,-753,-5,15073,0,0,14320,14320,1400-2-27,2021-05-17
791,خموتور,موتورسازان‌تراكتورسازي‌ايران‌,1,500,7105000,14950,14210,14210,-740,-4.95,14950,0,0,14210,14210,1400-2-27,2021-05-17
792,دفارا,داروسازي‌ فارابي‌,1,88,5015120,59980,56990,56990,-2990,-4.98,59980,0,0,56990,56990,1400-2-27,2021-05-17
793,صايپا012,صكوك مرابحه سايپا012-3ماهه 16%,1,10000,10000020000,1000002,1000002,1000002,0,0,1000002,0,0,1000002,1000002,1400-2-27,2021-05-17
794,فايرا2,آلومينيوم‌ايران‌,1,15000000,276000000000,18400,18400,18400,0,0,18400,0,0,18400,18400,1400-2-27,2021-05-17
795,ضمخا7067,اختيارخ اخابر-13700-1400/07/28,1,1,350000,501,350,350,-151,-30.14,350,-151,-30.14,350,350,1400-2-27,2021-05-17
