,نماد,نام,تعداد,حجم,ارزش,دیروز,اولین,آخرین معامله - مقدار,آخرین معامله - تغییر,آخرین معامله - درصد,قیمت پایانی - مقدار,قیمت پایانی - تغییر,قیمت پایانی - درصد,کمترین,بیشترین,تاریخ,gregorian_date
0,پالايش,صندوق پالايشي يكم-سهام,28193,31175738,2208528709560,68810,70980,71030,2220,3.23,70840,2030,2.95,70010,72010,1400-2-15,2021-05-05
1,دارا يكم,صندوق واسطه گري مالي يكم-سهام,27843,26965738,3721046140520,134980,136500,138620,3640,2.7,137990,3010,2.23,136500,139990,1400-2-15,2021-05-05
2,فملي,ملي‌ صنايع‌ مس‌ ايران‌,19320,129092724,1527321774700,11230,11600,11900,670,5.97,11830,600,5.34,11600,11900,1400-2-15,2021-05-05
3,خودرو,ايران‌ خودرو,18765,769114887,1537092192235,2058,1997,1997,-61,-2.96,1999,-59,-2.87,1997,2027,1400-2-15,2021-05-05
4,وبملت,بانك ملت,16236,394398136,1913838153432,4644,4660,4922,278,5.99,4853,209,4.5,4660,4922,1400-2-15,2021-05-05
5,شپنا,پالايش نفت اصفهان,15532,161648750,1650318038430,10510,10200,10200,-310,-2.95,10210,-300,-2.85,10200,10370,1400-2-15,2021-05-05
6,بركت,گروه دارويي بركت,12630,44264594,1277159670630,29710,28820,28820,-890,-3,28850,-860,-2.89,28820,29450,1400-2-15,2021-05-05
7,شستا,سرمايه گذاري تامين اجتماعي,12484,40483459,439712327470,10740,10630,10860,120,1.12,10860,120,1.12,10630,11070,1400-2-15,2021-05-05
8,وسپهر,سرمايه گذاري مالي سپهرصادرات,10440,28322008,286055119471,10100,10100,10100,0,0,10100,0,0,10100,10104,1400-2-15,2021-05-05
9,اپال,فرآوري معدني اپال كاني پارس,9949,5717423,98331954300,17090,17170,17190,100,0.59,17180,90,0.53,17090,17310,1400-2-15,2021-05-05
10,فولاد,فولاد مباركه اصفهان,9789,65679451,786018916900,11720,11580,11980,260,2.22,11970,250,2.13,11580,12210,1400-2-15,2021-05-05
11,وتجارت,بانك تجارت,9560,223671898,558716858615,2491,2430,2504,13,0.52,2498,7,0.28,2430,2560,1400-2-15,2021-05-05
12,خساپا,سايپا,9063,387466562,741051423140,1971,1912,1912,-59,-2.99,1913,-58,-2.94,1912,1936,1400-2-15,2021-05-05
13,امينح,ح . تامين سرمايه امين,8399,6251065,31015963410,4940,4990,4850,-90,-1.82,4960,20,0.4,4800,5100,1400-2-15,2021-05-05
14,شتران,پالايش نفت تهران,8257,73554492,596885336380,8360,8110,8110,-250,-2.99,8110,-250,-2.99,8110,8250,1400-2-15,2021-05-05
15,خبهمن,گروه‌بهمن‌,8130,343953042,484090020372,1403,1380,1421,18,1.28,1407,4,0.29,1361,1458,1400-2-15,2021-05-05
16,كرمان,س. توسعه و عمران استان كرمان,7445,245619140,294290997629,1201,1185,1186,-15,-1.25,1198,-3,-0.25,1171,1238,1400-2-15,2021-05-05
17,وبصادر,بانك صادرات ايران,6967,207460545,459529954764,2203,2161,2222,19,0.86,2215,12,0.54,2161,2270,1400-2-15,2021-05-05
18,بوعلي,پتروشيمي بوعلي سينا,6828,3082484,131151089970,42010,41510,42300,290,0.69,42550,540,1.29,41510,42860,1400-2-15,2021-05-05
19,پترول,گ.س.وت.ص.پتروشيمي خليج فارس,5583,26283764,212755544450,8030,8000,8120,90,1.12,8090,60,0.75,8000,8230,1400-2-15,2021-05-05
20,وپاسار,بانك  پاسارگاد,5341,53423082,855902029700,15130,16000,16100,970,6.41,16020,890,5.88,16000,16100,1400-2-15,2021-05-05
21,امين,تامين سرمايه امين,4941,4665179,32643593610,7010,7000,6990,-20,-0.29,7000,-10,-0.14,6990,7060,1400-2-15,2021-05-05
22,وكبهمن,مديريت سرمايه گذاري كوثربهمن,4820,2074374,21019090338,10377,10102,10162,-215,-2.07,10270,-107,-1.03,10075,10230,1400-2-15,2021-05-05
23,بپيوند,برق و انرژي پيوندگستر پارس,4519,3034076,33695126165,11302,11000,11008,-294,-2.6,11160,-142,-1.26,10964,11479,1400-2-15,2021-05-05
24,ومعادنح,ح . توسعه‌معادن‌وفلزات‌,4442,25123775,126842997400,4810,4730,5090,280,5.82,5050,240,4.99,4730,5150,1400-2-15,2021-05-05
25,كمند,صندوق س. با درآمد ثابت كمند,4418,180437177,1835096151645,10160,10170,10172,12,0.12,10170,10,0.1,10170,10172,1400-2-15,2021-05-05
26,آريا,پليمر آريا ساسول,4410,1548124,134028425365,85367,83700,86090,723,0.85,86575,1208,1.42,83700,88000,1400-2-15,2021-05-05
27,شبندر,پالايش نفت بندرعباس,4404,22603033,458805873660,20900,20280,20280,-620,-2.97,20300,-600,-2.87,20280,20710,1400-2-15,2021-05-05
28,سيتا,سرمايه گذاري سيمان تامين,4307,6758356,101379188430,15000,15000,15000,0,0,15000,0,0,15000,15010,1400-2-15,2021-05-05
29,شگويا,پتروشيمي تندگويان,4215,17012530,146444724214,8526,8739,8542,16,0.19,8608,82,0.96,8481,8739,1400-2-15,2021-05-05
30,امين يكم,صندوق درآمد ثابت امين يكم فردا,3916,135676924,1370033341233,10097,10099,10101,4,0.04,10098,1,0.01,10095,10102,1400-2-15,2021-05-05
31,ذوب,سهامي ذوب آهن  اصفهان,3595,65115018,206961120494,3274,3176,3176,-98,-2.99,3178,-96,-2.93,3176,3217,1400-2-15,2021-05-05
32,دماوند,توليد نيروي برق دماوند,3433,6316508,175836047642,26915,27799,27800,885,3.29,27838,923,3.43,27100,28490,1400-2-15,2021-05-05
33,بگيلان,توسعه مسير برق گيلان,3010,397985,7818920070,20223,19627,19620,-603,-2.98,20129,-94,-0.46,19617,19752,1400-2-15,2021-05-05
34,فارس,صنايع پتروشيمي خليج فارس,2904,15425921,131397708930,8430,8500,8470,40,0.47,8520,90,1.07,8430,8640,1400-2-15,2021-05-05
35,وغدير,سرمايه‌گذاري‌غدير(هلدينگ‌,2673,14413294,140050243480,9500,9530,9800,300,3.16,9720,220,2.32,9480,9930,1400-2-15,2021-05-05
36,ومعادن,توسعه‌معادن‌وفلزات‌,2390,26214327,191020639550,7410,7190,7270,-140,-1.89,7290,-120,-1.62,7190,7550,1400-2-15,2021-05-05
37,ثاميد,توسعه و عمران اميد,2362,22188413,30926352695,1432,1400,1390,-42,-2.93,1405,-27,-1.89,1390,1430,1400-2-15,2021-05-05
38,وساپا,سرمايه‌گذاري‌ سايپا,2197,23938754,108485196173,4404,4540,4537,133,3.02,4532,128,2.91,4430,4600,1400-2-15,2021-05-05
39,صبا,سرمايه گذاري صبا تامين,1983,5810948,43651752932,7503,7330,7465,-38,-0.51,7506,3,0.04,7308,7650,1400-2-15,2021-05-05
40,وخارزمح,ح.سرمايه گذاري خوارزمي,1940,5588199,16117424308,2888,2835,2904,16,0.55,2884,-4,-0.14,2827,2994,1400-2-15,2021-05-05
41,نوري,پتروشيمي نوري,1884,1762401,100970800110,56190,55510,57270,1080,1.92,57290,1100,1.96,55510,58930,1400-2-15,2021-05-05
42,فايرا,آلومينيوم‌ايران‌,1875,15674433,284560656920,17200,16710,18230,1030,5.99,18150,950,5.52,16710,18230,1400-2-15,2021-05-05
43,كيان,صندوق س. با درآمد ثابت كيان,1820,24158581,683524046772,28257,28292,28293,36,0.13,28293,36,0.13,28292,28296,1400-2-15,2021-05-05
44,ونوين,بانك‌اقتصادنوين‌,1813,26045917,116987442743,4396,4480,4470,74,1.68,4492,96,2.18,4400,4548,1400-2-15,2021-05-05
45,تسه0001,امتيازتسهيلات مسكن فروردين1400,1777,43083,22794543421,528893,530111,539000,10107,1.91,529084,191,0.04,517000,548990,1400-2-15,2021-05-05
46,تملت,تامين سرمايه بانك ملت,1748,8304230,41475328702,4990,5000,4951,-39,-0.78,4994,4,0.08,4913,5089,1400-2-15,2021-05-05
47,جم پيلن,پلي پروپيلن جم - جم پيلن,1690,2232248,187705070990,80220,80000,84700,4480,5.58,84090,3870,4.82,79100,85030,1400-2-15,2021-05-05
48,فخوز,فولاد  خوزستان,1662,8462175,122887070320,14180,14180,14500,320,2.26,14520,340,2.4,14180,14750,1400-2-15,2021-05-05
49,غگل,گلوكوزان‌,1660,21685863,60690545732,2884,2798,2798,-86,-2.98,2799,-85,-2.95,2798,2840,1400-2-15,2021-05-05
50,وپارس,بانك‌پارسيان‌,1652,55744462,135255140019,2392,2448,2406,14,0.59,2426,34,1.42,2401,2450,1400-2-15,2021-05-05
51,بجهرم,توسعه مولد نيروگاهي جهرم,1649,24471753,54512694893,2291,2223,2223,-68,-2.97,2228,-63,-2.75,2223,2268,1400-2-15,2021-05-05
52,اعتماد,صندوق س.اعتماد آفرين پارسيان-د,1592,32692920,1185290643110,36216,36248,36259,43,0.12,36255,39,0.11,36248,36270,1400-2-15,2021-05-05
53,سرو,صندوق س سروسودمند مدبران-سهام,1529,1580005,98229863590,61710,61310,61970,260,0.42,62170,460,0.75,61000,63200,1400-2-15,2021-05-05
54,فباهنرح,ح . مس‌ شهيدباهنر,1516,4318708,71771629900,15600,15750,16620,1020,6.54,16620,1020,6.54,15750,17070,1400-2-15,2021-05-05
55,تاصيكو,سرمايه گذاري صدرتامين,1371,15902514,157248826840,10180,9880,9880,-300,-2.95,9890,-290,-2.85,9880,10120,1400-2-15,2021-05-05
56,سفارس,سيمان فارس و خوزستان,1347,5281470,77432706580,14780,14350,14370,-410,-2.77,14660,-120,-0.81,14350,15100,1400-2-15,2021-05-05
57,وتوس,توسعه‌شهري‌توس‌گستر,1326,3770321,52301387150,13290,13360,14080,790,5.94,13870,580,4.36,13350,14080,1400-2-15,2021-05-05
58,تاپيكو,س. نفت و گاز و پتروشيمي تأمين,1320,8613614,87004327360,10160,9910,10170,10,0.1,10110,-50,-0.49,9910,10300,1400-2-15,2021-05-05
59,فاسمين,كالسيمين‌,1313,8490188,118666444430,14370,13940,13940,-430,-2.99,13980,-390,-2.71,13940,14840,1400-2-15,2021-05-05
60,كاوه,فولاد كاوه جنوب كيش,1306,4798232,95835076340,19970,19700,19600,-370,-1.85,19970,0,0,19500,20890,1400-2-15,2021-05-05
61,سمازن,سيمان‌مازندران‌,1304,4547884,55377436210,12260,12020,11980,-280,-2.28,12180,-80,-0.65,11920,12590,1400-2-15,2021-05-05
62,آگاس,صندوق س.هستي بخش آگاه-س,1299,1836095,116264599192,62662,63320,63070,408,0.65,63322,660,1.05,62662,64010,1400-2-15,2021-05-05
63,ارمغان,ص سرمايه گذاري ارمغان ايرانيان,1297,54219085,551053338959,10187,10185,10172,-15,-0.15,10163,-24,-0.24,10147,10190,1400-2-15,2021-05-05
64,دعبيد,لابراتوارداروسازي‌  دكترعبيدي‌,1243,2317667,57165234820,23400,24360,24800,1400,5.98,24660,1260,5.38,23750,24800,1400-2-15,2021-05-05
65,فباهنر,مس‌ شهيدباهنر,1207,3417428,81989097640,24690,23950,23950,-740,-3,23990,-700,-2.84,23950,24840,1400-2-15,2021-05-05
66,وساخت,سرمايه‌ گذاري‌ ساختمان‌ايران‌,1175,1803633,83889729790,47500,46090,46350,-1150,-2.42,46510,-990,-2.08,46080,48410,1400-2-15,2021-05-05
67,ورازي,بيمه رازي,1161,7335169,64132886050,8508,8450,8600,92,1.08,8743,235,2.76,8450,8921,1400-2-15,2021-05-05
68,بپاس,بيمه پاسارگاد,1125,1173532,103480103627,88154,88155,88187,33,0.04,88178,24,0.03,88155,88280,1400-2-15,2021-05-05
69,كچاد,معدني‌وصنعتي‌چادرملو,1087,4229982,87271537860,20450,20130,20400,-50,-0.24,20590,140,0.68,20130,21000,1400-2-15,2021-05-05
70,آوا,صندوق س.سهام آواي معيار-س,1071,8140416,52345039976,6344,6350,6420,76,1.2,6430,86,1.36,6350,6530,1400-2-15,2021-05-05
71,ضسپا3002,اختيارخ خساپا-1800-1400/03/26,1066,57671,8413681000,146,146,141,-5,-3.42,146,0,0,140,169,1400-2-15,2021-05-05
72,شيران,س. صنايع‌شيميايي‌ايران,968,5675592,116522069020,21160,20530,20530,-630,-2.98,20530,-630,-2.98,20530,20700,1400-2-15,2021-05-05
73,وسكرد,شركت س استان كردستان,917,55096922,36970249229,691,671,671,-20,-2.89,675,-16,-2.32,671,680,1400-2-15,2021-05-05
74,خگستر,گسترش‌سرمايه‌گذاري‌ايران‌خودرو,917,29898524,70141937304,2418,2346,2346,-72,-2.98,2346,-72,-2.98,2346,2346,1400-2-15,2021-05-05
75,ساراب,سيمان‌ داراب‌,909,3025408,64280377400,20190,21290,21400,1210,5.99,21250,1060,5.25,20550,21400,1400-2-15,2021-05-05
76,پيزد,مجتمع صنايع لاستيك يزد,893,120066,7243276809,62192,60327,60327,-1865,-3,61912,-280,-0.45,60327,60390,1400-2-15,2021-05-05
77,شبهرن,نفت‌ بهران‌,856,6212231,68824910920,11400,11060,11060,-340,-2.98,11080,-320,-2.81,11060,11400,1400-2-15,2021-05-05
78,ومهان,گروه توسعه مالي مهر آيندگان,854,2499633,30603485251,12375,12080,12120,-255,-2.06,12293,-82,-0.66,12004,12490,1400-2-15,2021-05-05
79,خكرمان,گروه اقتصادي كرمان خودرو,837,8093138,28001189531,3429,3380,3440,11,0.32,3460,31,0.9,3370,3530,1400-2-15,2021-05-05
80,ارفع,شركت آهن و فولاد ارفع,831,6278512,88049262142,14420,13988,13988,-432,-3,14024,-396,-2.75,13988,14500,1400-2-15,2021-05-05
81,كگلح,ح . معدني و صنعتي گل گهر,811,4407632,45119612660,10190,10010,10140,-50,-0.49,10240,50,0.49,10010,10570,1400-2-15,2021-05-05
82,وصنعت,سرمايه گذاري توسعه صنعت وتجارت,808,6246631,35659180330,5690,5720,5750,60,1.05,5700,10,0.18,5610,5780,1400-2-15,2021-05-05
83,تسه9912,امتياز تسهيلات مسكن اسفند99,804,13312,7228380410,542137,536000,560000,17863,3.29,542997,860,0.16,527525,569243,1400-2-15,2021-05-05
84,طلا,صندوق س.پشتوانه طلاي لوتوس,784,565595,36999003986,66595,65210,65860,-735,-1.1,65416,-1179,-1.77,65170,65870,1400-2-15,2021-05-05
85,البرز,بيمه البرز,780,9407655,32182895064,3477,3410,3450,-27,-0.78,3439,-38,-1.09,3380,3485,1400-2-15,2021-05-05
86,وسينا,بانك سينا,776,30233839,82554038921,2814,2730,2730,-84,-2.99,2731,-83,-2.95,2730,2789,1400-2-15,2021-05-05
87,فجر,فولاد اميركبيركاشان,772,1103399,63694623750,55870,55500,57990,2120,3.79,57730,1860,3.33,55500,59190,1400-2-15,2021-05-05
88,كگل,معدني و صنعتي گل گهر,764,4546570,60909671250,13400,13050,13240,-160,-1.19,13400,0,0,13020,13970,1400-2-15,2021-05-05
89,شصدف,صنعتي دوده فام,759,179677,5869688236,30819,32668,32668,1849,6,31023,204,0.66,32668,32668,1400-2-15,2021-05-05
90,وسكاب,س.ص.بازنشستگي كاركنان بانكها,725,6289293,30243329039,4745,4800,4830,85,1.79,4784,39,0.82,4752,4980,1400-2-15,2021-05-05
91,شلرد,كود شيميايي اوره لردگان,721,6784152,42778324881,6297,6220,6297,0,0,6306,9,0.14,6220,6420,1400-2-15,2021-05-05
92,هرمز,فولاد هرمزگان جنوب,716,2334524,35010795910,15035,14989,14860,-175,-1.16,15023,-12,-0.08,14750,15190,1400-2-15,2021-05-05
93,زگلدشتح,ح.كشت و دام گلدشت نمونه اصفهان,712,4457795,28561148578,6568,6371,6371,-197,-3,6407,-161,-2.45,6371,6660,1400-2-15,2021-05-05
94,وكار,بانك‌ كارآفرين‌,708,16328847,48139122876,2934,2940,2970,36,1.23,2948,14,0.48,2900,3000,1400-2-15,2021-05-05
95,رمپنا,گروه مپنا (سهامي عام),682,10634032,163870780800,15880,15410,15410,-470,-2.96,15410,-470,-2.96,15410,15420,1400-2-15,2021-05-05
96,ثمسكن,سرمايه‌گذاري‌ مسكن‌,662,6816750,33601664830,5056,4925,4905,-151,-2.99,4970,-86,-1.7,4905,5089,1400-2-15,2021-05-05
97,شغدير,پتروشيمي غدير,644,677636,41898782970,62070,62000,61990,-80,-0.13,61860,-210,-0.34,60500,64000,1400-2-15,2021-05-05
98,شفن,پتروشيمي فناوران,643,111508,34435430150,313670,304260,305550,-8120,-2.59,311940,-1730,-0.55,304260,315990,1400-2-15,2021-05-05
99,افق,فروشگاههاي زنجيره اي افق كوروش,634,1029941,70801421540,68450,67000,68990,540,0.79,68700,250,0.37,67000,70000,1400-2-15,2021-05-05
100,سرچشمه,سرمايه گذاري مس سرچشمه,632,3226896,19384662406,5973,5830,6030,57,0.95,5987,14,0.23,5830,6150,1400-2-15,2021-05-05
101,وبانك,سرمايه گذاري گروه توسعه ملي,626,4129506,31255082890,7720,7490,7530,-190,-2.46,7660,-60,-0.78,7490,7800,1400-2-15,2021-05-05
102,شاراك,پتروشيمي شازند,621,2267528,59144869000,25760,25010,26100,340,1.32,25990,230,0.89,24990,26500,1400-2-15,2021-05-05
103,سكه0012پ01,تمام سكه طرح جديد0012رفاه,606,168500,152719704800,933821,909999,904001,-29820,-3.19,906348,-27473,-2.94,903800,914399,1400-2-15,2021-05-05
104,مدير,ص.س.مديريت ثروت ص.بازنشستگي-س,601,2041449,16028883761,7760,7877,7818,58,0.75,7852,92,1.19,7701,7940,1400-2-15,2021-05-05
105,فنوال,نورد آلومينيوم‌,591,1209921,31626896980,26310,25560,26300,-10,-0.04,26190,-120,-0.46,25530,26890,1400-2-15,2021-05-05
106,زاگرس,پتروشيمي زاگرس,585,231516,46153028806,195362,199000,198710,3348,1.71,197251,1889,0.97,193310,201000,1400-2-15,2021-05-05
107,آريان,سرمايه گذاري پارس آريان,568,12223716,114454914239,9530,9342,9410,-120,-1.26,9363,-167,-1.75,9340,9529,1400-2-15,2021-05-05
108,ميدكو,هلدينگ صنايع  معدني خاورميانه,548,4178803,138178585811,32760,32761,33100,340,1.04,33067,307,0.94,32761,33100,1400-2-15,2021-05-05
109,رانفور,خدمات‌انفورماتيك‌,548,10216697,65795528680,6630,6440,6440,-190,-2.87,6460,-170,-2.56,6440,6440,1400-2-15,2021-05-05
110,شسپا,نفت سپاهان,529,1775015,25301501020,14410,14230,14190,-220,-1.53,14340,-70,-0.49,14010,14620,1400-2-15,2021-05-05
111,فنورد,نوردوقطعات‌ فولادي‌,521,122308,18698185150,151830,150000,153000,1170,0.77,152240,410,0.27,148590,157990,1400-2-15,2021-05-05
112,ونيكي,سرمايه‌گذاري‌ ملي‌ايران‌,509,5045979,40774035800,8320,8080,8080,-240,-2.88,8150,-170,-2.04,8080,8140,1400-2-15,2021-05-05
113,ثتوسا,س.توسعه و عمران استان اردبيل,506,1964651,76570308074,39769,38974,38974,-795,-2,38974,-795,-2,38974,38974,1400-2-15,2021-05-05
114,خديزل,بهمن  ديزل,499,900459,35250916187,40220,39014,39035,-1185,-2.95,39485,-735,-1.83,39014,40290,1400-2-15,2021-05-05
115,دسبحانح,ح. سبحان دارو,498,206528,2676146520,13100,12340,13100,0,0,12960,-140,-1.07,12320,13600,1400-2-15,2021-05-05
116,قيستو,شركت قند بيستون,497,4278854,82632772361,19463,19074,19231,-232,-1.19,19312,-151,-0.78,19074,19852,1400-2-15,2021-05-05
117,ضخود7075,اختيارخ خودرو-2000-1400/07/07,495,18337,4974280000,267,289,251,-16,-5.99,271,4,1.5,245,320,1400-2-15,2021-05-05
118,همراه,شركت ارتباطات سيار ايران,487,1765517,40627288960,23720,23010,23010,-710,-2.99,23420,-300,-1.26,23010,23200,1400-2-15,2021-05-05
119,تصميم,صندوق س با درآمد ثابت تصميم,485,5083770,82765901520,16263,16284,16277,14,0.09,16280,17,0.1,16255,16290,1400-2-15,2021-05-05
120,تسه9803,امتياز تسهيلات مسكن خرداد98,484,5505,2860086517,518358,504010,526969,8611,1.66,519543,1185,0.23,504010,528450,1400-2-15,2021-05-05
121,كارين2,صندوق س نگين سامان-ثابت,480,4800000,4800000,10076,1,1,-10075,-99.99,1,-10075,-99.99,1,1,1400-2-15,2021-05-05
122,شپديس,پتروشيمي پرديس,479,546151,50366671270,91770,91770,91940,170,0.19,92010,240,0.26,90750,93390,1400-2-15,2021-05-05
123,وپخش,داروپخش‌ (هلدينگ‌,470,266969,26804445210,102640,104800,99570,-3070,-2.99,101490,-1150,-1.12,99570,104800,1400-2-15,2021-05-05
124,ضخود7076,اختيارخ خودرو-2500-1400/07/07,468,17860,2710673000,144,158,151,7,4.86,152,8,5.56,140,177,1400-2-15,2021-05-05
125,مبين,مبين انرژي خليج فارس,461,2717962,42632420800,15490,15030,15890,400,2.58,15560,70,0.45,15030,16000,1400-2-15,2021-05-05
126,ارزش,صندوق س ارزش آفرين بيدار-سهام,460,2934281,26745796630,8980,9140,9090,110,1.22,9110,130,1.45,9040,9180,1400-2-15,2021-05-05
127,كارين,صندوق س نگين سامان-ثابت,460,21000514,211789132710,10076,10086,10087,11,0.11,10085,9,0.09,10084,10087,1400-2-15,2021-05-05
128,واميدح,ح.گروه مديريت سرمايه گذار اميد,446,2944630,23013325330,1250,8020,7540,6290,503.2,7820,6570,525.6,7540,8490,1400-2-15,2021-05-05
129,كگهر,سنگ آهن گهرزمين,439,1171809,49771857772,43223,41927,41927,-1296,-3,42899,-324,-0.75,41927,44800,1400-2-15,2021-05-05
130,پارسان,گسترش نفت و گاز پارسيان,436,1767704,31130645760,17630,17160,17550,-80,-0.45,17620,-10,-0.06,17160,17960,1400-2-15,2021-05-05
131,پارند,صندوق س. پارند پايدار سپهر,435,6914280,78588818341,11357,11366,11367,10,0.09,11366,9,0.08,11365,11369,1400-2-15,2021-05-05
132,فردا,صندوق س آواي فرداي زاگرس-ثابت,429,18674917,198514328042,10619,10629,10630,11,0.1,10630,11,0.1,10629,10631,1400-2-15,2021-05-05
133,واحيا,م .صنايع و معادن احياء سپاهان,428,544333,73594309672,134419,134330,135300,881,0.66,135201,782,0.58,134320,137000,1400-2-15,2021-05-05
134,آسيا,بيمه آسيا,417,13890201,25627420845,1902,1845,1845,-57,-3,1870,-32,-1.68,1845,1845,1400-2-15,2021-05-05
135,سمتاز,سيمان ممتازان كرمان,416,800764,18377726292,23352,22885,22885,-467,-2,22980,-372,-1.59,22885,23431,1400-2-15,2021-05-05
136,شرنگي,شيميايي رنگين,406,157092,40587977843,251081,258613,258613,7532,3,258371,7290,2.9,246061,258613,1400-2-15,2021-05-05
137,جم,پتروشيمي جم,404,1029421,36126214160,35500,34440,35500,0,0,35350,-150,-0.42,34440,36490,1400-2-15,2021-05-05
138,آكورد,صندوق س. آرمان آتي كوثر-د,403,7238276,230980580179,31879,31909,31911,32,0.1,31911,32,0.1,31909,31915,1400-2-15,2021-05-05
139,تسه9908,امتياز تسهيلات مسكن آبان99,403,9160,4901415010,533786,510000,549000,15214,2.85,535089,1303,0.24,510000,554999,1400-2-15,2021-05-05
140,افران,صندوق س افرا نماد پايدار-ثابت,395,9673105,128152096317,13234,13242,13260,26,0.2,13248,14,0.11,13242,13270,1400-2-15,2021-05-05
141,تسه9802,امتياز تسهيلات مسكن ارديبهشت98,393,5246,2085939973,391112,410657,410667,19555,5,397625,6513,1.67,371662,410667,1400-2-15,2021-05-05
142,سيدكو,سرمايه گذاري توسعه صنايع سيمان,390,1741271,10067744130,5800,5630,5720,-80,-1.38,5800,0,0,5630,5980,1400-2-15,2021-05-05
143,كرماشا,صنايع پتروشيمي كرمانشاه,388,657220,21926662950,33760,32750,33500,-260,-0.77,33580,-180,-0.53,32750,34100,1400-2-15,2021-05-05
144,سخوز,سيمان خوزستان,388,845129,18045065750,21410,20770,21300,-110,-0.51,21390,-20,-0.09,20770,22690,1400-2-15,2021-05-05
145,سپ,پرداخت الكترونيك سامان كيش,378,1063131,22767509070,21520,20880,21500,-20,-0.09,21470,-50,-0.23,20880,21810,1400-2-15,2021-05-05
146,تسه9911,امتياز تسهيلات مسكن بهمن99,377,5440,2932276379,537899,525097,527166,-10733,-2,539021,1122,0.21,522970,564793,1400-2-15,2021-05-05
147,حسينا,توسعه خدمات دريايي وبندري سينا,376,275349,15830592275,58371,57448,57087,-1284,-2.2,58070,-301,-0.52,56811,59480,1400-2-15,2021-05-05
148,شساخت,مهندسي و ساختمان صنايع نفت,367,879605,35092344012,39161,40330,40238,1077,2.75,39802,641,1.64,38502,40330,1400-2-15,2021-05-05
149,ضسپا3003,اختيارخ خساپا-2000-1400/03/26,365,16091,1260022000,68,77,70,2,2.94,78,10,14.71,66,100,1400-2-15,2021-05-05
150,كاريس,صندوق س.سپهر كاريزما-س,360,2055066,21261430146,10311,10221,10345,34,0.33,10346,35,0.34,10221,10460,1400-2-15,2021-05-05
151,دالبرح,ح . البرزدارو,358,469408,4102901790,8810,8500,8800,-10,-0.11,8740,-70,-0.79,8500,8940,1400-2-15,2021-05-05
152,ياقوت,صندوق س ياقوت آگاه-ثابت,355,7309997,90357354204,12351,12349,12349,-2,-0.02,12361,10,0.08,12340,12366,1400-2-15,2021-05-05
153,حكشتي,كشتيراني جمهوري اسلامي ايران,339,1569922,25322841860,16620,16130,16130,-490,-2.95,16510,-110,-0.66,16130,16130,1400-2-15,2021-05-05
154,فسپا,گروه‌صنعتي‌سپاهان‌,337,1171360,41737299270,36730,35630,35630,-1100,-2.99,35770,-960,-2.61,35630,36070,1400-2-15,2021-05-05
155,وصندوق,سرمايه‌گذاري‌صندوق‌بازنشستگي‌,332,1760571,24618487220,14320,13900,13920,-400,-2.79,14250,-70,-0.49,13900,14240,1400-2-15,2021-05-05
156,زر,صندوق س.پشتوانه سكه طلاي زر,330,337581,12877558023,39066,38505,37999,-1067,-2.73,38147,-919,-2.35,37523,38997,1400-2-15,2021-05-05
157,كنور,توسعه معدني و صنعتي صبانور,326,396064,19251919810,47610,47300,48380,770,1.62,47950,340,0.71,47000,50000,1400-2-15,2021-05-05
158,پاكشو,گروه صنعتي پاكشو,324,2826986,17427578470,6350,6160,6160,-190,-2.99,6320,-30,-0.47,6160,6290,1400-2-15,2021-05-05
159,سپاس,صندوق س. پاداش سهامداري-ثابت,323,14359912,146068546887,10162,10172,10171,9,0.09,10172,10,0.1,10170,10174,1400-2-15,2021-05-05
160,گوهران,سرمايه گذاري توسعه گوهران اميد,318,940636,6465330032,6961,6753,6860,-101,-1.45,6949,-12,-0.17,6753,6961,1400-2-15,2021-05-05
161,گشان,توسعه بين المللي پديده شانديز,308,649535,14645065645,23486,22547,22547,-939,-4,22547,-939,-4,22547,22547,1400-2-15,2021-05-05
162,ضجار2003,اختيارخ وتجارت-3000-1400/02/22,307,17581,91068000,6,7,5,-1,-16.67,5,-1,-16.67,3,8,1400-2-15,2021-05-05
163,وثوق,سرمايه گذاري وثوق امين,307,901014,15662326362,17737,17383,17383,-354,-2,17444,-293,-1.65,17383,17383,1400-2-15,2021-05-05
164,ضسپا3004,اختيارخ خساپا-2500-1400/03/26,306,18248,410346000,21,39,20,-1,-4.76,22,1,4.76,17,39,1400-2-15,2021-05-05
165,تيپيكو,سرمايه گذاري دارويي تامين,306,290958,10008422560,34790,33870,34300,-490,-1.41,34720,-70,-0.2,33870,35000,1400-2-15,2021-05-05
166,پارتا,مجتمع‌صنعتي‌آرتاويل‌تاير,299,1266404,37358844384,29146,28564,30020,874,3,29500,354,1.21,28564,30020,1400-2-15,2021-05-05
167,وتوسم,سرمايه‌گذاري‌توسعه‌ملي‌,279,1415266,10871371570,7910,7680,7700,-210,-2.65,7860,-50,-0.63,7680,7730,1400-2-15,2021-05-05
168,وخارزم,سرمايه گذاري خوارزمي,270,3610870,16429458500,4690,4550,4550,-140,-2.99,4641,-49,-1.04,4550,4550,1400-2-15,2021-05-05
169,وخاور,بانك خاورميانه,251,2045773,17650388970,8560,8400,8610,50,0.58,8580,20,0.23,8400,8740,1400-2-15,2021-05-05
170,تسه9810,امتياز تسهيلات مسكن دي98,250,4602,2432823399,527487,520011,518010,-9477,-1.8,528645,1158,0.22,512200,539900,1400-2-15,2021-05-05
171,تنوين,تامين سرمايه نوين,245,2042277,14766302400,7190,7190,7290,100,1.39,7200,10,0.14,7190,7290,1400-2-15,2021-05-05
172,پارس,پتروشيمي پارس,243,183900,26231261640,141760,141990,142900,1140,0.8,142000,240,0.17,140100,144130,1400-2-15,2021-05-05
173,شنفت,نفت‌ پارس‌,241,254419,12021543020,47280,45870,46450,-830,-1.76,47270,-10,-0.02,45870,48120,1400-2-15,2021-05-05
174,تسه9910,امتياز تسهيلات مسكن دي99,231,2919,1568104295,535909,540000,530000,-5909,-1.1,537206,1297,0.24,520100,562000,1400-2-15,2021-05-05
175,شيراز,پتروشيمي‌شيراز,229,242620,12570726680,52480,51350,50990,-1490,-2.84,52390,-90,-0.17,50920,53550,1400-2-15,2021-05-05
176,كاردان,صندوق س تجارت شاخصي كاردان,228,53815,7826980760,142950,145000,144700,1750,1.22,145440,2490,1.74,143510,147270,1400-2-15,2021-05-05
177,سشرق,سيمان‌ شرق‌,226,3230135,19413191350,6190,6010,6010,-180,-2.91,6120,-70,-1.13,6010,6020,1400-2-15,2021-05-05
178,فردا2,صندوق س آواي فرداي زاگرس-ثابت,220,22000000,22000000,10619,1,1,-10618,-99.99,1,-10618,-99.99,1,1,1400-2-15,2021-05-05
179,گوهر,صندوق سكه طلاي كيان,219,125714,5587491507,45631,44530,44001,-1630,-3.57,44446,-1185,-2.6,44000,45333,1400-2-15,2021-05-05
180,تسه9909,امتياز تسهيلات مسكن آذر99,219,2886,1545231845,534921,521000,530000,-4921,-0.92,535423,502,0.09,510000,560000,1400-2-15,2021-05-05
181,سحرخيز,صندوق س. گروه زعفران سحرخيز,219,925385,8326497290,9062,9022,9002,-60,-0.66,8998,-64,-0.71,8860,9140,1400-2-15,2021-05-05
182,درازك,دارويي‌ رازك‌,218,764262,23081448350,31130,30200,30200,-930,-2.99,30680,-450,-1.45,30200,30300,1400-2-15,2021-05-05
183,تسه9902,امتياز تسهيلات مسكن ارديبهشت99,215,4484,2425519669,531623,540000,520000,-11623,-2.19,540928,9305,1.75,516222,550000,1400-2-15,2021-05-05
184,عيار,صندوق سكه طلاي مفيد,214,262129,6052317998,23620,23000,23100,-520,-2.2,23089,-531,-2.25,22999,23288,1400-2-15,2021-05-05
185,شرانل,نفت ايرانول,209,304844,11878942912,39452,38270,38801,-651,-1.65,39333,-119,-0.3,38270,39500,1400-2-15,2021-05-05
186,شصفها,پتروشيمي‌ اصفهان‌,202,94930,12172441485,130098,130000,127497,-2601,-2,128617,-1481,-1.14,127497,131131,1400-2-15,2021-05-05
187,اطلس,صندوق س.توسعه اندوخته آينده-س,198,62358,12319309199,196382,193600,197800,1418,0.72,197558,1176,0.6,193600,199999,1400-2-15,2021-05-05
188,خراسان,پتروشيمي خراسان,197,97889,6658379280,69080,67110,67250,-1830,-2.65,68940,-140,-0.2,67010,69970,1400-2-15,2021-05-05
189,شخارك,پتروشيمي‌ خارك‌,196,224031,9674388470,43490,42190,42740,-750,-1.72,43460,-30,-0.07,42190,43980,1400-2-15,2021-05-05
190,كاما,باما,195,705540,8127820800,11870,11520,11520,-350,-2.95,11810,-60,-0.51,11520,11520,1400-2-15,2021-05-05
191,واتي,سرمايه‌ گذاري‌ آتيه‌ دماوند,187,1374069,13355950680,10330,9720,9720,-610,-5.91,10160,-170,-1.65,9720,9720,1400-2-15,2021-05-05
192,ونفت,سرمايه‌گذاري‌ صنعت‌ نفت‌,186,791522,10844930650,14120,13700,13700,-420,-2.97,14020,-100,-0.71,13700,13990,1400-2-15,2021-05-05
193,اخابر,مخابرات ايران,174,3455324,32065406720,9560,9280,9280,-280,-2.93,9480,-80,-0.84,9280,9280,1400-2-15,2021-05-05
194,فيروزه,صندوق شاخص30 شركت فيروزه- سهام,169,46582,5950124850,127510,126050,127600,90,0.07,127730,220,0.17,126050,128880,1400-2-15,2021-05-05
195,شلعابح,ح . لعابيران‌,169,1324081,12877856300,10310,10600,9700,-610,-5.92,9730,-580,-5.63,9700,10600,1400-2-15,2021-05-05
196,شكبير,پتروشيمي اميركبير,167,714106,59138523221,84459,82770,82770,-1689,-2,83441,-1018,-1.21,82770,84459,1400-2-15,2021-05-05
197,لوتوس,تامين سرمايه لوتوس پارسيان,164,757918,6880898480,9320,9080,9100,-220,-2.36,9290,-30,-0.32,9050,9170,1400-2-15,2021-05-05
198,وبشهر,توسعه‌ صنايع‌ بهشهر(هلدينگ,162,2499416,25818967280,10640,10330,10330,-310,-2.91,10470,-170,-1.6,10330,10330,1400-2-15,2021-05-05
199,سشمال,سيمان‌ شمال‌,162,1371083,13299505100,9990,9700,9700,-290,-2.9,9910,-80,-0.8,9700,9700,1400-2-15,2021-05-05
200,آساس,صندوق س.آسمان آرماني سهام-س,161,87061,14133285349,161766,161330,162200,434,0.27,162338,572,0.35,160000,163710,1400-2-15,2021-05-05
201,نهال,صندوق س. طلاي سرخ نوويرا,158,300597,2717907143,9013,8822,9101,88,0.98,9042,29,0.32,8822,9250,1400-2-15,2021-05-05
202,بفجر,فجر انرژي خليج فارس,157,814276,17029771710,20990,20370,20460,-530,-2.53,20970,-20,-0.1,20370,21200,1400-2-15,2021-05-05
203,تسه9907,امتياز تسهيلات مسكن مهر99,156,2092,1123173390,539069,513333,520000,-19069,-3.54,536890,-2179,-0.4,512522,566022,1400-2-15,2021-05-05
204,وسپه,سرمايه‌گذاري‌ سپه‌,153,1326306,8263684180,6420,6230,6230,-190,-2.96,6390,-30,-0.47,6230,6300,1400-2-15,2021-05-05
205,شبريز,پالايش نفت تبريز,152,477290,11769971400,25420,24660,24660,-760,-2.99,25320,-100,-0.39,24660,24660,1400-2-15,2021-05-05
206,وبازار,صندوق س شاخصي بازارآشنا,151,1184740,10579858150,8940,8840,9000,60,0.67,8930,-10,-0.11,8830,9180,1400-2-15,2021-05-05
207,ماديرا,صنايع ماديران,151,2533792,18674047040,7597,7370,7370,-227,-2.99,7506,-91,-1.2,7370,7370,1400-2-15,2021-05-05
208,پكرمان,گروه‌ صنعتي‌ بارز,145,1725457,42256441930,25240,24490,24490,-750,-2.97,24580,-660,-2.61,24490,24490,1400-2-15,2021-05-05
209,شبصير,توليدات پتروشيمي قائد بصير,143,367445,24215444286,67925,65888,65888,-2037,-3,66912,-1013,-1.49,65888,68000,1400-2-15,2021-05-05
210,كيان2,صندوق س. با درآمد ثابت كيان,142,14200000,14200000,28257,1,1,-28256,-100,1,-28256,-100,1,1,1400-2-15,2021-05-05
211,سامان,بانك سامان,141,786564,6786901126,8534,8534,8602,68,0.8,8550,16,0.19,8534,8780,1400-2-15,2021-05-05
212,تسه9904,امتياز تسهيلات مسكن تير99,139,1504,800880075,534107,510050,524000,-10107,-1.89,532500,-1607,-0.3,510050,560812,1400-2-15,2021-05-05
213,داروح,ح . كارخانجات‌داروپخش,139,1510823,29584851340,20820,21200,19580,-1240,-5.96,19580,-1240,-5.96,19580,21200,1400-2-15,2021-05-05
214,سكه0012پ04,تمام سكه طرح جديد0012صادرات,134,39500,35725592300,933366,906000,904800,-28566,-3.06,904445,-28921,-3.1,903002,913000,1400-2-15,2021-05-05
215,بترانس,ايران‌ ترانسفو,132,1558912,4285449088,2833,2749,2749,-84,-2.97,2826,-7,-0.25,2749,2749,1400-2-15,2021-05-05
216,بساما,بيمه سامان,131,1743711,37563040837,22208,21542,21542,-666,-3,21685,-523,-2.36,21542,21600,1400-2-15,2021-05-05
217,ثباغ,شهر سازي و خانه سازي باغميشه,131,682785,10158332840,15337,14877,14877,-460,-3,15239,-98,-0.64,14877,14950,1400-2-15,2021-05-05
218,فافزا,فولاد افزا سپاهان,124,134131,6632297548,50451,49442,49442,-1009,-2,50099,-352,-0.7,49442,49500,1400-2-15,2021-05-05
219,وحكمت,بيمه حكمت صبا,122,1406449,4788154974,3473,3404,3404,-69,-1.99,3456,-17,-0.49,3404,3430,1400-2-15,2021-05-05
220,ولپارس,ليزينگ پارسيان,121,1014001,4928044860,5010,4860,4860,-150,-2.99,4990,-20,-0.4,4860,4860,1400-2-15,2021-05-05
221,ضخود7074,اختيارخ خودرو-1800-1400/07/07,121,5778,2219075000,361,390,359,-2,-0.55,384,23,6.37,345,405,1400-2-15,2021-05-05
222,سكه0112پ03,تمام سكه طرح جديد0112سامان,120,26100,23620219500,932549,910100,905000,-27549,-2.95,904989,-27560,-2.96,903102,910100,1400-2-15,2021-05-05
223,تسه9906,امتياز تسهيلات مسكن شهريور99,118,1989,1068183684,536354,518122,535000,-1354,-0.25,537046,692,0.13,518122,560000,1400-2-15,2021-05-05
224,بكام,كارخانجات توليدي شهيد قندي,117,730853,2713657189,3949,3713,3713,-236,-5.98,3935,-14,-0.35,3713,3713,1400-2-15,2021-05-05
225,واعتبار,سرمايه گذاري اعتبار ايران,117,2545024,22803415040,8460,8960,8960,500,5.91,8660,200,2.36,8960,8960,1400-2-15,2021-05-05
226,مارون,پتروشيمي مارون,117,84339,12350498023,150040,145539,146005,-4035,-2.69,149578,-462,-0.31,145539,150191,1400-2-15,2021-05-05
227,قپيرا,فرآورده‌هاي‌غدايي‌وقندپيرانشهر,114,29561,2950322340,102580,100000,99510,-3070,-2.99,102410,-170,-0.17,99510,101090,1400-2-15,2021-05-05
228,فروي,ذوب روي اصفهان,114,80173,4451044614,57235,55518,55518,-1717,-3,57075,-160,-0.28,55518,55518,1400-2-15,2021-05-05
229,اتكاي,بيمه اتكايي ايرانيان,113,731042,11835921642,16687,16187,16187,-500,-3,16563,-124,-0.74,16187,16699,1400-2-15,2021-05-05
230,تسه9808,امتياز تسهيلات مسكن آبان98,113,1374,735154942,530066,515621,520037,-10029,-1.89,535047,4981,0.94,515621,556569,1400-2-15,2021-05-05
231,فيروزا,صندوق بادرآمد ثابت فيروزه آسيا,113,1771404,40210890599,22651,22769,22733,82,0.36,22700,49,0.22,22632,22769,1400-2-15,2021-05-05
232,خاتم,صندوق س خاتم ايساتيس پويا-ثابت,111,2217013,24523389677,11050,11062,11064,14,0.13,11061,11,0.1,11051,11064,1400-2-15,2021-05-05
233,تسه9903,امتياز تسهيلات مسكن خرداد99,107,1290,693067996,543460,518050,525000,-18460,-3.4,537262,-6198,-1.14,517222,569499,1400-2-15,2021-05-05
234,لبوتان,گروه‌صنعتي‌بوتان‌,106,86208,5054679860,60250,58450,58450,-1800,-2.99,60080,-170,-0.28,58450,61000,1400-2-15,2021-05-05
235,سكه0011پ02,تمام سكه طرح جديد0011ملت,105,20100,18183655700,931892,912000,904000,-27892,-2.99,904659,-27233,-2.92,902001,915500,1400-2-15,2021-05-05
236,تسه9905,امتياز تسهيلات مسكن مرداد99,105,1553,830746064,541464,518899,522223,-19241,-3.55,534930,-6534,-1.21,518899,560000,1400-2-15,2021-05-05
237,تسه9804,امتياز تسهيلات مسكن تير98,103,1121,604407918,539736,536000,530010,-9726,-1.8,539168,-568,-0.11,515000,547910,1400-2-15,2021-05-05
238,زعف0008پ05,زعفران0008نگين زرين(پ),103,49627,6082415574,122316,120801,121050,-1266,-1.04,122563,247,0.2,119902,123599,1400-2-15,2021-05-05
239,سكرما,سيمان‌ كرمان‌,103,782657,11865080120,15620,15160,15160,-460,-2.94,15510,-110,-0.7,15160,15160,1400-2-15,2021-05-05
240,وسبحان,سرمايه گذاري سبحان,102,6940711,19406227956,2882,2796,2796,-86,-2.98,2847,-35,-1.21,2796,2796,1400-2-15,2021-05-05
241,صايند,صندوق س. گنجينه آينده روشن-د,99,622890,6081875570,9790,9780,9752,-38,-0.39,9764,-26,-0.27,9752,9780,1400-2-15,2021-05-05
242,غسالم,سالمين‌,98,687623,2656975272,3983,3864,3864,-119,-2.99,3976,-7,-0.18,3864,3864,1400-2-15,2021-05-05
243,تسه9901,امتياز تسهيلات مسكن فروردين99,98,1053,568472815,546322,521551,519006,-27316,-5,539860,-6462,-1.18,519006,569999,1400-2-15,2021-05-05
244,ما,بيمه  ما,95,755399,5408732500,7380,7160,7160,-220,-2.98,7360,-20,-0.27,7160,7180,1400-2-15,2021-05-05
245,اخزا910,اسنادخزانه-م10بودجه99-020807,94,138151,83902199249,607291,606001,606650,-641,-0.11,607322,31,0.01,606001,609000,1400-2-15,2021-05-05
246,تسه9812,امتياز تسهيلات مسكن اسفند98,93,889,471040446,526593,502009,520000,-6593,-1.25,529854,3261,0.62,502009,552922,1400-2-15,2021-05-05
247,كفپارس,فرآورده‌هاي‌ نسوز پارس‌,89,628351,1998784531,3279,3181,3181,-98,-2.99,3273,-6,-0.18,3181,3181,1400-2-15,2021-05-05
248,حفاري,حفاري شمال,87,665363,4231708680,6550,6360,6360,-190,-2.9,6530,-20,-0.31,6360,6360,1400-2-15,2021-05-05
249,شتولي,تولي‌پرس‌,85,142740,5030443080,34551,35242,35242,691,2,34871,320,0.93,35242,35242,1400-2-15,2021-05-05
250,ولانا,شركت ليزينگ آريا دانا,85,189597,7527000900,40510,39700,39700,-810,-2,40199,-311,-0.77,39700,39700,1400-2-15,2021-05-05
251,خودكفا,اقتصادي و خودكفايي آزادگان,82,179028,3111148584,18102,17378,17378,-724,-4,18042,-60,-0.33,17378,17378,1400-2-15,2021-05-05
252,سپاها,سيمان‌سپاهان‌,81,539296,4276617280,8170,7930,7930,-240,-2.94,8150,-20,-0.24,7930,7930,1400-2-15,2021-05-05
253,خصدرا,صنعتي‌ دريايي‌ ايران‌,79,825627,2100395088,2595,2544,2544,-51,-1.97,2591,-4,-0.15,2544,2544,1400-2-15,2021-05-05
254,خزاميا,زامياد,78,766060,6534491800,8790,8530,8530,-260,-2.96,8750,-40,-0.46,8530,8530,1400-2-15,2021-05-05
255,تسه9809,امتياز تسهيلات مسكن آذر98,78,477,251625957,529603,504000,526900,-2703,-0.51,527518,-2085,-0.39,504000,550000,1400-2-15,2021-05-05
256,تسه9805,امتياز تسهيلات مسكن مرداد98,76,710,381423967,541472,522530,535020,-6452,-1.19,537217,-4255,-0.79,522530,545000,1400-2-15,2021-05-05
257,تسه9807,امتياز تسهيلات مسكن مهر98,75,509,272255800,525638,526010,530001,4363,0.83,534884,9246,1.76,526010,550000,1400-2-15,2021-05-05
258,تسه9811,امتياز تسهيلات مسكن بهمن98,74,631,335809740,529009,512000,529800,791,0.15,532187,3178,0.6,512000,555459,1400-2-15,2021-05-05
259,تسه9806,امتياز تسهيلات مسكن شهريور98,74,605,321694709,530934,517010,533600,2666,0.5,531727,793,0.15,517010,540000,1400-2-15,2021-05-05
260,زعف0008پ16,زعفران0008نگين بيرجند(پ),73,15313,1861492825,121600,118500,118505,-3095,-2.55,121563,-37,-0.03,117621,122500,1400-2-15,2021-05-05
261,ضخود7077,اختيارخ خودرو-3000-1400/07/07,73,4489,347558000,71,72,75,4,5.63,77,6,8.45,69,89,1400-2-15,2021-05-05
262,زرين,صندوق س. سهام زرين كوروش-س,72,203800,1899335564,9093,9460,9200,107,1.18,9320,227,2.5,9111,9510,1400-2-15,2021-05-05
263,اخزا903,اسنادخزانه-م3بودجه99-011110,71,150252,105907401734,703804,705990,704400,596,0.08,704865,1061,0.15,703521,705990,1400-2-15,2021-05-05
264,كدما,معدني‌ دماوند,71,29521,2854975910,99700,96710,96710,-2990,-3,99430,-270,-0.27,96710,96710,1400-2-15,2021-05-05
265,اخزا909,اسنادخزانه-م9بودجه99-020316,70,362595,238816625454,658204,659000,657038,-1166,-0.18,658632,428,0.07,657038,661000,1400-2-15,2021-05-05
266,فاراك,ماشين‌ سازي‌ اراك‌,65,775343,1803447818,2397,2326,2326,-71,-2.96,2394,-3,-0.13,2326,2326,1400-2-15,2021-05-05
267,بكهنوج,توليد برق ماهتاب كهنوج,64,587962,936035504,1641,1592,1592,-49,-2.99,1640,-1,-0.06,1592,1592,1400-2-15,2021-05-05
268,ساروج,بين المللي ساروج بوشهر,64,494458,8819014662,18186,17824,18100,-86,-0.47,18025,-161,-0.89,17823,18489,1400-2-15,2021-05-05
269,ضملي3002,اختيارخ فملي-10000-1400/03/02,64,1271,2608898000,1176,1450,2099,923,78.49,2053,877,74.57,1450,2200,1400-2-15,2021-05-05
270,بموتو,موتوژن‌,63,36523,1883125880,53150,51560,51560,-1590,-2.99,53090,-60,-0.11,51560,51560,1400-2-15,2021-05-05
271,افق ملت,صندوق س در سهام افق ملت,62,28414,3444982100,121260,120610,121300,40,0.03,121240,-20,-0.02,120610,122900,1400-2-15,2021-05-05
272,اخزا902,اسنادخزانه-م2بودجه99-011019,62,106937,76295339989,713465,712600,713011,-454,-0.06,713461,-4,0,712500,714979,1400-2-15,2021-05-05
273,اخزا901,اسنادخزانه-م1بودجه99-010621,62,37776,28773781153,761097,759600,760400,-697,-0.09,761695,598,0.08,758350,763000,1400-2-15,2021-05-05
274,كروي,توسعه‌ معادن‌ روي‌ ايران‌,61,379287,9618718320,26140,25360,25360,-780,-2.98,25980,-160,-0.61,25360,25360,1400-2-15,2021-05-05
275,ملت,بيمه ملت,58,104235,1577075550,15590,15130,15130,-460,-2.95,15580,-10,-0.06,15130,15130,1400-2-15,2021-05-05
276,فسازان,غلتك سازان سپاهان,56,434238,13891273620,32970,31990,31990,-980,-2.97,32690,-280,-0.85,31990,31990,1400-2-15,2021-05-05
277,زعف0008پ19,زعفران0008نگين تروند قاينات(پ),56,9300,1132686434,120729,122000,119500,-1229,-1.02,121794,1065,0.88,118010,122900,1400-2-15,2021-05-05
278,غپاك,لبنيات‌ پاك‌,55,120397,3491513000,30850,29000,29000,-1850,-6,30710,-140,-0.45,29000,29000,1400-2-15,2021-05-05
279,وثنو,سرمايه گذاري ساختماني نوين,55,465644,2102848304,4753,4516,4516,-237,-4.99,4725,-28,-0.59,4516,4516,1400-2-15,2021-05-05
280,وبوعلي,سرمايه‌گذاري‌بوعلي‌,54,543452,3043331200,5770,5600,5600,-170,-2.95,5760,-10,-0.17,5600,5600,1400-2-15,2021-05-05
281,ضخود7072,اختيارخ خودرو-1400-1400/07/07,53,836,617874000,721,750,699,-22,-3.05,739,18,2.5,699,769,1400-2-15,2021-05-05
282,فراز,صندوق س.سهام فراز داريك-س,51,71519,735724217,10260,10265,10300,40,0.39,10287,27,0.26,10265,10300,1400-2-15,2021-05-05
283,دقاضيح,ح . داروسازي شهيد قاضي,51,673137,17802608142,27548,27200,26447,-1101,-4,26447,-1101,-4,26447,27200,1400-2-15,2021-05-05
284,رتكو,كنترل‌خوردگي‌تكين‌كو,50,702090,12307637700,18070,17530,17530,-540,-2.99,17930,-140,-0.77,17530,17530,1400-2-15,2021-05-05
285,پلوله,گازلوله‌,50,457629,13678073181,29019,29889,29889,870,3,29572,553,1.91,29889,29889,1400-2-15,2021-05-05
286,قشرين,قند شيرين خراسان,50,916749,11005571745,12250,12005,12005,-245,-2,12101,-149,-1.22,12005,12005,1400-2-15,2021-05-05
287,ضشنا2002,اختيارخ شپنا-12000-1400/02/27,50,2201,229341000,106,110,90,-16,-15.09,104,-2,-1.89,88,175,1400-2-15,2021-05-05
288,ضملت3001,اختيارخ وبملت-3500-1400/03/19,50,466,668057000,1200,1400,1469,269,22.42,1434,234,19.5,1029,1500,1400-2-15,2021-05-05
289,اخزا815,اسنادخزانه-م15بودجه98-010406,49,40782,32496268912,797077,794510,796610,-467,-0.06,796829,-248,-0.03,794510,797300,1400-2-15,2021-05-05
290,ضملي7002,اختيارخ فملي-9720-1400/07/11,48,470,1331960000,2067,2800,2880,813,39.33,2834,767,37.11,2600,3200,1400-2-15,2021-05-05
291,ثروتم,صندوق س. ثروت آفرين پارسيان-س,46,146170,10437676010,70353,71200,71510,1157,1.64,71408,1055,1.5,71060,71848,1400-2-15,2021-05-05
292,دارا,صندوق س. دارا الگوريتم-د,45,931903,9357515873,10043,10058,10044,1,0.01,10041,-2,-0.02,10011,10058,1400-2-15,2021-05-05
293,وهور,مديريت انرژي اميد  تابان هور,45,312437,616750638,2035,1974,1974,-61,-3,2034,-1,-0.05,1974,1974,1400-2-15,2021-05-05
294,اتكام,شركت بيمه اتكايي امين,45,475368,2192627616,4754,4612,4612,-142,-2.99,4748,-6,-0.13,4612,4620,1400-2-15,2021-05-05
295,سپيدما,صندوق س. سپيد دماوند-د,45,1007496,10339611242,10252,10262,10267,15,0.15,10263,11,0.11,10262,10267,1400-2-15,2021-05-05
296,ضجار2002,اختيارخ وتجارت-2500-1400/02/22,45,2081,244370000,84,160,120,36,42.86,117,33,39.29,60,160,1400-2-15,2021-05-05
297,گكوثر,هتل پارسيان كوثر اصفهان,44,623513,1387939938,2294,2226,2226,-68,-2.96,2292,-2,-0.09,2226,2226,1400-2-15,2021-05-05
298,كزغال,زغال سنگ پروده طبس,43,215637,6651538902,31799,30846,30846,-953,-3,31667,-132,-0.42,30846,30846,1400-2-15,2021-05-05
299,وپويا,سرمايه گذاري پويا,42,784896,4923652608,6467,6273,6273,-194,-3,6447,-20,-0.31,6273,6273,1400-2-15,2021-05-05
300,وگستر,گسترش سرمايه گذاري ايرانيان,42,1332775,24914895850,19272,18694,18694,-578,-3,18975,-297,-1.54,18694,18694,1400-2-15,2021-05-05
301,آتيمس,صندوق س.آرمان آتيه درخشان مس-س,42,16368,2852743936,173993,172250,175000,1007,0.58,174288,295,0.17,172250,175898,1400-2-15,2021-05-05
302,ثاخت,بين‌المللي‌توسعه‌ساختمان,40,305997,735616788,2478,2404,2404,-74,-2.99,2477,-1,-0.04,2404,2404,1400-2-15,2021-05-05
303,ضخود7073,اختيارخ خودرو-1600-1400/07/07,40,1389,734670000,550,550,520,-30,-5.45,529,-21,-3.82,505,570,1400-2-15,2021-05-05
304,كوير,توليدي فولاد سپيد فراب كوير,39,1005421,19113053210,19590,19010,19010,-580,-2.96,19460,-130,-0.66,19010,19010,1400-2-15,2021-05-05
305,بورس,بورس اوراق بهادار تهران,39,388186,13147859820,34910,33870,33870,-1040,-2.98,34660,-250,-0.72,33870,33870,1400-2-15,2021-05-05
306,سپر,صندوق س سپر سرمايه بيدار- ثابت,37,270773,3186821439,11766,11770,11771,5,0.04,11769,3,0.03,11769,11771,1400-2-15,2021-05-05
307,وملي,گروه‌ صنعتي‌ ملي‌ (هلدينگ‌,36,7968,1320058560,170790,165670,165670,-5120,-3,170650,-140,-0.08,165670,165670,1400-2-15,2021-05-05
308,چكاپا,گروه صنايع كاغذ پارس,34,104125,524790000,5190,5040,5040,-150,-2.89,5190,0,0,5040,5040,1400-2-15,2021-05-05
309,ضملت3002,اختيارخ وبملت-4000-1400/03/19,34,1451,1417715000,827,755,1000,173,20.92,977,150,18.14,755,1000,1400-2-15,2021-05-05
310,فرابورس,فرابورس ايران,33,26920,818018040,31326,30387,30387,-939,-3,31310,-16,-0.05,30387,30387,1400-2-15,2021-05-05
311,انرژي3,سايراشخاص بورس انرژي,33,3625,882832500,251070,243540,243540,-7530,-3,250960,-110,-0.04,243540,243540,1400-2-15,2021-05-05
312,هنوري102,اختيارف ت نوري59561-01/02/15,33,300000,1281000000,3690,4270,4270,580,15.72,4270,580,15.72,4270,4270,1400-2-15,2021-05-05
313,چدن,توليدي چدن سازان,33,21920,519284800,24420,23690,23690,-730,-2.99,24410,-10,-0.04,23690,23690,1400-2-15,2021-05-05
314,ثنوسا,نوسازي‌وساختمان‌تهران‌,32,171851,2167041110,13000,12610,12610,-390,-3,12980,-20,-0.15,12610,12610,1400-2-15,2021-05-05
315,كالا,بورس كالاي ايران,32,13074,404640300,31900,30950,30950,-950,-2.98,31890,-10,-0.03,30950,30950,1400-2-15,2021-05-05
316,ختوقا,قطعات‌ اتومبيل‌ ايران‌,32,193607,471433045,2510,2435,2435,-75,-2.99,2509,-1,-0.04,2435,2435,1400-2-15,2021-05-05
317,وگردش,بانك گردشگري,31,1251241,20451534145,17026,16345,16345,-681,-4,16881,-145,-0.85,16345,16345,1400-2-15,2021-05-05
318,ضپاس7028,اختيارخ وپارس-2000-1400/07/28,31,320,187377000,534,625,570,36,6.74,586,52,9.74,550,625,1400-2-15,2021-05-05
319,زملارد,كشاورزي و دامپروري ملارد شير,31,28893,1053698817,37596,36469,36469,-1127,-3,37571,-25,-0.07,36469,36469,1400-2-15,2021-05-05
320,اخزا905,اسنادخزانه-م5بودجه99-020218,31,81785,54667615431,667867,665120,668750,883,0.13,668431,564,0.08,664000,668856,1400-2-15,2021-05-05
321,تمحركه,ماشين سازي نيرو محركه,31,84136,2050730864,25389,24374,24374,-1015,-4,25280,-109,-0.43,24374,24374,1400-2-15,2021-05-05
322,سبزوا,سيمان لار سبزوار,30,140261,451920942,3321,3222,3222,-99,-2.98,3320,-1,-0.03,3222,3222,1400-2-15,2021-05-05
323,آكورد2,صندوق س. آرمان آتي كوثر-د,30,3000000,3000000,31879,1,1,-31878,-100,1,-31878,-100,1,1,1400-2-15,2021-05-05
324,اخزا821,اسنادخزانه-م21بودجه98-020906,29,9738,5853403094,606794,604999,601100,-5694,-0.94,601089,-5705,-0.94,600500,604999,1400-2-15,2021-05-05
325,پتاير,ايران‌ تاير,29,263584,938095456,3669,3559,3559,-110,-3,3667,-2,-0.05,3559,3559,1400-2-15,2021-05-05
326,خمحور,توليدمحورخودرو,28,19382,1194706480,63540,61640,61640,-1900,-2.99,63490,-50,-0.08,61640,61640,1400-2-15,2021-05-05
327,وپست,پست بانك ايران,28,159917,3155162410,20330,19730,19730,-600,-2.95,20290,-40,-0.2,19730,19730,1400-2-15,2021-05-05
328,ضخوز2012,اختيارخ فخوز-10000-1400/02/15,28,665,2799623000,4086,4100,4320,234,5.73,4210,124,3.03,3002,4500,1400-2-15,2021-05-05
329,اوصتا,صندوق انديشه ورزان صباتامين -د,28,109051,2021441530,18520,18540,18540,20,0.11,18537,17,0.09,18530,18540,1400-2-15,2021-05-05
330,ضملي3004,اختيارخ فملي-14000-1400/03/02,28,1063,70835000,192,100,50,-142,-73.96,67,-125,-65.1,50,147,1400-2-15,2021-05-05
331,صنوين,صندوق سرمايه‌گذاري صنوين-مختلط,28,6375,652798910,103600,101830,102510,-1090,-1.05,102400,-1200,-1.16,101830,102880,1400-2-15,2021-05-05
332,شپترو,پتروشيمي آبادان,26,827562,3734787306,4605,4513,4513,-92,-2,4586,-19,-0.41,4513,4513,1400-2-15,2021-05-05
333,زعف0008پ20,زعفران0008نگين وحدت جام(پ),26,5450,664717150,122425,122500,121200,-1225,-1,121966,-459,-0.37,121200,122500,1400-2-15,2021-05-05
334,اخزا806,اسنادخزانه-م6بودجه98-000519,26,52437,49710457693,947909,947999,948201,292,0.03,948003,94,0.01,947999,948201,1400-2-15,2021-05-05
335,ولملت,واسپاري ملت,26,1313240,10072550800,7900,7670,7670,-230,-2.91,7850,-50,-0.63,7670,7670,1400-2-15,2021-05-05
336,ضشنا8003,اختيارخ شپنا-8800-1400/08/16,26,548,875122000,2094,1600,1600,-494,-23.59,1597,-497,-23.73,1500,1600,1400-2-15,2021-05-05
337,شفارا,پتروشيمي فارابي,25,1631855,6021544950,3765,3690,3690,-75,-1.99,3742,-23,-0.61,3690,3690,1400-2-15,2021-05-05
338,رتاپ,تجارت الكترونيك  پارسيان,25,183250,1227775000,6900,6700,6700,-200,-2.9,6890,-10,-0.14,6700,6700,1400-2-15,2021-05-05
339,آبادا,توليد نيروي برق آبادان,25,35958,439047180,12580,12210,12210,-370,-2.94,12580,0,0,12210,12210,1400-2-15,2021-05-05
340,زپارس,ملي كشت و صنعت و دامپروري پارس,25,265516,36707587000,142520,138250,138250,-4270,-3,139100,-3420,-2.4,138250,138250,1400-2-15,2021-05-05
341,ضملت3003,اختيارخ وبملت-4500-1400/03/19,25,334,179143000,381,500,590,209,54.86,536,155,40.68,500,590,1400-2-15,2021-05-05
342,سپيدار,سپيدار سيستم آسيا,25,3380,192832380,58815,57051,57051,-1764,-3,58808,-7,-0.01,57051,57051,1400-2-15,2021-05-05
343,سباقر,سيمان باقران,25,21863,334416448,15933,15296,15296,-637,-4,15922,-11,-0.07,15296,15296,1400-2-15,2021-05-05
344,آساميد,صندوق س.مشترك آسمان اميد -د,25,617806,7395518854,11962,11970,11974,12,0.1,11971,9,0.08,11970,11978,1400-2-15,2021-05-05
345,گنجين,صندوق س. گنجينه يكم آويد-د,25,760865,9703386275,12747,12766,12766,19,0.15,12753,6,0.05,12753,12766,1400-2-15,2021-05-05
346,ونيرو,سرمايه‌گذاري‌نيرو,25,186119,465483619,2578,2501,2501,-77,-2.99,2577,-1,-0.04,2501,2501,1400-2-15,2021-05-05
347,فوكا,فولاد كاويان,24,69987,800091384,11908,11432,11432,-476,-4,11894,-14,-0.12,11432,11432,1400-2-15,2021-05-05
348,ثشاهد,سرمايه‌ گذاري‌ شاهد,24,44564,752240320,17400,16880,16880,-520,-2.99,17390,-10,-0.06,16880,16880,1400-2-15,2021-05-05
349,ستران,سيمان‌ تهران‌,24,98831,2246428630,23430,22730,22730,-700,-2.99,23400,-30,-0.13,22730,22730,1400-2-15,2021-05-05
350,قرن,پديده شيمي قرن,24,15935,958330900,61990,60140,60140,-1850,-2.98,61950,-40,-0.06,60140,60140,1400-2-15,2021-05-05
351,خمحركه,نيرو محركه‌,24,51983,231948146,4599,4462,4462,-137,-2.98,4598,-1,-0.02,4462,4462,1400-2-15,2021-05-05
352,قثابت,قند ثابت‌ خراسان‌,24,5246,344294980,67650,65630,65630,-2020,-2.99,67640,-10,-0.01,65630,65630,1400-2-15,2021-05-05
353,ضملي3003,اختيارخ فملي-12000-1400/03/02,24,523,229329000,225,444,470,245,108.89,438,213,94.67,400,600,1400-2-15,2021-05-05
354,ثبهساز,بهساز كاشانه تهران,23,110034,243065106,2277,2209,2209,-68,-2.99,2277,0,0,2209,2209,1400-2-15,2021-05-05
355,دمعيار,صندوق س. توازن معيار-د,23,557609,5617609582,10064,10079,10078,14,0.14,10074,10,0.1,10073,10080,1400-2-15,2021-05-05
356,اخزا814,اسنادخزانه-م14بودجه98-010318,23,6945,5581361764,805511,805600,804799,-712,-0.09,803652,-1859,-0.23,803302,806000,1400-2-15,2021-05-05
357,شكف,كف,23,19885,2077763765,106621,104489,104489,-2132,-2,106197,-424,-0.4,104489,104489,1400-2-15,2021-05-05
358,زعف0008پ08,زعفران0008نگين روستا(پ),23,9446,1148728086,121682,122499,120028,-1654,-1.36,121610,-72,-0.06,120028,122500,1400-2-15,2021-05-05
359,فسرب,ملي‌ سرب‌وروي‌ ايران‌,22,4742,362478480,78800,76440,76440,-2360,-2.99,78780,-20,-0.03,76440,76440,1400-2-15,2021-05-05
360,كرازي,كارخانجات‌توليدي‌شيشه‌رازي‌,22,100923,2203149090,22500,21830,21830,-670,-2.98,22470,-30,-0.13,21830,21830,1400-2-15,2021-05-05
361,وسديد,گروه ‌صنعتي‌سديد,22,119636,333545168,2904,2788,2788,-116,-3.99,2903,-1,-0.03,2788,2788,1400-2-15,2021-05-05
362,جوين,كشت و صنعت جوين,22,116035,555227475,4984,4785,4785,-199,-3.99,4978,-6,-0.12,4785,4785,1400-2-15,2021-05-05
363,غپينو,پارس‌ مينو,22,42029,258478350,6340,6150,6150,-190,-3,6340,0,0,6150,6150,1400-2-15,2021-05-05
364,وبيمه,سرمايه‌ گذاري‌ صنعت‌ بيمه‌,21,146565,398070540,2800,2716,2716,-84,-3,2799,-1,-0.04,2716,2716,1400-2-15,2021-05-05
365,خريخت,صنايع‌ريخته‌گري‌ايران‌,21,304422,865471746,2930,2843,2843,-87,-2.97,2928,-2,-0.07,2843,2843,1400-2-15,2021-05-05
366,ضپاس2001,اختيارخ وپارس-2500-1400/02/29,21,1103,91110000,88,90,80,-8,-9.09,83,-5,-5.68,79,90,1400-2-15,2021-05-05
367,هپارس102,اختيارف ت پارس-157010-01/02/05,21,150000,607650000,3646,4051,4051,405,11.11,4051,405,11.11,4051,4051,1400-2-15,2021-05-05
368,ددام,داروسازي زاگرس فارمد پارس,21,136025,2893251750,21920,21270,21270,-650,-2.97,21880,-40,-0.18,21270,21270,1400-2-15,2021-05-05
369,اخزا818,اسنادخزانه-م18بودجه98-010614,21,4796,3678035799,768065,765101,765000,-3065,-0.4,766897,-1168,-0.15,764557,767979,1400-2-15,2021-05-05
370,ضپاس2002,اختيارخ وپارس-3000-1400/02/29,21,848,4675000,6,8,6,0,0,6,0,0,5,8,1400-2-15,2021-05-05
371,ختور,رادياتور ايران‌,20,155342,2960818520,19640,19060,19060,-580,-2.95,19600,-40,-0.2,19060,19060,1400-2-15,2021-05-05
372,خفولا,خدمات فني فولاد يزد,20,32642,1366949034,43621,41877,41877,-1744,-4,43497,-124,-0.28,41877,41877,1400-2-15,2021-05-05
373,بذر,صندوق س بذر اميد آفرين-سهام,20,15936,1443440980,90330,90720,90210,-120,-0.13,90580,250,0.28,90210,92670,1400-2-15,2021-05-05
374,ضغدر3002,اختيارخ وغدير-8200-1400/03/26,19,298,528880000,1663,1600,1850,187,11.24,1775,112,6.73,1600,1850,1400-2-15,2021-05-05
375,ولساپا,ليزينگ رايان‌ سايپا,19,403962,1296718020,3309,3210,3210,-99,-2.99,3306,-3,-0.09,3210,3210,1400-2-15,2021-05-05
376,هاي وب,داده گسترعصرنوين-هاي وب,19,42689,433720240,10470,10160,10160,-310,-2.96,10470,0,0,10160,10160,1400-2-15,2021-05-05
377,قجام,فرآوردههاي غذايي وقندتربت‌جام‌,19,601259,9701915224,16465,16136,16136,-329,-2,16139,-326,-1.98,16136,16136,1400-2-15,2021-05-05
378,باران,بيمه زندگي باران50%تاديه,19,191444,751226256,3738,3924,3924,186,4.98,3745,7,0.19,3924,3924,1400-2-15,2021-05-05
379,شاملا,معدني‌ املاح‌  ايران‌,19,10670,517815100,50030,48530,48530,-1500,-3,50010,-20,-0.04,48530,48530,1400-2-15,2021-05-05
380,وتوصا,گروه س توسعه صنعتي ايران,19,24538,276297880,11600,11260,11260,-340,-2.93,11600,0,0,11260,11260,1400-2-15,2021-05-05
381,شاروم,پتروشيمي اروميه,19,10356,194154288,19327,18748,18748,-579,-3,19325,-2,-0.01,18748,18748,1400-2-15,2021-05-05
382,لپارس,پارس‌ الكتريك‌,19,41991,3734259630,91680,88930,88930,-2750,-3,91470,-210,-0.23,88930,88930,1400-2-15,2021-05-05
383,هجرتح,ح . پخش هجرت,19,53501,986945945,19015,18500,18445,-570,-3,18447,-568,-2.99,18445,18500,1400-2-15,2021-05-05
384,واميد,گروه مديريت سرمايه گذاري اميد,18,271372,3286314920,12480,12110,12110,-370,-2.96,12470,-10,-0.08,12110,12110,1400-2-15,2021-05-05
385,ضشنا2003,اختيارخ شپنا-14000-1400/02/27,18,1440,27601000,18,19,11,-7,-38.89,19,1,5.56,4,50,1400-2-15,2021-05-05
386,رافزا,رايان هم افزا,18,6976,722148544,106720,103519,103519,-3201,-3,106672,-48,-0.04,103519,103519,1400-2-15,2021-05-05
387,اخزا810,اسنادخزانه-م10بودجه98-001006,18,11642,10221529045,879276,875846,879499,223,0.03,877987,-1289,-0.15,875846,879499,1400-2-15,2021-05-05
388,غزر,صنعتي زر ماكارون,18,11267,280435630,25650,24890,24890,-760,-2.96,25650,0,0,24890,24890,1400-2-15,2021-05-05
389,ورنا,سرمايه‌گذاري‌ رنا(هلدينگ‌,18,247758,1315594980,5470,5310,5310,-160,-2.93,5470,0,0,5310,5310,1400-2-15,2021-05-05
390,كخاك,صنايع‌خاك‌چيني‌ايران‌,18,23482,924955980,40600,39390,39390,-1210,-2.98,40580,-20,-0.05,39390,39390,1400-2-15,2021-05-05
391,ضفلا3004,اختيارخ فولاد-8560-1400/03/19,17,162,194680000,736,1200,1189,453,61.55,1202,466,63.32,1189,1250,1400-2-15,2021-05-05
392,همبين102,اختيارف ت مبين17952-01/02/10,17,377400,279276000,634,740,740,106,16.72,740,106,16.72,740,740,1400-2-15,2021-05-05
393,زعف0008پ09,زعفران0008نگين نوين(پ),17,5575,683302514,122052,123000,121300,-752,-0.62,122565,513,0.42,121300,123230,1400-2-15,2021-05-05
394,فخاس,فولاد خراسان,17,393717,10016160480,26220,25440,25440,-780,-2.97,26140,-80,-0.31,25440,25440,1400-2-15,2021-05-05
395,مفاخر,توسعه فناوري اطلاعات خوارزمي,17,260821,16117694516,63707,61796,61796,-1911,-3,63065,-642,-1.01,61796,61796,1400-2-15,2021-05-05
396,ضشنا2001,اختيارخ شپنا-10000-1400/02/27,17,508,227613000,443,600,550,107,24.15,448,5,1.13,310,800,1400-2-15,2021-05-05
397,غشهداب,كشت و صنعت شهداب ناب خراسان,17,265901,1022655246,3964,3846,3846,-118,-2.98,3962,-2,-0.05,3846,3846,1400-2-15,2021-05-05
398,اخزا907,اسنادخزانه-م7بودجه99-020704,17,86750,53683442139,617682,617700,619878,2196,0.36,618829,1147,0.19,617700,619998,1400-2-15,2021-05-05
399,سيستم,همكاران سيستم,17,48016,1195598400,25660,24900,24900,-760,-2.96,25640,-20,-0.08,24900,24900,1400-2-15,2021-05-05
400,والبر,سرمايه‌ گذاري‌ البرز(هلدينگ‌,17,22314,349883520,16160,15680,15680,-480,-2.97,16160,0,0,15680,15680,1400-2-15,2021-05-05
401,غمارگ,مارگارين‌,17,12244,361932640,31440,29560,29560,-1880,-5.98,31430,-10,-0.03,29560,29560,1400-2-15,2021-05-05
402,ضخوز2013,اختيارخ فخوز-12000-1400/02/15,16,248,573755000,1875,2000,2400,525,28,2314,439,23.41,1880,2450,1400-2-15,2021-05-05
403,وكارح,ح . بانك‌ كارآفرين‌,16,133299,215182973,1627,1627,1530,-97,-5.96,1614,-13,-0.8,1530,1627,1400-2-15,2021-05-05
404,كماسه,تامين‌ ماسه‌ ريخته‌گري‌,16,12882,546196800,43710,42400,42400,-1310,-3,43700,-10,-0.02,42400,42400,1400-2-15,2021-05-05
405,پكوير,كوير تاير,16,45800,571584000,12860,12480,12480,-380,-2.95,12860,0,0,12480,12480,1400-2-15,2021-05-05
406,بنيرو,نيروترانس‌,16,42204,616600440,15060,14610,14610,-450,-2.99,15050,-10,-0.07,14610,14610,1400-2-15,2021-05-05
407,اخزا809,اسنادخزانه-م9بودجه98-000923,15,6516,5768096307,885207,885207,885500,293,0.03,885220,13,0,883613,886000,1400-2-15,2021-05-05
408,حريل,ريل پردازسير,15,365478,1977235980,5577,5410,5410,-167,-2.99,5570,-7,-0.13,5410,5410,1400-2-15,2021-05-05
409,پارسيان,بيمه پارسيان,15,265115,2494732150,9700,9410,9410,-290,-2.99,9680,-20,-0.21,9410,9410,1400-2-15,2021-05-05
410,زگلدشت,كشت و دام گلدشت نمونه اصفهان,15,93370,1264883390,13965,13547,13547,-418,-2.99,13954,-11,-0.08,13547,13547,1400-2-15,2021-05-05
411,ضصاد3001,اختيارخ وبصادر-2000-1400/03/12,15,682,208760000,265,350,290,25,9.43,306,41,15.47,290,320,1400-2-15,2021-05-05
412,غگرجي,بيسكويت‌  گرجي‌,15,104419,1848216300,18240,17700,17700,-540,-2.96,18220,-20,-0.11,17700,17700,1400-2-15,2021-05-05
413,نمرينو,ايران‌ مرينوس‌,15,4167,443535480,113230,106440,106440,-6790,-6,113170,-60,-0.05,106440,106440,1400-2-15,2021-05-05
414,ضملت3004,اختيارخ وبملت-5000-1400/03/19,15,143,47297000,288,300,333,45,15.63,331,43,14.93,289,350,1400-2-15,2021-05-05
415,دالبر,البرزدارو,15,93062,1332647840,14760,14320,14320,-440,-2.98,14750,-10,-0.07,14320,14320,1400-2-15,2021-05-05
416,اخزا713,اسنادخزانه-م13بودجه97-000518,14,4879,4625842816,948239,947003,948999,760,0.08,948113,-126,-0.01,947002,948999,1400-2-15,2021-05-05
417,داريك,صندوق س.اعتماد داريك-د,14,50243,530288824,10554,10557,10560,6,0.06,10554,0,0,10554,10560,1400-2-15,2021-05-05
418,الماس,صندوق س.امين تدبيرگران فردا-س,14,1115,118547686,106030,106000,106110,80,0.08,106321,291,0.27,106000,107999,1400-2-15,2021-05-05
419,وصنا,گروه‌صنايع‌بهشهرايران‌,14,31899,174806520,5640,5480,5480,-160,-2.84,5640,0,0,5480,5480,1400-2-15,2021-05-05
420,وآرين,شركت توسعه اقتصادي آرين,14,35968,123298304,3497,3428,3428,-69,-1.97,3497,0,0,3428,3428,1400-2-15,2021-05-05
421,وآفري,بيمه كارآفرين,13,27187,88548059,3323,3257,3257,-66,-1.99,3323,0,0,3257,3257,1400-2-15,2021-05-05
422,اميد,تامين سرمايه اميد,13,16117,121199840,7750,7520,7520,-230,-2.97,7750,0,0,7520,7520,1400-2-15,2021-05-05
423,برن0003پ01,برنج طارم0003تجارت مازندران(پ),13,2360,658902000,278579,285000,279000,421,0.15,279196,617,0.22,276000,285000,1400-2-15,2021-05-05
424,وآيند,بانك  آينده,13,15845,254153800,16367,16040,16040,-327,-2,16366,-1,-0.01,16040,16040,1400-2-15,2021-05-05
425,ودي,بيمه  دي,13,31723,644167238,20934,20306,20306,-628,-3,20926,-8,-0.04,20306,20306,1400-2-15,2021-05-05
426,اراد50,مرابحه عام دولت5-ش.خ0302,13,153200,153204742000,1000029,1000000,1000001,-28,0,1000031,2,0,1000000,1000100,1400-2-15,2021-05-05
427,اخزا720,اسنادخزانه-م20بودجه97-000324,13,2229,2184717843,976640,977999,983000,6360,0.65,980134,3494,0.36,976631,983000,1400-2-15,2021-05-05
428,كحافظ,كاشي‌ وسراميك‌ حافظ‌,13,47276,549819880,11980,11630,11630,-350,-2.92,11980,0,0,11630,11630,1400-2-15,2021-05-05
429,خكاوه,سايپا ديزل,13,70352,243699328,3608,3464,3464,-144,-3.99,3606,-2,-0.06,3464,3464,1400-2-15,2021-05-05
430,شجم,صنايع پتروشيمي تخت جمشيد,12,55325,545449175,10269,9859,9859,-410,-3.99,10260,-9,-0.09,9859,9859,1400-2-15,2021-05-05
431,حفارس,حمل و نقل بين المللي خليج فارس,12,68984,322914104,4825,4681,4681,-144,-2.98,4824,-1,-0.02,4681,4681,1400-2-15,2021-05-05
432,اخزا804,اسنادخزانه-م4بودجه98-000421,12,5470,5260866746,964433,962000,964000,-433,-0.04,961767,-2666,-0.28,961750,964000,1400-2-15,2021-05-05
433,دلرح,ح . داروسازي‌ اكسير,12,6951,202246590,30940,29400,29090,-1850,-5.98,29100,-1840,-5.95,29090,29400,1400-2-15,2021-05-05
434,چخزر,صنايع چوب خزر كاسپين,12,1575,82361475,53910,52293,52293,-1617,-3,53907,-3,-0.01,52293,52293,1400-2-15,2021-05-05
435,اخزا721,اسنادخزانه-م21بودجه97-000728,12,5538,5047048053,911500,909008,912599,1099,0.12,911348,-152,-0.02,909007,912599,1400-2-15,2021-05-05
436,اخزا904,اسنادخزانه-م4بودجه99-011215,12,12346,8586437952,696408,695010,695600,-808,-0.12,695483,-925,-0.13,694000,695600,1400-2-15,2021-05-05
437,دزهراوي,داروسازي‌زهراوي‌,12,37913,320364850,8710,8450,8450,-260,-2.99,8710,0,0,8450,8450,1400-2-15,2021-05-05
438,حتايد,تايدواترخاورميانه,12,26081,643939890,25450,24690,24690,-760,-2.99,25440,-10,-0.04,24690,24690,1400-2-15,2021-05-05
439,تملي706,تسهيلات مسكن ب. ملي-شهريور97,11,292,145635652,518249,500000,518249,0,0,498752,-19497,-3.76,492337,518249,1400-2-15,2021-05-05
440,اخزا812,اسنادخزانه-م12بودجه98-001111,11,167276,144776464000,864769,864000,864000,-769,-0.09,865495,726,0.08,864000,866000,1400-2-15,2021-05-05
441,دلر,داروسازي‌ اكسير,11,5451,187841460,35520,34460,34460,-1060,-2.98,35520,0,0,34460,34460,1400-2-15,2021-05-05
442,سصوفي,سيمان‌ صوفيان‌,11,21028,405419840,19870,19280,19280,-590,-2.97,19870,0,0,19280,19280,1400-2-15,2021-05-05
443,اخزا908,اسنادخزانه-م8بودجه99-020606,11,10375,6522135666,629698,628555,628601,-1097,-0.17,628640,-1058,-0.17,628601,629000,1400-2-15,2021-05-05
444,ثزاگرس,سرمايه گذاري توسعه عمران زاگرس,11,44863,2445616719,57382,54513,54513,-2869,-5,57013,-369,-0.64,54513,54513,1400-2-15,2021-05-05
445,سيمرغ,سيمرغ,11,18859,334370070,18270,17730,17730,-540,-2.96,18270,0,0,17730,17730,1400-2-15,2021-05-05
446,ضترا3002,اختيارخ شتران-8000-1400/03/09,11,76,59101000,419,3001,500,81,19.33,778,359,85.68,400,3001,1400-2-15,2021-05-05
447,اخزا914,اسنادخزانه-م14بودجه99-021025,11,1953,1138383701,582791,583990,581050,-1741,-0.3,582890,99,0.02,581050,584000,1400-2-15,2021-05-05
448,اخزا817,اسنادخزانه-م17بودجه98-010512,11,3468,2704086846,781524,780000,779000,-2524,-0.32,779725,-1799,-0.23,779000,780000,1400-2-15,2021-05-05
449,اخزا811,اسنادخزانه-م11بودجه98-001013,11,103896,91132990464,876528,874784,877200,672,0.08,877156,628,0.07,874784,877200,1400-2-15,2021-05-05
450,ضملت3000,اختيارخ وبملت-3000-1400/03/19,10,49,79238000,1642,1888,2000,358,21.8,1617,-25,-1.52,871,2000,1400-2-15,2021-05-05
451,اپرداز,آتيه داده پرداز,10,19898,411689620,21329,20690,20690,-639,-3,21324,-5,-0.02,20690,20690,1400-2-15,2021-05-05
452,تملي701,تسهيلات مسكن ب. ملي-فروردين97,10,108,67888260,612494,643118,582000,-30494,-4.98,628595,16101,2.63,582000,643118,1400-2-15,2021-05-05
453,سخند,صندوق س.سپهرخبرگان نفت-د,10,43010,436523980,10142,10148,10148,6,0.06,10149,7,0.07,10148,10153,1400-2-15,2021-05-05
454,كگاز,شيشه‌ و گاز,10,7645,139291900,18780,18220,18220,-560,-2.98,18780,0,0,18220,18220,1400-2-15,2021-05-05
455,كمينا,شيشه سازي مينا,10,25591,617945877,25153,24147,24147,-1006,-4,25121,-32,-0.13,24147,24147,1400-2-15,2021-05-05
456,ضملت3005,اختيارخ وبملت-6000-1400/03/19,10,432,21584000,22,50,50,28,127.27,50,28,127.27,34,50,1400-2-15,2021-05-05
457,ضجار2000,اختيارخ وتجارت-1800-1400/02/22,10,231,137752000,543,700,656,113,20.81,596,53,9.76,400,800,1400-2-15,2021-05-05
458,آپ,آسان پرداخت پرشين,10,11745,198373050,17410,16890,16890,-520,-2.99,17410,0,0,16890,16890,1400-2-15,2021-05-05
459,چكارن,كارتن‌ ايران‌,10,43305,139918455,3330,3231,3231,-99,-2.97,3330,0,0,3231,3231,1400-2-15,2021-05-05
460,ساوه,سيمان ساوه,10,1487,80509154,55816,54142,54142,-1674,-3,55813,-3,-0.01,54142,54142,1400-2-15,2021-05-05
461,خرينگ,رينگ‌سازي‌مشهد,10,13343,678758410,52440,50870,50870,-1570,-2.99,52420,-20,-0.04,50870,50870,1400-2-15,2021-05-05
462,عيار2,صندوق سكه طلاي مفيد,10,100000,100000,23620,1,1,-23619,-100,1,-23619,-100,1,1,1400-2-15,2021-05-05
463,كبافق,معادن‌ بافق‌,10,4853,227605700,48350,46900,46900,-1450,-3,48340,-10,-0.02,46900,46900,1400-2-15,2021-05-05
464,تليسه,دامداري تليسه نمونه,10,49830,210282600,4350,4220,4220,-130,-2.99,4349,-1,-0.02,4220,4220,1400-2-15,2021-05-05
465,ضپيك7042,اختيارخ تاپيكو-8070-00/07/18,10,198,301018000,2200,1500,1501,-699,-31.77,1520,-680,-30.91,1500,1600,1400-2-15,2021-05-05
466,خمهر,مهركام‌پارس‌,10,39259,92572722,2430,2358,2358,-72,-2.96,2430,0,0,2358,2358,1400-2-15,2021-05-05
467,بميلا,توسعه بازرگاني آهن وفولادميلاد,10,16901,232084532,14012,13732,13732,-280,-2,14009,-3,-0.02,13732,13732,1400-2-15,2021-05-05
468,شوينده,مديريت صنعت شوينده ت.ص.بهشهر,10,9348,235569600,25970,25200,25200,-770,-2.96,25970,0,0,25200,25200,1400-2-15,2021-05-05
469,امين يكم2,صندوق درآمد ثابت امين يكم فردا,10,1000000,1000000,10097,1,1,-10096,-99.99,1,-10096,-99.99,1,1,1400-2-15,2021-05-05
470,كلر,كلر پارس,10,3213,404924751,129924,126027,126027,-3897,-3,129891,-33,-0.03,126027,126027,1400-2-15,2021-05-05
471,وايرا,سرمايه گذاري صنايع ايران,10,115850,1361121650,12238,11749,11749,-489,-4,12202,-36,-0.29,11749,11749,1400-2-15,2021-05-05
472,ضجار2001,اختيارخ وتجارت-2000-1400/02/22,9,480,249420000,454,500,524,70,15.42,520,66,14.54,500,600,1400-2-15,2021-05-05
473,ضترا8056,اختيارخ شتران-2558-1400/08/09,9,37,97450000,1,2900,2650,2649,264900,2634,2633,263300,2600,2900,1400-2-15,2021-05-05
474,فولاي,صنايع فولاد آلياژي يزد,9,165170,8138421410,50796,49273,49273,-1523,-3,50540,-256,-0.5,49273,49273,1400-2-15,2021-05-05
475,تايرا,تراكتورسازي‌ايران‌,9,48590,1272086200,26980,26180,26180,-800,-2.97,26960,-20,-0.07,26180,26180,1400-2-15,2021-05-05
476,وبهمن,سرمايه‌گذاري‌بهمن‌,9,209338,2909798200,14320,13900,13900,-420,-2.93,14290,-30,-0.21,13900,13900,1400-2-15,2021-05-05
477,سجام,مجتمع سيمان غرب آسيا,9,26606,111239686,4266,4181,4181,-85,-1.99,4266,0,0,4181,4181,1400-2-15,2021-05-05
478,اخزا808,اسنادخزانه-م8بودجه98-000817,9,13527,12212848958,901701,899828,903999,2298,0.25,902850,1149,0.13,899828,903999,1400-2-15,2021-05-05
479,بزاگرس,نيروگاه زاگرس كوثر,9,16772,116431224,7156,6942,6942,-214,-2.99,7155,-1,-0.01,6942,6942,1400-2-15,2021-05-05
480,تكمبا,كمباين‌ سازي‌ ايران‌,9,63427,482679470,7840,7610,7610,-230,-2.93,7840,0,0,7610,7610,1400-2-15,2021-05-05
481,دامين,داروسازي‌ امين‌,9,47263,240096040,5230,5080,5080,-150,-2.87,5230,0,0,5080,5080,1400-2-15,2021-05-05
482,وكادو,تكادو,9,46737,725124555,16161,15515,15515,-646,-4,16137,-24,-0.15,15515,15515,1400-2-15,2021-05-05
483,ضفلا3003,اختيارخ فولاد-7133-1400/03/19,9,165,343125000,2044,2410,2233,189,9.25,2080,36,1.76,2001,2411,1400-2-15,2021-05-05
484,زقيام,كشت و دام قيام اصفهان,9,15553,436743793,28949,28081,28081,-868,-3,28941,-8,-0.03,28081,28081,1400-2-15,2021-05-05
485,قنيشا,قند  نيشابور,9,12225,764184750,64440,62510,62510,-1930,-3,64410,-30,-0.05,62510,62510,1400-2-15,2021-05-05
486,اخزا813,اسنادخزانه-م13بودجه98-010219,8,4051,3308815526,816796,816800,816503,-293,-0.04,816790,-6,0,816503,816801,1400-2-15,2021-05-05
487,نوين,بيمه نوين,8,121388,697616836,5924,5747,5747,-177,-2.99,5921,-3,-0.05,5747,5747,1400-2-15,2021-05-05
488,كيسون,شركت كيسون,8,24173,266217249,11471,11013,11013,-458,-3.99,11466,-5,-0.04,11013,11013,1400-2-15,2021-05-05
489,زعف0008پ10,زعفران0008نگين طلاي سرخ(پ),8,789,100452212,128933,128368,127000,-1933,-1.5,127316,-1617,-1.25,123000,128368,1400-2-15,2021-05-05
490,شسينا,صنايع‌شيميايي‌سينا,8,5870,754353700,132480,128510,128510,-3970,-3,132420,-60,-0.05,128510,128510,1400-2-15,2021-05-05
491,ضخوز2014,اختيارخ فخوز-14000-1400/02/15,8,148,54940000,50,200,310,260,520,371,321,642,150,400,1400-2-15,2021-05-05
492,اخزا805,اسنادخزانه-م5بودجه98-000422,8,47839,46068957000,963000,963000,963000,0,0,963000,0,0,963000,963000,1400-2-15,2021-05-05
493,دتماد,توليدمواداوليه‌داروپخش‌,8,2252,96813480,44310,42990,42990,-1320,-2.98,44310,0,0,42990,42990,1400-2-15,2021-05-05
494,لكما,كارخانجات‌مخابراتي‌ايران‌,8,15734,94215192,6110,5988,5988,-122,-2,6109,-1,-0.02,5988,5988,1400-2-15,2021-05-05
495,سمگا,گروه سرمايه گذاري ميراث فرهنگي,8,25306,703987614,28679,27819,27819,-860,-3,28667,-12,-0.04,27819,27819,1400-2-15,2021-05-05
496,ولبهمن,شركت بهمن ليزينگ,8,211780,1568019120,7632,7404,7404,-228,-2.99,7625,-7,-0.09,7404,7404,1400-2-15,2021-05-05
497,فزرين,زرين معدن آسيا,8,21923,573374142,26962,26154,26154,-808,-3,26952,-10,-0.04,26154,26154,1400-2-15,2021-05-05
498,ثاژن,سخت آژند,8,71890,682595550,9688,9495,9495,-193,-1.99,9675,-13,-0.13,9495,9495,1400-2-15,2021-05-05
499,غويتا,ويتانا,8,3814,66455136,17962,17424,17424,-538,-3,17961,-1,-0.01,17424,17424,1400-2-15,2021-05-05
500,قشكر,شكرشاهرود,8,30659,114204775,3840,3725,3725,-115,-2.99,3840,0,0,3725,3725,1400-2-15,2021-05-05
501,اخزا716,اسنادخزانه-م16بودجه97-000407,8,1490,1450892158,970017,970100,974690,4673,0.48,973753,3736,0.39,970100,974690,1400-2-15,2021-05-05
502,افق ملت2,صندوق س در سهام افق ملت,8,800000,800000,121260,1,1,-121259,-100,1,-121259,-100,1,1,1400-2-15,2021-05-05
503,پست0008پ04,پسته فندقي32-30سبزدانه0008(پ),8,67,105606883,1607527,1650000,1540767,-66760,-4.15,1576222,-31305,-1.95,1540767,1650000,1400-2-15,2021-05-05
504,كسرا,سراميك‌هاي‌صنعتي‌اردكان‌,8,15379,310348220,20800,20180,20180,-620,-2.98,20800,0,0,20180,20180,1400-2-15,2021-05-05
505,وملت,سرمايه گذاري ملت,8,40897,172339958,4389,4214,4214,-175,-3.99,4386,-3,-0.07,4214,4214,1400-2-15,2021-05-05
506,كپارس,كاشي‌ پارس‌,8,1074,160101180,153680,149070,149070,-4610,-3,153660,-20,-0.01,149070,149070,1400-2-15,2021-05-05
507,گدنا,تهيه توزيع غذاي دنا آفرين فدك,7,1902,62594820,33927,32910,32910,-1017,-3,33926,-1,0,32910,32910,1400-2-15,2021-05-05
508,دسبحان,سبحان دارو,7,3257,59407680,18800,18240,18240,-560,-2.98,18800,0,0,18240,18240,1400-2-15,2021-05-05
509,پست0008پ08,پسته فندقي32-30مه ولات0008(پ),7,307,476877399,1634756,1570112,1550767,-83989,-5.14,1553347,-81409,-4.98,1540767,1570112,1400-2-15,2021-05-05
510,ضصاد3000,اختيارخ وبصادر-1800-1400/03/12,7,233,108701000,452,485,449,-3,-0.66,467,15,3.32,425,485,1400-2-15,2021-05-05
511,پرديس,سرمايه گذاري پرديس,7,20515,108114050,5430,5270,5270,-160,-2.95,5430,0,0,5270,5270,1400-2-15,2021-05-05
512,ضترا8058,اختيارخ شتران-3442-1400/08/09,7,260,326500000,1,1300,1250,1249,124900,1256,1255,125500,1250,1300,1400-2-15,2021-05-05
513,اعتلا,شركت سرمايه گذاري اعتلاء البرز,7,11079,78029397,7260,7043,7043,-217,-2.99,7260,0,0,7043,7043,1400-2-15,2021-05-05
514,ومشان,س. فني و مهندسي مشانير,7,594,40973526,71853,68979,68979,-2874,-4,71847,-6,-0.01,68979,68979,1400-2-15,2021-05-05
515,ولتجار,واسپاري تجارت وسرمايه ايرانيان,7,7248,57309936,8236,7907,7907,-329,-3.99,8235,-1,-0.01,7907,7907,1400-2-15,2021-05-05
516,كهمداح,ح . شيشه‌ همدان‌,7,117134,902045200,7700,7800,7700,0,0,7700,0,0,7700,7800,1400-2-15,2021-05-05
517,واحصا,احياء صنايع خراسان,7,858,59923578,72751,69841,69841,-2910,-4,72742,-9,-0.01,69841,69841,1400-2-15,2021-05-05
518,لسرما,سرما آفرين‌,7,13600,317968000,24100,23380,23380,-720,-2.99,24100,0,0,23380,23380,1400-2-15,2021-05-05
519,وجامي,سرمايه گذاري جامي,7,3223,46662594,15081,14478,14478,-603,-4,15080,-1,-0.01,14478,14478,1400-2-15,2021-05-05
520,كهمدا,شيشه‌ همدان‌,7,8124,79940160,10140,9840,9840,-300,-2.96,10140,0,0,9840,9840,1400-2-15,2021-05-05
521,فپنتا,سپنتا,7,305,120096800,405930,393760,393760,-12170,-3,405900,-30,-0.01,393760,393760,1400-2-15,2021-05-05
522,اخزا911,اسنادخزانه-م11بودجه99-020906,6,9925,5925294424,597001,596501,597100,99,0.02,597007,6,0,596501,597890,1400-2-15,2021-05-05
523,وساشرقي,شركت س استان آذربايجان شرقي,6,61658,58020178,970,941,941,-29,-2.99,970,0,0,941,941,1400-2-15,2021-05-05
524,ثنور,سرمايه گذاري كوه نور,6,44343,421036785,9688,9495,9495,-193,-1.99,9684,-4,-0.04,9495,9495,1400-2-15,2021-05-05
525,وپترو,سرمايه‌گذاري صنايع پتروشيمي‌,6,4538,60673060,13780,13370,13370,-410,-2.98,13780,0,0,13370,13370,1400-2-15,2021-05-05
526,شسم,توليد سموم‌ علف‌ كش,6,105,9629970,89916,91714,91714,1798,2,89918,2,0,91714,91714,1400-2-15,2021-05-05
527,وهنر,گروه توسعه هنر ايران,6,86135,702086385,8317,8151,8151,-166,-2,8311,-6,-0.07,8151,8151,1400-2-15,2021-05-05
528,كمنگنز,معادن‌منگنزايران‌,6,987,84615510,88380,85730,85730,-2650,-3,88380,0,0,85730,85730,1400-2-15,2021-05-05
529,غشوكو,شوكو پارس,6,2367,92521296,39885,39088,39088,-797,-2,39881,-4,-0.01,39088,39088,1400-2-15,2021-05-05
530,غپونه,نوش پونه مشهد,6,12813,233747559,18615,18243,18243,-372,-2,18611,-4,-0.02,18243,18243,1400-2-15,2021-05-05
531,ضمخا7075,اختيارخ اخابر-8700-1400/07/28,6,62,67711000,1333,1300,1050,-283,-21.23,1092,-241,-18.08,1050,1300,1400-2-15,2021-05-05
532,كيميا,معدني كيمياي زنجان گستران,6,4057,69626234,17692,17162,17162,-530,-3,17691,-1,-0.01,17162,17162,1400-2-15,2021-05-05
533,قصفها,قنداصفهان‌,6,974,148009040,156650,151960,151960,-4690,-2.99,156640,-10,-0.01,151960,151960,1400-2-15,2021-05-05
534,وسرمد,بيمه  سرمد,6,19328,115600768,6230,5981,5981,-249,-4,6229,-1,-0.02,5981,5981,1400-2-15,2021-05-05
535,ضجار7039,اختيارخ وتجارت-1997-1400/07/21,6,211,146200000,1,700,690,689,68900,693,692,69200,690,700,1400-2-15,2021-05-05
536,دتوليد,داروسازي توليد دارو,6,1748,45058196,26574,25777,25777,-797,-3,26573,-1,0,25777,25777,1400-2-15,2021-05-05
537,مرقام,ايران‌ارقام‌,6,3362,63676280,19520,18940,18940,-580,-2.97,19520,0,0,18940,18940,1400-2-15,2021-05-05
538,حتوكا,حمل‌ونقل‌توكا,6,15057,447795180,30650,29740,29740,-910,-2.97,30640,-10,-0.03,29740,29740,1400-2-15,2021-05-05
539,غدشت,دشت‌ مرغاب‌,6,335,93625800,288120,279480,279480,-8640,-3,288100,-20,-0.01,279480,279480,1400-2-15,2021-05-05
540,غدام,خوراك‌  دام‌ پارس‌,6,891,341056980,394610,382780,382780,-11830,-3,394530,-80,-0.02,382780,382780,1400-2-15,2021-05-05
541,بخاور,بيمه زندگي خاورميانه,6,6531,42915201,6774,6571,6571,-203,-3,6774,0,0,6571,6571,1400-2-15,2021-05-05
542,خعمرا,توسعه و عمران شهرستان نائين,5,1895,45243125,22739,23875,23875,1136,5,22741,2,0.01,23875,23875,1400-2-15,2021-05-05
543,ريشمك,توليد و صادرات ريشمك,5,2096,115020096,56573,54876,54876,-1697,-3,56569,-4,-0.01,54876,54876,1400-2-15,2021-05-05
544,پخش,پخش البرز,5,3700,114000700,31763,30811,30811,-952,-3,31761,-2,-0.01,30811,30811,1400-2-15,2021-05-05
545,زفكا,كشت و دامداري فكا,5,8490,104571330,12697,12317,12317,-380,-2.99,12696,-1,-0.01,12317,12317,1400-2-15,2021-05-05
546,كپرور,فرآوري زغال سنگ پروده طبس,5,1300,45977100,36460,35367,35367,-1093,-3,36459,-1,0,35367,35367,1400-2-15,2021-05-05
547,اراد33,مرابحه عام دولت3-ش.خ 0303,5,2100,1923919100,876727,870000,919400,42673,4.87,916152,39425,4.5,870000,919400,1400-2-15,2021-05-05
548,ضشنا8004,اختيارخ شپنا-10800-1400/08/16,5,131,130520000,1005,1000,940,-65,-6.47,996,-9,-0.9,940,1000,1400-2-15,2021-05-05
549,غبهنوش,بهنوش‌ ايران‌,5,5701,395706410,71550,69410,69410,-2140,-2.99,71530,-20,-0.03,69410,69410,1400-2-15,2021-05-05
550,ضمخا7070,اختيارخ اخابر-19700-1400/07/28,5,24,6062000,250,256,250,0,0,253,3,1.2,250,256,1400-2-15,2021-05-05
551,طسان2014,اختيارف پارسان-38750-00/02/15,5,500,10750000000,1,21500,21500,21499,2149900,21500,21499,2149900,21500,21500,1400-2-15,2021-05-05
552,دانا,بيمه دانا,5,10284,66126120,6620,6430,6430,-190,-2.87,6620,0,0,6430,6430,1400-2-15,2021-05-05
553,غنوش,نوش‌ مازندران‌,5,2453,135307480,56860,55160,55160,-1700,-2.99,56860,0,0,55160,55160,1400-2-15,2021-05-05
554,زكوثر,سرمايه گذاري كشاورزي كوثر,5,2731,57323690,21630,20990,20990,-640,-2.96,21630,0,0,20990,20990,1400-2-15,2021-05-05
555,شلعاب,لعابيران‌,5,2075,44114500,21910,21260,21260,-650,-2.97,21910,0,0,21260,21260,1400-2-15,2021-05-05
556,بمپنا,توليد برق عسلويه  مپنا,5,2645,180325520,70284,68176,68176,-2108,-3,70276,-8,-0.01,68176,68176,1400-2-15,2021-05-05
557,زشريف,كشت وصنعت شريف آباد,5,21294,107619876,5210,5054,5054,-156,-2.99,5210,0,0,5054,5054,1400-2-15,2021-05-05
558,زدشت,كشت و صنعت دشت خرم دره,5,2038,58170634,29425,28543,28543,-882,-3,29424,-1,0,28543,28543,1400-2-15,2021-05-05
559,شراز,پالايش نفت شيراز,5,1028,110514112,110828,107504,107504,-3324,-3,110820,-8,-0.01,107504,107504,1400-2-15,2021-05-05
560,گوهر2,صندوق سكه طلاي كيان,5,50000,50000,45631,1,1,-45630,-100,1,-45630,-100,1,1,1400-2-15,2021-05-05
561,قاسم,قاسم ايران,5,2720,34454240,13058,12667,12667,-391,-2.99,13058,0,0,12667,12667,1400-2-15,2021-05-05
562,شپاس,نفت پاسارگاد,5,9050,188855400,21513,20868,20868,-645,-3,21510,-3,-0.01,20868,20868,1400-2-15,2021-05-05
563,تبرك,گروه كارخانجات صنعتي تبرك,5,1940,37286800,19814,19220,19220,-594,-3,19814,0,0,19220,19220,1400-2-15,2021-05-05
564,تملي801,تسهيلات مسكن ب. ملي-فروردين98,5,85,57394008,643193,675000,675000,31807,4.95,675224,32031,4.98,675000,675352,1400-2-15,2021-05-05
565,هصيكو402,اختيارف ت تاصيكو13500-00/02/20,5,17510,57783000,3202,3300,3300,98,3.06,3300,98,3.06,3300,3300,1400-2-15,2021-05-05
566,ضجار7040,اختيارخ وتجارت-2497-1400/07/21,5,355,131350000,1,370,370,369,36900,370,369,36900,370,370,1400-2-15,2021-05-05
567,دارو,كارخانجات‌داروپخش‌,4,6762,219291660,33430,32430,32430,-1000,-2.99,33430,0,0,32430,32430,1400-2-15,2021-05-05
568,چفيبر,فيبر ايران‌,4,8567,115311820,13870,13460,13460,-410,-2.96,13870,0,0,13460,13460,1400-2-15,2021-05-05
569,نطرين,عطرين نخ قم,4,4264,50165960,12128,11765,11765,-363,-2.99,12128,0,0,11765,11765,1400-2-15,2021-05-05
570,سكرد,سيمان كردستان,4,7090,67355000,9790,9500,9500,-290,-2.96,9790,0,0,9500,9500,1400-2-15,2021-05-05
571,سخزر,سيمان‌ خزر,4,1220,36051000,30460,29550,29550,-910,-2.99,30460,0,0,29550,29550,1400-2-15,2021-05-05
572,ضترا8059,اختيارخ شتران-3882-1400/08/09,4,93,98265000,1100,1055,1060,-40,-3.64,1057,-43,-3.91,1055,1060,1400-2-15,2021-05-05
573,بكاب,صنايع‌جوشكاب‌يزد,4,68,23740160,359910,349120,349120,-10790,-3,359900,-10,0,349120,349120,1400-2-15,2021-05-05
574,دبالك,مواد اوليه دارويي البرز بالك,4,11943,241260543,20825,20201,20201,-624,-3,20822,-3,-0.01,20201,20201,1400-2-15,2021-05-05
575,كي بي سي,شركت كي بي سي,4,1054,26481750,25902,25125,25125,-777,-3,25902,0,0,25125,25125,1400-2-15,2021-05-05
576,دابور,داروسازي‌ ابوريحان‌,4,4118,151830660,38010,36870,36870,-1140,-3,38010,0,0,36870,36870,1400-2-15,2021-05-05
577,ضسان2007,اختيارخ پارسان-14750-00/02/15,4,5,11650000,4444,3000,2150,-2294,-51.62,2330,-2114,-47.57,2150,3000,1400-2-15,2021-05-05
578,زبينا,كشاورزي و دامپروري بينالود,4,12308,46647320,3907,3790,3790,-117,-2.99,3907,0,0,3790,3790,1400-2-15,2021-05-05
579,كمرجان,بازرگاني و توليدي مرجان كار,4,1036,147653828,146930,142523,142523,-4407,-3,146917,-13,-0.01,142523,142523,1400-2-15,2021-05-05
580,جهرم,پتروشيمي جهرم,4,205900,358266000,1775,1740,1740,-35,-1.97,1774,-1,-0.06,1740,1740,1400-2-15,2021-05-05
581,غاذر,كشت‌وصنعت‌پياذر,4,2617,141919910,55900,54230,54230,-1670,-2.99,55900,0,0,54230,54230,1400-2-15,2021-05-05
582,ضملي3000,اختيارخ فملي-8000-1400/03/02,4,4,15578000,3700,3888,3800,100,2.7,3894,194,5.24,3800,3990,1400-2-15,2021-05-05
583,صنفت0312,صكوك منفعت نفت0312-6ماهه 18/5%,4,19000,19000000000,1000000,1000000,1000000,0,0,1000000,0,0,1000000,1000000,1400-2-15,2021-05-05
584,شكربن,كربن‌ ايران‌,4,1446,122244840,87150,84540,84540,-2610,-2.99,87140,-10,-0.01,84540,84540,1400-2-15,2021-05-05
585,دلقما,دارويي‌ لقمان‌,4,2087,52362830,25860,25090,25090,-770,-2.98,25860,0,0,25090,25090,1400-2-15,2021-05-05
586,ضشنا8001,اختيارخ شپنا-6800-1400/08/16,4,36,108500000,3050,3000,2950,-100,-3.28,3014,-36,-1.18,2950,3050,1400-2-15,2021-05-05
587,كشرق,صنعتي و معدني شمال شرق شاهرود,4,272,24289872,92062,89301,89301,-2761,-3,92061,-1,0,89301,89301,1400-2-15,2021-05-05
588,سهگمت,سيمان‌هگمتان‌,4,2584,62119360,24780,24040,24040,-740,-2.99,24780,0,0,24040,24040,1400-2-15,2021-05-05
589,فلوله,لوله‌وماشين‌سازي‌ايران‌,4,3436,73839640,22150,21490,21490,-660,-2.98,22150,0,0,21490,21490,1400-2-15,2021-05-05
590,تملي709,تسهيلات مسكن ب. ملي-آذر97,4,40,29998920,714260,749973,749973,35713,5,749973,35713,5,749973,749973,1400-2-15,2021-05-05
591,آ س پ,آ.س.پ,4,2034,31836168,16136,15652,15652,-484,-3,16136,0,0,15652,15652,1400-2-15,2021-05-05
592,غگلپا,شير پاستوريزه پگاه گلپايگان,4,1170,74648340,65775,63802,63802,-1973,-3,65772,-3,0,63802,63802,1400-2-15,2021-05-05
593,وليز,ليزينگ‌ايران‌,4,2383,22066580,9540,9260,9260,-280,-2.94,9540,0,0,9260,9260,1400-2-15,2021-05-05
594,وزمين,بانك ايران زمين,4,1931,25054725,13239,12975,12975,-264,-1.99,13239,0,0,12975,12975,1400-2-15,2021-05-05
595,كفرا,فراورده‌ هاي‌ نسوزايران‌,4,1610,74043900,47410,45990,45990,-1420,-3,47410,0,0,45990,45990,1400-2-15,2021-05-05
596,غمينو,شركت صنايع غذايي مينو شرق,4,12612,139753572,11423,11081,11081,-342,-2.99,11422,-1,-0.01,11081,11081,1400-2-15,2021-05-05
597,وحافظ,بيمه حافظ,4,1160,74791000,65790,64475,64475,-1315,-2,65780,-10,-0.02,64475,64475,1400-2-15,2021-05-05
598,ضپيك2008,اختيارخ تاپيكو-9000-00/02/19,4,9,6260000,750,640,800,50,6.67,696,-54,-7.2,510,800,1400-2-15,2021-05-05
599,پست0008پ02,پسته فندقي32-30طلاسبززرند0008,4,45,76544265,1769028,1702951,1700000,-69028,-3.9,1700984,-68044,-3.85,1700000,1702951,1400-2-15,2021-05-05
600,زعف0008پ15,زعفران0008پوشالمعمول طلاسرخ(پ),4,640,56128100,91110,85210,90523,-587,-0.64,87700,-3410,-3.74,85210,90523,1400-2-15,2021-05-05
601,زنجان,صنايع كشاورزي وكود زنجان,4,2099,19233137,9349,9163,9163,-186,-1.99,9349,0,0,9163,9163,1400-2-15,2021-05-05
602,نگين,ص.س. زمين و ساختمان نگين شهرري,4,989,47011920,47980,47530,47540,-440,-0.92,47530,-450,-0.94,47530,47540,1400-2-15,2021-05-05
603,دسينا,داروسازي‌ سينا,3,3409,78952440,23870,23160,23160,-710,-2.97,23870,0,0,23160,23160,1400-2-15,2021-05-05
604,بالاس,مهندسي ساختمان تاسيسات راه آهن,3,340,19021980,57677,55947,55947,-1730,-3,57676,-1,0,55947,55947,1400-2-15,2021-05-05
605,وساربيل,شركت س استان اردبيل,3,15300,19002600,1280,1242,1242,-38,-2.97,1280,0,0,1242,1242,1400-2-15,2021-05-05
606,فرآور,فرآوري‌موادمعدني‌ايران‌,3,499,16985960,35090,34040,34040,-1050,-2.99,35090,0,0,34040,34040,1400-2-15,2021-05-05
607,تملي612,تسهيلات مسكن بانك ملي-اسفند96,3,58,31613306,519102,545057,545057,25955,5,545057,25955,5,545057,545057,1400-2-15,2021-05-05
608,فيروزا4,صندوق بادرآمد ثابت فيروزه آسيا,3,300000,6789900000,22651,22633,22633,-18,-0.08,22633,-18,-0.08,22633,22633,1400-2-15,2021-05-05
609,تكنو,تكنوتار,3,49243,1050845620,21990,21340,21340,-650,-2.96,21980,-10,-0.05,21340,21340,1400-2-15,2021-05-05
610,وسخوز,شركت س استان خوزستان,3,19544,18390904,970,941,941,-29,-2.99,970,0,0,941,941,1400-2-15,2021-05-05
611,هجرت,پخش هجرت,3,1900,51746500,28077,27235,27235,-842,-3,28076,-1,0,27235,27235,1400-2-15,2021-05-05
612,ضپيك7040,اختيارخ تاپيكو-6070-00/07/18,3,23,66100000,1,2900,2700,2699,269900,2874,2873,287300,2700,2900,1400-2-15,2021-05-05
613,چافست,افست‌,3,1020,16432200,16600,16110,16110,-490,-2.95,16600,0,0,16110,16110,1400-2-15,2021-05-05
614,وآوا,سرمايه گذاري آوا نوين,3,2147,18522169,8893,8627,8627,-266,-2.99,8893,0,0,8627,8627,1400-2-15,2021-05-05
615,كسرام,پارس‌ سرام‌,3,82218,664321440,8320,8080,8080,-240,-2.88,8320,0,0,8080,8080,1400-2-15,2021-05-05
616,تملي711,تسهيلات مسكن ب. ملي-بهمن97,3,99,49500000,482570,500000,500000,17430,3.61,500000,17430,3.61,500000,500000,1400-2-15,2021-05-05
617,وتوكا,سرمايه‌گذاري‌توكافولاد(هلدينگ,3,1553,17999270,11940,11590,11590,-350,-2.93,11940,0,0,11590,11590,1400-2-15,2021-05-05
618,غچين,كشت‌ و صنعت‌ چين‌ چين,3,5389,103792140,19850,19260,19260,-590,-2.97,19850,0,0,19260,19260,1400-2-15,2021-05-05
619,شگل,گلتاش‌,3,4829,47275910,10090,9790,9790,-300,-2.97,10090,0,0,9790,9790,1400-2-15,2021-05-05
620,سمايه,بانك سرمايه,3,9797,47740781,4972,4873,4873,-99,-1.99,4972,0,0,4873,4873,1400-2-15,2021-05-05
621,خاذين,سايپاآذين‌,3,6129,28242432,4750,4608,4608,-142,-2.99,4750,0,0,4608,4608,1400-2-15,2021-05-05
622,اراد35,مرابحه عام دولت3-ش.خ 0103,3,60000,56915920000,948897,948000,948898,1,0,948599,-298,-0.03,948000,948898,1400-2-15,2021-05-05
623,تپمپي,پمپ‌ سازي‌ ايران‌,3,1038,19545540,19410,18830,18830,-580,-2.99,19410,0,0,18830,18830,1400-2-15,2021-05-05
624,دروز,داروسازي‌ روزدارو,3,4294,148057120,35540,34480,34480,-1060,-2.98,35540,0,0,34480,34480,1400-2-15,2021-05-05
625,توريل,توكاريل,3,1330,32268460,25012,24262,24262,-750,-3,25012,0,0,24262,24262,1400-2-15,2021-05-05
626,ثفارس,عمران‌وتوسعه‌فارس‌,3,4626,44918460,10010,9710,9710,-300,-3,10010,0,0,9710,9710,1400-2-15,2021-05-05
627,فجام,جام‌دارو,3,44000,441320000,10330,10030,10030,-300,-2.9,10330,0,0,10030,10030,1400-2-15,2021-05-05
628,ضملي7003,اختيارخ فملي-11720-1400/07/11,3,3,5600000,1397,2000,1600,203,14.53,1867,470,33.64,1600,2000,1400-2-15,2021-05-05
629,زشگزا,شير و گوشت زاگرس شهركرد,3,43121,344493669,8236,7989,7989,-247,-3,8234,-2,-0.02,7989,7989,1400-2-15,2021-05-05
630,غالبر,لبنيات‌ كالبر,3,770,15099700,20210,19610,19610,-600,-2.97,20210,0,0,19610,19610,1400-2-15,2021-05-05
631,كهرام,توليدي گرانيت بهسرام,3,192,20919936,113497,108958,108958,-4539,-4,113492,-5,0,108958,108958,1400-2-15,2021-05-05
632,ضشنا2000,اختيارخ شپنا-9000-1400/02/27,3,21,27410000,1116,1200,1314,198,17.74,1305,189,16.94,1200,1314,1400-2-15,2021-05-05
633,ضچاد7031,اختيارخ كچاد-13870-1400/07/04,3,20,113900000,8780,6000,5550,-3230,-36.79,5695,-3085,-35.14,5550,6000,1400-2-15,2021-05-05
634,خزر,فنرسازي‌زر,3,432,19941120,47580,46160,46160,-1420,-2.98,47580,0,0,46160,46160,1400-2-15,2021-05-05
635,ضپنا8001,اختيارخ رمپنا-11850-1400/08/05,3,54,237600000,5500,4400,4400,-1100,-20,4400,-1100,-20,4400,4400,1400-2-15,2021-05-05
636,ضسپا3000,اختيارخ خساپا-1400-1400/03/26,3,12,6153000,473,569,494,21,4.44,513,40,8.46,494,569,1400-2-15,2021-05-05
637,آسام,صندوق س.آرمان سپهر آشنا-م,3,7380,753132400,101464,102000,102000,536,0.53,102050,586,0.58,102000,102980,1400-2-15,2021-05-05
638,اراد834,مرابحه عام دولت83-ش.خ041220,3,25489000,23290845475000,1000000,914042,913490,-86510,-8.65,913761,-86239,-8.62,913490,914042,1400-2-15,2021-05-05
639,بنو,بيمه تجارت نو,3,563,17403456,31868,30912,30912,-956,-3,31868,0,0,30912,30912,1400-2-15,2021-05-05
640,فروس,فروسيليس‌ ايران‌,3,5020,25702400,5270,5120,5120,-150,-2.85,5270,0,0,5120,5120,1400-2-15,2021-05-05
641,ضشنا8002,اختيارخ شپنا-7800-1400/08/16,3,42,87026000,2599,2070,2068,-531,-20.43,2072,-527,-20.28,2068,2075,1400-2-15,2021-05-05
642,ضجار2004,اختيارخ وتجارت-3500-1400/02/22,3,191,192000,1,1,2,1,100,1,0,0,1,2,1400-2-15,2021-05-05
643,سلار,شركت سيمان لارستان,3,432,24895728,60030,57629,57629,-2401,-4,60027,-3,0,57629,57629,1400-2-15,2021-05-05
644,سايرا,ايرانيت‌,3,100500,4140700500,42917,41201,41201,-1716,-4,42177,-740,-1.72,41201,41201,1400-2-15,2021-05-05
645,شاوان,پالايش نفت لاوان,3,334,26962818,83223,80727,80727,-2496,-3,83222,-1,0,80727,80727,1400-2-15,2021-05-05
646,تملي708,تسهيلات مسكن ب. ملي-آبان97,3,42,29079120,659391,692360,692360,32969,5,692360,32969,5,692360,692360,1400-2-15,2021-05-05
647,ضمخا7067,اختيارخ اخابر-13700-1400/07/28,3,3,1291000,1000,401,445,-555,-55.5,430,-570,-57,401,445,1400-2-15,2021-05-05
648,پلاسك,پلاسكوكار,3,20890,151452500,7470,7250,7250,-220,-2.95,7470,0,0,7250,7250,1400-2-15,2021-05-05
649,غصينو,صنعتي مينو,3,716,46537136,67006,64996,64996,-2010,-3,67005,-1,0,64996,64996,1400-2-15,2021-05-05
650,اراد65,مرابحه عام دولتي65-ش.خ0210,3,13000,12584000000,975735,940000,975000,-735,-0.08,968000,-7735,-0.79,940000,975000,1400-2-15,2021-05-05
651,شزنگ,تجهيزنيروي‌زنگان‌,3,129,29649102,234528,229838,229838,-4690,-2,234521,-7,0,229838,229838,1400-2-15,2021-05-05
652,دتوزيع,توزيع دارو پخش,3,754,36822344,50346,48836,48836,-1510,-3,50345,-1,0,48836,48836,1400-2-15,2021-05-05
653,ضغدر3000,اختيارخ وغدير-6200-1400/03/26,2,5,18000000,4000,3600,3600,-400,-10,3600,-400,-10,3600,3600,1400-2-15,2021-05-05
654,اخزا8144,اسنادخزانه-م14بودجه98-010318,2,710000,575138695000,805511,813127,806982,1471,0.18,810054,4543,0.56,806982,813127,1400-2-15,2021-05-05
655,غگلستا,شير پاستوريزه پگاه گلستان,2,1595,44125675,28520,27665,27665,-855,-3,28519,-1,0,27665,27665,1400-2-15,2021-05-05
656,افران2,صندوق س افرا نماد پايدار-ثابت,2,6800000,6800000,13234,1,1,-13233,-99.99,1,-13233,-99.99,1,1,1400-2-15,2021-05-05
657,لابسا,آبسال‌,2,288,14774400,52880,51300,51300,-1580,-2.99,52880,0,0,51300,51300,1400-2-15,2021-05-05
658,خشرق,الكتريك‌ خودرو شرق‌,2,13742,199259000,14940,14500,14500,-440,-2.95,14940,0,0,14500,14500,1400-2-15,2021-05-05
659,ساينا,صنايع بهداشتي ساينا,2,76,11069552,150156,145652,145652,-4504,-3,150155,-1,0,145652,145652,1400-2-15,2021-05-05
660,افاد744,منفعت دولت7-ش.خاص ساير0204,2,4000000,3798792000000,1045000,951433,947963,-97037,-9.29,949698,-95302,-9.12,947963,951433,1400-2-15,2021-05-05
661,قشير,قند شيروان قوچان و بجنورد,2,2300,57302200,25684,24914,24914,-770,-3,25683,-1,0,24914,24914,1400-2-15,2021-05-05
662,كپشير,پشم‌شيشه‌ايران‌,2,300,11634000,39970,38780,38780,-1190,-2.98,39970,0,0,38780,38780,1400-2-15,2021-05-05
663,ضبدر3002,اختيارخ شبندر-3843-1400/03/30,2,9,32080000,8000,2800,3660,-4340,-54.25,3564,-4436,-55.45,2800,3660,1400-2-15,2021-05-05
664,خفناور,مهندسي صنعتي روان فن آور,2,1132,53728116,48431,47463,47463,-968,-2,48428,-3,-0.01,47463,47463,1400-2-15,2021-05-05
665,بالبر,كابل‌ البرز,2,713,40847770,59060,57290,57290,-1770,-3,59060,0,0,57290,57290,1400-2-15,2021-05-05
666,دشيري,شيرين دارو,2,72,16646760,235923,231205,231205,-4718,-2,235919,-4,0,231205,231205,1400-2-15,2021-05-05
667,ضمخا7066,اختيارخ اخابر-11700-1400/07/28,2,2,1202000,862,601,601,-261,-30.28,601,-261,-30.28,601,601,1400-2-15,2021-05-05
668,كباده,توليد خاك نسوزاستقلال آباده,2,4176,38381616,8754,9191,9191,437,4.99,8755,1,0.01,9191,9191,1400-2-15,2021-05-05
669,ضمخا7076,اختيارخ اخابر-9700-1400/07/28,2,3,3700000,1750,1200,1300,-450,-25.71,1233,-517,-29.54,1200,1300,1400-2-15,2021-05-05
670,تملي702,تسهيلات مسكن ب. ملي-ارديبهشت97,2,13,5785000,452552,445000,445000,-7552,-1.67,445000,-7552,-1.67,445000,445000,1400-2-15,2021-05-05
671,ثپرديس,سرمايه گذاري مسكن پرديس,2,11010,108514560,10160,9856,9856,-304,-2.99,10159,-1,-0.01,9856,9856,1400-2-15,2021-05-05
672,فبيرا,بسته‌ بندي‌ ايران‌,2,7348,21867648,3100,2976,2976,-124,-4,3100,0,0,2976,2976,1400-2-15,2021-05-05
673,كاذر,فرآورده‌هاي‌نسوزآذر,2,361,11465360,32740,31760,31760,-980,-2.99,32740,0,0,31760,31760,1400-2-15,2021-05-05
674,تكنار,مجتمع معادن مس تكنار,2,2105,242586515,117594,115243,115243,-2351,-2,117565,-29,-0.02,115243,115243,1400-2-15,2021-05-05
675,ساربيل,سيمان آرتا اردبيل,2,40100,2082794000,53540,51940,51940,-1600,-2.99,53470,-70,-0.13,51940,51940,1400-2-15,2021-05-05
676,دجابر,داروسازي‌ جابرابن‌حيان‌,2,950,18658000,20240,19640,19640,-600,-2.96,20240,0,0,19640,19640,1400-2-15,2021-05-05
677,غشان,شيرپاستوريزه‌پگاه‌خراسان‌,2,10798,80553080,7690,7460,7460,-230,-2.99,7690,0,0,7460,7460,1400-2-15,2021-05-05
678,خچرخش,چرخشگر,2,1536,27248640,18280,17740,17740,-540,-2.95,18280,0,0,17740,17740,1400-2-15,2021-05-05
679,رنيك,جنرال مكانيك,2,776,16794968,22312,21643,21643,-669,-3,22312,0,0,21643,21643,1400-2-15,2021-05-05
680,زير0003پ01,زيره سبز0003كيميابذر(پ),2,260,156562000,584950,581200,603000,18050,3.09,602162,17212,2.94,581200,603000,1400-2-15,2021-05-05
681,خفنر,فنرسازي‌خاور,2,723,6080430,8660,8410,8410,-250,-2.89,8660,0,0,8410,8410,1400-2-15,2021-05-05
682,رطب0002پ01,رطب مضافتي0002افشارتعاون بم(پ),2,60,8882640,140995,148044,148044,7049,5,148044,7049,5,148044,148044,1400-2-15,2021-05-05
683,كسعدي,كاشي‌ سعدي‌,2,29240,605852800,21360,20720,20720,-640,-3,21350,-10,-0.05,20720,20720,1400-2-15,2021-05-05
684,افاد44,منفعت دولتي4-شرايط خاص14010729,2,6000000,5839977000000,1042700,975171,971488,-71212,-6.83,973329,-69371,-6.65,971488,975171,1400-2-15,2021-05-05
685,سنوين,سرمايه گذاري اقتصاد نوين,2,5451,48830058,9140,8958,8958,-182,-1.99,9140,0,0,8958,8958,1400-2-15,2021-05-05
686,سفار,سيمان‌فارس‌,2,7500,1109775000,152540,147970,147970,-4570,-3,152430,-110,-0.07,147970,147970,1400-2-15,2021-05-05
687,اخزا8064,اسنادخزانه-م6بودجه98-000519,2,310000,291655750000,947909,940086,941564,-6345,-0.67,940825,-7084,-0.75,940086,941564,1400-2-15,2021-05-05
688,غبشهر,صنعتي‌ بهشهر,2,638,15669280,25310,24560,24560,-750,-2.96,25310,0,0,24560,24560,1400-2-15,2021-05-05
689,پشاهن,توليدي پلاستيك‌ شاهين,2,31957,247475008,7376,7744,7744,368,4.99,7380,4,0.05,7744,7744,1400-2-15,2021-05-05
690,دسانكو,داروسازي سبحان انكولوژي,2,3972,56978340,14788,14345,14345,-443,-3,14787,-1,-0.01,14345,14345,1400-2-15,2021-05-05
691,آينده,بازرگاني آينده سازان بهشت پارس,2,2443,46568466,19856,19062,19062,-794,-4,19854,-2,-0.01,19062,19062,1400-2-15,2021-05-05
692,اخزا7224,اسنادخزانه-م22بودجه97-000428,2,1838000,1750445951000,959175,954192,950537,-8638,-0.9,952364,-6811,-0.71,950537,954192,1400-2-15,2021-05-05
693,افاد61,منفعت دولت6-ش.خاص140109,2,30000,29400000000,984000,980000,980000,-4000,-0.41,980000,-4000,-0.41,980000,980000,1400-2-15,2021-05-05
694,سيلام,سيمان‌ ايلام‌,2,961,10446070,11200,10870,10870,-330,-2.95,11200,0,0,10870,10870,1400-2-15,2021-05-05
695,ضملي7005,اختيارخ فملي-15720-1400/07/11,2,10,3000000,1,300,300,299,29900,300,299,29900,300,300,1400-2-15,2021-05-05
696,اخزا8114,اسنادخزانه-م11بودجه98-001013,2,1736000,1519986916000,876528,874579,876558,30,0,875568,-960,-0.11,874579,876558,1400-2-15,2021-05-05
697,فسديد,لوله‌وتجهيزات‌ سديد - ورشكسته,2,380,42020020,112835,110579,110579,-2256,-2,112816,-19,-0.02,110579,110579,1400-2-15,2021-05-05
698,زير0003پ04,زيره سبز0003شركت مينوبذر(پ),2,81,46251000,584950,571000,571000,-13950,-2.38,571000,-13950,-2.38,571000,571000,1400-2-15,2021-05-05
699,خكمك,كمك‌فنرايندامين‌,2,541,14239120,27130,26320,26320,-810,-2.99,27130,0,0,26320,26320,1400-2-15,2021-05-05
700,فالوم,آلومتك‌,2,353,12552327,36284,35559,35559,-725,-2,36284,0,0,35559,35559,1400-2-15,2021-05-05
701,اخزا8154,اسنادخزانه-م15بودجه98-010406,2,1012000,807685802000,797077,797401,798816,1739,0.22,798108,1031,0.13,797401,798816,1400-2-15,2021-05-05
702,كوثر,بيمه كوثر,2,2274,32356746,14669,14229,14229,-440,-3,14669,0,0,14229,14229,1400-2-15,2021-05-05
703,ولغدر,ليزينگ‌خودروغدير,2,1002,23917740,24600,23870,23870,-730,-2.97,24600,0,0,23870,23870,1400-2-15,2021-05-05
704,ختراك,ريخته‌گري‌ تراكتورسازي‌ ايران‌,2,33000,497970000,15550,15090,15090,-460,-2.96,15550,0,0,15090,15090,1400-2-15,2021-05-05
705,بايكا,كارخانجات كابلسازي ‌ايران‌,2,1155,47536335,41996,41157,41157,-839,-2,41994,-2,0,41157,41157,1400-2-15,2021-05-05
706,وسالت,بانك قرض الحسنه رسالت,2,10046,11482578,1110,1143,1143,33,2.97,1110,0,0,1143,1143,1400-2-15,2021-05-05
707,ضسپا3001,اختيارخ خساپا-1600-1400/03/26,2,20,6300000,360,320,310,-50,-13.89,315,-45,-12.5,310,320,1400-2-15,2021-05-05
708,ضفار8049,اختيارخ فارس-6400-1400/08/05,2,17,35350000,2010,2050,2100,90,4.48,2079,69,3.43,2050,2100,1400-2-15,2021-05-05
709,اخزا8124,اسنادخزانه-م12بودجه98-001111,2,1264000,1091316744000,864769,863165,863602,-1167,-0.13,863383,-1386,-0.16,863165,863602,1400-2-15,2021-05-05
710,ضپيك7041,اختيارخ تاپيكو-7070-00/07/18,2,18,36420000,2180,2100,1870,-310,-14.22,2023,-157,-7.2,1870,2100,1400-2-15,2021-05-05
711,ضصاد3003,اختيارخ وبصادر-3000-1400/03/12,2,31,371000,14,12,11,-3,-21.43,12,-2,-14.29,11,12,1400-2-15,2021-05-05
712,داسوه,داروسازي‌ اسوه‌,2,402,14560440,37330,36220,36220,-1110,-2.97,37330,0,0,36220,36220,1400-2-15,2021-05-05
713,تصميم2,صندوق س با درآمد ثابت تصميم,2,2000000,2000000,16263,1,1,-16262,-99.99,1,-16262,-99.99,1,1,1400-2-15,2021-05-05
714,سصفها,سيمان‌اصفهان‌,2,100,12316000,126960,123160,123160,-3800,-2.99,126960,0,0,123160,123160,1400-2-15,2021-05-05
715,ضبدر3000,اختيارخ شبندر-2989-1400/03/30,1,10,66000000,1,6600,6600,6599,659900,6600,6599,659900,6600,6600,1400-2-15,2021-05-05
716,زير0003پ02,زيره سبز0003 دانش(پ),1,40,23200000,584950,580000,580000,-4950,-0.85,580000,-4950,-0.85,580000,580000,1400-2-15,2021-05-05
717,واميد2,گروه مديريت سرمايه گذاري اميد,1,20000000,249600000000,12480,12480,12480,0,0,12480,0,0,12480,12480,1400-2-15,2021-05-05
718,شپاكسا,پاكسان‌,1,400,10580000,27260,26450,26450,-810,-2.97,27260,0,0,26450,26450,1400-2-15,2021-05-05
719,اخزا820,اسنادخزانه-م20بودجه98-020806,1,2650,1626821750,608764,613895,613895,5131,0.84,613895,5131,0.84,613895,613895,1400-2-15,2021-05-05
720,زكشت,كشاورزي مكانيزه اصفهان كشت,1,965,37790365,40372,39161,39161,-1211,-3,40371,-1,0,39161,39161,1400-2-15,2021-05-05
721,كطبس,ذغال‌سنگ‌ نگين‌ ط‌بس‌,1,320,25353600,81680,79230,79230,-2450,-3,81680,0,0,79230,79230,1400-2-15,2021-05-05
722,ضبدر3003,اختيارخ شبندر-4270-1400/03/30,1,100,154500000,1650,1545,1545,-105,-6.36,1545,-105,-6.36,1545,1545,1400-2-15,2021-05-05
723,اشاد1,مشاركت دولتي1-شرايط خاص001026,1,300,299983500,997491,999945,999945,2454,0.25,999945,2454,0.25,999945,999945,1400-2-15,2021-05-05
724,ارمغان2,ص سرمايه گذاري ارمغان ايرانيان,1,491400,491400,10187,1,1,-10186,-99.99,1,-10186,-99.99,1,1,1400-2-15,2021-05-05
725,ومعلم,بيمه معلم,1,2675,12938975,4986,4837,4837,-149,-2.99,4986,0,0,4837,4837,1400-2-15,2021-05-05
726,شستا002,اجاره تامين اجتماعي-تمدن000523,1,9800,9800000000,1000001,1000000,1000000,-1,0,1000000,-1,0,1000000,1000000,1400-2-15,2021-05-05
727,اراد554,مرابحه عام دولت5-ش.خ 0209,1,9777000,8340220965000,970000,853045,853045,-116955,-12.06,853045,-116955,-12.06,853045,853045,1400-2-15,2021-05-05
728,ضترا3000,اختيارخ شتران-6000-1400/03/09,1,1,2500000,2279,2500,2500,221,9.7,2500,221,9.7,2500,2500,1400-2-15,2021-05-05
729,اراد704,مرابحه عام دولت70-ش.خ0112,1,6000000,5634000000000,943750,939000,939000,-4750,-0.5,939000,-4750,-0.5,939000,939000,1400-2-15,2021-05-05
730,غمهرا,توليدي‌مهرام‌,1,43,5088190,121980,118330,118330,-3650,-2.99,121980,0,0,118330,118330,1400-2-15,2021-05-05
731,ضپاس2000,اختيارخ وپارس-2000-1400/02/29,1,71,35429000,407,499,499,92,22.6,499,92,22.6,499,499,1400-2-15,2021-05-05
732,ضفلا3002,اختيارخ فولاد-6420-1400/03/19,1,50,150050000,3001,3001,3001,0,0,3001,0,0,3001,3001,1400-2-15,2021-05-05
733,شستان,پتروشيمي گلستان,1,23300,88120600,3859,3782,3782,-77,-2,3858,-1,-0.03,3782,3782,1400-2-15,2021-05-05
734,قنقش,قند نقش جهان,1,140,10077760,73453,71984,71984,-1469,-2,73451,-2,0,71984,71984,1400-2-15,2021-05-05
735,لپيام,گسترش صنايع پيام,1,100,5377500,54872,53775,53775,-1097,-2,54872,0,0,53775,53775,1400-2-15,2021-05-05
736,ثنام,س ساختماني ب نام آوران مهندسي,1,310,5060440,16657,16324,16324,-333,-2,16657,0,0,16324,16324,1400-2-15,2021-05-05
737,وآذر,سرمايه‌گذاري‌توسعه‌آذربايجان‌,1,121,9895380,84300,81780,81780,-2520,-2.99,84300,0,0,81780,81780,1400-2-15,2021-05-05
738,ضترا3001,اختيارخ شتران-7000-1400/03/09,1,2,2000000,1250,1000,1000,-250,-20,1000,-250,-20,1000,1000,1400-2-15,2021-05-05
739,غديس,پاكديس,1,385,5016935,13434,13031,13031,-403,-3,13434,0,0,13031,13031,1400-2-15,2021-05-05
740,اخزا807,اسنادخزانه-م7بودجه98-000719,1,49,45031000,915508,919000,919000,3492,0.38,919000,3492,0.38,919000,919000,1400-2-15,2021-05-05
741,داوه,داروسازي آوه سينا,1,273,5343702,20179,19574,19574,-605,-3,20179,0,0,19574,19574,1400-2-15,2021-05-05
742,اخزا819,اسنادخزانه-م19بودجه98-020322,1,500,365250000,730500,730500,730500,0,0,730500,0,0,730500,730500,1400-2-15,2021-05-05
743,وسنا,سرمايه گذاري نيروگاهي ايران,1,455,6996080,15689,15376,15376,-313,-2,15689,0,0,15376,15376,1400-2-15,2021-05-05
744,چكاوه,صنايع‌كاغذسازي‌كاوه‌,1,2787,49803690,18420,17870,17870,-550,-2.99,18420,0,0,17870,17870,1400-2-15,2021-05-05
745,اخزا9032,اسنادخزانه-م3بودجه99-011110,1,186342,131557452000,703804,706000,706000,2196,0.31,706000,2196,0.31,706000,706000,1400-2-15,2021-05-05
746,غشهد,شهد ايران ‌,1,800,5648000,7270,7060,7060,-210,-2.89,7270,0,0,7060,7060,1400-2-15,2021-05-05
747,ضشنا2006,اختيارخ شپنا-20000-1400/02/27,1,1,8000,11,8,8,-3,-27.27,8,-3,-27.27,8,8,1400-2-15,2021-05-05
748,ولراز,ليزينگ رازي,1,92,5055768,56075,54954,54954,-1121,-2,56075,0,0,54954,54954,1400-2-15,2021-05-05
749,ضفلا3005,اختيارخ فولاد-9986-1400/03/19,1,5,455000,91,91,91,0,0,91,0,0,91,91,1400-2-15,2021-05-05
750,حسير,ريل سير كوثر,1,1883,31783157,17401,16879,16879,-522,-3,17401,0,0,16879,16879,1400-2-15,2021-05-05
751,سنير,سيمان‌ سفيد ني‌ريز,1,23,5563010,249350,241870,241870,-7480,-3,249350,0,0,241870,241870,1400-2-15,2021-05-05
752,قهكمت,قندهكمتان‌,1,106,4738200,46080,44700,44700,-1380,-2.99,46080,0,0,44700,44700,1400-2-15,2021-05-05
753,ضپاس2004,اختيارخ وپارس-4000-1400/02/29,1,4,8000,4,2,2,-2,-50,2,-2,-50,2,2,1400-2-15,2021-05-05
754,زعف0008پ12,زعفران0008پوشالمعمول سحرخيز(پ),1,60,5082600,88911,84710,84710,-4201,-4.72,84710,-4201,-4.72,84710,84710,1400-2-15,2021-05-05
755,ثعمرا,عمران و توسعه شاهد,1,400,5063600,13050,12659,12659,-391,-3,13050,0,0,12659,12659,1400-2-15,2021-05-05
756,گواهي ظرفيت,گواهي ظرفيت نقدي,1,23141000,363637674000,15714,15714,15714,0,0,15714,0,0,15714,15714,1400-2-15,2021-05-05
757,ثالوند,سرمايه گذاري مسكن الوند,1,200,6258800,32261,31294,31294,-967,-3,32261,0,0,31294,31294,1400-2-15,2021-05-05
758,سكارون,سيمان كارون,1,57,9939375,177933,174375,174375,-3558,-2,177931,-2,0,174375,174375,1400-2-15,2021-05-05
759,خنصير,مهندسي‌نصيرماشين‌,1,50,5261500,108480,105230,105230,-3250,-3,108480,0,0,105230,105230,1400-2-15,2021-05-05
760,وسخراش,شركت س استان خراسان شمالي,1,7800,10366200,1370,1329,1329,-41,-2.99,1370,0,0,1329,1329,1400-2-15,2021-05-05
761,اخزا816,اسنادخزانه-م16بودجه98-010503,1,360,281664000,783512,782400,782400,-1112,-0.14,782400,-1112,-0.14,782400,782400,1400-2-15,2021-05-05
762,همراه2,شركت ارتباطات سيار ايران,1,10500000,249060000000,23720,23720,23720,0,0,23720,0,0,23720,23720,1400-2-15,2021-05-05
763,ثنظام,س. ساختماني نظام مهندسي ايران,1,108,5020596,47435,46487,46487,-948,-2,47435,0,0,46487,46487,1400-2-15,2021-05-05
764,مبين016,اجاره اعتماد مبين اميد011019,1,1000,1000000000,980000,1000000,1000000,20000,2.04,1000000,20000,2.04,1000000,1000000,1400-2-15,2021-05-05
765,دسبحا,گروه دارويي سبحان,1,1000,18510000,19080,18510,18510,-570,-2.99,19080,0,0,18510,18510,1400-2-15,2021-05-05
766,سنفت010,سلف موازي استاندارد سنفت010,1,67500,103345200000,1529477,1531040,1531040,1563,0.1,1531040,1563,0.1,1531040,1531040,1400-2-15,2021-05-05
767,اخزا723,اسنادخزانه-م23بودجه97-000824,1,158,141887160,898290,898020,898020,-270,-0.03,898020,-270,-0.03,898020,898020,1400-2-15,2021-05-05
768,اراد36,مرابحه عام دولت3-ش.خ 0104,1,100,104690000,1102000,1046900,1046900,-55100,-5,1046900,-55100,-5,1046900,1046900,1400-2-15,2021-05-05
769,اراد61,مرابحه عام دولت61-ش.خ0309,1,3000,3000000000,1000000,1000000,1000000,0,0,1000000,0,0,1000000,1000000,1400-2-15,2021-05-05
770,حريل02,اجاره ريل پردازسير021212,1,600,579000000,970000,965000,965000,-5000,-0.52,965000,-5000,-0.52,965000,965000,1400-2-15,2021-05-05
771,وسزنجان,شركت س استان زنجان,1,3700,5098600,1420,1378,1378,-42,-2.96,1420,0,0,1378,1378,1400-2-15,2021-05-05
772,شفا,سرمايه گذاري شفادارو,1,111,5012760,46550,45160,45160,-1390,-2.99,46550,0,0,45160,45160,1400-2-15,2021-05-05
773,ضشنا2010,اختيارخ شپنا-8000-1400/02/27,1,8,16000000,6500,2000,2000,-4500,-69.23,2000,-4500,-69.23,2000,2000,1400-2-15,2021-05-05
774,نيرو,نيرو سرمايه,1,10000,528250000,53903,52825,52825,-1078,-2,53874,-29,-0.05,52825,52825,1400-2-15,2021-05-05
775,ياقوت2,صندوق س ياقوت آگاه-ثابت,1,5087000,5087000,12351,1,1,-12350,-99.99,1,-12350,-99.99,1,1,1400-2-15,2021-05-05
776,ولشرق,ليزينگ ايران و شرق,1,2356,19919980,8716,8455,8455,-261,-2.99,8716,0,0,8455,8455,1400-2-15,2021-05-05
777,ضترا8057,اختيارخ شتران-3000-1400/08/09,1,50,90000000,1,1800,1800,1799,179900,1800,1799,179900,1800,1800,1400-2-15,2021-05-05
778,سهرمز,سيمان‌هرمزگان‌,1,350,8428000,24820,24080,24080,-740,-2.98,24820,0,0,24080,24080,1400-2-15,2021-05-05
779,حخزر,كشتيراني درياي خزر,1,11459,315695450,28402,27550,27550,-852,-3,28396,-6,-0.02,27550,27550,1400-2-15,2021-05-05
780,كساوه,صنايع‌ كاشي‌ و سراميك‌ سينا,1,75,5133750,70560,68450,68450,-2110,-2.99,70560,0,0,68450,68450,1400-2-15,2021-05-05
781,دشيمي,شيمي‌ داروئي‌ داروپخش‌,1,300,8889000,30540,29630,29630,-910,-2.98,30540,0,0,29630,29630,1400-2-15,2021-05-05
782,شستا005,اجاره تامين اجتماعي-امين001220,1,400,404000000,1000000,1010000,1010000,10000,1,1010000,10000,1,1010000,1010000,1400-2-15,2021-05-05
783,سبهان,سيمان‌ بهبهان‌,1,37,5103410,142190,137930,137930,-4260,-3,142190,0,0,137930,137930,1400-2-15,2021-05-05
784,كلوند,كاشي‌ الوند,1,111,5006100,46490,45100,45100,-1390,-2.99,46490,0,0,45100,45100,1400-2-15,2021-05-05
785,كشم0006پ02,كشمش تيزابي0006تاكستان(پ),1,16,3298640,217015,206165,206165,-10850,-5,206165,-10850,-5,206165,206165,1400-2-15,2021-05-05
786,فاما,صنعتي‌ آما,1,280,5040000,18550,18000,18000,-550,-2.96,18550,0,0,18000,18000,1400-2-15,2021-05-05
787,ضغدر3001,اختيارخ وغدير-7200-1400/03/26,1,11,28600000,2550,2600,2600,50,1.96,2600,50,1.96,2600,2600,1400-2-15,2021-05-05
788,ضبدر3001,اختيارخ شبندر-3416-1400/03/30,1,1,4800000,6888,4800,4800,-2088,-30.31,4800,-2088,-30.31,4800,4800,1400-2-15,2021-05-05
789,بساما2,بيمه سامان,1,19000000,421952000000,22208,22208,22208,0,0,22208,0,0,22208,22208,1400-2-15,2021-05-05
790,ضسان2008,اختيارخ پارسان-16750-00/02/15,1,15,12000000,4600,800,800,-3800,-82.61,800,-3800,-82.61,800,800,1400-2-15,2021-05-05
791,اخزا9052,اسنادخزانه-م5بودجه99-020218,1,580125,388103625000,667867,669000,669000,1133,0.17,669000,1133,0.17,669000,669000,1400-2-15,2021-05-05
792,ضشنا2004,اختيارخ شپنا-16000-1400/02/27,1,100,1000000,18,10,10,-8,-44.44,10,-8,-44.44,10,10,1400-2-15,2021-05-05
793,سپر2,صندوق س سپر سرمايه بيدار- ثابت,1,4900000,4900000,11766,1,1,-11765,-99.99,1,-11765,-99.99,1,1,1400-2-15,2021-05-05
794,اراد504,مرابحه عام دولت5-ش.خ0302,1,150000,150000000000,1000029,1000000,1000000,-29,0,1000000,-29,0,1000000,1000000,1400-2-15,2021-05-05
795,ضمخا7078,اختيارخ اخابر-7700-1400/07/28,1,1,2000000,1,2000,2000,1999,199900,2000,1999,199900,2000,2000,1400-2-15,2021-05-05
796,خليبل,ماليبل سايپا,1,1435,357315,238,249,249,11,4.62,238,0,0,249,249,1400-2-15,2021-05-05
797,تاپكيش,تجارت الكترونيك پارسيان كيش,1,290,5120530,18203,17657,17657,-546,-3,18203,0,0,17657,17657,1400-2-15,2021-05-05
798,تملي807,تسهيلات مسكن ب. ملي-مهر98,1,19,11104303,615196,584437,584437,-30759,-5,584437,-30759,-5,584437,584437,1400-2-15,2021-05-05
799,سخواف,سيمان مجد خواف,1,442,7296536,16844,16508,16508,-336,-1.99,16844,0,0,16508,16508,1400-2-15,2021-05-05
800,پست0008پ09,پسته بادامي30-28مه ولات0008(پ),1,4,6428000,1691000,1607000,1607000,-84000,-4.97,1607000,-84000,-4.97,1607000,1607000,1400-2-15,2021-05-05
801,ضفار8050,اختيارخ فارس-7400-1400/08/05,1,2,3100000,1,1550,1550,1549,154900,1550,1549,154900,1550,1550,1400-2-15,2021-05-05
802,كيش1402,اجاره س. و توسعه كيش14020820,1,200,200000000,1002174,1000000,1000000,-2174,-0.22,1000000,-2174,-0.22,1000000,1000000,1400-2-15,2021-05-05
803,غشصفا,شيرپاستوريزه‌پگاه‌اصفهان‌,1,243,6599880,28000,27160,27160,-840,-3,28000,0,0,27160,27160,1400-2-15,2021-05-05
804,وصندوق2,سرمايه‌گذاري‌صندوق‌بازنشستگي‌,1,13750000,193875000000,14320,14100,14100,-220,-1.54,14100,-220,-1.54,14100,14100,1400-2-15,2021-05-05
805,غشاذر,پگاه‌آذربايجان‌غربي‌,1,550,5335000,10000,9700,9700,-300,-3,10000,0,0,9700,9700,1400-2-15,2021-05-05
806,ضملي3001,اختيارخ فملي-9000-1400/03/02,1,1,2900000,2350,2900,2900,550,23.4,2900,550,23.4,2900,2900,1400-2-15,2021-05-05
807,دفارا,داروسازي‌ فارابي‌,1,100,6252000,64450,62520,62520,-1930,-2.99,64450,0,0,62520,62520,1400-2-15,2021-05-05
808,خموتور,موتورسازان‌تراكتورسازي‌ايران‌,1,350,5085500,14970,14530,14530,-440,-2.94,14970,0,0,14530,14530,1400-2-15,2021-05-05
809,اطلس2,صندوق س.توسعه اندوخته آينده-س,1,10000,10000,196382,1,1,-196381,-100,1,-196381,-100,1,1,1400-2-15,2021-05-05
810,ضملي7001,اختيارخ فملي-8720-1400/07/11,1,1,3590000,2900,3590,3590,690,23.79,3590,690,23.79,3590,3590,1400-2-15,2021-05-05
811,طلا2,صندوق س.پشتوانه طلاي لوتوس,1,100000,100000,66595,1,1,-66594,-100,1,-66594,-100,1,1,1400-2-15,2021-05-05
812,ضفار3000,اختيارخ فارس-8000-1400/03/05,1,1,140000,1700,140,140,-1560,-91.76,140,-1560,-91.76,140,140,1400-2-15,2021-05-05
813,اوان,مبين وان كيش,1,785,41593225,54623,52985,52985,-1638,-3,54622,-1,0,52985,52985,1400-2-15,2021-05-05
814,پاسا,ايران‌ياساتايرورابر,1,196,5072480,26680,25880,25880,-800,-3,26680,0,0,25880,25880,1400-2-15,2021-05-05
815,ضچاد7032,اختيارخ كچاد-15870-1400/07/04,1,10,39000000,5270,3900,3900,-1370,-26,3900,-1370,-26,3900,3900,1400-2-15,2021-05-05
816,شكبير2,پتروشيمي اميركبير,1,2300000,194255700000,84459,84459,84459,0,0,84459,0,0,84459,84459,1400-2-15,2021-05-05
817,كرمان00,رهني كرمان موتور14001130,1,5,5100000,1026000,1020000,1020000,-6000,-0.58,1020000,-6000,-0.58,1020000,1020000,1400-2-15,2021-05-05
818,ضپيك7039,اختيارخ تاپيكو-5070-00/07/18,1,10,39000000,1,3900,3900,3899,389900,3900,3899,389900,3900,3900,1400-2-15,2021-05-05
819,زنگان,صنعت روي زنگان,1,96,9728160,104469,101335,101335,-3134,-3,104468,-1,0,101335,101335,1400-2-15,2021-05-05
820,ماهان01,منفعت هواپيمايي ماهان 14011123,1,6,5658000,920000,943000,943000,23000,2.5,943000,23000,2.5,943000,943000,1400-2-15,2021-05-05
821,مداران,داده‌پردازي‌ايران‌,1,1100,26807000,25120,24370,24370,-750,-2.99,25120,0,0,24370,24370,1400-2-15,2021-05-05
822,ضمخا7069,اختيارخ اخابر-17700-1400/07/28,1,1,356000,500,356,356,-144,-28.8,356,-144,-28.8,356,356,1400-2-15,2021-05-05
823,سبجنو,سيمان‌ بجنورد,1,1000,57640000,59420,57640,57640,-1780,-3,59420,0,0,57640,57640,1400-2-15,2021-05-05
