,نماد,نام,تعداد,حجم,ارزش,دیروز,اولین,آخرین معامله - مقدار,آخرین معامله - تغییر,آخرین معامله - درصد,قیمت پایانی - مقدار,قیمت پایانی - تغییر,قیمت پایانی - درصد,کمترین,بیشترین,تاریخ,gregorian_date
0,پالايش,صندوق پالايشي يكم-سهام,22003,25842734,1801743554520,67860,68720,70040,2180,3.21,69720,1860,2.74,67970,70510,1400-10-29,2022-01-19
1,فملي,ملي‌ صنايع‌ مس‌ ايران‌,12118,195151477,1312145006450,6830,6760,6740,-90,-1.32,6720,-110,-1.61,6670,6810,1400-10-29,2022-01-19
2,شپنا,پالايش نفت اصفهان,10612,136973057,738032065710,5180,5240,5430,250,4.83,5390,210,4.05,5180,5430,1400-10-29,2022-01-19
3,دارا يكم,صندوق واسطه گري مالي يكم-سهام,9886,6524052,690350567450,104930,105210,106400,1470,1.4,105820,890,0.85,104020,106770,1400-10-29,2022-01-19
4,ذوب,ذوب آهن اصفهان,7884,228466128,626097659001,2868,2725,2758,-110,-3.84,2740,-128,-4.46,2725,2820,1400-10-29,2022-01-19
5,شبندر,پالايش نفت بندرعباس,7622,141080989,906090384910,6150,6280,6450,300,4.88,6420,270,4.39,6180,6450,1400-10-29,2022-01-19
6,خودرو,ايران‌ خودرو,7564,259186005,501380994418,1947,1920,1950,3,0.15,1934,-13,-0.67,1891,1986,1400-10-29,2022-01-19
7,فولاد,فولاد مباركه اصفهان,6183,47305116,454972319400,9580,9620,9620,40,0.42,9620,40,0.42,9580,9760,1400-10-29,2022-01-19
8,قتربت,قند تربت حيدريه,5921,859034,60356676450,69000,71050,71050,2050,2.97,70250,1250,1.81,66950,71050,1400-10-29,2022-01-19
9,كمند,صندوق س. با درآمد ثابت كمند,5737,224784564,2266232123932,10076,10081,10082,6,0.06,10082,6,0.06,10081,10082,1400-10-29,2022-01-19
10,كرمان,س. توسعه و عمران استان كرمان,4967,169186320,133489594760,810,798,787,-23,-2.84,789,-21,-2.59,770,806,1400-10-29,2022-01-19
11,فرابورس,فرابورس ايران,4837,23860271,331444613730,14040,13810,13970,-70,-0.5,13890,-150,-1.07,13400,14320,1400-10-29,2022-01-19
12,كالا,بورس كالاي ايران,4575,15530374,377869486390,24330,24330,24700,370,1.52,24330,0,0,23300,25340,1400-10-29,2022-01-19
13,شتران,پالايش نفت تهران,4522,94812784,339176612097,3449,3480,3621,172,4.99,3577,128,3.71,3463,3621,1400-10-29,2022-01-19
14,خگستر,گسترش‌سرمايه‌گذاري‌ايران‌خودرو,4424,106399324,251321300835,2395,2360,2363,-32,-1.34,2362,-33,-1.38,2285,2430,1400-10-29,2022-01-19
15,خساپا,سايپا,4357,147009186,232291703766,1577,1574,1582,5,0.32,1580,3,0.19,1545,1617,1400-10-29,2022-01-19
16,كدما,معدني‌ دماوند,3886,3850326,212316481970,54910,53400,55980,1070,1.95,55140,230,0.42,53370,57500,1400-10-29,2022-01-19
17,مديريت,س. و خدمات مديريت صند. ب كشوري,3567,14326158,122240683790,8210,8240,8620,410,4.99,8530,320,3.9,8090,8620,1400-10-29,2022-01-19
18,كيان,صندوق س. با درآمد ثابت كيان,3554,38056945,1242499113183,32666,32690,32666,0,0,32648,-18,-0.06,32301,32700,1400-10-29,2022-01-19
19,بركت,گروه دارويي بركت,3226,11428296,175260436040,15510,15200,15210,-300,-1.93,15340,-170,-1.1,15010,15680,1400-10-29,2022-01-19
20,هفولا110,اختيارف ت فولاد-13176-01/10/28,3114,422470000,316852500000,1000,750,750,-250,-25,750,-250,-25,750,750,1400-10-29,2022-01-19
21,اعتماد,صندوق س.اعتماد آفرين پارسيان-د,3111,84521730,3503582418140,41412,41452,41451,39,0.09,41452,40,0.1,41451,41464,1400-10-29,2022-01-19
22,وبملت,بانك ملت,3072,104597038,298430844085,2867,2850,2869,2,0.07,2853,-14,-0.49,2760,2901,1400-10-29,2022-01-19
23,فسبزوار,پارس فولاد سبزوار,2945,1734011,58708347610,33840,33830,34000,160,0.47,33860,20,0.06,33700,34000,1400-10-29,2022-01-19
24,كارا,صندوق س. كارا -د,2909,133502518,1415519595466,10594,10603,10603,9,0.08,10603,9,0.08,10602,10604,1400-10-29,2022-01-19
25,توسن,توسعه سامانه ي نرم افزاري نگين,2873,8616783,214073637200,24800,24950,24950,150,0.6,24850,50,0.2,24200,25200,1400-10-29,2022-01-19
26,نوري,پتروشيمي نوري,2814,1707417,172288403380,98970,98000,102110,3140,3.17,100910,1940,1.96,98000,102240,1400-10-29,2022-01-19
27,پترول,گ.س.وت.ص.پتروشيمي خليج فارس,2746,45486738,93957980545,2048,2011,2071,23,1.12,2066,18,0.88,2005,2100,1400-10-29,2022-01-19
28,خنصير,مهندسي‌نصيرماشين‌,2736,16048600,245638147190,16010,15210,15270,-740,-4.62,15310,-700,-4.37,15210,15870,1400-10-29,2022-01-19
29,خبهمن,گروه‌بهمن‌,2706,71733723,133185643845,1845,1813,1864,19,1.03,1857,12,0.65,1800,1910,1400-10-29,2022-01-19
30,وخارزم,سرمايه گذاري خوارزمي,2672,32879126,131259011315,3882,3860,4050,168,4.33,3992,110,2.83,3830,4070,1400-10-29,2022-01-19
31,فجر,فولاد اميركبيركاشان,2658,9435820,176164671550,19610,18630,18760,-850,-4.33,18670,-940,-4.79,18630,19280,1400-10-29,2022-01-19
32,غزر,صنعتي زر ماكارون,2647,6909161,56483345310,8500,8080,8360,-140,-1.65,8180,-320,-3.76,8080,8580,1400-10-29,2022-01-19
33,فجهان,مجتمع جهان فولاد سيرجان,2615,15187897,83521652240,5500,5420,5500,0,0,5500,0,0,5420,5510,1400-10-29,2022-01-19
34,لپارس,پارس‌ الكتريك‌,2566,1239840,110985135620,89260,85900,90240,980,1.1,89520,260,0.29,85100,93680,1400-10-29,2022-01-19
35,شسينا,صنايع‌شيميايي‌سينا,2556,67740193,135116876380,2093,2000,1989,-104,-4.97,1995,-98,-4.68,1989,2051,1400-10-29,2022-01-19
36,وتجارت,بانك تجارت,2494,65079545,113558401686,1736,1727,1747,11,0.63,1745,9,0.52,1726,1780,1400-10-29,2022-01-19
37,وهامون,سرمايه گذاري هامون صبا,2462,18488277,50204158339,2641,2697,2740,99,3.75,2715,74,2.8,2620,2768,1400-10-29,2022-01-19
38,امين يكم,صندوق درآمد ثابت امين يكم فردا,2414,71235622,722387223700,10133,10138,10140,7,0.07,10141,8,0.08,10138,10144,1400-10-29,2022-01-19
39,سمگا,گروه سرمايه گذاري ميراث فرهنگي,2349,11418616,115497279620,10010,10330,10040,30,0.3,10110,100,1,9980,10330,1400-10-29,2022-01-19
40,آپ,آسان پرداخت پرشين,2316,19823862,153983265230,8120,7910,7720,-400,-4.93,7770,-350,-4.31,7720,8050,1400-10-29,2022-01-19
41,سپيد,سپيد ماكيان,2304,2296676,132320791200,55310,55490,58070,2760,4.99,57610,2300,4.16,55000,58070,1400-10-29,2022-01-19
42,شبريز,پالايش نفت تبريز,2279,7425646,254223598960,32730,33150,34360,1630,4.98,34240,1510,4.61,33010,34360,1400-10-29,2022-01-19
43,افران,صندوق س افرا نماد پايدار-ثابت,2190,60901400,931104416528,15280,15289,15289,9,0.06,15289,9,0.06,15288,15291,1400-10-29,2022-01-19
44,پارند,صندوق س. پارند پايدار سپهر,2147,86221615,868966854662,10072,10078,10078,6,0.06,10078,6,0.06,10078,10079,1400-10-29,2022-01-19
45,ونيرو,سرمايه‌گذاري‌نيرو,2045,57714659,148862056982,2481,2502,2577,96,3.87,2579,98,3.95,2502,2605,1400-10-29,2022-01-19
46,خپارس,پارس‌ خودرو,2039,79892454,80086708188,995,990,1007,12,1.21,1002,7,0.7,988,1028,1400-10-29,2022-01-19
47,كاما,باما,1985,17932475,101647542000,5650,5660,5680,30,0.53,5670,20,0.35,5550,5790,1400-10-29,2022-01-19
48,كيمياتك,آريان كيميا تك,1952,1145564,27505496090,24130,23940,24130,0,0,24010,-120,-0.5,23900,24500,1400-10-29,2022-01-19
49,زملاردح,ح.كشاورزي و دامپروري ملارد شير,1934,836488,4071588450,5010,4770,4810,-200,-3.99,4870,-140,-2.79,4760,5040,1400-10-29,2022-01-19
50,وفتخار,سرمايه گذاري افتخار سهام,1888,9230159,21065119219,2218,2284,2284,66,2.98,2282,64,2.89,2236,2284,1400-10-29,2022-01-19
51,سحرخيز,صندوق س. گروه زعفران سحرخيز,1879,4802392,87113883189,16944,17870,18500,1556,9.18,18140,1196,7.06,17401,18500,1400-10-29,2022-01-19
52,زقيام,كشت و دام قيام اصفهان,1856,58260708,88331543651,1516,1441,1590,74,4.88,1516,0,0,1441,1591,1400-10-29,2022-01-19
53,بهپاك,صنعتي بهپاك,1847,13254763,88663587690,6400,6530,6720,320,5,6690,290,4.53,6350,6720,1400-10-29,2022-01-19
54,شگويا,پتروشيمي تندگويان,1720,6076980,62898874640,10330,10200,10380,50,0.48,10340,10,0.1,10180,10520,1400-10-29,2022-01-19
55,بوعلي,پتروشيمي بوعلي سينا,1643,629394,45118387680,69910,69150,72650,2740,3.92,70710,800,1.14,69010,72900,1400-10-29,2022-01-19
56,گدنا,تهيه توزيع غذاي دنا آفرين فدك,1638,1011073,11064788960,10730,10500,10750,20,0.19,10910,180,1.68,10500,11100,1400-10-29,2022-01-19
57,زاگرس,پتروشيمي زاگرس,1626,554721,99451954700,180000,178500,178250,-1750,-0.97,179300,-700,-0.39,177000,182950,1400-10-29,2022-01-19
58,فخوز,فولاد  خوزستان,1626,17749707,98874987210,5670,5600,5450,-220,-3.88,5580,-90,-1.59,5450,5750,1400-10-29,2022-01-19
59,لكما,كارخانجات‌مخابراتي‌ايران‌,1625,51372268,39860461352,798,775,780,-18,-2.26,776,-22,-2.76,775,796,1400-10-29,2022-01-19
60,غشصفا,شيرپاستوريزه‌پگاه‌اصفهان‌,1625,8254101,135050701010,17080,16230,16240,-840,-4.92,16360,-720,-4.22,16230,17080,1400-10-29,2022-01-19
61,وبصادر,بانك صادرات ايران,1618,58382635,106868959222,1827,1790,1833,6,0.33,1830,3,0.16,1790,1860,1400-10-29,2022-01-19
62,غگيلا,شيرپاستوريزه پگاه گيلان,1559,2613236,40623303890,16180,15380,15380,-800,-4.94,15550,-630,-3.89,15380,16250,1400-10-29,2022-01-19
63,وغدير,سرمايه‌گذاري‌غدير(هلدينگ‌,1519,8295593,107434490900,12720,12550,13140,420,3.3,12940,220,1.73,12550,13200,1400-10-29,2022-01-19
64,تسه0009,امتيازتسهيلات مسكن آذر 1400,1508,86978,108231167880,1244256,1245000,1244900,644,0.05,1244351,95,0.01,1230000,1245000,1400-10-29,2022-01-19
65,شاروم,پتروشيمي اروميه,1495,1328808,16855955600,12600,12600,12750,150,1.19,12690,90,0.71,12360,12950,1400-10-29,2022-01-19
66,ثاميد,توسعه و عمران اميد,1466,5989493,7680559995,1259,1270,1289,30,2.38,1269,10,0.79,1250,1300,1400-10-29,2022-01-19
67,ثشاهد,سرمايه‌ گذاري‌ شاهد,1456,7533238,61975708170,8410,8180,8180,-230,-2.73,8230,-180,-2.14,8020,8450,1400-10-29,2022-01-19
68,هاي وب,داده گسترعصرنوين-هاي وب,1451,16391255,119821423740,7310,7190,7470,160,2.19,7310,0,0,7110,7490,1400-10-29,2022-01-19
69,ديران,ايران‌دارو,1451,6216958,86498896350,14320,13740,13610,-710,-4.96,13910,-410,-2.86,13610,14500,1400-10-29,2022-01-19
70,صبا,سرمايه گذاري صبا تامين,1435,11235015,67678033450,6050,6040,6150,100,1.65,6030,-20,-0.33,5970,6150,1400-10-29,2022-01-19
71,غكورش,صنعت غذايي كورش,1426,1075625,48282753730,45060,44340,45000,-60,-0.13,44910,-150,-0.33,44340,46200,1400-10-29,2022-01-19
72,رافزا,رايان هم افزا,1404,526253,28860967750,56150,54200,55700,-450,-0.8,54850,-1300,-2.32,53350,56950,1400-10-29,2022-01-19
73,فنفت,صنايع تجهيزات نفت,1381,7382521,158789620950,21030,20400,21660,630,3,21510,480,2.28,20400,21660,1400-10-29,2022-01-19
74,ومدير,گ.مديريت ارزش سرمايه ص ب كشوري,1359,5766279,24845471506,4283,4285,4379,96,2.24,4309,26,0.61,4217,4390,1400-10-29,2022-01-19
75,سپيدار,سپيدار سيستم آسيا,1353,328848,6127737400,18900,18550,18850,-50,-0.26,18800,-100,-0.53,18150,19000,1400-10-29,2022-01-19
76,وساغربي,شركت س استان آذربايجان غربي,1341,80120972,31519752563,393,391,400,7,1.78,393,0,0,382,401,1400-10-29,2022-01-19
77,تاپيكو,س. نفت و گاز و پتروشيمي تأمين,1331,15854526,206093458070,12840,12910,13200,360,2.8,13000,160,1.25,12810,13300,1400-10-29,2022-01-19
78,شمواد,توليد مواداوليه الياف مصنوعي,1288,1895071,98993749850,51900,51800,52400,500,0.96,52250,350,0.67,50900,52900,1400-10-29,2022-01-19
79,شپديس,پتروشيمي پرديس,1282,895606,128697342220,142300,142200,144500,2200,1.55,143700,1400,0.98,140000,146830,1400-10-29,2022-01-19
80,بپيوند,برق و انرژي پيوندگستر پارس,1276,1170422,10265557940,8770,8700,8830,60,0.68,8770,0,0,8610,9050,1400-10-29,2022-01-19
81,غصينو,صنعتي مينو,1257,4464016,73230851840,16140,16100,16420,280,1.73,16400,260,1.61,16000,16830,1400-10-29,2022-01-19
82,ضخود2019,اختيارخ خودرو-2500-1401/02/07,1250,43504,5644901000,128,129,130,2,1.56,130,2,1.56,119,137,1400-10-29,2022-01-19
83,خزاميا,زامياد,1231,11244143,86931697120,7800,7790,7710,-90,-1.15,7730,-70,-0.9,7570,7990,1400-10-29,2022-01-19
84,وسپهر,سرمايه گذاري مالي سپهرصادرات,1223,5384331,38015953200,7060,7060,7060,0,0,7060,0,0,7060,7070,1400-10-29,2022-01-19
85,كمنگنز,معادن‌منگنزايران‌,1210,9908494,100881439590,9850,9960,10340,490,4.97,10180,330,3.35,9400,10340,1400-10-29,2022-01-19
86,وپارس,بانك‌پارسيان‌,1209,37559387,64180335562,1744,1671,1740,-4,-0.23,1723,-21,-1.2,1657,1750,1400-10-29,2022-01-19
87,فاذر,صنايع‌ آذرآب‌,1207,38889277,31800824812,830,807,850,20,2.41,818,-12,-1.45,802,850,1400-10-29,2022-01-19
88,ختوقا,قطعات‌ اتومبيل‌ ايران‌,1202,24893228,66023374197,2664,2605,2658,-6,-0.23,2652,-12,-0.45,2603,2718,1400-10-29,2022-01-19
89,شفن,پتروشيمي فناوران,1178,3349258,41321835550,12190,12000,12500,310,2.54,12240,50,0.41,12000,12540,1400-10-29,2022-01-19
90,بورس,بورس اوراق بهادار تهران,1178,12648558,104676337200,8500,8350,8100,-400,-4.71,8280,-220,-2.59,8080,8630,1400-10-29,2022-01-19
91,فارس,صنايع پتروشيمي خليج فارس,1154,7932187,77807328740,9790,9860,9820,30,0.31,9800,10,0.1,9760,9950,1400-10-29,2022-01-19
92,حكشتي,كشتيراني جمهوري اسلامي ايران,1135,3938053,49566563180,12550,12250,12590,40,0.32,12570,20,0.16,12250,12760,1400-10-29,2022-01-19
93,سيتا,سرمايه گذاري سيمان تامين,1122,1536335,13133170720,8510,8290,8610,100,1.18,8520,10,0.12,8290,8630,1400-10-29,2022-01-19
94,حآفرين,ريل پرداز نو آفرين,1117,16335517,52229665382,3360,3197,3192,-168,-5,3197,-163,-4.85,3192,3290,1400-10-29,2022-01-19
95,وكبهمن,مديريت سرمايه گذاري كوثربهمن,1115,454790,3858933070,8710,8320,8540,-170,-1.95,8650,-60,-0.69,8320,8660,1400-10-29,2022-01-19
96,ثبهساز,بهساز كاشانه تهران,1085,7359033,10453407372,1408,1425,1416,8,0.57,1417,9,0.64,1405,1450,1400-10-29,2022-01-19
97,وسكرد,شركت س استان كردستان,1085,83649436,32790297911,392,386,400,8,2.04,392,0,0,375,400,1400-10-29,2022-01-19
98,وملي,گروه‌ صنعتي‌ ملي‌ (هلدينگ‌,1073,336982,41319406750,119200,119200,124640,5440,4.56,122620,3420,2.87,117500,124730,1400-10-29,2022-01-19
99,زملارد,كشاورزي و دامپروري ملارد شير,1070,555025,4247408900,7810,7440,7620,-190,-2.43,7760,-50,-0.64,7440,7870,1400-10-29,2022-01-19
100,آبادا,توليد نيروي برق آبادان,1063,458579,4023937050,8940,8510,8900,-40,-0.45,8890,-50,-0.56,8510,9020,1400-10-29,2022-01-19
101,شاراك,پتروشيمي شازند,1060,1754123,67994584910,37990,38300,39370,1380,3.63,38550,560,1.47,37520,39570,1400-10-29,2022-01-19
102,چكاپا,گروه صنايع كاغذ پارس,1052,9885660,26795862514,2668,2700,2705,37,1.39,2711,43,1.61,2661,2750,1400-10-29,2022-01-19
103,تليسه,دامداري تليسه نمونه,1051,21784818,45955761723,2200,2090,2162,-38,-1.73,2110,-90,-4.09,2090,2178,1400-10-29,2022-01-19
104,فتوسا,توليد و توسعه سرب روي ايرانيان,1036,572082,6145792790,10810,10310,11350,540,5,10780,-30,-0.28,10310,11350,1400-10-29,2022-01-19
105,ولپارس,ليزينگ پارسيان,1031,2102439,5412082697,2568,2570,2589,21,0.82,2570,2,0.08,2540,2620,1400-10-29,2022-01-19
106,نهال,صندوق س. طلاي سرخ نوويرا,1018,2171077,40299155295,17648,17922,18709,1061,6.01,18562,914,5.18,17922,18800,1400-10-29,2022-01-19
107,كترام,توليدي‌ كاشي‌ تكسرام‌,1008,3236639,72573629210,22690,23070,22500,-190,-0.84,22420,-270,-1.19,21560,23700,1400-10-29,2022-01-19
108,تاپكيش,تجارت الكترونيك پارسيان كيش,1003,4140927,62352241950,15460,14690,14940,-520,-3.36,15060,-400,-2.59,14690,15860,1400-10-29,2022-01-19
109,تاصيكو,سرمايه گذاري صدرتامين,997,5966044,47680354620,7980,7760,8200,220,2.76,7990,10,0.13,7760,8300,1400-10-29,2022-01-19
110,شصدف,صنعتي دوده فام,987,923530,31530423400,33700,34400,34000,300,0.89,34150,450,1.34,33100,34550,1400-10-29,2022-01-19
111,لطيف,محصولات كاغذي لطيف,983,226415,7820365750,34750,34050,34600,-150,-0.43,34650,-100,-0.29,33850,35500,1400-10-29,2022-01-19
112,غدام,خوراك‌  دام‌ پارس‌,975,492369,37332934260,79470,75600,76250,-3220,-4.05,75820,-3650,-4.59,75500,78950,1400-10-29,2022-01-19
113,شبصير,توليدات پتروشيمي قائد بصير,973,795029,85457686550,102900,103950,108000,5100,4.96,107500,4600,4.47,100700,108000,1400-10-29,2022-01-19
114,گشان,توسعه بين المللي پديده شانديز,969,1912303,31192059070,16270,16030,16270,0,0,16310,40,0.25,16020,16540,1400-10-29,2022-01-19
115,كيسون,شركت كيسون,966,22574631,33723963362,1523,1559,1518,-5,-0.33,1494,-29,-1.9,1478,1559,1400-10-29,2022-01-19
116,شغدير,پتروشيمي غدير,955,891676,67636777330,74300,75050,76000,1700,2.29,75850,1550,2.09,74450,76700,1400-10-29,2022-01-19
117,فاراك,ماشين‌ سازي‌ اراك‌,952,19282486,24090542565,1265,1213,1269,4,0.32,1249,-16,-1.26,1213,1271,1400-10-29,2022-01-19
118,بذر,صندوق س بذر اميد آفرين-سهام,950,81505,7378263900,90590,89410,91510,920,1.02,90530,-60,-0.07,89300,91710,1400-10-29,2022-01-19
119,بگيلان,توسعه مسير برق گيلان,950,299622,3916845720,13360,12800,13050,-310,-2.32,13310,-50,-0.37,12740,13380,1400-10-29,2022-01-19
120,فروس,فروسيليس‌ ايران‌,940,6563207,44863682860,6920,7000,7040,120,1.73,6840,-80,-1.16,6580,7110,1400-10-29,2022-01-19
121,چخزر,صنايع چوب خزر كاسپين,940,1294710,38585081000,31300,29750,29750,-1550,-4.95,29800,-1500,-4.79,29750,30800,1400-10-29,2022-01-19
122,شرنگي,شيميايي رنگين,940,178416,43408724050,243650,250900,242800,-850,-0.35,243300,-350,-0.14,236350,250900,1400-10-29,2022-01-19
123,ختور,رادياتور ايران‌,938,4597231,46615474380,10450,10600,10100,-350,-3.35,10140,-310,-2.97,9930,10600,1400-10-29,2022-01-19
124,طلا,صندوق س.پشتوانه طلاي لوتوس,932,3503991,294963815454,82263,82990,84160,1897,2.31,84179,1916,2.33,82510,84410,1400-10-29,2022-01-19
125,فنورد,نوردوقطعات‌ فولادي‌,930,518140,86088483920,174360,165650,165650,-8710,-5,166150,-8210,-4.71,165650,173240,1400-10-29,2022-01-19
126,كماسه,تامين‌ ماسه‌ ريخته‌گري‌,919,13696631,35914527794,2727,2600,2591,-136,-4.99,2622,-105,-3.85,2591,2710,1400-10-29,2022-01-19
127,بكهنوج,توليد برق ماهتاب كهنوج,917,35020606,35135275989,1041,1049,1000,-41,-3.94,1003,-38,-3.65,990,1049,1400-10-29,2022-01-19
128,غمارگ,مارگارين‌,907,30223956,72651590468,2509,2384,2427,-82,-3.27,2404,-105,-4.18,2384,2484,1400-10-29,2022-01-19
129,ولكار,ليزينگ كارآفرين,892,330512,1252132654,3936,3752,3810,-126,-3.2,3923,-13,-0.33,3752,3849,1400-10-29,2022-01-19
130,بترانس,ايران‌ ترانسفو,890,20253003,34298925358,1705,1706,1715,10,0.59,1694,-11,-0.65,1649,1739,1400-10-29,2022-01-19
131,سرو,صندوق س سروسودمند مدبران-سهام,870,1046266,67501993860,63850,63630,64830,980,1.53,64520,670,1.05,63140,65500,1400-10-29,2022-01-19
132,تملتح,ح . تامين سرمايه بانك ملت,862,4500060,4860667491,1069,1050,1100,31,2.9,1080,11,1.03,1021,1100,1400-10-29,2022-01-19
133,خكاوه,سايپا ديزل,859,20499059,89870365408,4513,4378,4378,-135,-2.99,4384,-129,-2.86,4378,4478,1400-10-29,2022-01-19
134,شسپا,نفت سپاهان,839,15268253,49727384209,3173,3125,3250,77,2.43,3230,57,1.8,3125,3300,1400-10-29,2022-01-19
135,فگستر,گسترش صنايع روي ايرانيان,838,431515,3846458650,9150,8760,8940,-210,-2.3,9080,-70,-0.77,8760,9060,1400-10-29,2022-01-19
136,هماي,صندوق س هماي آگاه-ثابت,830,18777320,190734933877,10157,10154,10155,-2,-0.02,10158,1,0.01,10154,10161,1400-10-29,2022-01-19
137,سيمرغ,سيمرغ,826,2090832,46694909100,21680,22000,22560,880,4.06,22330,650,3,21080,22760,1400-10-29,2022-01-19
138,وپاسار,بانك  پاسارگاد,818,15448657,112907669810,7290,7300,7300,10,0.14,7310,20,0.27,7200,7350,1400-10-29,2022-01-19
139,پيزد,مجتمع صنايع لاستيك يزد,816,144605,6636199500,46100,44050,45950,-150,-0.33,46000,-100,-0.22,44050,47000,1400-10-29,2022-01-19
140,وسكرمان,س.سهام عدالت استان كرمان,816,58190827,23099289630,395,390,397,2,0.51,397,2,0.51,378,402,1400-10-29,2022-01-19
141,آگاس,صندوق س.هستي بخش آگاه-س,802,676144,49046710332,72358,71870,73064,706,0.98,72539,181,0.25,71230,73200,1400-10-29,2022-01-19
142,خزر,فنرسازي‌زر,794,3142764,26437747140,8650,8340,8350,-300,-3.47,8410,-240,-2.77,8230,8720,1400-10-29,2022-01-19
143,شاوان,پالايش نفت لاوان,792,968745,121137205600,119850,120000,125800,5950,4.96,125050,5200,4.34,119400,125800,1400-10-29,2022-01-19
144,فروي,ذوب روي اصفهان,789,1082220,17670856010,16170,16170,16400,230,1.42,16330,160,0.99,15840,16630,1400-10-29,2022-01-19
145,خاور,ايران خودرو ديزل,785,48532715,52986280034,1097,1070,1102,5,0.46,1092,-5,-0.46,1070,1102,1400-10-29,2022-01-19
146,فلامي,لاميران‌,782,3033908,47293073340,16380,16650,15570,-810,-4.95,15590,-790,-4.82,15570,16650,1400-10-29,2022-01-19
147,وپويا,سرمايه گذاري پويا,780,2989128,9402601049,3157,3072,3200,43,1.36,3150,-7,-0.22,3072,3218,1400-10-29,2022-01-19
148,قچار,فراوردههاي غذايي وقند چهارمحال,772,12660890,112695008410,9310,8850,8950,-360,-3.87,8900,-410,-4.4,8850,9190,1400-10-29,2022-01-19
149,خمهرح,ح . مهركام‌پارس‌,767,16197874,7856802408,501,500,482,-19,-3.79,485,-16,-3.19,458,508,1400-10-29,2022-01-19
150,خفناور,مهندسي صنعتي روان فن آور,758,5884304,155805962000,27200,26400,27400,200,0.74,26500,-700,-2.57,26400,27800,1400-10-29,2022-01-19
151,قرن,پديده شيمي قرن,751,1377139,32526728070,24800,23560,23700,-1100,-4.44,23620,-1180,-4.76,23560,24900,1400-10-29,2022-01-19
152,حسير,ريل سير كوثر,740,2284963,35994147240,15660,15900,15820,160,1.02,15750,90,0.57,15640,16060,1400-10-29,2022-01-19
153,ونيكي,سرمايه‌گذاري‌ ملي‌ايران‌,726,7299290,66077652950,8790,8540,9050,260,2.96,9050,260,2.96,8540,9220,1400-10-29,2022-01-19
154,كوير,توليدي فولاد سپيد فراب كوير,726,6308790,24182212368,3965,3877,3825,-140,-3.53,3881,-84,-2.12,3780,3948,1400-10-29,2022-01-19
155,كچاد,معدني‌وصنعتي‌چادرملو,722,2600079,75001666600,28250,28490,29000,750,2.65,28640,390,1.38,28300,29630,1400-10-29,2022-01-19
156,دلقما,دارويي‌ لقمان‌,720,19537330,33197187717,1776,1688,1754,-22,-1.24,1699,-77,-4.34,1688,1757,1400-10-29,2022-01-19
157,نتوس,پشم‌ بافي‌ توس,717,4548802,51544652570,11180,10850,11510,330,2.95,11330,150,1.34,10850,11510,1400-10-29,2022-01-19
158,ومعادن,توسعه‌معادن‌وفلزات‌,701,7758710,68494650570,8820,8670,8890,70,0.79,8820,0,0,8670,8960,1400-10-29,2022-01-19
159,ولملتح,ح . واسپاري ملت,691,13949382,12953649943,963,930,939,-24,-2.49,929,-34,-3.53,873,970,1400-10-29,2022-01-19
160,وسكرشا,س.سهام عدالت استان كرمانشاه,690,53425319,21146131047,399,399,405,6,1.5,396,-3,-0.75,380,405,1400-10-29,2022-01-19
161,حفاري,حفاري شمال,678,6424839,23415794090,3562,3566,3715,153,4.3,3645,83,2.33,3500,3715,1400-10-29,2022-01-19
162,ضخود2018,اختيارخ خودرو-2000-1401/02/07,676,18929,6509741000,344,311,342,-2,-0.58,344,0,0,311,366,1400-10-29,2022-01-19
163,خصدرا,صنعتي‌ دريايي‌ ايران‌,675,14217140,26878501955,1948,1890,1890,-58,-2.98,1891,-57,-2.93,1890,1929,1400-10-29,2022-01-19
164,ولساپا,ليزينگ رايان‌ سايپا,667,24031912,30794312648,1264,1281,1300,36,2.85,1281,17,1.34,1244,1301,1400-10-29,2022-01-19
165,مفاخر,توسعه فناوري اطلاعات خوارزمي,663,1126510,33340060250,28800,29400,29450,650,2.26,29600,800,2.78,28600,30200,1400-10-29,2022-01-19
166,حتايد,تايدواترخاورميانه,655,9453146,48345781110,4910,5050,5120,210,4.28,5110,200,4.07,4870,5150,1400-10-29,2022-01-19
167,فسرب,ملي‌ سرب‌وروي‌ ايران‌,647,9944024,14687757744,1505,1470,1479,-26,-1.73,1477,-28,-1.86,1440,1529,1400-10-29,2022-01-19
168,كپارس,كاشي‌ پارس‌,643,4917593,35139594560,7240,7050,7180,-60,-0.83,7150,-90,-1.24,7010,7400,1400-10-29,2022-01-19
169,واحيا,م .صنايع و معادن احياء سپاهان,643,5508070,77417661630,14460,14030,14200,-260,-1.8,14060,-400,-2.77,14030,14290,1400-10-29,2022-01-19
170,ملت,بيمه ملت,642,36799199,44826609811,1221,1210,1223,2,0.16,1218,-3,-0.25,1200,1230,1400-10-29,2022-01-19
171,خكمك,كمك‌فنرايندامين‌,640,1663644,36679229970,22840,22460,21730,-1110,-4.86,22050,-790,-3.46,21700,23640,1400-10-29,2022-01-19
172,خمحركه,نيرو محركه‌,640,5687086,17667204804,3148,3050,3115,-33,-1.05,3107,-41,-1.3,3035,3183,1400-10-29,2022-01-19
173,اپال,فرآوري معدني اپال كاني پارس,634,939447,22024757310,23490,23490,23370,-120,-0.51,23480,-10,-0.04,23360,23550,1400-10-29,2022-01-19
174,رتاپ,تجارت الكترونيك  پارسيان,633,12231168,63712204026,4984,4990,5137,153,3.07,5209,225,4.51,4845,5233,1400-10-29,2022-01-19
175,رانفور,خدمات‌انفورماتيك‌,625,19702943,67586014861,3389,3400,3431,42,1.24,3430,41,1.21,3350,3500,1400-10-29,2022-01-19
176,كاوه,فولاد كاوه جنوب كيش,622,2874491,33198053510,11780,11500,11510,-270,-2.29,11670,-110,-0.93,11300,11780,1400-10-29,2022-01-19
177,بجهرم,توسعه مولد نيروگاهي جهرم,621,6704629,12131826357,1781,1805,1810,29,1.63,1801,20,1.12,1783,1829,1400-10-29,2022-01-19
178,ياقوت,صندوق س ياقوت آگاه-ثابت,621,15543250,217734068190,14001,14008,14008,7,0.05,14008,7,0.05,14008,14013,1400-10-29,2022-01-19
179,كگل,معدني و صنعتي گل گهر,620,3289062,71057721880,21180,21180,21800,620,2.93,21440,260,1.23,21180,21970,1400-10-29,2022-01-19
180,قاسم,قاسم ايران,618,2570553,8995286665,3440,3360,3429,-11,-0.32,3477,37,1.08,3360,3570,1400-10-29,2022-01-19
181,پارس,پتروشيمي پارس,615,288321,47834994880,164150,165800,165580,1430,0.87,164990,840,0.51,165010,167990,1400-10-29,2022-01-19
182,غسالم,سالمين‌,614,6427811,15564187168,2463,2382,2398,-65,-2.64,2421,-42,-1.71,2340,2482,1400-10-29,2022-01-19
183,غمينو,شركت صنايع غذايي مينو شرق,613,6737836,26814828064,3814,3634,4004,190,4.98,3980,166,4.35,3631,4004,1400-10-29,2022-01-19
184,دسانكو,داروسازي سبحان انكولوژي,610,1948387,24120991660,12080,12320,12600,520,4.3,12380,300,2.48,12100,12600,1400-10-29,2022-01-19
185,غفارس,شير پاستوريزه پگاه فارس,609,4232044,21906376448,5169,5245,5020,-149,-2.88,5176,7,0.14,5000,5400,1400-10-29,2022-01-19
186,ماديرا,صنايع ماديران,607,4091861,18732304200,4720,4520,4630,-90,-1.91,4580,-140,-2.97,4510,4690,1400-10-29,2022-01-19
187,فولاي,صنايع فولاد آلياژي يزد,599,2343354,14361544820,6380,6320,6080,-300,-4.7,6130,-250,-3.92,6070,6360,1400-10-29,2022-01-19
188,قثابت,قند ثابت‌ خراسان‌,596,10081599,15298749068,1537,1528,1523,-14,-0.91,1517,-20,-1.3,1479,1545,1400-10-29,2022-01-19
189,وصنعت,سرمايه گذاري توسعه صنعت وتجارت,593,3382888,21156993490,6460,6400,6200,-260,-4.02,6250,-210,-3.25,6160,6600,1400-10-29,2022-01-19
190,غديس,پاكديس,590,2735559,27779168500,10660,10130,10130,-530,-4.97,10150,-510,-4.78,10130,10440,1400-10-29,2022-01-19
191,تسه0006,امتيازتسهيلات مسكن شهريور1400,586,13529,16809257448,1240432,1244969,1260000,19568,1.58,1242461,2029,0.16,1222000,1270000,1400-10-29,2022-01-19
192,وسديد,گروه ‌صنعتي‌سديد,584,9535645,8677436950,938,910,910,-28,-2.99,916,-22,-2.35,910,910,1400-10-29,2022-01-19
193,كسرا,سراميك‌هاي‌صنعتي‌اردكان‌,573,3976472,53057293190,13510,13800,13140,-370,-2.74,13340,-170,-1.26,12900,13800,1400-10-29,2022-01-19
194,ونوين,بانك‌اقتصادنوين‌,572,12525605,39788693811,3197,3197,3181,-16,-0.5,3177,-20,-0.63,3058,3259,1400-10-29,2022-01-19
195,اتكاي,بيمه اتكايي ايرانيان,571,6527260,67928147720,10260,10430,10540,280,2.73,10410,150,1.46,10210,10580,1400-10-29,2022-01-19
196,زنگان,صنعت روي زنگان,569,294017,14974540250,52800,50600,51500,-1300,-2.46,50950,-1850,-3.5,50200,52800,1400-10-29,2022-01-19
197,پسهند,صنايع‌ لاستيكي‌  سهند,566,1220783,33675711180,28860,27460,28000,-860,-2.98,27590,-1270,-4.4,27420,28700,1400-10-29,2022-01-19
198,شلعاب,لعابيران‌,558,5822949,25375473230,4570,4350,4400,-170,-3.72,4360,-210,-4.6,4350,4420,1400-10-29,2022-01-19
199,زبينا,كشاورزي و دامپروري بينالود,553,9545437,21041362040,2171,2073,2267,96,4.42,2204,33,1.52,2073,2270,1400-10-29,2022-01-19
200,كرماشا,صنايع پتروشيمي كرمانشاه,544,807445,38094888600,45370,46500,47630,2260,4.98,46410,1040,2.29,45000,47630,1400-10-29,2022-01-19
201,حفارس,حمل و نقل بين المللي خليج فارس,540,8892239,47707259602,5119,5258,5374,255,4.98,5365,246,4.81,5200,5374,1400-10-29,2022-01-19
202,شجم,صنايع پتروشيمي تخت جمشيد,535,4628444,49133515660,10560,10040,10800,240,2.27,10620,60,0.57,10040,10990,1400-10-29,2022-01-19
203,پتاير,ايران‌ تاير,534,9932871,16210420906,1634,1620,1628,-6,-0.37,1632,-2,-0.12,1600,1684,1400-10-29,2022-01-19
204,تملت,تامين سرمايه بانك ملت,530,4770829,11840461714,2498,2470,2487,-11,-0.44,2486,-12,-0.48,2435,2506,1400-10-29,2022-01-19
205,تسه0008,امتيازتسهيلات مسكن آبان1400,529,8093,10041656399,1242193,1230000,1230000,-12193,-0.98,1240783,-1410,-0.11,1215101,1250960,1400-10-29,2022-01-19
206,كارين,صندوق س نگين سامان-ثابت,505,19565550,198936709696,10161,10166,10168,7,0.07,10168,7,0.07,10165,10168,1400-10-29,2022-01-19
207,فسپا,گروه‌صنعتي‌سپاهان‌,502,1632089,25539520800,15740,15590,15890,150,0.95,15650,-90,-0.57,15390,16100,1400-10-29,2022-01-19
208,شيران,س. صنايع‌شيميايي‌ايران,500,1568183,28746466570,18270,17730,18500,230,1.26,18290,20,0.11,17730,18510,1400-10-29,2022-01-19
209,ميهن,بيمه ميهن,500,20619720,47839542699,2294,2270,2404,110,4.8,2320,26,1.13,2270,2408,1400-10-29,2022-01-19
210,اخابر,مخابرات ايران,497,5389298,36804938260,6880,6710,6830,-50,-0.73,6860,-20,-0.29,6710,6990,1400-10-29,2022-01-19
211,هرمز,فولاد هرمزگان جنوب,496,1776898,24255814800,13780,13730,13530,-250,-1.81,13750,-30,-0.22,13460,14000,1400-10-29,2022-01-19
212,پرداخت,به پرداخت ملت,496,3121735,47346777910,14490,14970,15210,720,4.97,15170,680,4.69,14190,15210,1400-10-29,2022-01-19
213,نطرين,عطرين نخ قم,494,3529985,22504792050,6680,6350,6350,-330,-4.94,6380,-300,-4.49,6350,6750,1400-10-29,2022-01-19
214,دسبحانح,ح. سبحان دارو,494,1470486,8710518720,12350,6490,5850,-6500,-52.63,5920,-6430,-52.06,5850,6490,1400-10-29,2022-01-19
215,وبانك,سرمايه گذاري گروه توسعه ملي,491,6141178,47841061360,7790,7650,7850,60,0.77,7790,0,0,7640,7880,1400-10-29,2022-01-19
216,حآسا,آسيا سير ارس,490,2442727,28154223050,11040,11300,11590,550,4.98,11530,490,4.44,11200,11590,1400-10-29,2022-01-19
217,وگردش,بانك گردشگري,490,17559149,180861751810,10290,10300,10310,20,0.19,10300,10,0.1,10270,10340,1400-10-29,2022-01-19
218,غگرجي,بيسكويت‌  گرجي‌,485,11669155,18389144749,1650,1571,1601,-49,-2.97,1576,-74,-4.48,1568,1631,1400-10-29,2022-01-19
219,فپنتا,سپنتا,484,38529,16429028230,444320,442800,435700,-8620,-1.94,426410,-17910,-4.03,422110,442800,1400-10-29,2022-01-19
220,ارفع,شركت آهن و فولاد ارفع,482,7212979,94995767520,13860,13170,13170,-690,-4.98,13170,-690,-4.98,13170,13440,1400-10-29,2022-01-19
221,چدن,توليدي چدن سازان,482,7583161,15030446489,2012,1921,1971,-41,-2.04,1982,-30,-1.49,1921,2040,1400-10-29,2022-01-19
222,غپآذر,شير پگاه آذربايجان شرقي,476,951890,33359443500,34450,33500,34350,-100,-0.29,35050,600,1.74,32900,35900,1400-10-29,2022-01-19
223,خكار,ايركا پارت صنعت,473,8094540,21990211219,2755,2664,2700,-55,-2,2717,-38,-1.38,2634,2800,1400-10-29,2022-01-19
224,وساپا,سرمايه‌گذاري‌ سايپا,471,7390904,28741267338,3867,3868,3882,15,0.39,3889,22,0.57,3773,3949,1400-10-29,2022-01-19
225,كبافق,معادن‌ بافق‌,469,605416,13498814840,22410,22370,22330,-80,-0.36,22300,-110,-0.49,21510,23060,1400-10-29,2022-01-19
226,سنير,سيمان‌ سفيد ني‌ريز,469,489467,11511074510,24610,23900,23380,-1230,-5,23640,-970,-3.94,23380,24140,1400-10-29,2022-01-19
227,سكه0012پ01,تمام سكه طرح جديد0012رفاه,467,277100,329238235100,1179419,1186010,1184000,4581,0.39,1188157,8738,0.74,1183500,1197000,1400-10-29,2022-01-19
228,وصنا,گروه‌صنايع‌بهشهرايران‌,462,4309036,11943233065,2747,2740,2767,20,0.73,2769,22,0.8,2724,2873,1400-10-29,2022-01-19
229,بپاس,بيمه پاسارگاد,462,3275275,114531852250,35000,35000,35100,100,0.29,34950,-50,-0.14,33600,35150,1400-10-29,2022-01-19
230,كصدف,كاشي صدف سرام استقلال آباده,460,3591681,81896235700,23000,23650,22550,-450,-1.96,22800,-200,-0.87,22350,23650,1400-10-29,2022-01-19
231,غالبر,لبنيات‌ كالبر,460,1531447,14021187880,9530,9080,9060,-470,-4.93,9160,-370,-3.88,9060,9700,1400-10-29,2022-01-19
232,فباهنر,مس‌ شهيدباهنر,459,534866,14155838050,26040,25550,26750,710,2.73,26260,220,0.84,25550,26800,1400-10-29,2022-01-19
233,واحصا,احياء صنايع خراسان,458,540877,17787881600,32750,34350,31800,-950,-2.9,32900,150,0.46,31150,34350,1400-10-29,2022-01-19
234,وپترو,سرمايه‌گذاري صنايع پتروشيمي‌,453,2624595,24175835550,9680,9200,9200,-480,-4.96,9210,-470,-4.86,9200,9700,1400-10-29,2022-01-19
235,غپينو,پارس‌ مينو,453,4809723,9102152738,1874,1846,1886,12,0.64,1887,13,0.69,1820,1938,1400-10-29,2022-01-19
236,دلر,داروسازي‌ اكسير,450,2024286,80768872740,38210,37700,40120,1910,5,39900,1690,4.42,37700,40120,1400-10-29,2022-01-19
237,ختراك,ريخته‌گري‌ تراكتورسازي‌ ايران‌,445,4310604,19199218359,4672,4446,4440,-232,-4.97,4454,-218,-4.67,4439,4592,1400-10-29,2022-01-19
238,كتوكاح,ح.توليدي وخدمات صنايع نسوزتوكا,442,5583172,24166707596,4175,4036,4240,65,1.56,4328,153,3.66,4036,4376,1400-10-29,2022-01-19
239,پاكشو,گروه صنعتي پاكشو,441,18801198,113848239450,6000,5950,6250,250,4.17,6050,50,0.83,5910,6250,1400-10-29,2022-01-19
240,شپترو,پتروشيمي آبادان,441,6618718,17894029018,2641,2596,2704,63,2.39,2704,63,2.39,2596,2720,1400-10-29,2022-01-19
241,سمايه,بانك سرمايه,438,3693442,15262005002,4015,3952,4135,120,2.99,4132,117,2.91,3952,4135,1400-10-29,2022-01-19
242,سغدير,توسعه سرمايه و صنعت غدير,438,1132980,14905593570,13450,13300,13140,-310,-2.3,13200,-250,-1.86,12780,13500,1400-10-29,2022-01-19
243,قزوين,كارخانجات‌ قند قزوين‌,435,5059586,21337404092,4248,4037,4340,92,2.17,4217,-31,-0.73,4036,4460,1400-10-29,2022-01-19
244,كيميا,معدني كيمياي زنجان گستران,434,1947378,21567548120,11240,10700,11290,50,0.44,11080,-160,-1.42,10700,11500,1400-10-29,2022-01-19
245,خرينگ,رينگ‌سازي‌مشهد,433,781335,18042494700,23710,23000,23000,-710,-2.99,23090,-620,-2.61,22620,23700,1400-10-29,2022-01-19
246,چكارن,كارتن‌ ايران‌,432,6036136,15831544283,2608,2610,2647,39,1.5,2623,15,0.58,2600,2685,1400-10-29,2022-01-19
247,كتوكا,توليدي و خدمات صنايع نسوز توكا,430,2485700,15910434060,6290,6310,6480,190,3.02,6400,110,1.75,6100,6530,1400-10-29,2022-01-19
248,ومهان,گروه توسعه مالي مهر آيندگان,430,3444018,13835921806,4042,3920,4004,-38,-0.94,4035,-7,-0.17,3920,4060,1400-10-29,2022-01-19
249,فلوله,لوله‌وماشين‌سازي‌ايران‌,429,10945744,9699073578,878,852,898,20,2.28,884,6,0.68,852,900,1400-10-29,2022-01-19
250,شنفت,نفت‌ پارس‌,426,2249448,20817480250,9380,9100,8990,-390,-4.16,9340,-40,-0.43,8990,9570,1400-10-29,2022-01-19
251,واميد,گروه مديريت سرمايه گذاري اميد,424,7556690,106508728680,14050,14050,14210,160,1.14,14090,40,0.28,13840,14260,1400-10-29,2022-01-19
252,پخش,پخش البرز,421,1626443,39174931100,23150,23350,24300,1150,4.97,24100,950,4.1,22850,24300,1400-10-29,2022-01-19
253,فسازانح,ح . غلتك سازان سپاهان,418,5030474,10750347211,2180,2151,2057,-123,-5.64,2137,-43,-1.97,1962,2207,1400-10-29,2022-01-19
254,دماوند,توليد نيروي برق دماوند,416,872512,14132303990,16740,16010,16170,-570,-3.41,16530,-210,-1.25,16010,16550,1400-10-29,2022-01-19
255,بشهاب,لامپ‌  پارس‌ شهاب‌,412,453621,62562155760,139770,133010,139000,-770,-0.55,137920,-1850,-1.32,132790,139800,1400-10-29,2022-01-19
256,افرا,افرانت,411,1144022,25850360700,21550,22600,22600,1050,4.87,22600,1050,4.87,21850,22600,1400-10-29,2022-01-19
257,تپمپي,پمپ‌ سازي‌ ايران‌,405,1552881,32868382680,20920,21000,21500,580,2.77,21170,250,1.2,20530,21530,1400-10-29,2022-01-19
258,رمپنا,گروه مپنا (سهامي عام),404,3966377,59148908490,15060,14600,14950,-110,-0.73,14980,-80,-0.53,14600,15480,1400-10-29,2022-01-19
259,شفارس,صنايع‌ شيميايي‌ فارس‌,402,9315824,8394799908,930,895,903,-27,-2.9,912,-18,-1.94,887,928,1400-10-29,2022-01-19
260,همراه,شركت ارتباطات سيار ايران,401,2517410,19489397130,7790,7620,7690,-100,-1.28,7780,-10,-0.13,7620,7950,1400-10-29,2022-01-19
261,وليز,ليزينگ‌ايران‌,400,6030897,9780034318,1704,1619,1619,-85,-4.99,1649,-55,-3.23,1619,1680,1400-10-29,2022-01-19
262,خريختح,ح . صنايع‌ريخته‌گري‌ايران‌,399,5791575,7081145481,1272,1170,1200,-72,-5.66,1223,-49,-3.85,1170,1270,1400-10-29,2022-01-19
263,وآذر,سرمايه‌گذاري‌توسعه‌آذربايجان‌,399,2201160,64508612970,29770,29800,30050,280,0.94,29310,-460,-1.55,28550,30540,1400-10-29,2022-01-19
264,خفنر,فنرسازي‌خاور,399,2967904,16745427540,5920,5630,5630,-290,-4.9,5640,-280,-4.73,5630,5760,1400-10-29,2022-01-19
265,البرز,بيمه البرز,399,8068003,13160562847,1619,1667,1623,4,0.25,1628,9,0.56,1619,1669,1400-10-29,2022-01-19
266,خمهر,مهركام‌پارس‌,398,11867045,19943239500,1665,1623,1701,36,2.16,1681,16,0.96,1623,1725,1400-10-29,2022-01-19
267,تسه0007,امتيازتسهيلات مسكن مهر1400,397,5500,6829377948,1247003,1224000,1255000,7997,0.64,1241705,-5298,-0.42,1224000,1259000,1400-10-29,2022-01-19
268,زكوثر,سرمايه گذاري كشاورزي كوثر,397,683422,8863141680,12950,12550,12980,30,0.23,12960,10,0.08,12550,13380,1400-10-29,2022-01-19
269,كرازي,كارخانجات‌توليدي‌شيشه‌رازي‌,396,11970128,13949423310,1153,1185,1168,15,1.3,1165,12,1.04,1150,1186,1400-10-29,2022-01-19
270,وهنر,گروه توسعه هنر ايران,394,7285264,15298239216,2163,2099,2099,-64,-2.96,2100,-63,-2.91,2099,2130,1400-10-29,2022-01-19
271,زدشت,كشت و صنعت دشت خرم دره,390,2346925,28978383400,12980,12340,12350,-630,-4.85,12350,-630,-4.85,12340,12870,1400-10-29,2022-01-19
272,سصفها,سيمان‌اصفهان‌,389,859137,20002330080,22720,22500,23850,1130,4.97,23280,560,2.46,21660,23850,1400-10-29,2022-01-19
273,غويتا,ويتانا,387,2794023,11826086121,4233,4233,4201,-32,-0.76,4233,0,0,4100,4350,1400-10-29,2022-01-19
274,شيراز,پتروشيمي‌شيراز,384,892152,56646204950,64040,63000,63220,-820,-1.28,63690,-350,-0.55,63000,64080,1400-10-29,2022-01-19
275,خمحور,توليدمحورخودرو,384,6472909,16735244823,2577,2499,2620,43,1.67,2585,8,0.31,2463,2648,1400-10-29,2022-01-19
276,تسه0005,امتيازتسهيلات مسكن مرداد 1400,382,7371,9160277929,1241945,1223000,1220000,-21945,-1.77,1242746,801,0.06,1210522,1272998,1400-10-29,2022-01-19
277,تكشا,گسترش‌صنايع‌وخدمات‌كشاورزي‌,381,810532,31875249040,37630,36030,39510,1880,5,39330,1700,4.52,36030,39510,1400-10-29,2022-01-19
278,گكوثر,هتل پارسيان كوثر اصفهان,380,5031487,6566924451,1287,1321,1320,33,2.56,1295,8,0.62,1273,1321,1400-10-29,2022-01-19
279,دفاراح,ح . داروسازي‌ فارابي‌,373,12677169,120434055500,9500,9500,9500,0,0,9500,0,0,9500,10450,1400-10-29,2022-01-19
280,ولشرقح,ح . ليزينگ ايران و شرق,370,14530002,7137940934,513,488,489,-24,-4.68,491,-22,-4.29,488,513,1400-10-29,2022-01-19
281,دتوليد,داروسازي توليد دارو,370,1301148,8516495370,6640,6600,6670,30,0.45,6580,-60,-0.9,6360,6680,1400-10-29,2022-01-19
282,فمراد,آلومراد,370,674304,8089830550,11900,12040,12010,110,0.92,11950,50,0.42,11500,12290,1400-10-29,2022-01-19
283,اطلس,صندوق س.توسعه اندوخته آينده-س,368,75416,17088904588,226080,225100,227479,1399,0.62,226595,515,0.23,225002,229000,1400-10-29,2022-01-19
284,كامياب,صندوق س. كامياب آشنا-د,368,6020849,67979983689,11283,11290,11291,8,0.07,11291,8,0.07,11290,11291,1400-10-29,2022-01-19
285,مدير,ص.س.مديريت ثروت ص.بازنشستگي-س,367,2335311,19423769628,8302,8296,8361,59,0.71,8317,15,0.18,8230,8400,1400-10-29,2022-01-19
286,حريل,ريل پردازسير,364,4285495,9081036861,2154,2070,2110,-44,-2.04,2130,-24,-1.11,2070,2180,1400-10-29,2022-01-19
287,چكاوه,صنايع‌كاغذسازي‌كاوه‌,361,2594576,17891711360,7010,6720,7000,-10,-0.14,6900,-110,-1.57,6660,7090,1400-10-29,2022-01-19
288,آريان,سرمايه گذاري پارس آريان,359,5783557,73195222030,12390,12480,12760,370,2.99,12580,190,1.53,12480,12760,1400-10-29,2022-01-19
289,ولملت,واسپاري ملت,359,6855363,16567093143,2542,2418,2421,-121,-4.76,2417,-125,-4.92,2415,2474,1400-10-29,2022-01-19
290,شفا,سرمايه گذاري شفادارو,357,1308829,13527328620,10290,9780,10470,180,1.75,10330,40,0.39,9780,10800,1400-10-29,2022-01-19
291,ثبات,صندوق س. ثبات ويستا -د,354,14694128,158490551082,10778,10785,10786,8,0.07,10786,8,0.07,10785,10788,1400-10-29,2022-01-19
292,خلنت,لنت‌ ترمزايران‌,353,170166,11004691350,64280,67490,64470,190,0.3,64590,310,0.48,63000,67490,1400-10-29,2022-01-19
293,خكرمان,گروه اقتصادي كرمان خودرو,350,7346172,23579324992,3303,3270,3272,-31,-0.94,3210,-93,-2.82,3204,3272,1400-10-29,2022-01-19
294,خموتور,موتورسازان‌تراكتورسازي‌ايران‌,350,3631519,13788495464,3981,3782,3785,-196,-4.92,3797,-184,-4.62,3782,3913,1400-10-29,2022-01-19
295,غپاك,لبنيات‌ پاك‌,348,1084094,13146983050,12610,12770,12130,-480,-3.81,12170,-440,-3.49,11980,12770,1400-10-29,2022-01-19
296,وهور,مديريت انرژي اميد  تابان هور,347,11414726,12590079051,1108,1062,1088,-20,-1.81,1106,-2,-0.18,1062,1135,1400-10-29,2022-01-19
297,ثتران,سرمايه گذاري مسكن تهران,347,7205788,21103896028,3079,2926,2926,-153,-4.97,2929,-150,-4.87,2926,3063,1400-10-29,2022-01-19
298,كاذر,فرآورده‌هاي‌نسوزآذر,344,1325026,14650420510,11120,11490,11150,30,0.27,11060,-60,-0.54,10570,11500,1400-10-29,2022-01-19
299,سفارس,سيمان فارس و خوزستان,343,2199660,32306418240,14430,14260,14760,330,2.29,14680,250,1.73,14260,14870,1400-10-29,2022-01-19
300,وايران,ليزينگ ايرانيان,341,3395819,8376008706,2510,2510,2448,-62,-2.47,2483,-27,-1.08,2414,2590,1400-10-29,2022-01-19
301,كسرام,پارس‌ سرام‌,341,5976045,24976101341,4045,3925,4247,202,4.99,4179,134,3.31,3922,4247,1400-10-29,2022-01-19
302,ضخود2021,اختيارخ خودرو-3500-1401/02/07,340,20860,896450000,35,49,38,3,8.57,43,8,22.86,29,50,1400-10-29,2022-01-19
303,غبشهر,صنعتي‌ بهشهر,338,5448072,18080636255,3308,3300,3377,69,2.09,3315,7,0.21,3204,3379,1400-10-29,2022-01-19
304,سخاش,سيمان‌خاش‌,335,156712,11129542680,71950,74100,71470,-480,-0.67,71170,-780,-1.08,69060,74100,1400-10-29,2022-01-19
305,غشهداب,كشت و صنعت شهداب ناب خراسان,334,3261345,7599576467,2307,2241,2345,38,1.65,2320,13,0.56,2241,2376,1400-10-29,2022-01-19
306,وسكاب,س.ص.بازنشستگي كاركنان بانكها,333,5024393,14176165561,2784,2784,2878,94,3.38,2820,36,1.29,2750,2880,1400-10-29,2022-01-19
307,سبزوا,سيمان لار سبزوار,332,3825372,6514559966,1748,1760,1699,-49,-2.8,1728,-20,-1.14,1675,1760,1400-10-29,2022-01-19
308,زكشت,كشاورزي مكانيزه اصفهان كشت,332,646828,10078486500,16310,16100,15680,-630,-3.86,15760,-550,-3.37,15500,16260,1400-10-29,2022-01-19
309,وسين,بيمه سينا,332,7923711,24112159538,3134,3060,3041,-93,-2.97,3043,-91,-2.9,3040,3112,1400-10-29,2022-01-19
310,وجامي,سرمايه گذاري جامي,330,2355747,7989591020,3487,3383,3383,-104,-2.98,3392,-95,-2.72,3383,3500,1400-10-29,2022-01-19
311,حپترو,حمل و نقل پتروشيمي( سهامي عام,329,779309,13781269040,18580,17800,17820,-760,-4.09,17680,-900,-4.84,17660,18680,1400-10-29,2022-01-19
312,كسعدي,كاشي‌ سعدي‌,325,1869743,13069271930,6910,6950,6980,70,1.01,6980,70,1.01,6610,7170,1400-10-29,2022-01-19
313,فزرين,زرين معدن آسيا,323,1783738,18378962580,10100,10010,10420,320,3.17,10300,200,1.98,10000,10440,1400-10-29,2022-01-19
314,فاسمين,كالسيمين‌,321,2672846,41698468840,15490,15690,15600,110,0.71,15600,110,0.71,15450,15990,1400-10-29,2022-01-19
315,شبهرن,نفت‌ بهران‌,321,1777775,19065581930,10720,10700,10750,30,0.28,10720,0,0,10520,10940,1400-10-29,2022-01-19
316,تبرك,گروه كارخانجات صنعتي تبرك,319,1374515,11006471320,7910,7950,8090,180,2.28,7980,70,0.88,7800,8150,1400-10-29,2022-01-19
317,ثمسكن,سرمايه‌گذاري‌ مسكن‌,318,3367053,9813235584,3032,3040,2949,-83,-2.74,2944,-88,-2.9,2881,3040,1400-10-29,2022-01-19
318,زماهان,مجتمع توليد گوشت مرغ ماهان,317,2598288,16190403740,6250,6240,6220,-30,-0.48,6230,-20,-0.32,6100,6390,1400-10-29,2022-01-19
319,فرآور,فرآوري‌موادمعدني‌ايران‌,317,595834,14128429270,24280,23900,23650,-630,-2.59,23710,-570,-2.35,23330,24190,1400-10-29,2022-01-19
320,بموتو,موتوژن‌,317,243185,15695368370,65420,64210,65500,80,0.12,64630,-790,-1.21,64150,66900,1400-10-29,2022-01-19
321,تپولا,مهندسي مرآت پولاد,317,663908,8161134040,12480,12850,12110,-370,-2.96,12290,-190,-1.52,12110,12850,1400-10-29,2022-01-19
322,ودي,بيمه  دي,317,3099267,12246734054,4013,3902,3970,-43,-1.07,3960,-53,-1.32,3862,4083,1400-10-29,2022-01-19
323,آكورد,صندوق س. آرمان آتي كوثر-د,316,6870816,249909432263,36355,36372,36375,20,0.06,36373,18,0.05,36372,36377,1400-10-29,2022-01-19
324,زر,صندوق س.پشتوانه سكه طلاي زر,316,323151,16589877057,49993,50968,51300,1307,2.61,51338,1345,2.69,50001,51594,1400-10-29,2022-01-19
325,بزاگرس,نيروگاه زاگرس كوثر,310,3034627,8489865232,2904,2790,2820,-84,-2.89,2837,-67,-2.31,2759,2940,1400-10-29,2022-01-19
326,سشرق,سيمان‌ شرق‌,310,2256554,14615969300,6440,6500,6560,120,1.86,6480,40,0.62,6340,6620,1400-10-29,2022-01-19
327,تصميم,صندوق س با درآمد ثابت تصميم,310,6458824,120063804932,18567,18585,18606,39,0.21,18589,22,0.12,18585,18698,1400-10-29,2022-01-19
328,جم پيلن,پلي پروپيلن جم - جم پيلن,309,231451,26644272190,115560,115550,116500,940,0.81,115430,-130,-0.11,112710,117000,1400-10-29,2022-01-19
329,زشريف,كشت وصنعت شريف آباد,307,4324156,14214964379,3410,3240,3253,-157,-4.6,3290,-120,-3.52,3240,3480,1400-10-29,2022-01-19
330,قشكر,شكرشاهرود,306,11019375,21512284869,2053,1951,1951,-102,-4.97,1952,-101,-4.92,1951,2000,1400-10-29,2022-01-19
331,ميدكو,توسعه معادن وص.معدني خاورميانه,305,4982932,228769850020,45900,45200,45960,60,0.13,45910,10,0.02,44530,46000,1400-10-29,2022-01-19
332,كپرور,فرآوري زغال سنگ پروده طبس,305,529235,16605019350,30250,31650,31200,950,3.14,31400,1150,3.8,30000,31750,1400-10-29,2022-01-19
333,غبهنوش,بهنوش‌ ايران‌,304,221242,11920977460,55210,52500,53420,-1790,-3.24,54050,-1160,-2.1,52500,57000,1400-10-29,2022-01-19
334,كروي,توسعه‌ معادن‌ روي‌ ايران‌,303,600333,12104153430,20250,19570,20360,110,0.54,20200,-50,-0.25,19570,20650,1400-10-29,2022-01-19
335,وساخت,سرمايه‌ گذاري‌ ساختمان‌ايران‌,303,285318,8697424580,31580,30010,30300,-1280,-4.05,30880,-700,-2.22,30010,31580,1400-10-29,2022-01-19
336,شپاكسا,پاكسان‌,299,582652,10027002220,17820,17400,17140,-680,-3.82,17360,-460,-2.58,16930,17820,1400-10-29,2022-01-19
337,دتماد,توليدمواداوليه‌داروپخش‌,298,346425,12805910560,36860,35800,36970,110,0.3,36960,100,0.27,35800,38100,1400-10-29,2022-01-19
338,توريل,توكاريل,297,1638758,12050059160,7110,6970,7400,290,4.08,7320,210,2.95,6970,7460,1400-10-29,2022-01-19
339,وبشهر,توسعه‌ صنايع‌ بهشهر(هلدينگ,297,2051930,12584550220,6430,6310,6110,-320,-4.98,6330,-100,-1.56,6110,6310,1400-10-29,2022-01-19
340,غشان,شيرپاستوريزه‌پگاه‌خراسان‌,296,4160974,14839319637,3738,3552,3553,-185,-4.95,3566,-172,-4.6,3552,3738,1400-10-29,2022-01-19
341,آسيا,بيمه آسيا,296,5258794,8270592217,1573,1555,1573,0,0,1573,0,0,1515,1600,1400-10-29,2022-01-19
342,تكمبا,كمباين‌ سازي‌ ايران‌,295,3802982,12367304933,3418,3248,3249,-169,-4.94,3269,-149,-4.36,3248,3335,1400-10-29,2022-01-19
343,فافق,صنايع مس افق كرمان,294,2601532,7859036664,3039,3050,3044,5,0.16,3024,-15,-0.49,2961,3060,1400-10-29,2022-01-19
344,جوين,كشت و صنعت جوين,293,2300875,5559182395,2452,2395,2392,-60,-2.45,2432,-20,-0.82,2379,2470,1400-10-29,2022-01-19
345,خاذين,سايپاآذين‌,293,3512594,8567342884,2437,2351,2446,9,0.37,2438,1,0.04,2351,2529,1400-10-29,2022-01-19
346,تسه0004,امتيازتسهيلات مسكن تير1400,290,4062,5051299259,1240744,1236000,1230101,-10643,-0.86,1243550,2806,0.23,1220066,1257000,1400-10-29,2022-01-19
347,دتوزيع,توزيع دارو پخش,289,829714,19332125400,22250,22400,23350,1100,4.94,23300,1050,4.72,22400,23350,1400-10-29,2022-01-19
348,شخارك,پتروشيمي‌ خارك‌,288,599611,28337547550,47980,45750,46700,-1280,-2.67,47770,-210,-0.44,45740,47890,1400-10-29,2022-01-19
349,وگستر,گسترش سرمايه گذاري ايرانيان,288,1897779,8740648131,4632,4503,4600,-32,-0.69,4616,-16,-0.35,4503,4660,1400-10-29,2022-01-19
350,اهرم,صندوق س سهامي كاريزما- اهرمي,288,1065941,10084541320,9420,9430,9540,120,1.27,9460,40,0.42,9420,9540,1400-10-29,2022-01-19
351,بكام,كارخانجات توليدي شهيد قندي,288,5406600,7959754928,1467,1498,1482,15,1.02,1470,3,0.2,1455,1498,1400-10-29,2022-01-19
352,لخزر,پارس‌ خزر,287,88308,8713273270,103630,98470,99430,-4200,-4.05,100460,-3170,-3.06,98450,100900,1400-10-29,2022-01-19
353,شكلر,نيروكلر,286,982495,31218653830,31960,30800,31110,-850,-2.66,31770,-190,-0.59,30380,32750,1400-10-29,2022-01-19
354,خشرق,الكتريك‌ خودرو شرق‌,285,1252378,12710607130,10470,10610,9980,-490,-4.68,10160,-310,-2.96,9950,10610,1400-10-29,2022-01-19
355,وبوعلي,سرمايه‌گذاري‌بوعلي‌,284,2802247,9576883982,3479,3361,3400,-79,-2.27,3438,-41,-1.18,3361,3500,1400-10-29,2022-01-19
356,ساوه,سيمان ساوه,281,57909,2537437250,44400,42800,43700,-700,-1.58,44300,-100,-0.23,42800,44200,1400-10-29,2022-01-19
357,والبر,سرمايه‌ گذاري‌ البرز(هلدينگ‌,281,1763446,12453154280,7170,6820,7280,110,1.53,7110,-60,-0.84,6820,7280,1400-10-29,2022-01-19
358,شكربن,كربن‌ ايران‌,276,243638,19108989080,75590,75160,79360,3770,4.99,78430,2840,3.76,75140,79360,1400-10-29,2022-01-19
359,خاهن,آهنگري‌ تراكتورسازي‌ ايران‌,276,1708307,6517942696,3966,3768,3864,-102,-2.57,3921,-45,-1.13,3768,3922,1400-10-29,2022-01-19
360,تسه9908,امتياز تسهيلات مسكن آبان99,274,5264,6524217802,1236173,1215167,1237000,827,0.07,1239403,3230,0.26,1202115,1258844,1400-10-29,2022-01-19
361,ستران,سيمان‌ تهران‌,272,601361,11273627770,18790,18250,18830,40,0.21,18760,-30,-0.16,18250,19390,1400-10-29,2022-01-19
362,كپشير,پشم‌شيشه‌ايران‌,272,1539261,14600088960,9970,9480,9480,-490,-4.91,9490,-480,-4.81,9480,9930,1400-10-29,2022-01-19
363,تسه0003,امتيازتسهيلات مسكن خرداد1400,271,4287,5329631527,1243044,1200000,1230000,-13044,-1.05,1243208,164,0.01,1200000,1267990,1400-10-29,2022-01-19
364,وخاور,بانك خاورميانه,269,3407774,16712202615,4952,4880,4900,-52,-1.05,4936,-16,-0.32,4880,4952,1400-10-29,2022-01-19
365,وپسا,س. پتروشيمي ساختمان  خليج فارس,269,7712244,11300494896,1424,1466,1466,42,2.95,1465,41,2.88,1434,1466,1400-10-29,2022-01-19
366,شدوصح,ح . دوده‌ صنعتي‌ پارس‌,268,1070840,7212554780,6620,6460,6820,200,3.02,6740,120,1.81,6460,6920,1400-10-29,2022-01-19
367,دكپسول,توليد ژلاتين كپسول ايران,264,590360,16533476800,26900,27550,28200,1300,4.83,28000,1100,4.09,26100,28200,1400-10-29,2022-01-19
368,وسگيلا,شركت س استان گيلان,263,18844747,7750666031,414,394,416,2,0.48,413,-1,-0.24,394,419,1400-10-29,2022-01-19
369,گنگين,اقتصادي نگين گردشگري ايرانيان,262,1126615,35684610200,31050,31950,31950,900,2.9,31650,600,1.93,31300,31950,1400-10-29,2022-01-19
370,شتوكا,توكا رنگ فولاد سپاهان,262,1083410,14707050600,13370,13220,13550,180,1.35,13570,200,1.5,13220,13850,1400-10-29,2022-01-19
371,وصندوق,سرمايه‌گذاري‌صندوق‌بازنشستگي‌,260,3450914,37843445380,11200,11000,10940,-260,-2.32,11120,-80,-0.71,10670,11440,1400-10-29,2022-01-19
372,تسه0002,امتيازتسهيلاتمسكن ارديبهشت1400,260,3800,4712967624,1243692,1181509,1230000,-13692,-1.1,1240255,-3437,-0.28,1181509,1257980,1400-10-29,2022-01-19
373,زگلدشت,كشت و دام گلدشت نمونه اصفهان,259,1139664,9647701570,8240,8020,8560,320,3.88,8400,160,1.94,8020,8650,1400-10-29,2022-01-19
374,زگلدشتح,ح.كشت و دام گلدشت نمونه اصفهان,259,28003142,176771121570,6500,6820,6500,0,0,6310,-190,-2.92,6300,6820,1400-10-29,2022-01-19
375,وسنا,سرمايه گذاري نيروگاهي ايران,258,965007,8110173770,8490,8700,8490,0,0,8430,-60,-0.71,8240,8700,1400-10-29,2022-01-19
376,سخواف,سيمان مجد خواف,257,3204475,26501008250,8030,8270,8270,240,2.99,8270,240,2.99,8270,8270,1400-10-29,2022-01-19
377,كفپارس,فرآورده‌هاي‌ نسوز پارس‌,256,5485865,14154822094,2481,2411,2605,124,5,2580,99,3.99,2411,2605,1400-10-29,2022-01-19
378,كلر,كلر پارس,254,283523,21164991950,78550,74650,74650,-3900,-4.96,74650,-3900,-4.96,74650,74650,1400-10-29,2022-01-19
379,فافزا,فولاد افزا سپاهان,254,600658,17437574900,29050,28350,28650,-400,-1.38,29050,0,0,28200,29900,1400-10-29,2022-01-19
380,غچين,كشت‌ و صنعت‌ چين‌ چين,251,748990,7437661230,10340,10010,10000,-340,-3.29,10110,-230,-2.22,9830,10260,1400-10-29,2022-01-19
381,كاردان,صندوق س تجارت شاخصي كاردان,249,72345,12300778820,170070,172460,171750,1680,0.99,170030,-40,-0.02,168000,175150,1400-10-29,2022-01-19
382,وسپه,سرمايه‌گذاري‌ سپه‌,249,3268817,25456959620,7810,7540,7800,-10,-0.13,7790,-20,-0.26,7540,7840,1400-10-29,2022-01-19
383,تسه0001,امتيازتسهيلات مسكن فروردين1400,249,3146,3911954195,1242975,1245001,1226050,-16925,-1.36,1243469,494,0.04,1211590,1270000,1400-10-29,2022-01-19
384,شراز,پالايش نفت شيراز,246,159971,18032191500,109150,107050,113000,3850,3.53,110550,1400,1.28,107050,114550,1400-10-29,2022-01-19
385,گوهران,سرمايه گذاري توسعه گوهران اميد,243,2614571,12949742051,4946,4750,4975,29,0.59,4952,6,0.12,4750,5000,1400-10-29,2022-01-19
386,ولصنم,ليزينگ‌صنعت‌ومعدن‌,242,2336438,7932395137,3366,3319,3497,131,3.89,3382,16,0.48,3202,3529,1400-10-29,2022-01-19
387,ضخود2020,اختيارخ خودرو-3000-1401/02/07,241,12857,768745000,60,58,63,3,5,60,0,0,55,66,1400-10-29,2022-01-19
388,قهكمت,قندهكمتان‌,241,2263804,10439309701,4398,4616,4617,219,4.98,4546,148,3.37,4352,4617,1400-10-29,2022-01-19
389,ورازي,بيمه رازي,240,12261028,15387590140,1219,1255,1255,36,2.95,1255,36,2.95,1255,1255,1400-10-29,2022-01-19
390,تپكو,توليدتجهيزات‌سنگين‌هپكو,238,6684879,14793637227,2281,2213,2213,-68,-2.98,2227,-54,-2.37,2213,2213,1400-10-29,2022-01-19
391,پكرمان,گروه‌ صنعتي‌ بارز,238,752039,13972118670,18920,18190,18700,-220,-1.16,18670,-250,-1.32,18060,19100,1400-10-29,2022-01-19
392,ولقمان,سرمايه گذاري لقمان,238,1263081,3453913664,2750,2790,2810,60,2.18,2745,-5,-0.18,2668,2829,1400-10-29,2022-01-19
393,دشيمي,شيمي‌ داروئي‌ داروپخش‌,236,572126,11686724170,20430,19800,20860,430,2.1,20430,0,0,19670,21250,1400-10-29,2022-01-19
394,كساوه,صنايع‌ كاشي‌ و سراميك‌ سينا,234,432692,20189180400,46060,46000,46660,600,1.3,46660,600,1.3,45200,47900,1400-10-29,2022-01-19
395,تايرا,تراكتورسازي‌ايران‌,230,1130228,19161442880,17840,16950,16950,-890,-4.99,17060,-780,-4.37,16950,17380,1400-10-29,2022-01-19
396,ثاباد,توريستي ورفاهي آبادگران ايران,230,340897,12508647610,36600,36970,36700,100,0.27,36690,90,0.25,35060,38100,1400-10-29,2022-01-19
397,غگلستا,شير پاستوريزه پگاه گلستان,229,917075,7628118790,8610,8310,8320,-290,-3.37,8440,-170,-1.97,8200,8600,1400-10-29,2022-01-19
398,قصفها,قنداصفهان‌,229,116012,8160880190,69970,69990,70150,180,0.26,70180,210,0.3,66540,71950,1400-10-29,2022-01-19
399,شدوص,دوده‌ صنعتي‌ پارس‌,227,1330876,15088269490,11310,11560,11570,260,2.3,11340,30,0.27,11100,11610,1400-10-29,2022-01-19
400,كنور,توسعه معدني و صنعتي صبانور,227,720972,13072521170,18410,18100,17840,-570,-3.1,18370,-40,-0.22,17720,18480,1400-10-29,2022-01-19
401,قلرست,قند لرستان‌,227,412249,6212651380,15540,14900,15050,-490,-3.15,15340,-200,-1.29,14870,15530,1400-10-29,2022-01-19
402,فردا,صندوق س آواي فرداي زاگرس-ثابت,225,7105745,86940042763,12228,12235,12235,7,0.06,12235,7,0.06,12235,12236,1400-10-29,2022-01-19
403,واعتبار,سرمايه گذاري اعتبار ايران,222,3297255,9706637614,2829,2690,2890,61,2.16,2899,70,2.47,2690,2970,1400-10-29,2022-01-19
404,خريخت,صنايع‌ريخته‌گري‌ايران‌,222,4347928,10013983386,2415,2301,2295,-120,-4.97,2326,-89,-3.69,2295,2370,1400-10-29,2022-01-19
405,كوثر,بيمه كوثر,222,1679500,5967736338,3692,3589,3619,-73,-1.98,3658,-34,-0.92,3508,3650,1400-10-29,2022-01-19
406,وارس,سرمايه گذاري ارس صبا,221,1101080,12519967460,11690,11760,11350,-340,-2.91,11370,-320,-2.74,11340,11770,1400-10-29,2022-01-19
407,پاسا,ايران‌ياساتايرورابر,221,763828,9938091390,13150,12600,13150,0,0,13060,-90,-0.68,12600,13150,1400-10-29,2022-01-19
408,ضسپا3013,اختيارخ خساپا-1600-1401/03/25,221,11552,3014006000,260,280,260,0,0,261,1,0.38,250,280,1400-10-29,2022-01-19
409,ضخود2016,اختيارخ خودرو-1600-1401/02/07,221,11815,6453038000,551,675,542,-9,-1.63,546,-5,-0.91,502,675,1400-10-29,2022-01-19
410,ارزش,صندوق س ارزش آفرين بيدار-سهام,220,1149943,9829031880,8500,8700,8590,90,1.06,8550,50,0.59,8370,8700,1400-10-29,2022-01-19
411,وآوا,سرمايه گذاري آوا نوين,219,1171182,2652638737,2316,2222,2257,-59,-2.55,2306,-10,-0.43,2222,2305,1400-10-29,2022-01-19
412,رنيك,جنرال مكانيك,218,496279,4745630790,9730,9730,9420,-310,-3.19,9670,-60,-0.62,9330,9990,1400-10-29,2022-01-19
413,زشگزا,شير و گوشت زاگرس شهركرد,216,2170183,9984536772,4701,4503,4550,-151,-3.21,4631,-70,-1.49,4470,4750,1400-10-29,2022-01-19
414,ولراز,ليزينگ رازي,216,447305,7961318670,17300,17810,17810,510,2.95,17800,500,2.89,17540,17810,1400-10-29,2022-01-19
415,شاملا,معدني‌ املاح‌  ايران‌,216,614908,6963854400,11180,11110,11290,110,0.98,11250,70,0.63,11070,11640,1400-10-29,2022-01-19
416,شگل,گلتاش‌,216,1990829,9648711060,4980,4960,4870,-110,-2.21,4880,-100,-2.01,4780,5000,1400-10-29,2022-01-19
417,دسبحان,سبحان دارو,215,940043,7439058210,8280,8060,7880,-400,-4.83,8080,-200,-2.42,7870,8140,1400-10-29,2022-01-19
418,مثقال,صندوق س.پشتوانه طلاي زرين آگاه,215,273181,2588378465,9321,9344,9541,220,2.36,9475,154,1.65,9344,9548,1400-10-29,2022-01-19
419,انار,صندوق س.انارنماد ارزش-درسهام,213,421314,3703239770,8640,8570,8890,250,2.89,8790,150,1.74,8560,9090,1400-10-29,2022-01-19
420,بميلا,توسعه بازرگاني آهن وفولادميلاد,213,1884282,15980835840,8700,8440,8450,-250,-2.87,8480,-220,-2.53,8440,8800,1400-10-29,2022-01-19
421,تابا,تابان نيرو سپاهان,212,507519,10127536150,20550,19950,19950,-600,-2.92,19950,-600,-2.92,19950,20900,1400-10-29,2022-01-19
422,وتوصا,گروه س توسعه صنعتي ايران,211,1517168,15197468640,9930,10000,10010,80,0.81,10010,80,0.81,9860,10130,1400-10-29,2022-01-19
423,سفانو,سيمان فارس نو,211,1024955,24288971200,23250,23990,23700,450,1.94,23700,450,1.94,23080,24390,1400-10-29,2022-01-19
424,خاتم,صندوق س خاتم ايساتيس پويا-ثابت,209,7535797,95594744122,12675,12685,12686,11,0.09,12685,10,0.08,12685,12686,1400-10-29,2022-01-19
425,خديزل,بهمن  ديزل,209,300849,15835526650,52800,50350,53900,1100,2.08,52700,-100,-0.19,50350,54000,1400-10-29,2022-01-19
426,زمگسا,كشاورزي‌ ودامپروي‌ مگسال‌,206,537087,9102983200,17570,16700,17600,30,0.17,17160,-410,-2.33,16700,17600,1400-10-29,2022-01-19
427,ضخود2017,اختيارخ خودرو-1800-1401/02/07,205,8892,3931197000,444,480,437,-7,-1.58,442,-2,-0.45,420,480,1400-10-29,2022-01-19
428,فاما,صنعتي‌ آما,204,514197,8052886570,16460,15660,15640,-820,-4.98,15980,-480,-2.92,15640,16090,1400-10-29,2022-01-19
429,سبهان,سيمان‌ بهبهان‌,204,170434,6700425790,39990,39850,39840,-150,-0.38,39670,-320,-0.8,38800,39860,1400-10-29,2022-01-19
430,تيپيكو,سرمايه گذاري دارويي تامين,204,555190,9978972990,18250,17990,18000,-250,-1.37,18220,-30,-0.16,17340,18400,1400-10-29,2022-01-19
431,ركيش,كارت اعتباري ايران كيش,204,6973139,42823420300,6170,5950,6000,-170,-2.76,6140,-30,-0.49,5870,6300,1400-10-29,2022-01-19
432,شستان,پتروشيمي گلستان,204,1930344,8170765252,4091,4254,4253,162,3.96,4233,142,3.47,4002,4254,1400-10-29,2022-01-19
433,وصندوقح,ح.سرمايه گذاري صندوق بازنشستگي,203,2470288,23268262590,9290,9200,9450,160,1.72,9420,130,1.4,9020,9500,1400-10-29,2022-01-19
434,كمينا,شيشه سازي مينا,203,967586,7501054740,7960,8180,7770,-190,-2.39,7810,-150,-1.88,7730,8180,1400-10-29,2022-01-19
435,نوين,بيمه نوين,203,2147740,7115927186,3334,3334,3360,26,0.78,3323,-11,-0.33,3200,3360,1400-10-29,2022-01-19
436,ومعلم,بيمه معلم,202,2221876,3832147853,1802,1713,1721,-81,-4.5,1781,-21,-1.17,1712,1769,1400-10-29,2022-01-19
437,تسه9902,امتياز تسهيلات مسكن ارديبهشت99,202,2762,3431993812,1240055,1250033,1232153,-7902,-0.64,1242576,2521,0.2,1230040,1264900,1400-10-29,2022-01-19
438,تسه9912,امتياز تسهيلات مسكن اسفند99,201,2433,3037721455,1249441,1235150,1290000,40559,3.25,1248550,-891,-0.07,1233000,1299000,1400-10-29,2022-01-19
439,بفجرح,ح . فجر انرژي خليج فارس,201,2766971,23050219420,7990,8250,8140,150,1.88,8330,340,4.26,7860,8480,1400-10-29,2022-01-19
440,جم,پتروشيمي جم,201,416939,19965127970,48890,47540,48400,-490,-1,48680,-210,-0.43,47540,48900,1400-10-29,2022-01-19
441,فسازان,غلتك سازان سپاهان,200,1129387,4474999985,4112,3911,4040,-72,-1.75,4065,-47,-1.14,3910,4060,1400-10-29,2022-01-19
442,دالبر,البرزدارو,200,621857,7218136550,11750,11710,11450,-300,-2.55,11680,-70,-0.6,11300,11990,1400-10-29,2022-01-19
443,وتوكا,سرمايه‌گذاري‌توكافولاد(هلدينگ,199,1627964,9719182420,6080,6080,6000,-80,-1.32,6000,-80,-1.32,5850,6130,1400-10-29,2022-01-19
444,ددام,داروسازي زاگرس فارمد پارس,199,505316,4118952500,8000,7820,8170,170,2.13,8040,40,0.5,7820,8330,1400-10-29,2022-01-19
445,آوا,صندوق س.سهام آواي معيار-س,196,886170,6493219142,7317,7350,7336,19,0.26,7327,10,0.14,7150,7458,1400-10-29,2022-01-19
446,ولغدر,ليزينگ‌خودروغدير,195,1884506,14826329220,8270,7890,7860,-410,-4.96,7870,-400,-4.84,7860,8100,1400-10-29,2022-01-19
447,وساشرقي,شركت س استان آذربايجان شرقي,195,11291654,4598598724,415,410,416,1,0.24,414,-1,-0.24,400,418,1400-10-29,2022-01-19
448,وكار,بانك‌ كارآفرين‌,193,6332569,13323750176,2214,2104,2104,-110,-4.97,2170,-44,-1.99,2104,2105,1400-10-29,2022-01-19
449,سپاها,سيمان‌سپاهان‌,193,1086499,7312158200,6640,6770,6900,260,3.92,6690,50,0.75,6610,6900,1400-10-29,2022-01-19
450,قنقش,قند نقش جهان,191,84745,11811063850,138450,141200,139800,1350,0.98,139350,900,0.65,135700,141200,1400-10-29,2022-01-19
451,لابسا,آبسال‌,191,402043,11848995610,29530,29210,29680,150,0.51,29480,-50,-0.17,29040,29890,1400-10-29,2022-01-19
452,وكادو,تكادو,191,758851,10180048020,13310,13000,13690,380,2.85,13420,110,0.83,13000,13700,1400-10-29,2022-01-19
453,حبندر,دريايي و کشتيراني خط دريابندر,190,1228173,19314712360,14990,15730,15730,740,4.94,15730,740,4.94,15170,15730,1400-10-29,2022-01-19
454,شكام,صنايع شيميايي كيمياگران امروز,190,1789831,52678628250,28100,27550,29500,1400,4.98,29450,1350,4.8,27550,29500,1400-10-29,2022-01-19
455,كهمدا,شيشه‌ همدان‌,188,1022268,9287856720,8980,8920,9130,150,1.67,9050,70,0.78,8710,9250,1400-10-29,2022-01-19
456,ريشمك,توليد و صادرات ريشمك,188,206324,5358933200,26650,25900,26000,-650,-2.44,26350,-300,-1.13,25600,26900,1400-10-29,2022-01-19
457,كلوند,كاشي‌ الوند,187,282775,5749281260,20300,20300,20340,40,0.2,20310,10,0.05,19820,20980,1400-10-29,2022-01-19
458,بفجر,فجر انرژي خليج فارس,186,1154175,12001015060,10820,10480,10310,-510,-4.71,10760,-60,-0.55,10280,10690,1400-10-29,2022-01-19
459,فايرا,آلومينيوم‌ايران‌,185,315875,5287591250,16880,16200,16590,-290,-1.72,16870,-10,-0.06,16200,17200,1400-10-29,2022-01-19
460,دابور,داروسازي‌ ابوريحان‌,185,475347,10438915840,21290,20990,22350,1060,4.98,21760,470,2.21,20420,22350,1400-10-29,2022-01-19
461,پلوله,گازلوله‌,185,503887,10277277150,20950,20350,20750,-200,-0.95,20400,-550,-2.63,20350,21000,1400-10-29,2022-01-19
462,سپر,صندوق س سپر سرمايه بيدار- ثابت,185,3244263,44142066115,13602,13616,13606,4,0.03,13606,4,0.03,13603,13616,1400-10-29,2022-01-19
463,تسه9909,امتياز تسهيلات مسكن آذر99,183,2513,3155682412,1247905,1240000,1308999,61094,4.9,1255743,7838,0.63,1200112,1309999,1400-10-29,2022-01-19
464,دزهراوي,داروسازي‌زهراوي‌,182,1379961,5213432547,3855,3667,3784,-71,-1.84,3826,-29,-0.75,3667,3887,1400-10-29,2022-01-19
465,كمرجان,بازرگاني و توليدي مرجان كار,182,1557676,7154616210,4830,4610,4590,-240,-4.97,4690,-140,-2.9,4590,4710,1400-10-29,2022-01-19
466,تسه9910,امتياز تسهيلات مسكن دي99,181,2230,2772485677,1247880,1232112,1235000,-12880,-1.03,1243267,-4613,-0.37,1230000,1270000,1400-10-29,2022-01-19
467,فجام,جام‌دارو,181,1780609,6532336998,3680,3679,3700,20,0.54,3675,-5,-0.14,3612,3799,1400-10-29,2022-01-19
468,ولشرق,ليزينگ ايران و شرق,180,2665626,5202636143,2008,1920,1959,-49,-2.44,1986,-22,-1.1,1910,2070,1400-10-29,2022-01-19
469,ضشنا2014,اختيارخ شپنا-5000-1401/02/25,180,3035,3108088000,878,1070,1098,220,25.06,1024,146,16.63,910,1099,1400-10-29,2022-01-19
470,لسرما,سرما آفرين‌,180,289993,5520539480,19500,19680,19330,-170,-0.87,19320,-180,-0.92,18700,19680,1400-10-29,2022-01-19
471,ساينا,صنايع بهداشتي ساينا,179,56777,4889903500,90050,87000,87250,-2800,-3.11,88650,-1400,-1.55,85550,89000,1400-10-29,2022-01-19
472,حبندرح,ح.دريايي وكشتيراني خط دريابندر,178,2240674,24754615560,10770,10900,11090,320,2.97,11050,280,2.6,10640,11090,1400-10-29,2022-01-19
473,سدور,سيمان‌ دورود,176,1158608,5590269210,4930,4960,4770,-160,-3.25,4890,-40,-0.81,4740,4960,1400-10-29,2022-01-19
474,آساميد,صندوق س.مشترك آسمان اميد -د,176,2505931,34830661669,13889,13898,13904,15,0.11,13899,10,0.07,13897,13904,1400-10-29,2022-01-19
475,پرديس,سرمايه گذاري پرديس,174,1296821,4178522490,3294,3211,3220,-74,-2.25,3273,-21,-0.64,3182,3317,1400-10-29,2022-01-19
476,كفراح,ح . فراورده‌ هاي‌ نسوزايران‌,174,875079,3632891353,4032,4250,4380,348,8.63,4152,120,2.98,4020,4380,1400-10-29,2022-01-19
477,مبين,مبين انرژي خليج فارس,173,674360,14258225470,21080,21100,21490,410,1.94,21090,10,0.05,21080,21780,1400-10-29,2022-01-19
478,خوساز,محورسازان‌ايران‌خودرو,172,888450,5513500990,6420,6180,6240,-180,-2.8,6330,-90,-1.4,6110,6490,1400-10-29,2022-01-19
479,ضخود2015,اختيارخ خودرو-1400-1401/02/07,172,4744,3244837000,680,720,685,5,0.74,684,4,0.59,652,738,1400-10-29,2022-01-19
480,شوينده,مديريت صنعت شوينده ت.ص.بهشهر,171,272087,4366097570,16420,16350,16250,-170,-1.04,16300,-120,-0.73,15840,16430,1400-10-29,2022-01-19
481,فوكا,فولاد كاويان,171,1176512,14660722930,12840,12460,12460,-380,-2.96,12650,-190,-1.48,12460,12530,1400-10-29,2022-01-19
482,غشاذر,پگاه‌آذربايجان‌غربي‌,170,1514229,6550694171,4515,4300,4392,-123,-2.72,4426,-89,-1.97,4290,4515,1400-10-29,2022-01-19
483,پارند2,صندوق س. پارند پايدار سپهر,169,16900000,16900000,10072,1,1,-10071,-99.99,1,-10071,-99.99,1,1,1400-10-29,2022-01-19
484,كطبس,ذغال‌سنگ‌ نگين‌ ط‌بس‌,169,281064,12598176890,44570,45900,44570,0,0,44780,210,0.47,43570,45900,1400-10-29,2022-01-19
485,سصوفي,سيمان‌ صوفيان‌,169,448533,6036104150,13590,13000,13360,-230,-1.69,13530,-60,-0.44,12990,13840,1400-10-29,2022-01-19
486,شپاس,نفت پاسارگاد,169,555249,7991567950,14250,14750,14690,440,3.09,14330,80,0.56,14230,14860,1400-10-29,2022-01-19
487,تسه9911,امتياز تسهيلات مسكن بهمن99,167,1680,2086790338,1239220,1179113,1240000,780,0.06,1242137,2917,0.24,1179113,1254000,1400-10-29,2022-01-19
488,غگلپا,شير پاستوريزه پگاه گلپايگان,167,239255,13157862550,57350,56000,54500,-2850,-4.97,55300,-2050,-3.57,54500,56700,1400-10-29,2022-01-19
489,ثعمرا,عمران و توسعه شاهد,166,797237,4968347130,6350,6110,6180,-170,-2.68,6310,-40,-0.63,6060,6450,1400-10-29,2022-01-19
490,فيروزه,صندوق شاخص30 شركت فيروزه- سهام,166,92838,14123788140,154540,154640,154350,-190,-0.12,152130,-2410,-1.56,151000,156310,1400-10-29,2022-01-19
491,دامين,داروسازي‌ امين‌,165,1576920,3229816643,2132,2030,2075,-57,-2.67,2112,-20,-0.94,2026,2095,1400-10-29,2022-01-19
492,غاذر,كشت‌وصنعت‌پياذر,165,123991,4040173750,32800,31920,32700,-100,-0.3,32740,-60,-0.18,31920,33790,1400-10-29,2022-01-19
493,دفارا,داروسازي‌ فارابي‌,164,432701,4937423740,11830,11240,11320,-510,-4.31,11680,-150,-1.27,11240,11630,1400-10-29,2022-01-19
494,ثپرديس,سرمايه گذاري مسكن پرديس,161,2318806,7674356318,3479,3306,3306,-173,-4.97,3384,-95,-2.73,3306,3390,1400-10-29,2022-01-19
495,دبالك,مواد اوليه دارويي البرز بالك,161,467433,3321950990,7360,7100,7150,-210,-2.85,7300,-60,-0.82,7000,7300,1400-10-29,2022-01-19
496,بايكا,كارخانجات كابلسازي ‌ايران‌,160,214638,3047429830,14430,14000,14030,-400,-2.77,14360,-70,-0.49,14000,14630,1400-10-29,2022-01-19
497,زفكا,كشت و دامداري فكا,157,761953,5231659630,6740,6850,6900,160,2.37,6790,50,0.74,6740,7030,1400-10-29,2022-01-19
498,تسه9907,امتياز تسهيلات مسكن مهر99,157,2691,3339781752,1240554,1231000,1302580,62026,5,1241093,539,0.04,1205055,1302580,1400-10-29,2022-01-19
499,پلاسك,پلاسكوكار,157,841214,3326690316,4039,3900,3960,-79,-1.96,4019,-20,-0.5,3900,4000,1400-10-29,2022-01-19
500,اپرداز,آتيه داده پرداز,155,361557,6474037100,18800,17900,17900,-900,-4.79,18350,-450,-2.39,17900,18400,1400-10-29,2022-01-19
501,بالاس,مهندسي ساختمان تاسيسات راه آهن,155,332750,7867091150,23450,24500,23350,-100,-0.43,23550,100,0.43,22400,24500,1400-10-29,2022-01-19
502,اعتلا,شركت سرمايه گذاري اعتلاء البرز,153,1553016,5389840421,3422,3543,3480,58,1.69,3440,18,0.53,3353,3543,1400-10-29,2022-01-19
503,اخزا005,اسنادخزانه-م5بودجه00-030626,152,155188,86831551590,558700,559000,560000,1300,0.23,559520,820,0.15,556510,560010,1400-10-29,2022-01-19
504,آبين,كشت و صنعت آبشيرين,151,2627671,3974452114,1528,1483,1490,-38,-2.49,1521,-7,-0.46,1483,1550,1400-10-29,2022-01-19
505,چفيبر,فيبر ايران‌,151,603847,3831435330,6590,6290,6480,-110,-1.67,6520,-70,-1.06,6270,6560,1400-10-29,2022-01-19
506,يارا,صندوق س. آريا-د,150,9678424,96784240000,10000,10000,10000,0,0,10000,0,0,10000,10000,1400-10-29,2022-01-19
507,اخزا006,اسنادخزانه-م6بودجه00-030723,150,303118,166853147160,550400,550000,551000,600,0.11,550460,60,0.01,549200,551000,1400-10-29,2022-01-19
508,هجرت,پخش هجرت,148,1486108,36929783800,23700,24850,24850,1150,4.85,24850,1150,4.85,24850,24850,1400-10-29,2022-01-19
509,سپيدما,صندوق س. سپيد دماوند-د,148,6764419,79291185070,11714,11743,11721,7,0.06,11722,8,0.07,11720,11747,1400-10-29,2022-01-19
510,وتوسم,سرمايه‌گذاري‌توسعه‌ملي‌,148,667810,5414433820,8120,8110,8200,80,0.99,8120,0,0,7960,8210,1400-10-29,2022-01-19
511,داسوه,داروسازي‌ اسوه‌,147,197882,4911109010,23870,24490,24500,630,2.64,24180,310,1.3,24010,25060,1400-10-29,2022-01-19
512,حپارسا,توسعه حمل و نقل ريلي پارسيان,147,578828,17007078150,28100,27950,29500,1400,4.98,29400,1300,4.63,27950,29500,1400-10-29,2022-01-19
513,ما,بيمه  ما,147,658284,3023238607,4635,4550,4699,64,1.38,4626,-9,-0.19,4405,4699,1400-10-29,2022-01-19
514,فنوال,نورد آلومينيوم‌,147,304019,6813718780,22470,21510,22540,70,0.31,22440,-30,-0.13,21360,23500,1400-10-29,2022-01-19
515,سخزر,سيمان‌ خزر,147,116291,1725797440,14980,14310,14960,-20,-0.13,14960,-20,-0.13,14310,15460,1400-10-29,2022-01-19
516,تكنار,مجتمع معادن مس تكنار,146,94149,4698986050,50100,51500,49150,-950,-1.9,50000,-100,-0.2,49050,51500,1400-10-29,2022-01-19
517,كساپا,سايپاشيشه‌,146,602267,7399981730,12920,12290,12280,-640,-4.95,12560,-360,-2.79,12280,12750,1400-10-29,2022-01-19
518,كحافظ,كاشي‌ وسراميك‌ حافظ‌,145,1624048,6148837318,3789,3741,3818,29,0.77,3788,-1,-0.03,3741,3850,1400-10-29,2022-01-19
519,وملل,اعتباري ملل,145,980657,9105462310,9450,9220,9210,-240,-2.54,9410,-40,-0.42,9100,9450,1400-10-29,2022-01-19
520,فبيرا,بسته‌ بندي‌ ايران‌,145,1692726,2834528165,1679,1648,1710,31,1.85,1678,-1,-0.06,1629,1728,1400-10-29,2022-01-19
521,نمرينو,ايران‌ مرينوس‌,143,102185,6693254390,68930,65500,65490,-3440,-4.99,67230,-1700,-2.47,65490,68280,1400-10-29,2022-01-19
522,زيتون,صندوق س زيتون نماد پايا- مختلط,143,674190,6185023300,9120,9180,9230,110,1.21,9170,50,0.55,9130,9240,1400-10-29,2022-01-19
523,عيار,صندوق سكه طلاي مفيد,141,250372,7545045828,29742,30000,30100,358,1.2,30135,393,1.32,29800,30240,1400-10-29,2022-01-19
524,درهآور,دارويي ره آورد تامين,139,284348,5453716950,19650,18900,19550,-100,-0.51,19450,-200,-1.02,18850,19600,1400-10-29,2022-01-19
525,وحافظح,ح . بيمه حافظ,139,24990000,75069960000,2834,3004,3004,170,6,3004,170,6,3004,3004,1400-10-29,2022-01-19
526,ماني,صندوق س. با درآمد ثابت ماني,137,4183248,45392128576,10845,10850,10850,5,0.05,10851,6,0.06,10850,10851,1400-10-29,2022-01-19
527,وتوس,توسعه‌شهري‌توس‌گستر,137,644057,4099986610,6630,6550,6300,-330,-4.98,6550,-80,-1.21,6300,6600,1400-10-29,2022-01-19
528,داوه,داروسازي آوه سينا,137,363078,2941669730,8500,8080,8180,-320,-3.76,8420,-80,-0.94,8080,8350,1400-10-29,2022-01-19
529,كگهر,سنگ آهن گهرزمين,135,362791,16976968000,47450,47450,46600,-850,-1.79,47350,-100,-0.21,45250,47950,1400-10-29,2022-01-19
530,مداران,داده‌پردازي‌ايران‌,135,968482,12950377320,14070,13380,13370,-700,-4.98,13390,-680,-4.83,13370,13780,1400-10-29,2022-01-19
531,اخزا001,اسنادخزانه-م1بودجه00-030821,134,176342,95454125880,540910,542900,541000,90,0.02,541300,390,0.07,540510,542900,1400-10-29,2022-01-19
532,وحكمت,بيمه حكمت صبا,133,927514,2738649649,2900,2940,2945,45,1.55,2915,15,0.52,2900,2980,1400-10-29,2022-01-19
533,ساروم,سيمان‌اروميه‌,130,111513,3918299230,35630,36450,35300,-330,-0.93,35490,-140,-0.39,34880,36450,1400-10-29,2022-01-19
534,ثشرق,سرمايه گذاري مسكن شمال شرق,129,909502,2634265913,2877,3014,2870,-7,-0.24,2881,4,0.14,2834,3014,1400-10-29,2022-01-19
535,وتوشه,سرمايه‌ گذاري‌ پارس‌ توشه‌,127,1025495,4945097150,4900,4720,4880,-20,-0.41,4870,-30,-0.61,4690,4950,1400-10-29,2022-01-19
536,تسه9903,امتياز تسهيلات مسكن خرداد99,125,1320,1629722569,1237689,1230000,1240001,2312,0.19,1234638,-3051,-0.25,1203334,1249000,1400-10-29,2022-01-19
537,سخوز,سيمان خوزستان,124,344650,6986662460,20660,20500,20230,-430,-2.08,20470,-190,-0.92,20010,20650,1400-10-29,2022-01-19
538,بنو,بيمه تجارت نو,123,1216425,6645909050,5740,5460,5460,-280,-4.88,5600,-140,-2.44,5460,5580,1400-10-29,2022-01-19
539,دعبيد,لابراتوارداروسازي‌  دكترعبيدي‌,122,252158,4467074660,17870,17200,17990,120,0.67,17850,-20,-0.11,17200,18080,1400-10-29,2022-01-19
540,حتوكا,حمل‌ونقل‌توكا,122,757125,9471633750,13160,12510,12510,-650,-4.94,12720,-440,-3.34,12510,12510,1400-10-29,2022-01-19
541,مارون,پتروشيمي مارون,121,25739,4458254550,171950,172050,175400,3450,2.01,172000,50,0.03,171950,175400,1400-10-29,2022-01-19
542,ثباغ,شهر سازي و خانه سازي باغميشه,120,530770,3731419270,7230,7000,7100,-130,-1.8,7180,-50,-0.69,6880,7200,1400-10-29,2022-01-19
543,غمهرا,توليدي‌مهرام‌,119,376175,2983753630,8100,8030,7880,-220,-2.72,8060,-40,-0.49,7840,8080,1400-10-29,2022-01-19
544,فخاس,فولاد خراسان,119,530558,11132395740,22060,20960,20980,-1080,-4.9,21930,-130,-0.59,20960,21610,1400-10-29,2022-01-19
545,وسبحان,سرمايه گذاري سبحان,119,2110312,4603744784,2193,2239,2198,5,0.23,2189,-4,-0.18,2121,2239,1400-10-29,2022-01-19
546,ضسپا1113,اختيارخ خساپا-1800-1400/11/20,118,6800,324364000,44,60,39,-5,-11.36,48,4,9.09,13,64,1400-10-29,2022-01-19
547,اوان,مبين وان كيش,118,562499,5024317630,9390,8930,8930,-460,-4.9,9220,-170,-1.81,8930,9000,1400-10-29,2022-01-19
548,شصفها,پتروشيمي‌ اصفهان‌,117,120571,13026313050,110200,108000,108000,-2200,-2,108050,-2150,-1.95,108000,110900,1400-10-29,2022-01-19
549,تسه9904,امتياز تسهيلات مسكن تير99,117,1068,1325502738,1236264,1244000,1240000,3736,0.3,1241107,4843,0.39,1230001,1249800,1400-10-29,2022-01-19
550,دكوثر,داروسازي‌ كوثر,117,1098170,2539452702,2407,2300,2306,-101,-4.2,2389,-18,-0.75,2287,2368,1400-10-29,2022-01-19
551,دجابر,داروسازي‌ جابرابن‌حيان‌,116,285495,2639477310,9610,9130,9250,-360,-3.75,9540,-70,-0.73,9130,9790,1400-10-29,2022-01-19
552,گوهر,صندوق سكه طلاي كيان,115,75499,4460874413,58501,58330,59000,499,0.85,59085,584,1,58330,59357,1400-10-29,2022-01-19
553,تسه9901,امتياز تسهيلات مسكن فروردين99,115,1849,2296266744,1241572,1250001,1232111,-9461,-0.76,1241896,324,0.03,1220022,1261997,1400-10-29,2022-01-19
554,شاملاح,ح . معدني‌ املاح‌  ايران‌,113,394051,2718745970,6750,6950,6900,150,2.22,6900,150,2.22,6710,6980,1400-10-29,2022-01-19
555,آ س پ,آ.س.پ,113,1125865,5291993980,4940,4700,4700,-240,-4.86,4840,-100,-2.02,4700,4790,1400-10-29,2022-01-19
556,شتوكاح,ح . توكا رنگ فولاد سپاهان,113,306980,3715152340,12710,13180,12080,-630,-4.96,12100,-610,-4.8,12080,13180,1400-10-29,2022-01-19
557,سيستم,همكاران سيستم,112,1001681,4887113300,4900,4900,4990,90,1.84,4890,-10,-0.2,4750,5030,1400-10-29,2022-01-19
558,شكبير,پتروشيمي اميركبير,111,102700,8984057750,88050,85600,88700,650,0.74,88000,-50,-0.06,85600,88900,1400-10-29,2022-01-19
559,زعف0110پ19,زعفران0110نگين تروند قاينات(پ),111,42668,15462017268,353028,361000,362500,9472,2.68,362380,9352,2.65,360000,365000,1400-10-29,2022-01-19
560,تسه9906,امتياز تسهيلات مسكن شهريور99,111,1568,1979910055,1265420,1240000,1310000,44580,3.52,1262698,-2722,-0.22,1210000,1325999,1400-10-29,2022-01-19
561,سرود,سيمان‌شاهرود,111,468352,9074566360,20320,19950,19310,-1010,-4.97,19700,-620,-3.05,19310,19960,1400-10-29,2022-01-19
562,واتي,سرمايه‌ گذاري‌ آتيه‌ دماوند,110,421279,3469418710,8130,8110,8240,110,1.35,8150,20,0.25,8090,8360,1400-10-29,2022-01-19
563,سمازن,سيمان‌مازندران‌,110,357021,4883096640,13580,13440,13700,120,0.88,13610,30,0.22,13440,13890,1400-10-29,2022-01-19
564,پكوير,كوير تاير,109,564548,2670761250,4880,4670,4750,-130,-2.66,4850,-30,-0.61,4650,4880,1400-10-29,2022-01-19
565,شرانل,نفت ايرانول,107,52214,2279351300,43250,44200,43900,650,1.5,43300,50,0.12,42600,44200,1400-10-29,2022-01-19
566,خچرخش,چرخشگر,105,358028,2175428610,6260,5980,6100,-160,-2.56,6230,-30,-0.48,5970,6260,1400-10-29,2022-01-19
567,سپاس,صندوق س. پاداش سهامداري-ثابت,105,3128700,31526049623,10072,10077,10078,6,0.06,10076,4,0.04,10076,10080,1400-10-29,2022-01-19
568,خودكفا,اقتصادي و خودكفايي آزادگان,105,711926,4940766440,7150,6940,6940,-210,-2.94,7100,-50,-0.7,6940,6940,1400-10-29,2022-01-19
569,سدشت,صنايع سيمان دشتستان,105,79441,1878235920,24560,23400,23970,-590,-2.4,24440,-120,-0.49,23340,24480,1400-10-29,2022-01-19
570,ضصاد1113,اختيارخ وبصادر-2000-1400/11/06,104,4225,53788000,15,22,9,-6,-40,13,-2,-13.33,4,33,1400-10-29,2022-01-19
571,كخاك,صنايع‌خاك‌چيني‌ايران‌,103,385557,4883556570,13090,12700,12590,-500,-3.82,12970,-120,-0.92,12530,13090,1400-10-29,2022-01-19
572,سكه0011پ02,تمام سكه طرح جديد0011ملت,103,51600,61243986900,1178770,1183000,1186000,7230,0.61,1186899,8129,0.69,1183000,1193000,1400-10-29,2022-01-19
573,قپيرا,فرآورده‌هاي‌غدايي‌وقندپيرانشهر,103,410718,3210648870,8050,7700,7900,-150,-1.86,8000,-50,-0.62,7650,8400,1400-10-29,2022-01-19
574,تسه9905,امتياز تسهيلات مسكن مرداد99,102,857,1086784769,1259533,1230000,1240000,-19533,-1.55,1268127,8594,0.68,1230000,1322498,1400-10-29,2022-01-19
575,ومشان,س. فني و مهندسي مشانير,102,84790,3554675650,43050,41800,41800,-1250,-2.9,42100,-950,-2.21,41800,43000,1400-10-29,2022-01-19
576,وبهمن,سرمايه‌گذاري‌بهمن‌,100,360952,4664957460,13500,12830,12860,-640,-4.74,13310,-190,-1.41,12830,13290,1400-10-29,2022-01-19
577,سجام,مجتمع سيمان غرب آسيا,100,990935,1991724916,2019,2025,2020,1,0.05,2017,-2,-0.1,2000,2027,1400-10-29,2022-01-19
578,بمپنا,توليد برق عسلويه  مپنا,99,980489,5184722110,5550,5310,5290,-260,-4.68,5470,-80,-1.44,5280,5450,1400-10-29,2022-01-19
579,وآرين,شركت توسعه اقتصادي آرين,99,1448883,2629098111,1861,1810,1816,-45,-2.42,1849,-12,-0.64,1806,1850,1400-10-29,2022-01-19
580,دسبحا,گروه دارويي سبحان,98,420511,7053868830,17600,16730,17000,-600,-3.41,17330,-270,-1.53,16720,17180,1400-10-29,2022-01-19
581,اخزا917,اسنادخزانه-م17بودجه99-010226,98,168514,157679785950,935010,936000,936200,1190,0.13,935710,700,0.07,935150,936200,1400-10-29,2022-01-19
582,كاسپين,داروسازي كاسپين تامين,97,196362,4013880550,20750,20850,20500,-250,-1.2,20650,-100,-0.48,19900,20850,1400-10-29,2022-01-19
583,بخاور,بيمه زندگي خاورميانه,97,1102245,2393312867,2281,2179,2169,-112,-4.91,2263,-18,-0.79,2167,2256,1400-10-29,2022-01-19
584,ضملت1133,اختيارخ وبملت-3000-1400/11/13,97,3192,227921000,65,75,65,0,0,71,6,9.23,63,139,1400-10-29,2022-01-19
585,تسه9812,امتياز تسهيلات مسكن اسفند98,93,1260,1563413974,1246840,1195010,1240000,-6840,-0.55,1240805,-6035,-0.48,1195010,1289900,1400-10-29,2022-01-19
586,كخاكح,ح . صنايع‌خاك‌چيني‌ايران‌,93,421115,3424427340,8390,8220,8080,-310,-3.69,8130,-260,-3.1,8020,8800,1400-10-29,2022-01-19
587,بسويچ,پارس‌سويچ‌,93,202331,2478747580,12840,12200,12220,-620,-4.83,12730,-110,-0.86,12200,12720,1400-10-29,2022-01-19
588,غبهار,كشت وصنعت بهاران گلبهار خراسان,93,208824,3867420480,19090,18520,18520,-570,-2.99,18850,-240,-1.26,18520,18520,1400-10-29,2022-01-19
589,وثخوز,سرمايه گذاري و توسعه خوزستان,91,88754,2782150050,31750,30900,31500,-250,-0.79,31650,-100,-0.31,30850,32450,1400-10-29,2022-01-19
590,لبوتان,گروه‌صنعتي‌بوتان‌,91,67993,2820720060,41220,41450,42070,850,2.06,41270,50,0.12,40120,42440,1400-10-29,2022-01-19
591,تنوين,تامين سرمايه نوين,91,1058035,6446610240,6250,6110,6110,-140,-2.24,6220,-30,-0.48,6060,6160,1400-10-29,2022-01-19
592,خپويش,سازه‌ پويش‌,91,71805,5074567850,71250,69900,69150,-2100,-2.95,71050,-200,-0.28,68020,72000,1400-10-29,2022-01-19
593,تكنو,تكنوتار,89,469084,2689222370,6020,5930,5800,-220,-3.65,5960,-60,-1,5720,5930,1400-10-29,2022-01-19
594,كفرا,فراورده‌ هاي‌ نسوزايران‌,89,251949,1739946290,6910,6920,7000,90,1.3,6910,0,0,6600,7240,1400-10-29,2022-01-19
595,ضملت1134,اختيارخ وبملت-3500-1400/11/13,89,4527,13632000,6,4,2,-4,-66.67,3,-3,-50,2,9,1400-10-29,2022-01-19
596,كقزوي,شيشه‌ قزوين‌,89,543546,4409485290,8150,8080,8160,10,0.12,8130,-20,-0.25,8060,8200,1400-10-29,2022-01-19
597,زعف0110پ09,زعفران0110نگين نوين(پ),88,39031,14134227016,355332,361000,362000,6668,1.88,362128,6796,1.91,360000,364499,1400-10-29,2022-01-19
598,سفار,سيمان‌فارس‌,88,43031,2188483460,50880,51290,50010,-870,-1.71,50880,0,0,49200,51890,1400-10-29,2022-01-19
599,وپخش,داروپخش‌ (هلدينگ‌,88,184097,5791300100,32500,30880,31270,-1230,-3.78,32360,-140,-0.43,30880,32280,1400-10-29,2022-01-19
600,زعف0110پ11,زعفران0110نگين سحرخيز(پ),88,28584,10540112473,360300,364999,370000,9700,2.69,368742,8442,2.34,364999,372999,1400-10-29,2022-01-19
601,دروز,داروسازي‌ روزدارو,87,66995,1892253190,28160,29090,28600,440,1.56,28170,10,0.04,26940,29090,1400-10-29,2022-01-19
602,سغرب,سيمان‌غرب‌,87,136203,1901734930,13840,13240,13860,20,0.14,13860,20,0.14,13240,14300,1400-10-29,2022-01-19
603,سشمال,سيمان‌ شمال‌,85,274342,2051293350,7440,7390,7450,10,0.13,7450,10,0.13,7390,7640,1400-10-29,2022-01-19
604,اخزا004,اسنادخزانه-م4بودجه00-030522,84,248858,142207371540,571560,570990,572500,940,0.16,571440,-120,-0.02,570110,572500,1400-10-29,2022-01-19
605,زعف0110پ20,زعفران0110نگين وحدت جام(پ),84,18322,6640586345,356195,358000,362501,6306,1.77,362438,6243,1.75,358000,366500,1400-10-29,2022-01-19
606,اخزا002,اسنادخزانه-م2بودجه00-031024,84,36970,19275460980,521710,521700,522000,290,0.06,521380,-330,-0.06,520010,522000,1400-10-29,2022-01-19
607,ثالوند,سرمايه گذاري مسكن الوند,83,287089,1546648042,5600,5380,5356,-244,-4.36,5577,-23,-0.41,5344,5490,1400-10-29,2022-01-19
608,كشرق,صنعتي و معدني شمال شرق شاهرود,82,98834,6532916600,67050,65700,66750,-300,-0.45,66650,-400,-0.6,64000,67000,1400-10-29,2022-01-19
609,سمتاز,سيمان ممتازان كرمان,82,254322,3616321470,13920,13800,14170,250,1.8,14030,110,0.79,13800,14330,1400-10-29,2022-01-19
610,فلات,گروه صنايع معادن فلات ايرانيان,82,132087,1108867050,8630,8800,8390,-240,-2.78,8600,-30,-0.35,8380,8800,1400-10-29,2022-01-19
611,دارو,كارخانجات‌داروپخش‌,82,72267,2046460420,28020,27020,28290,270,0.96,28060,40,0.14,27020,28990,1400-10-29,2022-01-19
612,كاريس,صندوق س.سپهر كاريزما-س,82,216768,2678941690,12321,12260,12466,145,1.18,12359,38,0.31,12254,12578,1400-10-29,2022-01-19
613,پلاست,كارخانجات توليدي پلاستيران,81,166280,1050858140,6480,6300,6290,-190,-2.93,6460,-20,-0.31,6290,6450,1400-10-29,2022-01-19
614,پكويرح,ح. كوير تاير,81,517516,1321039161,2580,2573,2589,9,0.35,2553,-27,-1.05,2501,2678,1400-10-29,2022-01-19
615,سكرما,سيمان‌ كرمان‌,80,367993,5246901300,14350,14460,14390,40,0.28,14320,-30,-0.21,14070,14500,1400-10-29,2022-01-19
616,سقاين,سيمان‌ قائن‌,79,69864,2801456770,39890,39690,39520,-370,-0.93,39930,40,0.1,38990,40890,1400-10-29,2022-01-19
617,سدبير,س. تدبيرگران فارس وخوزستان,78,185716,5822196600,33000,31350,31350,-1650,-5,32300,-700,-2.12,31350,31350,1400-10-29,2022-01-19
618,غشهد,شهد ايران ‌,78,438260,1748175905,4152,3950,4000,-152,-3.66,4131,-21,-0.51,3947,4135,1400-10-29,2022-01-19
619,زرين,صندوق س. سهام زرين كوروش-س,76,208236,2464073207,11864,11800,11821,-43,-0.36,11833,-31,-0.26,11665,11949,1400-10-29,2022-01-19
620,دحاوي,الحاوي,75,736690,2967298287,4104,3984,4130,26,0.63,4080,-24,-0.58,3981,4130,1400-10-29,2022-01-19
621,سكرد,سيمان كردستان,75,798397,3637811905,4543,4500,4543,0,0,4546,3,0.07,4440,4619,1400-10-29,2022-01-19
622,بنيرو,نيروترانس‌,74,1127113,1845012298,1675,1630,1630,-45,-2.69,1670,-5,-0.3,1594,1673,1400-10-29,2022-01-19
623,تسه9811,امتياز تسهيلات مسكن بهمن98,74,1221,1506984548,1235295,1239888,1229000,-6295,-0.51,1234222,-1073,-0.09,1210111,1297000,1400-10-29,2022-01-19
624,رتكو,كنترل‌خوردگي‌تكين‌كو,73,314296,2081485150,6930,6600,6590,-340,-4.91,6880,-50,-0.72,6590,6780,1400-10-29,2022-01-19
625,ضسپا1114,اختيارخ خساپا-2000-1400/11/20,73,4836,74122000,18,13,14,-4,-22.22,15,-3,-16.67,13,20,1400-10-29,2022-01-19
626,تماوند,تامين سرمايه دماوند,73,1049269,5978717910,5740,5740,5590,-150,-2.61,5720,-20,-0.35,5570,5750,1400-10-29,2022-01-19
627,شزنگ,تجهيزنيروي‌زنگان‌,72,21427,2160912950,103950,100850,100850,-3100,-2.98,103200,-750,-0.72,100850,100850,1400-10-29,2022-01-19
628,صنوين,صندوق سرمايه‌گذاري صنوين-مختلط,70,14842,1628576170,109630,109750,110000,370,0.34,109730,100,0.09,109560,110000,1400-10-29,2022-01-19
629,سهگمت,سيمان‌هگمتان‌,70,61225,1213055240,20320,19480,19990,-330,-1.62,20280,-40,-0.2,19470,20190,1400-10-29,2022-01-19
630,زعف0110پ16,زعفران0110نگين بيرجند(پ),69,47189,17110274034,357175,363000,362500,5325,1.49,362590,5415,1.52,360000,365000,1400-10-29,2022-01-19
631,ضسپا1112,اختيارخ خساپا-1600-1400/11/20,68,1987,214614000,115,109,110,-5,-4.35,108,-7,-6.09,95,134,1400-10-29,2022-01-19
632,اخزا908,اسنادخزانه-م8بودجه99-020606,67,41052,29407922330,715490,714200,717500,2010,0.28,716360,870,0.12,714200,717500,1400-10-29,2022-01-19
633,كيان2,صندوق س. با درآمد ثابت كيان,66,6600000,6600000,32666,1,1,-32665,-100,1,-32665,-100,1,1,1400-10-29,2022-01-19
634,وملت,سرمايه گذاري ملت,65,378478,861699185,2307,2296,2266,-41,-1.78,2301,-6,-0.26,2262,2320,1400-10-29,2022-01-19
635,قمرو,قند مرودشت‌,64,99969,2123434210,21350,21350,21190,-160,-0.75,21330,-20,-0.09,20920,21490,1400-10-29,2022-01-19
636,شليا,شركت مواد ويژه ليا,63,277595,6426324250,22500,23150,23150,650,2.89,23150,650,2.89,23150,23150,1400-10-29,2022-01-19
637,سكه0112پ03,تمام سكه طرح جديد0112سامان,63,46600,55420662500,1176915,1189999,1186002,9087,0.77,1189285,12370,1.05,1185000,1193000,1400-10-29,2022-01-19
638,ساربيل,سيمان آرتا اردبيل,62,123939,2602385200,21240,21100,21290,50,0.24,21200,-40,-0.19,20620,21300,1400-10-29,2022-01-19
639,اخزا901,اسنادخزانه-م1بودجه99-010621,62,14723,12851603060,875370,869210,872910,-2460,-0.28,872890,-2480,-0.28,869100,875500,1400-10-29,2022-01-19
640,سيدكو,سرمايه گذاري توسعه صنايع سيمان,61,667693,3600214190,5460,5380,5380,-80,-1.47,5440,-20,-0.37,5340,5450,1400-10-29,2022-01-19
641,ساراب,سيمان‌ داراب‌,61,124930,2057401710,16520,16360,16510,-10,-0.06,16510,-10,-0.06,15990,16520,1400-10-29,2022-01-19
642,شساخت,مهندسي و ساختمان صنايع نفت,61,107123,4771654750,44150,44150,45000,850,1.93,44200,50,0.11,44150,45450,1400-10-29,2022-01-19
643,زعف0110پ05,زعفران0110نگين زرين(پ),61,18965,6936580218,358134,362001,365114,6980,1.95,365757,7623,2.13,362000,370000,1400-10-29,2022-01-19
644,ولبهمن,شركت بهمن ليزينگ,61,222332,1322234770,5960,5950,5890,-70,-1.17,5960,0,0,5800,6130,1400-10-29,2022-01-19
645,ويسا,سرمايه گذاري ايساتيس پويا,60,1014413,7467387530,7580,7580,7540,-40,-0.53,7410,-170,-2.24,7360,7580,1400-10-29,2022-01-19
646,غپونه,نوش پونه مشهد,60,323001,3595728420,11450,11110,11280,-170,-1.48,11330,-120,-1.05,11110,11280,1400-10-29,2022-01-19
647,معيار ,سرمايه گذاري معيار صنعت پارس,58,94582,3582572500,39000,37900,38750,-250,-0.64,38550,-450,-1.15,37850,39150,1400-10-29,2022-01-19
648,تشتاد,صنايع توليدي اشتاد ايران‌,57,882458,4076401560,4756,4614,4614,-142,-2.99,4699,-57,-1.2,4614,4753,1400-10-29,2022-01-19
649,اخزا008,اسنادخزانه-م8بودجه00-030919,57,189635,100689634290,531950,533500,533500,1550,0.29,530970,-980,-0.18,530000,533500,1400-10-29,2022-01-19
650,وبازار,صندوق س شاخصي بازارآشنا,56,278962,3081940870,11010,11020,11050,40,0.36,11050,40,0.36,10940,11090,1400-10-29,2022-01-19
651,لوتوس,تامين سرمايه لوتوس پارسيان,54,757463,4332745770,5720,5720,5720,0,0,5720,0,0,5710,5750,1400-10-29,2022-01-19
652,پدرخش,درخشان‌ تهران‌,53,388557,2813152680,6900,7240,7240,340,4.93,6960,60,0.87,7240,7240,1400-10-29,2022-01-19
653,دسينا,داروسازي‌ سينا,52,65702,1302095160,19760,19800,19700,-60,-0.3,19770,10,0.05,19500,19990,1400-10-29,2022-01-19
654,پلاستح,ح.كارخانجات توليدي پلاستيران,50,305010,954750849,3167,3075,3167,0,0,3130,-37,-1.17,3075,3181,1400-10-29,2022-01-19
655,وزمين,بانك ايران زمين,49,257165,2181923930,8330,8400,8490,160,1.92,8350,20,0.24,8400,8490,1400-10-29,2022-01-19
656,وامين,س. امين توان آفرين ساز,48,137127,1687329330,12420,12350,12300,-120,-0.97,12420,0,0,12250,12420,1400-10-29,2022-01-19
657,سكه0012پ04,تمام سكه طرح جديد0012صادرات,46,11500,13665082600,1176772,1190000,1185000,8228,0.7,1188268,11496,0.98,1185000,1193398,1400-10-29,2022-01-19
658,سجامح,ح.مجتمع سيمان غرب آسيا,46,655663,429585434,669,650,675,6,0.9,655,-14,-2.09,649,675,1400-10-29,2022-01-19
659,كفرآور,فرآورده هاي سيمان شرق,46,127921,2303857210,18950,18010,18010,-940,-4.96,18720,-230,-1.21,18010,18010,1400-10-29,2022-01-19
660,صايند,صندوق س. گنجينه آينده روشن-د,46,232810,2337447910,10033,10038,10037,4,0.04,10040,7,0.07,10037,10043,1400-10-29,2022-01-19
661,سبجنو,سيمان‌ بجنورد,46,35162,1274282780,36780,36760,36500,-280,-0.76,36730,-50,-0.14,36100,37690,1400-10-29,2022-01-19
662,اخزا003,اسنادخزانه-م3بودجه00-030418,46,31332,18297405720,583500,583180,585000,1500,0.26,583980,480,0.08,582900,585000,1400-10-29,2022-01-19
663,زعف0110پ18,زعفران0110نگين بهرامن(پ),44,11161,4073169588,354786,373994,364000,9214,2.6,364947,10161,2.86,358000,373994,1400-10-29,2022-01-19
664,دكيمي,كيميدارو,44,66407,1024846540,16020,15220,15790,-230,-1.44,15980,-40,-0.25,15220,15900,1400-10-29,2022-01-19
665,سهرمز,سيمان‌هرمزگان‌,44,50989,791015940,16050,15260,15780,-270,-1.68,16020,-30,-0.19,15250,15790,1400-10-29,2022-01-19
666,حخزر,كشتيراني درياي خزر,43,45331,612644240,14050,13450,13480,-570,-4.06,14030,-20,-0.14,13400,13970,1400-10-29,2022-01-19
667,قشرين,قند شيرين خراسان,43,1573090,8478955100,5550,5390,5390,-160,-2.88,5410,-140,-2.52,5390,5390,1400-10-29,2022-01-19
668,شفارا,پتروشيمي فارابي,42,246672,1396846800,5820,5650,5650,-170,-2.92,5800,-20,-0.34,5650,5950,1400-10-29,2022-01-19
669,داريوش,صندوق س. ثروت داريوش -س,41,231082,2125981004,9204,9156,9289,85,0.92,9200,-4,-0.04,9140,9300,1400-10-29,2022-01-19
670,آساس,صندوق س.آسمان آرماني سهام-س,41,9451,1471203635,154876,155800,156500,1624,1.05,155666,790,0.51,153130,156500,1400-10-29,2022-01-19
671,ثاژن,سخت آژند,40,190093,747179445,4006,3940,3926,-80,-2,3995,-11,-0.27,3926,3979,1400-10-29,2022-01-19
672,لازما,كارخانه هاي صنعتي آزمايش,39,113365,2397669750,22250,21150,21150,-1100,-4.94,21950,-300,-1.35,21150,21150,1400-10-29,2022-01-19
673,اخزا007,اسنادخزانه-م7بودجه00-030912,39,27457,14683143980,534810,530500,535900,1090,0.2,534770,-40,-0.01,530500,535900,1400-10-29,2022-01-19
674,ضبدر1163,اختيارخ شبندر-6000-1400/11/13,38,414,231947000,370,500,590,220,59.46,560,190,51.35,344,655,1400-10-29,2022-01-19
675,ارمغان,ص سرمايه گذاري ارمغان ايرانيان,38,894504,9006677645,10062,10069,10075,13,0.13,10069,7,0.07,10065,10075,1400-10-29,2022-01-19
676,اخزا910,اسنادخزانه-م10بودجه99-020807,36,37421,25892838590,691730,690000,691960,230,0.03,691930,200,0.03,689200,692320,1400-10-29,2022-01-19
677,وثنو,سرمايه گذاري ساختماني نوين,36,405270,1557047340,4044,3842,3842,-202,-5,4009,-35,-0.87,3842,3842,1400-10-29,2022-01-19
678,دارا,صندوق س. دارا الگوريتم-د,35,957767,9695613404,10114,10123,10124,10,0.1,10123,9,0.09,10113,10129,1400-10-29,2022-01-19
679,برن0104پ01,برنج طارم0104تجارت مازندران(پ),35,6584,3882604898,565260,567500,593523,28263,5,589703,24443,4.32,567000,593523,1400-10-29,2022-01-19
680,ضفلا1163,اختيارخ فولاد-10000-1400/11/24,35,849,375114000,433,450,375,-58,-13.39,442,9,2.08,375,499,1400-10-29,2022-01-19
681,اخزا902,اسنادخزانه-م2بودجه99-011019,34,54472,44600184160,818990,819000,818760,-230,-0.03,818770,-220,-0.03,818100,820960,1400-10-29,2022-01-19
682,اخزا816,اسنادخزانه-م16بودجه98-010503,33,11030,9930982560,898760,899990,901200,2440,0.27,900360,1600,0.18,897010,901200,1400-10-29,2022-01-19
683,طخود2017,اختيارف خودرو-1800-1401/02/07,33,1323,97021000,65,70,70,5,7.69,73,8,12.31,70,83,1400-10-29,2022-01-19
684,اراد50,مرابحه عام دولت5-ش.خ0302,33,650300,650300950000,1000000,1000000,1000010,10,0,1000000,0,0,1000000,1000010,1400-10-29,2022-01-19
685,فيروزا,صندوق بادرآمد ثابت فيروزه آسيا,32,144984,3820804874,26333,26350,26360,27,0.1,26353,20,0.08,26350,26360,1400-10-29,2022-01-19
686,پارتا,مجتمع‌صنعتي‌آرتاويل‌تاير,32,254517,4555854300,18450,17900,17900,-550,-2.98,18290,-160,-0.87,17900,17900,1400-10-29,2022-01-19
687,طلا2,صندوق س.پشتوانه طلاي لوتوس,30,3000000,3000000,82263,1,1,-82262,-100,1,-82262,-100,1,1,1400-10-29,2022-01-19
688,داريك,صندوق س.اعتماد داريك-د,30,1012600,12317284123,12159,12164,12164,5,0.04,12164,5,0.04,12164,12166,1400-10-29,2022-01-19
689,اوصتا,صندوق انديشه ورزان صباتامين -د,30,255194,5424723517,21247,21257,21258,11,0.05,21257,10,0.05,21257,21258,1400-10-29,2022-01-19
690,سكارون,سيمان كارون,30,30758,1048847800,35150,34100,34100,-1050,-2.99,35050,-100,-0.28,34100,34100,1400-10-29,2022-01-19
691,كهربا,صندوق س.پشتوانه سكه طلا كهربا,29,100911,1026117745,10072,10193,10230,158,1.57,10169,97,0.96,10140,10242,1400-10-29,2022-01-19
692,الماس,صندوق س.امين تدبيرگران فردا-س,28,4462,426349557,95638,96000,95680,42,0.04,95551,-87,-0.09,94301,96000,1400-10-29,2022-01-19
693,پارسيان,بيمه پارسيان,28,36260,286985050,8180,8130,7980,-200,-2.44,8180,0,0,7780,8130,1400-10-29,2022-01-19
694,كرونا2,تامين مالي جمعي صرفا اهداي سود,28,5991,59910000,10000,10000,10000,0,0,10000,0,0,10000,10000,1400-10-29,2022-01-19
695,اخزا911,اسنادخزانه-م11بودجه99-020906,27,20644,14057407520,680150,680000,681500,1350,0.2,680940,790,0.12,680000,681500,1400-10-29,2022-01-19
696,اخزا812,اسنادخزانه-م12بودجه98-001111,26,13835,13747776790,992610,994990,993500,890,0.09,993700,1090,0.11,992110,995600,1400-10-29,2022-01-19
697,سيناد,صندوق س.سپهرسودمند سينا-د,26,753800,7585434300,10043,10047,10100,57,0.57,10063,20,0.2,10047,10100,1400-10-29,2022-01-19
698,وسخوز,شركت س استان خوزستان,25,677931,387098601,634,571,571,-63,-9.94,634,0,0,571,571,1400-10-29,2022-01-19
699,فسا,پتروشيمي فسا,25,332850,276931200,875,832,832,-43,-4.91,874,-1,-0.11,832,832,1400-10-29,2022-01-19
700,سكه0111پ05,تمام سكه طرح جديد0111آينده,24,7300,8691235700,1177774,1189990,1184001,6227,0.53,1190580,12806,1.09,1184001,1195000,1400-10-29,2022-01-19
701,آتيمس,صندوق س.آرمان آتيه درخشان مس-س,24,3882,657672513,170866,169271,170000,-866,-0.51,169416,-1450,-0.85,168100,171000,1400-10-29,2022-01-19
702,وآفري,بيمه كارآفرين,23,146056,598586940,4048,4000,4158,110,2.72,4050,2,0.05,4000,4168,1400-10-29,2022-01-19
703,افق ملت,صندوق س در سهام افق ملت,23,11748,1529081010,130950,132990,130000,-950,-0.73,130160,-790,-0.6,130000,133000,1400-10-29,2022-01-19
704,زعف0110پ10,زعفران0110نگين طلاي سرخ(پ),23,9299,3406109820,359096,372499,370000,10904,3.04,366288,7192,2,362005,372499,1400-10-29,2022-01-19
705,حشكوه,دليجان طلايي شكوه پارس,21,161727,507666826,3235,3220,3138,-97,-3,3230,-5,-0.15,3138,3220,1400-10-29,2022-01-19
706,اخزا814,اسنادخزانه-م14بودجه98-010318,21,64503,59655758000,924670,924670,925800,1130,0.12,924850,180,0.02,924000,926000,1400-10-29,2022-01-19
707,هپارس102,اختيارف ت پارس-157010-01/02/05,20,150000,150000,1,1,1,0,0,1,0,0,1,1,1400-10-29,2022-01-19
708,قنيشا,قند  نيشابور,20,22229,907165490,42950,40810,40810,-2140,-4.98,42810,-140,-0.33,40810,40810,1400-10-29,2022-01-19
709,ولتجار,واسپاري تجارت وسرمايه ايرانيان,20,672049,1632407021,2504,2429,2429,-75,-3,2491,-13,-0.52,2429,2429,1400-10-29,2022-01-19
710,ضصاد1112,اختيارخ وبصادر-1800-1400/11/06,19,532,36253000,71,75,67,-4,-5.63,68,-3,-4.23,60,75,1400-10-29,2022-01-19
711,گنجين,صندوق س. گنجينه يكم آويد-د,18,105238,1538552360,14613,14614,14622,9,0.06,14620,7,0.05,14614,14622,1400-10-29,2022-01-19
712,اخزا815,اسنادخزانه-م15بودجه98-010406,18,28486,26038769690,912230,915980,915000,2770,0.3,914090,1860,0.2,910090,916000,1400-10-29,2022-01-19
713,سباقر,سيمان باقران,18,73074,818428800,11540,11200,11200,-340,-2.95,11510,-30,-0.26,11200,11200,1400-10-29,2022-01-19
714,اخزا914,اسنادخزانه-م14بودجه99-021025,17,15802,10462590540,661810,662000,663000,1190,0.18,662110,300,0.05,662000,663000,1400-10-29,2022-01-19
715,فالوم,آلومتك‌,17,15358,240813440,16160,15680,15680,-480,-2.97,16150,-10,-0.06,15680,15680,1400-10-29,2022-01-19
716,اگ010518,گام بانك تجارت0105,17,150000,130875750000,872025,872505,872505,480,0.06,872505,480,0.06,872505,872505,1400-10-29,2022-01-19
717,اخزا903,اسنادخزانه-م3بودجه99-011110,17,44999,36467574580,810390,809920,810010,-380,-0.05,810410,20,0,809200,810500,1400-10-29,2022-01-19
718,ثروتم,صندوق س. ثروت آفرين پارسيان-س,16,13790,1114081910,79751,79992,79992,241,0.3,80789,1038,1.3,79992,81573,1400-10-29,2022-01-19
719,ضپنا2012,اختيارخ رمپنا-12000-1401/02/07,15,117,520500000,5850,4500,4500,-1350,-23.08,4449,-1401,-23.95,4300,4600,1400-10-29,2022-01-19
720,غشوكو,شوكو پارس,15,37745,277048300,7560,7340,7340,-220,-2.91,7550,-10,-0.13,7340,7340,1400-10-29,2022-01-19
721,ضسپا1111,اختيارخ خساپا-1400-1400/11/20,15,663,163186000,249,278,249,0,0,246,-3,-1.2,240,278,1400-10-29,2022-01-19
722,فراز,صندوق س.سهام فراز داريك-س,15,67546,962820680,14253,14254,14254,1,0.01,14254,1,0.01,14254,14256,1400-10-29,2022-01-19
723,ضترا3011,اختيارخ شتران-3000-1401/03/08,15,281,337310000,104,1199,1180,1076,1034.62,1200,1096,1053.85,1001,1390,1400-10-29,2022-01-19
724,اخزا918,اسنادخزانه-م18بودجه99-010323,15,17289,15903732670,919140,923640,920120,980,0.11,919880,740,0.08,919560,923640,1400-10-29,2022-01-19
725,ضشنا2015,اختيارخ شپنا-6000-1401/02/25,15,560,281752000,501,490,599,98,19.56,503,2,0.4,490,599,1400-10-29,2022-01-19
726,ثجوان,تامين مسكن جوانان,15,34000,150348000,4558,4422,4422,-136,-2.98,4556,-2,-0.04,4422,4422,1400-10-29,2022-01-19
727,تمحركه,ماشين سازي نيرو محركه,14,19732,293414840,15320,14870,14870,-450,-2.94,15310,-10,-0.07,14870,14870,1400-10-29,2022-01-19
728,ثمين,صندوق س. ثروت افزون ثمين-س,14,46402,465260061,9833,9800,10040,207,2.11,10027,194,1.97,9800,10040,1400-10-29,2022-01-19
729,اخزا818,اسنادخزانه-م18بودجه98-010614,13,1698,1485384730,879450,872530,875000,-4450,-0.51,874780,-4670,-0.53,872530,880010,1400-10-29,2022-01-19
730,آسام,صندوق س.آرمان سپهر آشنا-م,13,618910,71357987000,114858,114400,115300,442,0.38,115296,438,0.38,114400,115310,1400-10-29,2022-01-19
731,كارا2,صندوق س. كارا -د,13,111500000,111500000,10594,1,1,-10593,-99.99,1,-10593,-99.99,1,1,1400-10-29,2022-01-19
732,ضفلا1164,اختيارخ فولاد-12000-1400/11/24,12,247,15237000,72,50,70,-2,-2.78,62,-10,-13.89,50,84,1400-10-29,2022-01-19
733,ضملي1160,اختيارخ فملي-6000-1400/11/03,12,143,190750000,647,700,590,-57,-8.81,667,20,3.09,550,700,1400-10-29,2022-01-19
734,ضشنا2016,اختيارخ شپنا-7000-1401/02/25,11,124,36396000,500,300,349,-151,-30.2,294,-206,-41.2,290,349,1400-10-29,2022-01-19
735,هفارس104,اختيارف ت فارس-11832-01/04/12,11,181656,121164552,636,667,667,31,4.87,667,31,4.87,667,667,1400-10-29,2022-01-19
736,ضملت3009,اختيارخ وبملت-2000-1401/03/18,10,49,60120000,1339,1250,1210,-129,-9.63,1227,-112,-8.36,1200,1250,1400-10-29,2022-01-19
737,ثغرب,شركت سرمايه گذاري مسكن شمالغرب,10,51864,178152840,3615,3435,3435,-180,-4.98,3613,-2,-0.06,3435,3435,1400-10-29,2022-01-19
738,ضفلا1160,اختيارخ فولاد-7000-1400/11/24,10,24,73050000,3009,3700,2800,-209,-6.95,3044,35,1.16,2800,3700,1400-10-29,2022-01-19
739,دمعيار,صندوق س. توازن معيار-د,10,73022,713618880,9753,9779,9770,17,0.17,9773,20,0.21,9770,9790,1400-10-29,2022-01-19
740,فولاد2,فولاد مباركه اصفهان,10,422470000,4245823500000,9580,10050,10050,470,4.91,10050,470,4.91,10050,10050,1400-10-29,2022-01-19
741,اخزا817,اسنادخزانه-م17بودجه98-010512,9,3432,3081180910,895950,889500,894010,-1940,-0.22,897780,1830,0.2,889500,898980,1400-10-29,2022-01-19
742,اخزا909,اسنادخزانه-م9بودجه99-020316,9,26212,19691585920,751160,751180,752000,840,0.11,751240,80,0.01,750100,752000,1400-10-29,2022-01-19
743,ضذوب3000,اختيارخ ذوب-2000-1401/03/04,9,72,64440000,1500,1100,301,-1199,-79.93,895,-605,-40.33,301,1150,1400-10-29,2022-01-19
744,ساروج,بين المللي ساروج بوشهر,9,75875,1215952830,16200,16040,15710,-490,-3.02,16190,-10,-0.06,15710,16040,1400-10-29,2022-01-19
745,خفولا,خدمات فني فولاد يزد,8,3936,72422400,18950,18400,18400,-550,-2.9,18400,-550,-2.9,18400,18400,1400-10-29,2022-01-19
746,انار2,صندوق س.انارنماد ارزش-درسهام,8,230000,230000,8640,1,1,-8639,-99.99,1,-8639,-99.99,1,1,1400-10-29,2022-01-19
747,ضصاد1111,اختيارخ وبصادر-1600-1400/11/06,8,374,87993000,255,250,235,-20,-7.84,235,-20,-7.84,233,250,1400-10-29,2022-01-19
748,اخزا821,اسنادخزانه-م21بودجه98-020906,8,40458,27565082990,676320,681480,681490,5170,0.76,681330,5010,0.74,680500,681500,1400-10-29,2022-01-19
749,وتعاون,بيمه تعاون,8,51450,81445350,1666,1583,1583,-83,-4.98,1666,0,0,1583,1583,1400-10-29,2022-01-19
750,اخزا907,اسنادخزانه-م7بودجه99-020704,8,19869,14005525000,705000,704000,705500,500,0.07,704890,-110,-0.02,704000,705500,1400-10-29,2022-01-19
751,خاتم2,صندوق س خاتم ايساتيس پويا-ثابت,8,7400000,7400000,12675,1,1,-12674,-99.99,1,-12674,-99.99,1,1,1400-10-29,2022-01-19
752,جهرم,پتروشيمي جهرم,7,115341,125721690,1123,1090,1090,-33,-2.94,1090,-33,-2.94,1090,1090,1400-10-29,2022-01-19
753,ضپاس2012,اختيارخ وپارس-1800-1401/02/28,7,94,23532000,209,250,252,43,20.57,250,41,19.62,245,295,1400-10-29,2022-01-19
754,عيار2,صندوق سكه طلاي مفيد,7,70000,70000,29742,1,1,-29741,-100,1,-29741,-100,1,1,1400-10-29,2022-01-19
755,ضاريان1200,اختيارخ آريان-10000-14001211,7,17,59600000,3000,3600,3500,500,16.67,3506,506,16.87,3500,3600,1400-10-29,2022-01-19
756,ضذوب3001,اختيارخ ذوب-2500-1401/03/04,7,19,13985000,790,715,750,-40,-5.06,736,-54,-6.84,715,750,1400-10-29,2022-01-19
757,اخزا010,اسناد خزانه-م10بودجه00-031115,7,2175,1131226966,526142,520005,527980,1838,0.35,520104,-6038,-1.15,518053,527980,1400-10-29,2022-01-19
758,ضملت3010,اختيارخ وبملت-2500-1401/03/18,7,76,63160000,838,830,850,12,1.43,831,-7,-0.84,830,850,1400-10-29,2022-01-19
759,غشوكوح,ح . شوكو پارس,7,63741,278548170,4640,4370,4370,-270,-5.82,4370,-270,-5.82,4370,4370,1400-10-29,2022-01-19
760,ضفلا3009,اختيارخ فولاد-7000-1401/03/18,7,35,133700000,4000,3700,3800,-200,-5,3820,-180,-4.5,3700,3900,1400-10-29,2022-01-19
761,ضبدر1165,اختيارخ شبندر-8000-1400/11/13,6,235,6405000,12,26,25,13,108.33,27,15,125,25,30,1400-10-29,2022-01-19
762,باران,بيمه زندگي باران50%تاديه,6,12188,48624136,4022,4022,4022,0,0,4022,0,0,3902,4022,1400-10-29,2022-01-19
763,حرهشا,رهشاد سپاهان (سهامي عام,6,1501,112725100,77400,75100,75100,-2300,-2.97,77350,-50,-0.06,75100,75100,1400-10-29,2022-01-19
764,اراد61,مرابحه عام دولت61-ش.خ0309,6,39000,39000000000,1000000,1000000,1000000,0,0,1000000,0,0,1000000,1000000,1400-10-29,2022-01-19
765,خبنيان,بنيان ديزل,6,47021,63290266,1387,1346,1346,-41,-2.96,1387,0,0,1346,1346,1400-10-29,2022-01-19
766,آسام2,صندوق س.آرمان سپهر آشنا-م,6,600000,600000,114858,1,1,-114857,-100,1,-114857,-100,1,1,1400-10-29,2022-01-19
767,نخو0102پ01,نخود متوسط0102شيري(پ),6,115,40772450,340500,340000,357525,17025,5,354543,14043,4.12,340000,357525,1400-10-29,2022-01-19
768,خبازرس,بازرسي مهندسي و صنعتي ايران,6,17952,394046400,22600,21950,21950,-650,-2.88,22550,-50,-0.22,21950,21950,1400-10-29,2022-01-19
769,اخزا813,اسنادخزانه-م13بودجه98-010219,6,877,822941140,938530,949900,938010,-520,-0.06,938360,-170,-0.02,938010,949900,1400-10-29,2022-01-19
770,لخانه,لوازم‌ خانگي‌ پارس‌,6,7017,103921770,15260,14810,14810,-450,-2.95,15260,0,0,14810,14810,1400-10-29,2022-01-19
771,ثتوسا,س.توسعه و عمران استان اردبيل,6,5948,67450320,11690,11340,11340,-350,-2.99,11690,0,0,11340,11340,1400-10-29,2022-01-19
772,ضملت1135,اختيارخ وبملت-4000-1400/11/13,5,30,32000,1,2,1,0,0,1,0,0,1,2,1400-10-29,2022-01-19
773,كباده,توليد خاك نسوزاستقلال آباده,5,2191,77670950,34450,35450,35450,1000,2.9,35450,1000,2.9,35450,35450,1400-10-29,2022-01-19
774,آكورد2,صندوق س. آرمان آتي كوثر-د,5,500000,500000,36355,1,1,-36354,-100,1,-36354,-100,1,1,1400-10-29,2022-01-19
775,اخزا905,اسنادخزانه-م5بودجه99-020218,5,50520,38546797970,762690,763000,763000,310,0.04,763000,310,0.04,763000,763020,1400-10-29,2022-01-19
776,ضپاس2011,اختيارخ وپارس-1600-1401/02/28,5,500,160700000,298,300,325,27,9.06,321,23,7.72,300,332,1400-10-29,2022-01-19
777,ضترا1135,اختيارخ شتران-6176-1400/11/10,5,194,1625439,1,2,2,1,100,4,3,300,2,5,1400-10-29,2022-01-19
778,هنوري102,اختيارف ت نوري59561-01/02/15,5,40871,40871,1,1,1,0,0,1,0,0,1,1,1400-10-29,2022-01-19
779,ثنام,س ساختماني ب نام آوران مهندسي,5,10540,84109200,8220,7980,7980,-240,-2.92,8220,0,0,7980,7980,1400-10-29,2022-01-19
780,طخود2018,اختيارف خودرو-2000-1401/02/07,5,116,18418000,150,120,160,10,6.67,159,9,6,120,160,1400-10-29,2022-01-19
781,غناب,روغن‌ نباتي‌ ناب,5,659,98948850,145800,150150,150150,4350,2.98,145850,50,0.03,150150,150150,1400-10-29,2022-01-19
782,زعف0110پ08,زعفران0110نگين روستا(پ),4,2270,823780000,358471,364000,362500,4029,1.12,362899,4428,1.24,362500,364000,1400-10-29,2022-01-19
783,ضترا3013,اختيارخ شتران-4000-1401/03/08,4,7,2800000,1,400,400,399,39900,400,399,39900,400,400,1400-10-29,2022-01-19
784,خعمرا,توسعه و عمران شهرستان نائين,4,50100,319638000,6200,6380,6380,180,2.9,6210,10,0.16,6380,6380,1400-10-29,2022-01-19
785,ضپنا2011,اختيارخ رمپنا-10000-1401/02/07,4,15,93800000,7600,6300,6200,-1400,-18.42,6253,-1347,-17.72,6200,6300,1400-10-29,2022-01-19
786,صبا1404,اجاصبابدون ضامن بارتبه اعتباري,4,200000,200000000000,1000000,1000000,1000000,0,0,1000000,0,0,1000000,1000000,1400-10-29,2022-01-19
787,سلار,شركت سيمان لارستان,4,1705,35378750,21350,20750,20750,-600,-2.81,21350,0,0,20750,20750,1400-10-29,2022-01-19
788,فنرژي,گسترش صنايع انرژي آذرآب,4,3803,31450810,8430,8270,8270,-160,-1.9,8270,-160,-1.9,8270,8270,1400-10-29,2022-01-19
789,تملي708,تسهيلات مسكن ب. ملي-آبان97,4,39,29129061,711333,746899,746899,35566,5,746899,35566,5,746899,746899,1400-10-29,2022-01-19
790,سخند,صندوق س.سپهرخبرگان نفت-د,4,4000,40316500,10067,10079,10080,13,0.13,10079,12,0.12,10079,10080,1400-10-29,2022-01-19
791,ضملي3013,اختيارخ فملي-7000-1401/03/02,4,5,4750000,751,1000,975,224,29.83,950,199,26.5,900,1000,1400-10-29,2022-01-19
792,ولانا,شركت ليزينگ آريا دانا,4,2020,20846400,10630,10320,10320,-310,-2.92,10630,0,0,10320,10320,1400-10-29,2022-01-19
793,پادا,صندوق س.پاداش سرمايه پارس-س,4,591,60559300,102825,102500,102850,25,0.02,102469,-356,-0.35,102300,102950,1400-10-29,2022-01-19
794,ضجار2013,اختيارخ وتجارت-2000-1401/02/21,3,29,4919000,178,170,170,-8,-4.49,170,-8,-4.49,169,170,1400-10-29,2022-01-19
795,كمان,س.خ.كمان كاريزما 35% تاديه,3,52000,20128786000,386867,387093,387092,225,0.06,387092,225,0.06,387092,387093,1400-10-29,2022-01-19
796,هكشو208,اختيارف ت پاكشو10000-02/08/29,3,110000,81180000,724,738,738,14,1.93,738,14,1.93,738,738,1400-10-29,2022-01-19
797,حاريا,كشتيراني آريا,3,2046,22076340,11010,10790,10790,-220,-2,10790,-220,-2,10790,10790,1400-10-29,2022-01-19
798,افران2,صندوق س افرا نماد پايدار-ثابت,3,15300000,15300000,15280,1,1,-15279,-99.99,1,-15279,-99.99,1,1,1400-10-29,2022-01-19
799,ضملي1161,اختيارخ فملي-7000-1400/11/03,3,14,280000,18,10,10,-8,-44.44,10,-8,-44.44,10,10,1400-10-29,2022-01-19
800,اراد45,مرابحه عام دولت4-ش.خ 0107,3,4500,4446495000,968940,985000,989000,20060,2.07,988110,19170,1.98,985000,989000,1400-10-29,2022-01-19
801,صگل1411,ص اجاره گل گهر 1411-3 ماهه 17%,3,30000,30000000000,971587,1000000,1000000,28413,2.92,1000000,28413,2.92,1000000,1000000,1400-10-29,2022-01-19
802,ضصاد1110,اختيارخ وبصادر-1400-1400/11/06,3,3,1410000,482,470,470,-12,-2.49,470,-12,-2.49,470,470,1400-10-29,2022-01-19
803,شجم2,صنايع پتروشيمي تخت جمشيد,3,20000000,211200000000,10560,10560,10560,0,0,10560,0,0,10560,10560,1400-10-29,2022-01-19
804,ضملت1136,اختيارخ وبملت-4500-1400/11/13,3,148,148000,1,1,1,0,0,1,0,0,1,1,1400-10-29,2022-01-19
805,سيلام,سيمان‌ ايلام‌,3,57066,360086460,6640,6310,6310,-330,-4.97,6630,-10,-0.15,6310,6310,1400-10-29,2022-01-19
806,شيراز2,پتروشيمي‌شيراز,3,3200000,204928000000,64040,64040,64040,0,0,64040,0,0,64040,64040,1400-10-29,2022-01-19
807,زعف0110پ21,زعفران0110نگين ملل(پ),3,300,110099652,354823,366997,366999,12176,3.43,366999,12176,3.43,366997,366999,1400-10-29,2022-01-19
808,فملي2,ملي‌ صنايع‌ مس‌ ايران‌,3,29000000,194870000000,6830,6700,6730,-100,-1.46,6720,-110,-1.61,6700,6730,1400-10-29,2022-01-19
809,تبريز304,مشاركت ش تبريز304-3ماهه18%,3,21000,21000000000,1000000,1000000,1000000,0,0,1000000,0,0,1000000,1000000,1400-10-29,2022-01-19
810,زير0103پ01,زيره سبز0103كيميابذر(پ),3,364,335800000,950000,940000,902500,-47500,-5,922527,-27473,-2.89,902500,950000,1400-10-29,2022-01-19
811,تملي806,تسهيلات مسكن ب. ملي-شهريور98,3,33,26188470,755800,793590,793590,37790,5,793590,37790,5,793590,793590,1400-10-29,2022-01-19
812,سفاسي,شركت فارسيت اهواز,3,17898,60029892,3457,3354,3354,-103,-2.98,3456,-1,-0.03,3354,3354,1400-10-29,2022-01-19
813,ضملت1132,اختيارخ وبملت-2500-1400/11/13,2,2,949000,383,399,550,167,43.6,474,91,23.76,399,550,1400-10-29,2022-01-19
814,ضترا3012,اختيارخ شتران-3500-1401/03/08,2,200,23000000,1,115,115,114,11400,115,114,11400,115,115,1400-10-29,2022-01-19
815,ياقوت2,صندوق س ياقوت آگاه-ثابت,2,11770000,11770000,14001,1,1,-14000,-99.99,1,-14000,-99.99,1,1,1400-10-29,2022-01-19
816,ضفرابورس1200,اختيارخ فرابورس-19000-14001218,2,16,4800000,300,300,300,0,0,300,0,0,300,300,1400-10-29,2022-01-19
817,تملي804,تسهيلات مسكن ب. ملي-تير98,2,23,15913812,725253,688991,756010,30757,4.24,691905,-33348,-4.6,688991,756010,1400-10-29,2022-01-19
818,تاصيكو2,سرمايه گذاري صدرتامين,2,7000000,55300000000,7980,7900,7900,-80,-1,7900,-80,-1,7900,7900,1400-10-29,2022-01-19
819,وسالت,بانك قرض الحسنه رسالت,2,100,172600,1676,1726,1726,50,2.98,1726,50,2.98,1726,1726,1400-10-29,2022-01-19
820,اراد404,مرابحه عام دولت4-ش.خ 0207,2,1204000,1123911335000,1000000,928305,968000,-32000,-3.2,933481,-66519,-6.65,928305,968000,1400-10-29,2022-01-19
821,ضملت1131,اختيارخ وبملت-2000-1400/11/13,2,20,16120000,950,806,806,-144,-15.16,806,-144,-15.16,806,806,1400-10-29,2022-01-19
822,غدشت,دشت‌ مرغاب‌,2,1055,20878450,20830,19790,19790,-1040,-4.99,20830,0,0,19790,19790,1400-10-29,2022-01-19
823,وحافظ,بيمه حافظ,2,1630,10529800,6650,6460,6460,-190,-2.86,6650,0,0,6460,6460,1400-10-29,2022-01-19
824,تابان03,اجاره تابان سپهر14021206,2,4310,4153196000,980000,960000,998990,18990,1.94,963620,-16380,-1.67,960000,998990,1400-10-29,2022-01-19
825,كابگن,توليدي و صنعتي آبگينه‌,2,3400,24446000,7120,7190,7190,70,0.98,7190,70,0.98,7190,7190,1400-10-29,2022-01-19
826,وشمال,س. چشم انداز توسعه شمال,2,266,15640800,59950,58800,58800,-1150,-1.92,58800,-1150,-1.92,58800,58800,1400-10-29,2022-01-19
827,طخود2019,اختيارف خودرو-2500-1401/02/07,2,7,3430000,546,490,490,-56,-10.26,490,-56,-10.26,490,490,1400-10-29,2022-01-19
828,ضترا1133,اختيارخ شتران-4411-1400/11/10,2,10,793450,2,35,35,33,1650,35,33,1650,35,35,1400-10-29,2022-01-19
829,زير0103پ04,زيره سبز0103شركت مينوبذر(پ),2,92,83030000,951895,902500,902500,-49395,-5.19,902500,-49395,-5.19,902500,902500,1400-10-29,2022-01-19
830,اروند11,منفعت صبا اروند سپهر 14001222,2,60,60300000,973000,1005000,1005000,32000,3.29,1005000,32000,3.29,1005000,1005000,1400-10-29,2022-01-19
831,طترا1132,اختيارف شتران-3970-1400/11/10,2,2,1020150,200,225,225,25,12.5,225,25,12.5,225,225,1400-10-29,2022-01-19
832,حگردش,ريل گردش ايرانيان,2,6400,24249600,3906,3789,3789,-117,-3,3906,0,0,3789,3789,1400-10-29,2022-01-19
833,ساذري,آذريت‌,2,1490,10176700,7040,6830,6830,-210,-2.98,7040,0,0,6830,6830,1400-10-29,2022-01-19
834,فن آواح,ح.گروه فن آوا,2,600,5028000,8630,8380,8380,-250,-2.9,8380,-250,-2.9,8380,8380,1400-10-29,2022-01-19
835,تملي703,تسهيلات مسكن ب. ملي-خرداد97,2,20,10878340,518017,543917,543917,25900,5,543917,25900,5,543917,543917,1400-10-29,2022-01-19
836,هاميد104,اختيارف ت ثاميد-2050-01/04/20,2,79,47795,466,605,605,139,29.83,605,139,29.83,605,605,1400-10-29,2022-01-19
837,شسم,توليد سموم‌ علف‌ كش,2,24,3043200,123150,126800,126800,3650,2.96,126800,3650,2.96,126800,126800,1400-10-29,2022-01-19
838,ضكاريس903,اختيارخ كاريس-16000-14010930,2,7,11089000,1299,1600,1489,190,14.63,1584,285,21.94,1489,1600,1400-10-29,2022-01-19
839,ضبدر1164,اختيارخ شبندر-7000-1400/11/13,2,20,1580000,35,98,60,25,71.43,79,44,125.71,60,98,1400-10-29,2022-01-19
840,سپيدما2,صندوق س. سپيد دماوند-د,2,2000000,2000000,11714,1,1,-11713,-99.99,1,-11713,-99.99,1,1,1400-10-29,2022-01-19
841,كمند2,صندوق س. با درآمد ثابت كمند,2,77800000,77800000,10076,1,1,-10075,-99.99,1,-10075,-99.99,1,1,1400-10-29,2022-01-19
842,شگويات.ف0104,اختيارف.تبعي شگويا010408,1,1000,140000,140,140,140,0,0,140,0,0,140,140,1400-10-29,2022-01-19
843,سميعا002,سلف موازي استاندارد سميعا002,1,100,147270200,1430813,1472702,1472702,41889,2.93,1472702,41889,2.93,1472702,1472702,1400-10-29,2022-01-19
844,سنفت004,سلف موازي استاندارد سنفت004,1,23480,29999104600,1277645,1277645,1277645,0,0,1277645,0,0,1277645,1277645,1400-10-29,2022-01-19
845,فكمند,گسترش قطعه سازي كمند,1,300,9735000,33450,32450,32450,-1000,-2.99,33450,0,0,32450,32450,1400-10-29,2022-01-19
846,ضسپا3010,اختيارخ خساپا-1000-1401/03/25,1,5,3650000,770,730,730,-40,-5.19,730,-40,-5.19,730,730,1400-10-29,2022-01-19
847,ضپال2006,اختيارخ اپال-28000-1401/02/12,1,3,1647000,423,549,549,126,29.79,549,126,29.79,549,549,1400-10-29,2022-01-19
848,اطلس2,صندوق س.توسعه اندوخته آينده-س,1,10000,10000,226080,1,1,-226079,-100,1,-226079,-100,1,1,1400-10-29,2022-01-19
849,دامين2,داروسازي‌ امين‌,1,30000000,61800000000,2132,2060,2060,-72,-3.38,2060,-72,-3.38,2060,2060,1400-10-29,2022-01-19
850,ضصاد1114,اختيارخ وبصادر-2500-1400/11/06,1,20,20000,1,1,1,0,0,1,0,0,1,1,1400-10-29,2022-01-19
851,اخزا8134,اسنادخزانه-م13بودجه98-010219,1,176063,173355855312,938530,984624,984624,46094,4.91,984624,46094,4.91,984624,984624,1400-10-29,2022-01-19
852,شتولي,تولي‌پرس‌,1,270,4941000,18650,18300,18300,-350,-1.88,18300,-350,-1.88,18300,18300,1400-10-29,2022-01-19
853,اراد874,مرابحه عام دولت87-ش.خ030304,1,1000000,931000000000,954500,931000,931000,-23500,-2.46,931000,-23500,-2.46,931000,931000,1400-10-29,2022-01-19
854,اراد424,مرابحه عام دولت4-ش.خ 0106,1,2002300,2002300000000,984700,1000000,1000000,15300,1.55,1000000,15300,1.55,1000000,1000000,1400-10-29,2022-01-19
855,ضشگويا1206,اختيارخ شگويا-18000-14001222,1,1,20000000,14600,20000,20000,5400,36.99,20000,5400,36.99,20000,20000,1400-10-29,2022-01-19
856,ويستا,صندوق س. ويستا -س,1,999,9990000,10000,10000,10000,0,0,10000,0,0,10000,10000,1400-10-29,2022-01-19
857,شكف,كف,1,215,14297500,67850,66500,66500,-1350,-1.99,66500,-1350,-1.99,66500,66500,1400-10-29,2022-01-19
858,اخزا009,اسناد خزانه-م9بودجه00-031101,1,70,36785700,527860,525510,525510,-2350,-0.45,525510,-2350,-0.45,525510,525510,1400-10-29,2022-01-19
859,ونچر,ص.ج.فيروزه40%تاديه,1,2000,844000000,425000,422000,422000,-3000,-0.71,422000,-3000,-0.71,422000,422000,1400-10-29,2022-01-19
860,ثعمرا2,عمران و توسعه شاهد,1,12900000,81657000000,6350,6330,6330,-20,-0.31,6330,-20,-0.31,6330,6330,1400-10-29,2022-01-19
861,اوج,صندوق س.اوج دماوند-س,1,555,5551110,10002,10002,10002,0,0,10002,0,0,10002,10002,1400-10-29,2022-01-19
862,دشيري,شيرين دارو,1,78,8560500,113100,109750,109750,-3350,-2.96,113100,0,0,109750,109750,1400-10-29,2022-01-19
863,اخزا9094,اسنادخزانه-م9بودجه99-020316,1,21352,19965358416,751160,935058,935058,183898,24.48,935058,183898,24.48,935058,935058,1400-10-29,2022-01-19
864,ثعتما,س. ساختماني اعتماد گستر,1,345,7590000,22650,22000,22000,-650,-2.87,22650,0,0,22000,22000,1400-10-29,2022-01-19
865,اخزا8144,اسنادخزانه-م14بودجه98-010318,1,5520,5413221120,924670,980656,980656,55986,6.05,980656,55986,6.05,980656,980656,1400-10-29,2022-01-19
866,طسپا1112,اختيارف خساپا-1600-1400/11/20,1,10,1500000,65,150,150,85,130.77,150,85,130.77,150,150,1400-10-29,2022-01-19
867,اخزا8214,اسنادخزانه-م21بودجه98-020906,1,1943848,1777983337856,676320,914672,914672,238352,35.24,914672,238352,35.24,914672,914672,1400-10-29,2022-01-19
868,افاد81,منفعت دولت8-ش.خاص مهر0205,1,5000,5000000000,1000000,1000000,1000000,0,0,1000000,0,0,1000000,1000000,1400-10-29,2022-01-19
869,افران4,صندوق س افرا نماد پايدار-ثابت,1,21000000,321048000000,15280,15288,15288,8,0.05,15288,8,0.05,15288,15288,1400-10-29,2022-01-19
870,اراد834,مرابحه عام دولت83-ش.خ041220,1,60000,60000000000,1000000,1000000,1000000,0,0,1000000,0,0,1000000,1000000,1400-10-29,2022-01-19
871,وسرضوي,س.سهام عدالت استان خراسان رضوي,1,7500,5167500,725,689,689,-36,-4.97,725,0,0,689,689,1400-10-29,2022-01-19
872,تملي805,تسهيلات مسكن ب. ملي-مرداد98,1,10,7341320,772770,734132,734132,-38638,-5,734132,-38638,-5,734132,734132,1400-10-29,2022-01-19
873,اراد49,مرابحه عام دولت4-ش.خ 0206,1,500,494995000,980070,989990,989990,9920,1.01,989990,9920,1.01,989990,989990,1400-10-29,2022-01-19
874,پشاهن,توليدي پلاستيك‌ شاهين,1,10,58600,5690,5860,5860,170,2.99,5860,170,2.99,5860,5860,1400-10-29,2022-01-19
875,اخزا9074,اسنادخزانه-م7بودجه99-020704,1,1399973,1290542710482,705000,921834,921834,216834,30.76,921834,216834,30.76,921834,921834,1400-10-29,2022-01-19
876,اخزا0064,اسنادخزانه-م6بودجه00-030723,1,738199,649024560800,550400,879200,879200,328800,59.74,879200,328800,59.74,879200,879200,1400-10-29,2022-01-19
877,پا ه 19,بار پايه هفته 19,1,10000,5100000,589,510,510,-79,-13.41,510,-79,-13.41,510,510,1400-10-29,2022-01-19
878,اخزا9104,اسنادخزانه-م10بودجه99-020807,1,661959,607683657672,691730,918008,918008,226278,32.71,918008,226278,32.71,918008,918008,1400-10-29,2022-01-19
879,پا ه 21,بار پايه هفته 21,1,10000,5100000,800,510,510,-290,-36.25,510,-290,-36.25,510,510,1400-10-29,2022-01-19
880,اراد40,مرابحه عام دولت4-ش.خ 0207,1,3000,2904000000,1000000,968000,968000,-32000,-3.2,968000,-32000,-3.2,968000,968000,1400-10-29,2022-01-19
881,طفلا1163,اختيارف فولاد-10000-1400/11/24,1,10,5800000,700,580,580,-120,-17.14,580,-120,-17.14,580,580,1400-10-29,2022-01-19
882,اراد43,مرابحه عام دولت4-ش.خ 0205,1,1000,955000000,920000,955000,955000,35000,3.8,955000,35000,3.8,955000,955000,1400-10-29,2022-01-19
883,آگاس2,صندوق س.هستي بخش آگاه-س,1,100000,100000,72358,1,1,-72357,-100,1,-72357,-100,1,1,1400-10-29,2022-01-19
884,اخزا9044,اسنادخزانه-م4بودجه99-011215,1,673556,637324749204,796490,946209,946209,149719,18.8,946209,149719,18.8,946209,946209,1400-10-29,2022-01-19
885,اخزا0044,اسنادخزانه-م4بودجه00-030522,1,1130000,1001091860000,571560,885922,885922,314362,55,885922,314362,55,885922,885922,1400-10-29,2022-01-19
886,اخزا9024,اسنادخزانه-م2بودجه99-011019,1,2738748,2610374664996,818990,953127,953127,134137,16.38,953127,134137,16.38,953127,953127,1400-10-29,2022-01-19
887,ديزل04,مرابحه بهمن ديزل14040331,1,1000,996960000,977410,996960,996960,19550,2,996960,19550,2,996960,996960,1400-10-29,2022-01-19
888,ثقزوي,شركت عمران و سازندگي قزوين,1,262,5006820,19700,19110,19110,-590,-2.99,19110,-590,-2.99,19110,19110,1400-10-29,2022-01-19
889,وسصفا,شركت س استان اصفهان,1,40000,27720000,729,693,693,-36,-4.94,729,0,0,693,693,1400-10-29,2022-01-19
890,اخزا820,اسنادخزانه-م20بودجه98-020806,1,8,5538640,691910,692330,692330,420,0.06,692330,420,0.06,692330,692330,1400-10-29,2022-01-19
891,اخزا906,اسنادخزانه-م6بودجه99-020321,1,19,14225490,748710,748710,748710,0,0,748710,0,0,748710,748710,1400-10-29,2022-01-19
892,اخزا9084,اسنادخزانه-م8بودجه99-020606,1,800000,740177600000,715490,925222,925222,209732,29.31,925222,209732,29.31,925222,925222,1400-10-29,2022-01-19
893,ضبدر1161,اختيارخ شبندر-4500-1400/11/13,1,1,2200000,1842,2200,2200,358,19.44,2200,358,19.44,2200,2200,1400-10-29,2022-01-19
894,تملي711,تسهيلات مسكن ب. ملي-بهمن97,1,7,5367418,807130,766774,766774,-40356,-5,766774,-40356,-5,766774,766774,1400-10-29,2022-01-19
895,اراد244,مرابحه عام دولت2-ش.خ ساير0212,1,133000,130340000000,1000000,980000,980000,-20000,-2,980000,-20000,-2,980000,980000,1400-10-29,2022-01-19
896,ضپال2002,اختيارخ اپال-16000-1401/02/12,1,1,7500000,6500,7500,7500,1000,15.38,7500,1000,15.38,7500,7500,1400-10-29,2022-01-19
897,مثقال2,صندوق س.پشتوانه طلاي زرين آگاه,1,100000,100000,9321,1,1,-9320,-99.99,1,-9320,-99.99,1,1,1400-10-29,2022-01-19
898,فسديد,لوله‌وتجهيزات‌ سديد - ورشكسته,1,60,5097000,85800,84950,84950,-850,-0.99,84950,-850,-0.99,84950,84950,1400-10-29,2022-01-19
899,ضترا1131,اختيارخ شتران-3529-1400/11/10,1,2,1586900,216,350,350,134,62.04,350,134,62.04,350,350,1400-10-29,2022-01-19
900,تاپيكو2,س. نفت و گاز و پتروشيمي تأمين,1,10000000,128500000000,12840,12850,12850,10,0.08,12850,10,0.08,12850,12850,1400-10-29,2022-01-19
901,وسخراج,شركت س استان خراسان جنوبي,1,4746,9961854,2209,2099,2099,-110,-4.98,2209,0,0,2099,2099,1400-10-29,2022-01-19
902,مشهد112,مشاركت ش مشهد112-3ماهه18%,1,500,450000000,859950,900000,900000,40050,4.66,900000,40050,4.66,900000,900000,1400-10-29,2022-01-19
903,اخزا9034,اسنادخزانه-م3بودجه99-011110,1,155826,148115885346,810390,950521,950521,140131,17.29,950521,140131,17.29,950521,950521,1400-10-29,2022-01-19
904,دسبحان2,سبحان دارو,1,6350000,50165000000,8280,7900,7900,-380,-4.59,7900,-380,-4.59,7900,7900,1400-10-29,2022-01-19
905,تبريز0342,مشاركت ش تبريز034-3 ماهه 18%,1,500000,500045000000,1000000,1000090,1000090,90,0.01,1000090,90,0.01,1000090,1000090,1400-10-29,2022-01-19
906,پست0108پ04,پسته فندقي32-30سبزدانه0108(پ),1,50,107500000,2249000,2150000,2150000,-99000,-4.4,2150000,-99000,-4.4,2150000,2150000,1400-10-29,2022-01-19
907,طملت1133,اختيارف وبملت-3000-1400/11/13,1,1,150000,49,150,150,101,206.12,150,101,206.12,150,150,1400-10-29,2022-01-19
908,ضپاس2009,اختيارخ وپارس-1200-1401/02/28,1,5,3300000,650,660,660,10,1.54,660,10,1.54,660,660,1400-10-29,2022-01-19
909,كرمان39,مرابحه كرمان موتور14030915,1,1000,1006000000,1000000,1006000,1006000,6000,0.6,1006000,6000,0.6,1006000,1006000,1400-10-29,2022-01-19
910,ضسپا1110,اختيارخ خساپا-1200-1400/11/20,1,1,482000,413,482,482,69,16.71,482,69,16.71,482,482,1400-10-29,2022-01-19
911,سفارود,كارخانه فارسيت درود,1,2000,21720000,11080,10860,10860,-220,-1.99,10860,-220,-1.99,10860,10860,1400-10-29,2022-01-19
912,ثبات2,صندوق س. ثبات ويستا -د,1,9300000,9300000,10778,1,1,-10777,-99.99,1,-10777,-99.99,1,1,1400-10-29,2022-01-19
913,فبستم,صنايع ‌بسته‌بندي‌ مشهد,1,50,63250,1229,1265,1265,36,2.93,1265,36,2.93,1265,1265,1400-10-29,2022-01-19
914,اخزا9164,اسنادخزانه-م16بودجه99-020528,1,10908,10103840424,746500,926278,926278,179778,24.08,926278,179778,24.08,926278,926278,1400-10-29,2022-01-19
915,تابان032,اجاره تابان سپهر14021206,1,196847,185036180000,980000,940000,940000,-40000,-4.08,940000,-40000,-4.08,940000,940000,1400-10-29,2022-01-19
916,اخزا8124,اسنادخزانه-م12بودجه98-001111,1,28168,28106396584,992610,997813,997813,5203,0.52,997813,5203,0.52,997813,997813,1400-10-29,2022-01-19
917,پا ه 20,بار پايه هفته 20,1,10000,5100000,800,510,510,-290,-36.25,510,-290,-36.25,510,510,1400-10-29,2022-01-19
918,اخزا8154,اسنادخزانه-م15بودجه98-010406,1,486105,475487980695,912230,978159,978159,65929,7.23,978159,65929,7.23,978159,978159,1400-10-29,2022-01-19
919,اراد72,مرابحه عام دولت72-ش.خ0311,1,10700,10058000000,940000,940000,940000,0,0,940000,0,0,940000,940000,1400-10-29,2022-01-19
920,اروند05,منفعت صبا اروند لوتوس 14001113,1,45,45000000,1000000,1000000,1000000,0,0,1000000,0,0,1000000,1000000,1400-10-29,2022-01-19
921,صنفت0312,صكوك منفعت نفت0312-6ماهه 18/5%,1,1000,1020000000,1000000,1020000,1020000,20000,2,1020000,20000,2,1020000,1020000,1400-10-29,2022-01-19
922,اراد334,مرابحه عام دولت3-ش.خ 0303,1,840500,840500000000,993990,1000000,1000000,6010,0.6,1000000,6010,0.6,1000000,1000000,1400-10-29,2022-01-19
923,صخود401,ص مرابحه خودرو401- 3ماهه 18%,1,1000,950000000,930000,950000,950000,20000,2.15,950000,20000,2.15,950000,950000,1400-10-29,2022-01-19
924,شتهران,داروسازي تهران شيمي,1,7,53550,7500,7650,7650,150,2,7650,150,2,7650,7650,1400-10-29,2022-01-19
925,تابان01,اجاره تابان تمدن14021206,1,800,790120000,975940,987650,987650,11710,1.2,987650,11710,1.2,987650,987650,1400-10-29,2022-01-19
926,سبرق021,سلف موازي برق صادراتي گيلان021,1,780000,150930000000,193500,193500,193500,0,0,193500,0,0,193500,193500,1400-10-29,2022-01-19
927,اخزا8204,اسنادخزانه-م20بودجه98-020806,1,1975091,1813378449284,691910,918124,918124,226214,32.69,918124,226214,32.69,918124,918124,1400-10-29,2022-01-19
928,اخزا9054,اسنادخزانه-م5بودجه99-020218,1,571127,536028390215,762690,938545,938545,175855,23.06,938545,175855,23.06,938545,938545,1400-10-29,2022-01-19
929,ثهام,صندوق س ثروت هامرز-سهام,1,2,20600,10400,10300,10300,-100,-0.96,10300,-100,-0.96,10300,10300,1400-10-29,2022-01-19
930,ضملي1162,اختيارخ فملي-8000-1400/11/03,1,3,30000,9,5,5,-4,-44.44,5,-4,-44.44,5,5,1400-10-29,2022-01-19
931,افاد44,منفعت دولتي4-شرايط خاص14010729,1,3006000,3006000000000,999990,1000000,1000000,10,0,1000000,10,0,1000000,1000000,1400-10-29,2022-01-19
932,اراد36,مرابحه عام دولت3-ش.خ 0104,1,1000,990000000,976660,990000,990000,13340,1.37,990000,13340,1.37,990000,990000,1400-10-29,2022-01-19
933,اراد75,مرابحه عام دولت75-ش.خ040226,1,1000,1000000000,987000,1000000,1000000,13000,1.32,1000000,13000,1.32,1000000,1000000,1400-10-29,2022-01-19
934,ضهمن3000,اختيارخ خبهمن-1200-1401/03/11,1,1,920000,825,920,920,95,11.52,920,95,11.52,920,920,1400-10-29,2022-01-19
935,ضشنا2017,اختيارخ شپنا-8000-1401/02/25,1,3,750000,452,250,250,-202,-44.69,250,-202,-44.69,250,250,1400-10-29,2022-01-19
936,ضفلا1165,اختيارخ فولاد-14000-1400/11/24,1,10,500000,22,50,50,28,127.27,50,28,127.27,50,50,1400-10-29,2022-01-19
937,سنوين,سرمايه گذاري اقتصاد نوين,1,1000,5220000,5490,5220,5220,-270,-4.92,5490,0,0,5220,5220,1400-10-29,2022-01-19
938,سحرا021,سلف موازي برق نيروي برق حرارتي,1,170000,54443520000,324924,320256,320256,-4668,-1.44,320256,-4668,-1.44,320256,320256,1400-10-29,2022-01-19
939,صبا14042,اجاصبابدون ضامن بارتبه اعتباري,1,10000,10067800000,1000000,1006780,1006780,6780,0.68,1006780,6780,0.68,1006780,1006780,1400-10-29,2022-01-19
940,ضملي1158,اختيارخ فملي-4500-1400/11/03,1,6,24012000,2500,2001,2001,-499,-19.96,2001,-499,-19.96,2001,2001,1400-10-29,2022-01-19
941,شكلر2,نيروكلر,1,20750000,643250000000,31960,31000,31000,-960,-3,31000,-960,-3,31000,31000,1400-10-29,2022-01-19
942,طخود2016,اختيارف خودرو-1600-1401/02/07,1,1,50000,43,50,50,7,16.28,50,7,16.28,50,50,1400-10-29,2022-01-19
