,نماد,نام,تعداد,حجم,ارزش,دیروز,اولین,آخرین معامله - مقدار,آخرین معامله - تغییر,آخرین معامله - درصد,قیمت پایانی - مقدار,قیمت پایانی - تغییر,قیمت پایانی - درصد,کمترین,بیشترین,تاریخ,gregorian_date
0,پالايش,صندوق پالايشي يكم-سهام,66386,96800670,7554517384480,74520,75280,78610,4090,5.49,78040,3520,4.72,75010,79450,1400-8-18,2021-11-09
1,خودرو,ايران‌ خودرو,34777,1532746439,3152406545978,2043,2050,2046,3,0.15,2057,14,0.69,1962,2139,1400-8-18,2021-11-09
2,دارا يكم,صندوق واسطه گري مالي يكم-سهام,31071,25649104,3127271665070,121360,120100,121350,-10,-0.01,121930,570,0.47,119210,124180,1400-8-18,2021-11-09
3,خساپا,سايپا,24942,961453485,1688040306653,1806,1768,1730,-76,-4.21,1756,-50,-2.77,1716,1834,1400-8-18,2021-11-09
4,شستا,سرمايه گذاري تامين اجتماعي,21395,108512002,1310130069880,12040,11950,11990,-50,-0.42,12070,30,0.25,11890,12320,1400-8-18,2021-11-09
5,فرابورس,فرابورس ايران,15610,43275224,1108013792207,26209,25460,25040,-1169,-4.46,25604,-605,-2.31,24899,27290,1400-8-18,2021-11-09
6,شپنا,پالايش نفت اصفهان,14419,184764917,2190056907560,11320,11330,11880,560,4.95,11850,530,4.68,11330,11880,1400-8-18,2021-11-09
7,بركت,گروه دارويي بركت,14245,43156397,1022637247100,22880,23400,23900,1020,4.46,23700,820,3.58,22900,24020,1400-8-18,2021-11-09
8,كالا,بورس كالاي ايران,13080,39623863,1484999045650,36140,35600,37030,890,2.46,37480,1340,3.71,35600,37940,1400-8-18,2021-11-09
9,شبندر,پالايش نفت بندرعباس,13034,310046549,2133400262200,6570,6700,6890,320,4.87,6880,310,4.72,6660,6890,1400-8-18,2021-11-09
10,نوري,پتروشيمي نوري,12936,8205527,1053641038810,127850,129000,126500,-1350,-1.06,128410,560,0.44,126000,131000,1400-8-18,2021-11-09
11,فولاد,فولاد مباركه اصفهان,10873,67165074,806501814590,11940,12030,11940,0,0,12010,70,0.59,11880,12200,1400-8-18,2021-11-09
12,فسبزوار,پارس فولاد سبزوار,10759,6876656,243626879120,35260,35100,35300,40,0.11,35430,170,0.48,35100,35720,1400-8-18,2021-11-09
13,فجهان,مجتمع جهان فولاد سيرجان,10675,38107872,227211820013,5966,5900,5970,4,0.07,5962,-4,-0.07,5865,6049,1400-8-18,2021-11-09
14,توسن,توسعه سامانه ي نرم افزاري نگين,9755,10927417,181818504277,17404,17030,16534,-870,-5,16639,-765,-4.4,16534,17280,1400-8-18,2021-11-09
15,خپارس,پارس‌ خودرو,9553,473049314,531691584130,1170,1128,1112,-58,-4.96,1124,-46,-3.93,1112,1160,1400-8-18,2021-11-09
16,خگستر,گسترش‌سرمايه‌گذاري‌ايران‌خودرو,9197,271041829,638229651334,2390,2385,2310,-80,-3.35,2355,-35,-1.46,2284,2456,1400-8-18,2021-11-09
17,شتران,پالايش نفت تهران,9049,162358256,788823076973,4638,4620,4869,231,4.98,4859,221,4.76,4620,4869,1400-8-18,2021-11-09
18,بركتح,ح . گروه دارويي بركت,9027,22027075,473437175410,21190,21490,21350,160,0.76,21490,300,1.42,20550,22500,1400-8-18,2021-11-09
19,خبهمن,گروه‌بهمن‌,8856,396076027,722672959927,1899,1826,1805,-94,-4.95,1825,-74,-3.9,1805,1895,1400-8-18,2021-11-09
20,فملي,ملي‌ صنايع‌ مس‌ ايران‌,8784,51170795,705588962360,13540,13720,13660,120,0.89,13790,250,1.85,13590,14000,1400-8-18,2021-11-09
21,تپكو,توليدتجهيزات‌سنگين‌هپكو,7732,201221408,689475929836,3451,3348,3554,103,2.98,3426,-25,-0.72,3348,3554,1400-8-18,2021-11-09
22,كيمياتك,آريان كيميا تك,7444,2613492,68286762670,26190,26000,25800,-390,-1.49,26130,-60,-0.23,25560,26910,1400-8-18,2021-11-09
23,مديريت,س. و خدمات مديريت صند. ب كشوري,7406,9297085,89865443659,9736,9700,9602,-134,-1.38,9666,-70,-0.72,9450,9890,1400-8-18,2021-11-09
24,آريا,پليمر آريا ساسول,6799,2895792,353961776166,118276,118239,121400,3124,2.64,122233,3957,3.35,118239,123800,1400-8-18,2021-11-09
25,وخارزم,سرمايه گذاري خوارزمي,6797,105724768,528609232002,4805,4798,5041,236,4.91,5000,195,4.06,4690,5045,1400-8-18,2021-11-09
26,كمند,صندوق س. با درآمد ثابت كمند,6497,254864051,2552810940531,10011,10016,10016,5,0.05,10016,5,0.05,10016,10018,1400-8-18,2021-11-09
27,بوعلي,پتروشيمي بوعلي سينا,6462,4433750,359688641330,78640,79710,81240,2600,3.31,81130,2490,3.17,79000,82570,1400-8-18,2021-11-09
28,كدما,معدني‌ دماوند,6207,3323130,299216431000,90690,91130,89350,-1340,-1.48,90040,-650,-0.72,88160,92990,1400-8-18,2021-11-09
29,امين,تامين سرمايه امين,5657,7188089,86195132970,11990,11990,12020,30,0.25,11990,0,0,11700,12040,1400-8-18,2021-11-09
30,وتجارت,بانك تجارت,5322,143047286,292027512127,2049,2000,2016,-33,-1.61,2041,-8,-0.39,2000,2097,1400-8-18,2021-11-09
31,كرمان,س. توسعه و عمران استان كرمان,5161,163655347,169567082766,1040,1024,1043,3,0.29,1036,-4,-0.38,1019,1063,1400-8-18,2021-11-09
32,فردا,صندوق س آواي فرداي زاگرس-ثابت,5087,251845171,2964952079738,11766,11772,11773,7,0.06,11773,7,0.06,11772,11775,1400-8-18,2021-11-09
33,زاگرس,پتروشيمي زاگرس,4970,3447989,982299406582,271860,272299,285453,13593,5,284891,13031,4.79,272299,285453,1400-8-18,2021-11-09
34,وسديد,گروه ‌صنعتي‌سديد,4940,86310423,85899604352,1021,1005,993,-28,-2.74,995,-26,-2.55,991,1032,1400-8-18,2021-11-09
35,لپارس,پارس‌ الكتريك‌,4804,3292591,341118106050,108710,104580,103280,-5430,-4.99,103600,-5110,-4.7,103280,107000,1400-8-18,2021-11-09
36,سحرخيز,صندوق س. گروه زعفران سحرخيز,4779,12261732,213856416156,16933,18620,16798,-135,-0.8,17441,508,3,16500,18620,1400-8-18,2021-11-09
37,غزر,صنعتي زر ماكارون,4775,6461120,65868267080,10400,10190,10080,-320,-3.08,10190,-210,-2.02,10000,10490,1400-8-18,2021-11-09
38,گدنا,تهيه توزيع غذاي دنا آفرين فدك,4704,2572537,37961906889,14732,14596,14610,-122,-0.83,14757,25,0.17,14200,15144,1400-8-18,2021-11-09
39,سپيدار,سپيدار سيستم آسيا,4533,607102,11298835936,18380,18120,18703,323,1.76,18555,175,0.95,18120,18870,1400-8-18,2021-11-09
40,شاروم,پتروشيمي اروميه,4409,3150844,46593816825,14229,14514,14940,711,5,14788,559,3.93,14305,14940,1400-8-18,2021-11-09
41,ولقمان,سرمايه گذاري لقمان,4400,19905792,75074904108,3642,3507,3824,182,5,3772,130,3.57,3470,3824,1400-8-18,2021-11-09
42,سپيد,سپيد ماكيان,4393,2087708,116248043560,54950,54970,56000,1050,1.91,55680,730,1.33,54970,56700,1400-8-18,2021-11-09
43,وغدير,سرمايه‌گذاري‌غدير(هلدينگ‌,4099,27371442,438852716800,15510,15600,15610,100,0.64,16030,520,3.35,15500,16280,1400-8-18,2021-11-09
44,غگيلا,شيرپاستوريزه پگاه گيلان,3987,4175125,72067042372,17066,16800,17550,484,2.84,17261,195,1.14,16450,17600,1400-8-18,2021-11-09
45,وهامون,سرمايه گذاري هامون صبا,3937,6793248,20394352202,3026,2962,2975,-51,-1.69,3002,-24,-0.79,2953,3072,1400-8-18,2021-11-09
46,وبصادر,بانك صادرات ايران,3916,103878036,202143642906,1953,1955,1913,-40,-2.05,1946,-7,-0.36,1910,2000,1400-8-18,2021-11-09
47,خزر,فنرسازي‌زر,3771,16567622,208524173360,12820,13430,12320,-500,-3.9,12590,-230,-1.79,12180,13440,1400-8-18,2021-11-09
48,كيان,صندوق س. با درآمد ثابت كيان,3693,46514414,1463839100004,31454,31470,31472,18,0.06,31471,17,0.05,31468,31472,1400-8-18,2021-11-09
49,شاراك,پتروشيمي شازند,3608,11794585,593213455330,48040,48900,50440,2400,5,50300,2260,4.7,48390,50440,1400-8-18,2021-11-09
50,ضخود1052,اختيارخ خودرو-2000-1400/10/08,3530,156152,33886972000,211,200,222,11,5.21,217,6,2.84,181,250,1400-8-18,2021-11-09
51,خمهرح,ح . مهركام‌پارس‌,3515,58966708,50433948272,924,890,832,-92,-9.96,855,-69,-7.47,832,900,1400-8-18,2021-11-09
52,كاما,باما,3453,24756495,212859306480,8500,8490,8550,50,0.59,8600,100,1.18,8370,8800,1400-8-18,2021-11-09
53,خنصير,مهندسي‌نصيرماشين‌,3437,16604805,376730491420,21700,22200,22780,1080,4.98,22690,990,4.56,22000,22780,1400-8-18,2021-11-09
54,زملارد,كشاورزي و دامپروري ملارد شير,3433,613228,14209037967,22550,23440,23040,490,2.17,23060,510,2.26,22798,23606,1400-8-18,2021-11-09
55,سمگا,گروه سرمايه گذاري ميراث فرهنگي,3424,79478446,864348005905,10366,10884,10884,518,5,10875,509,4.91,10637,10884,1400-8-18,2021-11-09
56,ديران,ايران‌دارو,3389,11309152,257496992460,23900,22710,22750,-1150,-4.81,22770,-1130,-4.73,22710,23290,1400-8-18,2021-11-09
57,ذوب,سهامي ذوب آهن  اصفهان,3364,42045540,168151397732,3990,3963,3947,-43,-1.08,3999,9,0.23,3927,4099,1400-8-18,2021-11-09
58,ثشاهد,سرمايه‌ گذاري‌ شاهد,3343,20078474,254557876640,12230,11900,12540,310,2.53,12680,450,3.68,11900,12840,1400-8-18,2021-11-09
59,ضخود1053,اختيارخ خودرو-2500-1400/10/08,3323,159177,8062636000,56,55,48,-8,-14.29,51,-5,-8.93,41,60,1400-8-18,2021-11-09
60,خزاميا,زامياد,3270,41946524,283470966690,7060,6870,6710,-350,-4.96,6760,-300,-4.25,6710,7030,1400-8-18,2021-11-09
61,شگويا,پتروشيمي تندگويان,3260,12473224,146060998368,11582,11600,11585,3,0.03,11710,128,1.11,11500,11960,1400-8-18,2021-11-09
62,ثبهساز,بهساز كاشانه تهران,3222,17014383,29460481096,1748,1710,1724,-24,-1.37,1732,-16,-0.92,1710,1770,1400-8-18,2021-11-09
63,فارس,صنايع پتروشيمي خليج فارس,3220,22028665,273565154280,12490,12480,12250,-240,-1.92,12420,-70,-0.56,12220,12670,1400-8-18,2021-11-09
64,ثاميد,توسعه و عمران اميد,3197,21838517,32209142626,1484,1485,1478,-6,-0.4,1475,-9,-0.61,1442,1507,1400-8-18,2021-11-09
65,ولكار,ليزينگ كارآفرين,3135,3047739,12741796779,4200,4124,4153,-47,-1.12,4183,-17,-0.4,4124,4274,1400-8-18,2021-11-09
66,چخزر,صنايع چوب خزر كاسپين,3059,178494,5046675600,28342,27600,27891,-451,-1.59,28319,-23,-0.08,27500,29080,1400-8-18,2021-11-09
67,شبريز,پالايش نفت تبريز,3005,13172163,471167173830,34150,33900,35850,1700,4.98,35770,1620,4.74,33900,35850,1400-8-18,2021-11-09
68,ولپارس,ليزينگ پارسيان,3000,4289465,17379333671,4169,4130,4017,-152,-3.65,4052,-117,-2.81,4000,4164,1400-8-18,2021-11-09
69,آبادا,توليد نيروي برق آبادان,2971,1402319,19271526320,13920,13900,13820,-100,-0.72,13740,-180,-1.29,13460,14270,1400-8-18,2021-11-09
70,وسپهر,سرمايه گذاري مالي سپهرصادرات,2962,9409414,66460074357,7118,7062,7063,-55,-0.77,7075,-43,-0.6,7060,7100,1400-8-18,2021-11-09
71,وكبهمن,مديريت سرمايه گذاري كوثربهمن,2922,857377,9025576273,10612,10569,10476,-136,-1.28,10562,-50,-0.47,10411,10800,1400-8-18,2021-11-09
72,كزغال,زغال سنگ پروده طبس,2889,2392844,78531057724,33190,33000,32580,-610,-1.84,32819,-371,-1.12,31531,33760,1400-8-18,2021-11-09
73,بپيوند,برق و انرژي پيوندگستر پارس,2841,1837463,19236785583,10635,10465,10389,-246,-2.31,10469,-166,-1.56,10250,10850,1400-8-18,2021-11-09
74,ختور,رادياتور ايران‌,2839,15305041,262895119180,16480,16010,17300,820,4.98,17180,700,4.25,16010,17300,1400-8-18,2021-11-09
75,ومدير,گ.مديريت ارزش سرمايه ص ب كشوري,2779,8131877,36404134785,4479,4412,4435,-44,-0.98,4477,-2,-0.04,4410,4538,1400-8-18,2021-11-09
76,غكورش,صنعت غذايي كورش,2749,1391145,66153055130,47410,46510,47500,90,0.19,47550,140,0.3,46270,48600,1400-8-18,2021-11-09
77,لطيف,محصولات كاغذي لطيف,2725,347584,13378739053,38126,38100,38120,-6,-0.02,38445,319,0.84,36620,39430,1400-8-18,2021-11-09
78,فگستر,گسترش صنايع روي ايرانيان,2715,1948113,17874887042,9245,9001,9141,-104,-1.12,9175,-70,-0.76,9000,9399,1400-8-18,2021-11-09
79,پترول,گ.س.وت.ص.پتروشيمي خليج فارس,2711,27801154,91535174629,3284,3263,3262,-22,-0.67,3292,8,0.24,3225,3383,1400-8-18,2021-11-09
80,خبنيان,بنيان ديزل,2684,192109,31911229082,170872,165746,165746,-5126,-3,166110,-4762,-2.79,165746,169574,1400-8-18,2021-11-09
81,خصدرا,صنعتي‌ دريايي‌ ايران‌,2608,56485079,144859446430,2608,2539,2542,-66,-2.53,2565,-43,-1.65,2530,2650,1400-8-18,2021-11-09
82,تسه0007,امتيازتسهيلات مسكن مهر1400,2557,116895,86794569134,742438,730000,755000,12562,1.69,742500,62,0.01,724001,756888,1400-8-18,2021-11-09
83,امين يكم,صندوق درآمد ثابت امين يكم فردا,2541,75208806,759185054595,10088,10095,10096,8,0.08,10094,6,0.06,10087,10097,1400-8-18,2021-11-09
84,اتكاي,بيمه اتكايي ايرانيان,2529,32109921,372498892531,11097,11290,11650,553,4.98,11601,504,4.54,11200,11651,1400-8-18,2021-11-09
85,بگيلان,توسعه مسير برق گيلان,2509,693565,10795276216,15632,15200,15550,-82,-0.52,15605,-27,-0.17,15000,15999,1400-8-18,2021-11-09
86,اعتماد,صندوق س.اعتماد آفرين پارسيان-د,2492,58050540,2314283517590,39844,39865,39870,26,0.07,39867,23,0.06,39865,39870,1400-8-18,2021-11-09
87,فتوسا,توليد و توسعه سرب روي ايرانيان,2470,1466328,16252319528,11127,10907,10880,-247,-2.22,11084,-43,-0.39,10860,11330,1400-8-18,2021-11-09
88,وحافظ,بيمه حافظ,2457,18975659,186479366626,10278,9765,9765,-513,-4.99,9827,-451,-4.39,9765,10166,1400-8-18,2021-11-09
89,سيتا,سرمايه گذاري سيمان تامين,2414,2326817,23884233200,10310,10000,10140,-170,-1.65,10290,-20,-0.19,10000,10480,1400-8-18,2021-11-09
90,امينح,ح . تامين سرمايه امين,2405,11639366,107045835600,9000,9000,9200,200,2.22,9200,200,2.22,8900,9200,1400-8-18,2021-11-09
91,غدام,خوراك‌  دام‌ پارس‌,2399,1374240,170726739800,119260,123000,122500,3240,2.72,124230,4970,4.17,119270,125220,1400-8-18,2021-11-09
92,پارند,صندوق س. پارند پايدار سپهر,2340,97509556,976871858697,10013,10019,10018,5,0.05,10018,5,0.05,10018,10020,1400-8-18,2021-11-09
93,هاي وب,داده گسترعصرنوين-هاي وب,2334,21524207,186034436330,8620,8410,8630,10,0.12,8640,20,0.23,8360,8830,1400-8-18,2021-11-09
94,ختوقا,قطعات‌ اتومبيل‌ ايران‌,2329,65437428,142097305484,2245,2250,2142,-103,-4.59,2171,-74,-3.3,2133,2289,1400-8-18,2021-11-09
95,كوير,توليدي فولاد سپيد فراب كوير,2299,14515805,189020040920,13010,13130,13040,30,0.23,13020,10,0.08,12950,13220,1400-8-18,2021-11-09
96,سمايه,بانك سرمايه,2291,25287825,166317175527,6396,6587,6587,191,2.99,6577,181,2.83,6430,6587,1400-8-18,2021-11-09
97,رافزا,رايان هم افزا,2233,270748,18085154156,63617,66797,66797,3180,5,66797,3180,5,66797,66797,1400-8-18,2021-11-09
98,شصدف,صنعتي دوده فام,2210,2214246,68486516013,30320,30085,30930,610,2.01,30930,610,2.01,30060,31500,1400-8-18,2021-11-09
99,حكشتي,كشتيراني جمهوري اسلامي ايران,2179,12542767,172813929410,13760,13480,13700,-60,-0.44,13780,20,0.15,13410,14150,1400-8-18,2021-11-09
100,لكما,كارخانجات‌مخابراتي‌ايران‌,2168,53850248,57576992038,1096,1070,1070,-26,-2.37,1069,-27,-2.46,1064,1091,1400-8-18,2021-11-09
101,سرو,صندوق س سروسودمند مدبران-سهام,2142,3084189,236111452710,75310,75500,76500,1190,1.58,76560,1250,1.66,75500,77490,1400-8-18,2021-11-09
102,خمحركه,نيرو محركه‌,2090,32444767,116026658458,3725,3680,3539,-186,-4.99,3576,-149,-4,3539,3723,1400-8-18,2021-11-09
103,فردا2,صندوق س آواي فرداي زاگرس-ثابت,2085,208500000,208500000,11766,1,1,-11765,-99.99,1,-11765,-99.99,1,1,1400-8-18,2021-11-09
104,شغدير,پتروشيمي غدير,2050,1784597,178866040300,98820,98820,99790,970,0.98,100230,1410,1.43,98820,102990,1400-8-18,2021-11-09
105,اپال,فرآوري معدني اپال كاني پارس,2041,4461889,97038325260,21400,21300,22020,620,2.9,21680,280,1.31,21100,22100,1400-8-18,2021-11-09
106,شبصير,توليدات پتروشيمي قائد بصير,2032,2115521,275297998268,124454,126000,130000,5546,4.46,130132,5678,4.56,126000,130676,1400-8-18,2021-11-09
107,شپديس,پتروشيمي پرديس,2027,2068497,411800772040,193770,195900,198900,5130,2.65,199080,5310,2.74,194510,200580,1400-8-18,2021-11-09
108,ثفارس,عمران‌وتوسعه‌فارس‌,1997,19969179,171877929340,8850,8600,8500,-350,-3.95,8610,-240,-2.71,8490,9000,1400-8-18,2021-11-09
109,شسپا,نفت سپاهان,1966,48441946,182849181788,3604,3611,3784,180,4.99,3775,171,4.74,3611,3784,1400-8-18,2021-11-09
110,بكاب,صنايع‌جوشكاب‌يزد,1941,1062941,126598776510,124940,122700,118700,-6240,-4.99,119100,-5840,-4.67,118700,124490,1400-8-18,2021-11-09
111,وملي,گروه‌ صنعتي‌ ملي‌ (هلدينگ‌,1939,657465,118934203440,179720,179600,179300,-420,-0.23,180900,1180,0.66,174450,185690,1400-8-18,2021-11-09
112,فاسمين,كالسيمين‌,1915,13483364,236763703030,16770,16980,17600,830,4.95,17560,790,4.71,16510,17600,1400-8-18,2021-11-09
113,چكاپا,گروه صنايع كاغذ پارس,1898,29373641,89166301878,2992,2989,3040,48,1.6,3036,44,1.47,2930,3120,1400-8-18,2021-11-09
114,وسكرمان,س.سهام عدالت استان كرمان,1890,138480404,63804197319,442,444,464,22,4.98,461,19,4.3,440,464,1400-8-18,2021-11-09
115,پيزد,مجتمع صنايع لاستيك يزد,1877,176532,9904759979,56691,56200,55280,-1411,-2.49,56330,-361,-0.64,55155,57700,1400-8-18,2021-11-09
116,ماديرا,صنايع ماديران,1876,9845683,65046414454,6829,6726,6509,-320,-4.69,6607,-222,-3.25,6488,6969,1400-8-18,2021-11-09
117,خاذين,سايپاآذين‌,1857,39965380,114439932310,2805,2897,2881,76,2.71,2863,58,2.07,2711,2945,1400-8-18,2021-11-09
118,غگل,گلوكوزان‌,1833,24855347,85280555753,3404,3313,3410,6,0.18,3431,27,0.79,3313,3520,1400-8-18,2021-11-09
119,افران,صندوق س افرا نماد پايدار-ثابت,1818,60979968,896026214584,14686,14693,14693,7,0.05,14694,8,0.05,14693,14696,1400-8-18,2021-11-09
120,وپويا,سرمايه گذاري پويا,1814,2948087,12082616142,4116,4011,4044,-72,-1.75,4102,-14,-0.34,4011,4221,1400-8-18,2021-11-09
121,كماسه,تامين‌ ماسه‌ ريخته‌گري‌,1803,20555276,114775617300,5640,5670,5500,-140,-2.48,5580,-60,-1.06,5420,5730,1400-8-18,2021-11-09
122,وصنعت,سرمايه گذاري توسعه صنعت وتجارت,1794,17079462,117282361190,7030,7000,6940,-90,-1.28,6870,-160,-2.28,6720,7100,1400-8-18,2021-11-09
123,شپلي,پلي اكريل ايران,1788,13540208,107656938140,7785,7870,8017,232,2.98,7951,166,2.13,7684,8018,1400-8-18,2021-11-09
124,ملت,بيمه ملت,1781,67386412,81803436934,1262,1225,1215,-47,-3.72,1214,-48,-3.8,1200,1259,1400-8-18,2021-11-09
125,بپاس,بيمه پاسارگاد,1761,5719618,260056815210,45358,46180,45500,142,0.31,45468,110,0.24,45001,46180,1400-8-18,2021-11-09
126,خكمك,كمك‌فنرايندامين‌,1756,6818153,161439596430,24670,23990,23830,-840,-3.4,23680,-990,-4.01,23440,24470,1400-8-18,2021-11-09
127,آگاس,صندوق س.هستي بخش آگاه-س,1726,1915129,159845164388,82585,83197,83295,710,0.86,83464,879,1.06,82666,84290,1400-8-18,2021-11-09
128,وساپا,سرمايه‌گذاري‌ سايپا,1726,26919800,124814067027,4822,4700,4584,-238,-4.94,4637,-185,-3.84,4581,4820,1400-8-18,2021-11-09
129,حسير,ريل سير كوثر,1714,3886160,142322575355,38109,36204,36204,-1905,-5,36623,-1486,-3.9,36204,38670,1400-8-18,2021-11-09
130,بترانس,ايران‌ ترانسفو,1695,38392614,85628130349,2257,2260,2200,-57,-2.53,2230,-27,-1.2,2187,2299,1400-8-18,2021-11-09
131,وايران,ليزينگ ايرانيان,1682,17526073,73147238445,4356,4170,4139,-217,-4.98,4174,-182,-4.18,4139,4350,1400-8-18,2021-11-09
132,دزهراوي,داروسازي‌زهراوي‌,1670,15131684,88110634283,5609,5889,5889,280,4.99,5823,214,3.82,5513,5889,1400-8-18,2021-11-09
133,وپارس,بانك‌پارسيان‌,1668,52513608,117356099936,2263,2240,2208,-55,-2.43,2236,-27,-1.19,2203,2280,1400-8-18,2021-11-09
134,قتربت,قند تربت حيدريه,1666,263918,13879510214,51805,51838,53358,1553,3,52590,785,1.52,50706,53359,1400-8-18,2021-11-09
135,پارسان,گسترش نفت و گاز پارسيان,1649,9176670,322633883990,33620,33020,34850,1230,3.66,35160,1540,4.58,33000,35300,1400-8-18,2021-11-09
136,وگستر,گسترش سرمايه گذاري ايرانيان,1636,8052666,60022610014,7576,7247,7400,-176,-2.32,7454,-122,-1.61,7247,7750,1400-8-18,2021-11-09
137,بكام,كارخانجات توليدي شهيد قندي,1633,24582423,47250297546,1998,1990,1910,-88,-4.4,1922,-76,-3.8,1899,2030,1400-8-18,2021-11-09
138,تاپيكو,س. نفت و گاز و پتروشيمي تأمين,1618,9803203,144178942890,14400,14400,14650,250,1.74,14710,310,2.15,14240,14870,1400-8-18,2021-11-09
139,خفنر,فنرسازي‌خاور,1610,7967428,68088954400,8760,8800,8350,-410,-4.68,8550,-210,-2.4,8330,8980,1400-8-18,2021-11-09
140,غصينو,صنعتي مينو,1584,5820236,123096754962,20223,21000,21234,1011,5,21150,927,4.58,20631,21234,1400-8-18,2021-11-09
141,ومعادن,توسعه‌معادن‌وفلزات‌,1562,6614344,71326192620,10740,10800,10740,0,0,10760,20,0.19,10660,10990,1400-8-18,2021-11-09
142,حفاري,حفاري شمال,1557,14993246,67581588404,4452,4371,4450,-2,-0.04,4507,55,1.24,4371,4590,1400-8-18,2021-11-09
143,شاوان,پالايش نفت لاوان,1555,3042623,424234535091,132999,134600,139489,6490,4.88,139431,6432,4.84,132720,139648,1400-8-18,2021-11-09
144,تسه0006,امتيازتسهيلات مسكن شهريور1400,1547,47836,35740603547,742875,740002,746000,3125,0.42,747149,4274,0.58,740002,758984,1400-8-18,2021-11-09
145,ثتران,سرمايه گذاري مسكن تهران,1546,15640965,69496924893,4486,4440,4350,-136,-3.03,4443,-43,-0.96,4282,4591,1400-8-18,2021-11-09
146,كگل,معدني و صنعتي گل گهر,1542,10166063,244847874390,23940,23910,23800,-140,-0.58,24080,140,0.58,23650,24200,1400-8-18,2021-11-09
147,خموتورح,ح . موتورسازان‌تراكتورسازي‌,1532,8674705,44084745494,5963,5500,4950,-1013,-16.99,5082,-881,-14.77,4950,5500,1400-8-18,2021-11-09
148,ورنا,سرمايه‌گذاري‌ رنا(هلدينگ‌,1528,26537329,82911699070,3241,3340,3079,-162,-5,3124,-117,-3.61,3079,3340,1400-8-18,2021-11-09
149,كچاد,معدني‌وصنعتي‌چادرملو,1506,4253788,130829345030,30020,30600,30500,480,1.6,30760,740,2.47,30000,31080,1400-8-18,2021-11-09
150,فاراك,ماشين‌ سازي‌ اراك‌,1462,36580912,60090100146,1664,1631,1640,-24,-1.44,1643,-21,-1.26,1610,1686,1400-8-18,2021-11-09
151,تكشا,گسترش‌صنايع‌وخدمات‌كشاورزي‌,1456,2197192,74016698200,33280,32160,34720,1440,4.33,33690,410,1.23,31620,34930,1400-8-18,2021-11-09
152,وهنر,گروه توسعه هنر ايران,1413,12078615,40039993015,3264,3300,3278,14,0.43,3315,51,1.56,3225,3361,1400-8-18,2021-11-09
153,كلر,كلر پارس,1413,771072,86501714543,116124,115000,110318,-5806,-5,112184,-3940,-3.39,110318,116800,1400-8-18,2021-11-09
154,خرينگ,رينگ‌سازي‌مشهد,1387,2420907,71003128710,30450,29740,28930,-1520,-4.99,29330,-1120,-3.68,28930,30840,1400-8-18,2021-11-09
155,نهال,صندوق س. طلاي سرخ نوويرا,1361,4609618,73652134474,15497,15899,16160,663,4.28,15978,481,3.1,15550,16230,1400-8-18,2021-11-09
156,وسكرشا,س.سهام عدالت استان كرمانشاه,1345,96739818,46022590175,458,453,480,22,4.8,476,18,3.93,453,480,1400-8-18,2021-11-09
157,خمهر,مهركام‌پارس‌,1343,37288843,68806730334,1923,1841,1827,-96,-4.99,1845,-78,-4.06,1827,1940,1400-8-18,2021-11-09
158,آپ,آسان پرداخت پرشين,1336,6379271,67047462170,10390,10220,10500,110,1.06,10510,120,1.15,10210,10800,1400-8-18,2021-11-09
159,آ س پ,آ.س.پ,1312,9703719,70005231923,7398,7135,7353,-45,-0.61,7214,-184,-2.49,7029,7767,1400-8-18,2021-11-09
160,سيمرغ,سيمرغ,1298,4778246,110614893750,23250,23000,23120,-130,-0.56,23150,-100,-0.43,22630,23750,1400-8-18,2021-11-09
161,فروي,ذوب روي اصفهان,1291,1716145,40738722338,23593,24100,23560,-33,-0.14,23739,146,0.62,23154,24148,1400-8-18,2021-11-09
162,فجر,فولاد اميركبيركاشان,1287,2920110,75213590660,26020,25400,25750,-270,-1.04,25760,-260,-1,25400,26500,1400-8-18,2021-11-09
163,گشان,توسعه بين المللي پديده شانديز,1276,2690317,50872339137,18980,18985,18850,-130,-0.68,18909,-71,-0.37,18702,19300,1400-8-18,2021-11-09
164,فسرب,ملي‌ سرب‌وروي‌ ايران‌,1275,958345,60668172280,65140,65280,63260,-1880,-2.89,63310,-1830,-2.81,61890,66000,1400-8-18,2021-11-09
165,وبانك,سرمايه گذاري گروه توسعه ملي,1272,13065953,117288789950,8760,8650,9000,240,2.74,8980,220,2.51,8650,9080,1400-8-18,2021-11-09
166,خموتور,موتورسازان‌تراكتورسازي‌ايران‌,1252,8747188,59033215180,6940,7180,6600,-340,-4.9,6750,-190,-2.74,6600,7180,1400-8-18,2021-11-09
167,زماهان,مجتمع توليد گوشت مرغ ماهان,1235,8224811,59320842983,7440,7370,7068,-372,-5,7212,-228,-3.06,7068,7780,1400-8-18,2021-11-09
168,زقيام,كشت و دام قيام اصفهان,1220,25062872,43659330107,1758,1770,1725,-33,-1.88,1742,-16,-0.91,1681,1820,1400-8-18,2021-11-09
169,ونوين,بانك‌اقتصادنوين‌,1217,25415941,88044696963,3526,3490,3409,-117,-3.32,3464,-62,-1.76,3400,3575,1400-8-18,2021-11-09
170,هرمز,فولاد هرمزگان جنوب,1200,5354675,95443865569,17796,17641,17600,-196,-1.1,17818,22,0.12,17554,18053,1400-8-18,2021-11-09
171,فباهنر,مس‌ شهيدباهنر,1198,1565780,40602403610,26330,26000,25610,-720,-2.73,25930,-400,-1.52,25430,27040,1400-8-18,2021-11-09
172,صبا,سرمايه گذاري صبا تامين,1198,6981614,43747058541,6331,6330,6290,-41,-0.65,6306,-25,-0.39,6200,6346,1400-8-18,2021-11-09
173,شپترو,پتروشيمي آبادان,1191,12266644,44347211655,3615,3659,3600,-15,-0.41,3615,0,0,3511,3700,1400-8-18,2021-11-09
174,كرازي,كارخانجات‌توليدي‌شيشه‌رازي‌,1188,32985152,44541806236,1346,1332,1340,-6,-0.45,1350,4,0.3,1316,1390,1400-8-18,2021-11-09
175,شفا,سرمايه گذاري شفادارو,1183,1052012,50871562070,47510,48870,47640,130,0.27,48360,850,1.79,46500,49640,1400-8-18,2021-11-09
176,غويتا,ويتانا,1171,6828290,42036803635,6269,6240,6149,-120,-1.91,6156,-113,-1.8,5970,6420,1400-8-18,2021-11-09
177,ختراك,ريخته‌گري‌ تراكتورسازي‌ ايران‌,1169,9553485,67243583040,6830,7170,6890,60,0.88,7040,210,3.07,6850,7170,1400-8-18,2021-11-09
178,اخابر,مخابرات ايران,1156,11352685,88230620050,7850,7710,7710,-140,-1.78,7800,-50,-0.64,7700,7960,1400-8-18,2021-11-09
179,نطرين,عطرين نخ قم,1155,8905116,81573964765,9136,9020,9251,115,1.26,9160,24,0.26,8860,9400,1400-8-18,2021-11-09
180,دماوند,توليد نيروي برق دماوند,1151,2634655,55880755468,21207,20300,21448,241,1.14,21210,3,0.01,20300,21694,1400-8-18,2021-11-09
181,كاوه,فولاد كاوه جنوب كيش,1130,3724690,60184911910,15930,15550,16140,210,1.32,16070,140,0.88,15550,16570,1400-8-18,2021-11-09
182,غالبر,لبنيات‌ كالبر,1125,7090416,79382275620,11570,11470,11400,-170,-1.47,11200,-370,-3.2,11000,11820,1400-8-18,2021-11-09
183,وسكرد,شركت س استان كردستان,1122,85850353,39802471257,445,437,467,22,4.94,464,19,4.27,432,467,1400-8-18,2021-11-09
184,ثاخت,بين‌المللي‌توسعه‌ساختمان,1107,20777935,42499014895,2036,2048,2031,-5,-0.25,2045,9,0.44,2001,2095,1400-8-18,2021-11-09
185,غمارگ,مارگارين‌,1107,3306125,92801022090,28500,27610,27720,-780,-2.74,28070,-430,-1.51,27530,28990,1400-8-18,2021-11-09
186,غمينو,شركت صنايع غذايي مينو شرق,1106,11171497,54942084275,4703,4551,4938,235,5,4918,215,4.57,4551,4938,1400-8-18,2021-11-09
187,شيران,س. صنايع‌شيميايي‌ايران,1102,3577271,85930372000,23600,23600,24160,560,2.37,23990,390,1.65,22950,24700,1400-8-18,2021-11-09
188,ثنظام,س. ساختماني نظام مهندسي ايران,1100,2192769,55202085913,25697,24927,25420,-277,-1.08,25175,-522,-2.03,24927,25890,1400-8-18,2021-11-09
189,ريشمك,توليد و صادرات ريشمك,1089,1904002,59755683911,30235,31400,30800,565,1.87,31384,1149,3.8,30501,31746,1400-8-18,2021-11-09
190,قرن,پديده شيمي قرن,1086,1202791,31551075340,26890,26950,25770,-1120,-4.17,26230,-660,-2.45,25550,27300,1400-8-18,2021-11-09
191,خراسان,پتروشيمي خراسان,1085,1534948,185986898440,116620,114700,122350,5730,4.91,121170,4550,3.9,114700,122450,1400-8-18,2021-11-09
192,وجامي,سرمايه گذاري جامي,1082,7588641,71514013294,9554,9268,9268,-286,-2.99,9424,-130,-1.36,9268,9839,1400-8-18,2021-11-09
193,كتوكا,توليدي و خدمات صنايع نسوز توكا,1073,4258567,58270528031,13221,12900,13548,327,2.47,13683,462,3.49,12900,13882,1400-8-18,2021-11-09
194,ثعتما,س. ساختماني اعتماد گستر,1065,4955704,149308111444,29413,30295,30295,882,3,30129,716,2.43,29420,30295,1400-8-18,2021-11-09
195,طلا,صندوق س.پشتوانه طلاي لوتوس,1060,1295046,110801206004,85644,86180,85501,-143,-0.17,85558,-86,-0.1,85200,86180,1400-8-18,2021-11-09
196,غسالم,سالمين‌,1054,11783398,34520183652,2935,2868,3002,67,2.28,2930,-5,-0.17,2868,3010,1400-8-18,2021-11-09
197,كفپارس,فرآورده‌هاي‌ نسوز پارس‌,1048,16693438,61370402738,3515,3530,3690,175,4.98,3676,161,4.58,3524,3690,1400-8-18,2021-11-09
198,تاپكيش,تجارت الكترونيك پارسيان كيش,1042,4842516,85433469934,18262,18260,17349,-913,-5,17642,-620,-3.4,17349,18538,1400-8-18,2021-11-09
199,ويسا,سرمايه گذاري ايساتيس پويا,1034,3999872,30094561817,7329,7410,7462,133,1.81,7524,195,2.66,7410,7548,1400-8-18,2021-11-09
200,اطلس,صندوق س.توسعه اندوخته آينده-س,1034,276105,71129254271,255110,257000,257100,1990,0.78,257617,2507,0.98,254410,259001,1400-8-18,2021-11-09
201,ولساپا,ليزينگ رايان‌ سايپا,1032,24442721,64946603736,2652,2602,2640,-12,-0.45,2657,5,0.19,2561,2725,1400-8-18,2021-11-09
202,ونيرو,سرمايه‌گذاري‌نيرو,1030,15036699,35132665666,2272,2329,2369,97,4.27,2336,64,2.82,2312,2377,1400-8-18,2021-11-09
203,فكمند,گسترش قطعه سازي كمند,993,2097774,63565880319,30615,31495,31000,385,1.26,30302,-313,-1.02,29697,31533,1400-8-18,2021-11-09
204,تملت,تامين سرمايه بانك ملت,993,6548903,24537329564,3750,3760,3756,6,0.16,3747,-3,-0.08,3681,3819,1400-8-18,2021-11-09
205,فزرين,زرين معدن آسيا,989,5775801,82736359589,13746,13990,14433,687,5,14325,579,4.21,13747,14433,1400-8-18,2021-11-09
206,مدير,ص.س.مديريت ثروت ص.بازنشستگي-س,988,3356696,34284163552,10114,10120,10182,68,0.67,10214,100,0.99,10090,10320,1400-8-18,2021-11-09
207,پتاير,ايران‌ تاير,985,19380292,41182766216,2121,2051,2100,-21,-0.99,2125,4,0.19,2051,2179,1400-8-18,2021-11-09
208,اعتلا,شركت سرمايه گذاري اعتلاء البرز,978,11630687,45967174217,3861,4054,3885,24,0.62,3952,91,2.36,3820,4054,1400-8-18,2021-11-09
209,گكوثر,هتل پارسيان كوثر اصفهان,974,23945908,53880595135,2193,2263,2228,35,1.6,2250,57,2.6,2180,2294,1400-8-18,2021-11-09
210,زكوثر,سرمايه گذاري كشاورزي كوثر,973,2193879,37841941230,17350,17000,17010,-340,-1.96,17250,-100,-0.58,16720,17700,1400-8-18,2021-11-09
211,بجهرم,توسعه مولد نيروگاهي جهرم,965,13251046,29129483802,2202,2160,2179,-23,-1.04,2198,-4,-0.18,2155,2244,1400-8-18,2021-11-09
212,كسعدي,كاشي‌ سعدي‌,956,4761869,44170462340,9630,9980,9190,-440,-4.57,9280,-350,-3.63,9150,9980,1400-8-18,2021-11-09
213,كمرجان,بازرگاني و توليدي مرجان كار,952,602702,37106741223,63803,61660,61980,-1823,-2.86,61567,-2236,-3.5,60900,63700,1400-8-18,2021-11-09
214,دسانكو,داروسازي سبحان انكولوژي,922,5144869,61858179801,12510,12491,11888,-622,-4.97,12023,-487,-3.89,11885,12800,1400-8-18,2021-11-09
215,شبهرن,نفت‌ بهران‌,920,5424390,66912279280,12050,12310,12230,180,1.49,12340,290,2.41,12020,12610,1400-8-18,2021-11-09
216,مرقام,ايران‌ارقام‌,915,8274190,111240784100,12810,13450,13450,640,5,13440,630,4.92,13150,13450,1400-8-18,2021-11-09
217,تبرك,گروه كارخانجات صنعتي تبرك,913,3712658,30890391422,8571,8460,8239,-332,-3.87,8320,-251,-2.93,8143,8660,1400-8-18,2021-11-09
218,شفارس,صنايع‌ شيميايي‌ فارس‌,909,26508739,33868514479,1266,1268,1274,8,0.63,1278,12,0.95,1243,1302,1400-8-18,2021-11-09
219,افق,فروشگاههاي زنجيره اي افق كوروش,902,2357259,106220317960,45300,45900,45400,100,0.22,45060,-240,-0.53,44620,45900,1400-8-18,2021-11-09
220,كرماشا,صنايع پتروشيمي كرمانشاه,901,1933939,103500595570,52030,51700,54200,2170,4.17,53520,1490,2.86,51700,54400,1400-8-18,2021-11-09
221,فروس,فروسيليس‌ ايران‌,900,6759125,49553618750,7310,7230,7360,50,0.68,7330,20,0.27,7190,7500,1400-8-18,2021-11-09
222,خلنت,لنت‌ ترمزايران‌,887,493341,41948910150,89170,84740,84720,-4450,-4.99,85030,-4140,-4.64,84720,87500,1400-8-18,2021-11-09
223,سبزوا,سيمان لار سبزوار,861,9896383,22993214790,2358,2281,2296,-62,-2.63,2323,-35,-1.48,2281,2380,1400-8-18,2021-11-09
224,حريل,ريل پردازسير,847,10124972,31271237811,3129,3080,3050,-79,-2.52,3089,-40,-1.28,3030,3157,1400-8-18,2021-11-09
225,چدن,توليدي چدن سازان,846,12229062,36624100225,2972,3030,3029,57,1.92,2995,23,0.77,2920,3035,1400-8-18,2021-11-09
226,ياقوت,صندوق س ياقوت آگاه-ثابت,841,11672848,157930141253,13520,13531,13530,10,0.07,13530,10,0.07,13525,13551,1400-8-18,2021-11-09
227,فلوله,لوله‌وماشين‌سازي‌ايران‌,839,25200962,26262672501,1041,1046,1053,12,1.15,1042,1,0.1,1011,1060,1400-8-18,2021-11-09
228,خكار,ايركا پارت صنعت,834,9269689,42876584499,4841,4675,4599,-242,-5,4625,-216,-4.46,4599,4799,1400-8-18,2021-11-09
229,ثبات,صندوق س. ثبات ويستا -د,825,40697317,421339560970,10347,10353,10354,7,0.07,10353,6,0.06,10352,10356,1400-8-18,2021-11-09
230,رمپنا,گروه مپنا (سهامي عام),824,2436281,39640841100,16250,16020,16110,-140,-0.86,16260,10,0.06,15760,16810,1400-8-18,2021-11-09
231,قشرين,قند شيرين خراسان,810,8626403,71737191766,7948,8060,8345,397,4.99,8316,368,4.63,7960,8345,1400-8-18,2021-11-09
232,تسه0005,امتيازتسهيلات مسكن مرداد 1400,806,10868,8123781363,742196,730000,741820,-376,-0.05,747495,5299,0.71,730000,772000,1400-8-18,2021-11-09
233,تاصيكو,سرمايه گذاري صدرتامين,796,7532638,71044058500,9420,9560,9380,-40,-0.42,9430,10,0.11,9230,9560,1400-8-18,2021-11-09
234,ولغدر,ليزينگ‌خودروغدير,795,5007713,64379183140,13380,13200,13000,-380,-2.84,12860,-520,-3.89,12720,13500,1400-8-18,2021-11-09
235,وكار,بانك‌ كارآفرين‌,793,20336563,61939682591,2987,3045,3005,18,0.6,3046,59,1.98,2990,3110,1400-8-18,2021-11-09
236,پارس,پتروشيمي پارس,792,740165,141298696730,188880,190810,191400,2520,1.33,190900,2020,1.07,189300,194790,1400-8-18,2021-11-09
237,شجم,صنايع پتروشيمي تخت جمشيد,791,7553231,97269197033,12358,12500,12975,617,4.99,12878,520,4.21,12280,12975,1400-8-18,2021-11-09
238,خكاوه,سايپا ديزل,784,15063616,57610548099,3921,3949,3804,-117,-2.98,3824,-97,-2.47,3804,3949,1400-8-18,2021-11-09
239,سصفها,سيمان‌اصفهان‌,782,751532,22834823300,31180,31460,30220,-960,-3.08,30380,-800,-2.57,29640,31460,1400-8-18,2021-11-09
240,بشهاب,لامپ‌  پارس‌ شهاب‌,781,411307,52497093120,127830,122700,130340,2510,1.96,127630,-200,-0.16,122700,131770,1400-8-18,2021-11-09
241,خشرق,الكتريك‌ خودرو شرق‌,774,2712402,41381675320,15880,15140,15090,-790,-4.97,15260,-620,-3.9,15090,15880,1400-8-18,2021-11-09
242,فولاي,صنايع فولاد آلياژي يزد,771,2083271,37143183926,18019,17746,17522,-497,-2.76,17829,-190,-1.05,17410,18500,1400-8-18,2021-11-09
243,ونيكي,سرمايه‌گذاري‌ ملي‌ايران‌,766,5284547,55959751180,10420,10300,10550,130,1.25,10550,130,1.25,10220,10790,1400-8-18,2021-11-09
244,كبافق,معادن‌ بافق‌,765,717488,23807098470,33080,32940,32600,-480,-1.45,33180,100,0.3,32000,34100,1400-8-18,2021-11-09
245,وسكاب,س.ص.بازنشستگي كاركنان بانكها,761,12661128,41691067021,3232,3200,3337,105,3.25,3293,61,1.89,3200,3389,1400-8-18,2021-11-09
246,فنفتح,ح . صنايع تجهيزات نفت,757,3054644,28652711386,9670,9380,9380,-290,-3,9380,-290,-3,9380,9449,1400-8-18,2021-11-09
247,ارزش,صندوق س ارزش آفرين بيدار-سهام,755,3521365,35367638430,10040,10010,10020,-20,-0.2,10040,0,0,9910,10220,1400-8-18,2021-11-09
248,شفارا,پتروشيمي فارابي,754,6304675,55850570317,8634,8800,8893,259,3,8859,225,2.61,8400,8893,1400-8-18,2021-11-09
249,حبندر,دريايي و کشتيراني خط دريابندر,749,3555290,119951850318,32821,33240,33805,984,3,33739,918,2.8,31910,33805,1400-8-18,2021-11-09
250,غشصفا,شيرپاستوريزه‌پگاه‌اصفهان‌,749,1737114,62411968970,35080,36680,35520,440,1.25,35930,850,2.42,35060,36700,1400-8-18,2021-11-09
251,غپينو,پارس‌ مينو,745,6032303,20534656866,3349,3420,3390,41,1.22,3404,55,1.64,3333,3480,1400-8-18,2021-11-09
252,زبينا,كشاورزي و دامپروري بينالود,743,10508460,24015800740,2291,2250,2300,9,0.39,2285,-6,-0.26,2181,2404,1400-8-18,2021-11-09
253,تسه0004,امتيازتسهيلات مسكن تير1400,742,24797,18499458067,741012,742000,741000,-12,0,746036,5024,0.68,740000,755000,1400-8-18,2021-11-09
254,فمراد,آلومراد,731,1807533,31358054190,18020,18470,17180,-840,-4.66,17350,-670,-3.72,17120,18470,1400-8-18,2021-11-09
255,ودي,بيمه  دي,731,9269753,53881423696,5862,5651,5750,-112,-1.91,5813,-49,-0.84,5651,5970,1400-8-18,2021-11-09
256,وتوصا,گروه س توسعه صنعتي ايران,730,4474759,44603672850,9770,9650,10000,230,2.35,9970,200,2.05,9650,10050,1400-8-18,2021-11-09
257,فسپا,گروه‌صنعتي‌سپاهان‌,727,2469099,44511428530,17840,17700,18000,160,0.9,18030,190,1.07,17690,18340,1400-8-18,2021-11-09
258,وسين,بيمه سينا,725,18669993,67550121348,3577,3620,3684,107,2.99,3618,41,1.15,3540,3684,1400-8-18,2021-11-09
259,ضسپا8041,اختيارخ خساپا-1600-1400/08/26,721,31522,5030516000,187,137,145,-42,-22.46,160,-27,-14.44,124,198,1400-8-18,2021-11-09
260,شراز,پالايش نفت شيراز,707,711503,86619735037,116368,119843,121729,5361,4.61,121742,5374,4.62,118900,122186,1400-8-18,2021-11-09
261,ضسپا8042,اختيارخ خساپا-1800-1400/08/26,706,39561,1555539000,58,50,33,-25,-43.1,39,-19,-32.76,30,62,1400-8-18,2021-11-09
262,وسينا,بانك سينا,704,25393236,58049370128,2303,2320,2294,-9,-0.39,2286,-17,-0.74,2221,2355,1400-8-18,2021-11-09
263,غاذر,كشت‌وصنعت‌پياذر,704,1605336,45636378420,27270,27940,28630,1360,4.99,28430,1160,4.25,26950,28630,1400-8-18,2021-11-09
264,شلعاب,لعابيران‌,702,7838329,48033408760,5840,6130,6130,290,4.97,6130,290,4.97,6090,6130,1400-8-18,2021-11-09
265,كفرآور,فرآورده هاي سيمان شرق,701,3578038,62515640655,17194,17650,17709,515,3,17472,278,1.62,16850,17709,1400-8-18,2021-11-09
266,دتوليد,داروسازي توليد دارو,695,2183778,21294107998,9844,9800,9601,-243,-2.47,9751,-93,-0.94,9500,10095,1400-8-18,2021-11-09
267,نوين,بيمه نوين,689,8294637,33744423384,3937,3969,4133,196,4.98,4068,131,3.33,3818,4133,1400-8-18,2021-11-09
268,كاذر,فرآورده‌هاي‌نسوزآذر,688,3117051,43703677050,13490,14150,14000,510,3.78,14020,530,3.93,13490,14160,1400-8-18,2021-11-09
269,غشهداب,كشت و صنعت شهداب ناب خراسان,685,8590547,24341169463,2800,2864,2822,22,0.79,2833,33,1.18,2780,2865,1400-8-18,2021-11-09
270,غديس,پاكديس,682,2765821,33013126296,11649,11600,12000,351,3.01,11936,287,2.46,11531,12203,1400-8-18,2021-11-09
271,وسپه,سرمايه‌گذاري‌ سپه‌,675,5578817,48300795690,8490,8640,8590,100,1.18,8660,170,2,8410,8790,1400-8-18,2021-11-09
272,ساوه,سيمان ساوه,675,144045,7024674803,49493,47735,49130,-363,-0.73,49161,-332,-0.67,47735,50779,1400-8-18,2021-11-09
273,ولشرق,ليزينگ ايران و شرق,674,6493345,29761861497,4799,4799,4560,-239,-4.98,4583,-216,-4.5,4560,4799,1400-8-18,2021-11-09
274,وپاسار,بانك  پاسارگاد,672,17627373,239463056730,13590,13600,13600,10,0.07,13580,-10,-0.07,13500,13640,1400-8-18,2021-11-09
275,ثرود,سرمايه‌گذاري مسكن زاينده رود,662,2503147,20225498619,8222,8219,7998,-224,-2.72,8080,-142,-1.73,7889,8346,1400-8-18,2021-11-09
276,وتوكا,سرمايه‌گذاري‌توكافولاد(هلدينگ,660,5221587,45883653850,8590,8640,8790,200,2.33,8790,200,2.33,8610,9000,1400-8-18,2021-11-09
277,بكهنوج,توليد برق ماهتاب كهنوج,655,20435259,24206357391,1198,1201,1185,-13,-1.09,1185,-13,-1.09,1150,1220,1400-8-18,2021-11-09
278,حشكوه,دليجان طلايي شكوه پارس,651,23974502,79883345962,3242,3339,3339,97,2.99,3332,90,2.78,3250,3339,1400-8-18,2021-11-09
279,فايرا,آلومينيوم‌ايران‌,649,2473802,42686194760,17490,17690,17140,-350,-2,17340,-150,-0.86,17120,17690,1400-8-18,2021-11-09
280,قنيشا,قند  نيشابور,648,652379,27338686800,42450,43000,40650,-1800,-4.24,41910,-540,-1.27,40410,43000,1400-8-18,2021-11-09
281,حآسا,آسيا سير ارس,648,2057862,25706767515,12605,12280,12250,-355,-2.82,12492,-113,-0.9,12020,12970,1400-8-18,2021-11-09
282,غگلستا,شير پاستوريزه پگاه گلستان,642,2099857,28478718452,13242,13700,13404,162,1.22,13562,320,2.42,12910,13800,1400-8-18,2021-11-09
283,پدرخش,درخشان‌ تهران‌,641,1347931,26761444460,20280,19700,19820,-460,-2.27,19850,-430,-2.12,19400,20500,1400-8-18,2021-11-09
284,شخارك,پتروشيمي‌ خارك‌,640,864568,48539996410,55070,54330,56000,930,1.69,55580,510,0.93,54330,57000,1400-8-18,2021-11-09
285,وحكمت,بيمه حكمت صبا,634,8047576,35195804009,4249,4360,4376,127,2.99,4373,124,2.92,4305,4376,1400-8-18,2021-11-09
286,سفاسي,شركت فارسيت اهواز,625,4339887,18172839688,4237,4351,4110,-127,-3,4187,-50,-1.18,4110,4351,1400-8-18,2021-11-09
287,ستران,سيمان‌ تهران‌,620,1748787,38385748590,21750,22470,22140,390,1.79,21950,200,0.92,21140,22470,1400-8-18,2021-11-09
288,خاهن,آهنگري‌ تراكتورسازي‌ ايران‌,620,6675834,34764013320,5240,5210,5210,-30,-0.57,5210,-30,-0.57,5180,5350,1400-8-18,2021-11-09
289,دلقما,دارويي‌ لقمان‌,618,1303861,35324340170,26960,26300,26500,-460,-1.71,27090,130,0.48,26000,27900,1400-8-18,2021-11-09
290,وشهر,بانك شهر,616,6138281,30717664304,5147,5060,5000,-147,-2.86,5006,-141,-2.74,4942,5130,1400-8-18,2021-11-09
291,كپشير,پشم‌شيشه‌ايران‌,616,1761570,21114148580,12180,11810,11850,-330,-2.71,11990,-190,-1.56,11600,12430,1400-8-18,2021-11-09
292,حپترو,حمل و نقل پتروشيمي( سهامي عام,610,1274267,32761281210,24640,24640,25870,1230,4.99,25710,1070,4.34,24640,25870,1400-8-18,2021-11-09
293,هماي,صندوق س هماي آگاه-ثابت,610,10193679,103028076535,10102,10108,10108,6,0.06,10107,5,0.05,10099,10109,1400-8-18,2021-11-09
294,وپست,پست بانك ايران,608,1534387,33295291100,21980,22140,21980,0,0,21700,-280,-1.27,21260,22140,1400-8-18,2021-11-09
295,ومعلم,بيمه معلم,607,5473646,13707493210,2477,2461,2480,3,0.12,2502,25,1.01,2400,2559,1400-8-18,2021-11-09
296,كيميا,معدني كيمياي زنجان گستران,606,3484607,50615227542,14241,14031,14680,439,3.08,14525,284,1.99,14031,14848,1400-8-18,2021-11-09
297,فپنتا,سپنتا,602,81322,38680219430,492890,495970,468250,-24640,-5,475640,-17250,-3.5,468250,501500,1400-8-18,2021-11-09
298,فجام,جام‌دارو,601,6520063,31787772867,4678,4740,4911,233,4.98,4875,197,4.21,4610,4911,1400-8-18,2021-11-09
299,ونفت,سرمايه‌گذاري‌ صنعت‌ نفت‌,594,4055910,61365180510,14900,14800,15210,310,2.08,15130,230,1.54,14800,15390,1400-8-18,2021-11-09
300,شيراز,پتروشيمي‌شيراز,593,1109051,94490071300,82810,84490,86460,3650,4.41,84910,2100,2.54,83930,86460,1400-8-18,2021-11-09
301,آريان,سرمايه گذاري پارس آريان,588,7827841,134796616131,17125,17000,17399,274,1.6,17220,95,0.55,17000,17448,1400-8-18,2021-11-09
302,تكمبا,كمباين‌ سازي‌ ايران‌,584,4353718,20021816522,4690,4760,4475,-215,-4.58,4599,-91,-1.94,4456,4768,1400-8-18,2021-11-09
303,دامين,داروسازي‌ امين‌,584,6206931,17422065342,2874,2801,2783,-91,-3.17,2807,-67,-2.33,2732,2948,1400-8-18,2021-11-09
304,سفارس,سيمان فارس و خوزستان,582,3492104,63499487110,17740,18040,18160,420,2.37,18180,440,2.48,17710,18430,1400-8-18,2021-11-09
305,كسرا,سراميك‌هاي‌صنعتي‌اردكان‌,581,3530237,56019705500,15590,15710,15720,130,0.83,15870,280,1.8,15120,16210,1400-8-18,2021-11-09
306,زشريف,كشت وصنعت شريف آباد,580,7175805,23807776253,3356,3388,3256,-100,-2.98,3318,-38,-1.13,3255,3408,1400-8-18,2021-11-09
307,ثاباد,توريستي ورفاهي آبادگران ايران,576,1360661,52166203230,37310,35580,38930,1620,4.34,38340,1030,2.76,35580,39100,1400-8-18,2021-11-09
308,شكام,صنايع شيميايي كيمياگران امروز,576,1133347,34702019649,30360,29190,30100,-260,-0.86,30619,259,0.85,29190,31650,1400-8-18,2021-11-09
309,دتوزيع,توزيع دارو پخش,566,1331484,38058313115,28611,28200,27400,-1211,-4.23,28583,-28,-0.1,27400,28987,1400-8-18,2021-11-09
310,توريل,توكاريل,565,2894372,32464494783,11433,11889,11200,-233,-2.04,11216,-217,-1.9,10862,11889,1400-8-18,2021-11-09
311,خپويش,سازه‌ پويش‌,565,452600,40730289600,88110,92510,88550,440,0.5,89990,1880,2.13,87780,92510,1400-8-18,2021-11-09
312,رانفور,خدمات‌انفورماتيك‌,563,6656287,29647114265,4451,4374,4411,-40,-0.9,4452,1,0.02,4374,4530,1400-8-18,2021-11-09
313,سرچشمه,سرمايه گذاري مس سرچشمه,562,5827963,34704583612,5743,5800,5900,157,2.73,5955,212,3.69,5750,6030,1400-8-18,2021-11-09
314,وآذر,سرمايه‌گذاري‌توسعه‌آذربايجان‌,561,581487,21488522130,38170,37200,37100,-1070,-2.8,36950,-1220,-3.2,36330,38150,1400-8-18,2021-11-09
315,رتاپ,تجارت الكترونيك  پارسيان,560,1818302,10249505010,5650,5470,5680,30,0.53,5640,-10,-0.18,5470,5700,1400-8-18,2021-11-09
316,البرز,بيمه البرز,559,11483301,25126104428,2209,2128,2177,-32,-1.45,2188,-21,-0.95,2127,2230,1400-8-18,2021-11-09
317,وسگيلا,شركت س استان گيلان,559,51553355,23892294193,445,440,467,22,4.94,461,16,3.6,431,467,1400-8-18,2021-11-09
318,كنور,توسعه معدني و صنعتي صبانور,555,1896439,35747063720,18680,18280,19130,450,2.41,18740,60,0.32,18280,19240,1400-8-18,2021-11-09
319,وساخت,سرمايه‌ گذاري‌ ساختمان‌ايران‌,554,558736,21943369900,39690,39000,39500,-190,-0.48,39270,-420,-1.06,38890,39990,1400-8-18,2021-11-09
320,كساوه,صنايع‌ كاشي‌ و سراميك‌ سينا,554,841148,34514412460,42040,40400,41500,-540,-1.28,41030,-1010,-2.4,40050,43390,1400-8-18,2021-11-09
321,دانا,بيمه دانا,553,5998048,28286747861,4688,4600,4700,12,0.26,4716,28,0.6,4600,4889,1400-8-18,2021-11-09
322,سدبير,س. تدبيرگران فارس وخوزستان,552,1429688,53553641053,35758,36800,37545,1787,5,37458,1700,4.75,36161,37545,1400-8-18,2021-11-09
323,پكوير,كوير تاير,549,4277710,29787100730,7080,6900,7000,-80,-1.13,6960,-120,-1.69,6800,7110,1400-8-18,2021-11-09
324,سخاش,سيمان‌خاش‌,536,222067,21022490790,95020,96600,93270,-1750,-1.84,94670,-350,-0.37,93200,97930,1400-8-18,2021-11-09
325,فنورد,نوردوقطعات‌ فولادي‌,535,158604,33757308890,214330,216000,211550,-2780,-1.3,212840,-1490,-0.7,210000,218500,1400-8-18,2021-11-09
326,خكرمان,گروه اقتصادي كرمان خودرو,533,11011790,29672824216,2730,2700,2680,-50,-1.83,2695,-35,-1.28,2649,2760,1400-8-18,2021-11-09
327,بالبر,كابل‌ البرز,528,821482,20068753040,25140,24720,24000,-1140,-4.53,24430,-710,-2.82,23920,25670,1400-8-18,2021-11-09
328,قچار,فراوردههاي غذايي وقند چهارمحال,522,4392085,45484802961,10711,10310,10176,-535,-4.99,10356,-355,-3.31,10176,10900,1400-8-18,2021-11-09
329,وساغربي,شركت س استان آذربايجان غربي,521,37081870,16885595729,443,452,465,22,4.97,450,7,1.58,421,465,1400-8-18,2021-11-09
330,وساشرقي,شركت س استان آذربايجان شرقي,520,36761893,17081957009,451,435,473,22,4.88,457,6,1.33,435,473,1400-8-18,2021-11-09
331,كروي,توسعه‌ معادن‌ روي‌ ايران‌,519,1314973,32438839100,24160,24750,24510,350,1.45,24670,510,2.11,23510,25100,1400-8-18,2021-11-09
332,دلر,داروسازي‌ اكسير,518,865356,38973767930,44040,45080,44800,760,1.73,45040,1000,2.27,43010,46190,1400-8-18,2021-11-09
333,قشكر,شكرشاهرود,511,6224100,18904141469,3102,3170,2983,-119,-3.84,3037,-65,-2.1,2980,3170,1400-8-18,2021-11-09
334,كترام,توليدي‌ كاشي‌ تكسرام‌,507,1614135,31983459180,19300,19240,19710,410,2.12,19810,510,2.64,18520,20230,1400-8-18,2021-11-09
335,كحافظ,كاشي‌ وسراميك‌ حافظ‌,506,4595497,16232527716,3481,3557,3654,173,4.97,3532,51,1.47,3445,3655,1400-8-18,2021-11-09
336,اتكامح,ح . بيمه اتكايي امين,504,4268485,8534745989,1969,1925,2043,74,3.76,1999,30,1.52,1925,2043,1400-8-18,2021-11-09
337,ارفع,شركت آهن و فولاد ارفع,502,1977370,30613701686,15475,15460,15550,75,0.48,15478,3,0.02,15100,15970,1400-8-18,2021-11-09
338,پخش,پخش البرز,501,1187744,33547739641,27804,27550,28804,1000,3.6,28245,441,1.59,26670,29100,1400-8-18,2021-11-09
339,ميهن,بيمه ميهن,494,6688465,14644634536,2236,2227,2190,-46,-2.06,2191,-45,-2.01,2150,2280,1400-8-18,2021-11-09
340,غبهار,كشت وصنعت بهاران گلبهار خراسان,494,2017559,29676750101,14032,14698,14733,701,5,14709,677,4.82,14040,14733,1400-8-18,2021-11-09
341,جم,پتروشيمي جم,492,2977304,142848852530,47040,48100,48440,1400,2.98,47980,940,2,47020,48870,1400-8-18,2021-11-09
342,مفاخر,توسعه فناوري اطلاعات خوارزمي,492,526752,14709637455,29203,27770,27760,-1443,-4.94,27925,-1278,-4.38,27743,29201,1400-8-18,2021-11-09
343,چكارن,كارتن‌ ايران‌,490,7796747,21962357908,2803,2770,2804,1,0.04,2817,14,0.5,2770,2880,1400-8-18,2021-11-09
344,فلامي,لاميران‌,489,1655343,31309225970,18070,18900,18970,900,4.98,18910,840,4.65,18220,18970,1400-8-18,2021-11-09
345,وهور,مديريت انرژي اميد  تابان هور,487,10923168,15497441532,1408,1389,1435,27,1.92,1412,4,0.28,1389,1460,1400-8-18,2021-11-09
346,زكشت,كشاورزي مكانيزه اصفهان كشت,487,1525354,31163515251,19556,19670,20533,977,5,20430,874,4.47,19670,20533,1400-8-18,2021-11-09
347,كلوند,كاشي‌ الوند,486,1179313,26984803080,22540,21820,22860,320,1.42,22880,340,1.51,21820,23110,1400-8-18,2021-11-09
348,واعتبار,سرمايه گذاري اعتبار ايران,486,3560486,24124465520,7090,6860,6800,-290,-4.09,6780,-310,-4.37,6740,7100,1400-8-18,2021-11-09
349,تليسه,دامداري تليسه نمونه,485,5241537,12907171200,2457,2552,2478,21,0.85,2462,5,0.2,2385,2552,1400-8-18,2021-11-09
350,تنوين,تامين سرمايه نوين,484,5265311,28279687120,5370,5410,5370,0,0,5370,0,0,5300,5490,1400-8-18,2021-11-09
351,خوساز,محورسازان‌ايران‌خودرو,483,2663771,19631011400,7690,7600,7310,-380,-4.94,7370,-320,-4.16,7310,7700,1400-8-18,2021-11-09
352,همراه,شركت ارتباطات سيار ايران,478,1745668,14877433590,8580,8470,8480,-100,-1.17,8570,-10,-0.12,8460,8630,1400-8-18,2021-11-09
353,تسه0003,امتيازتسهيلات مسكن خرداد1400,477,8045,6008317915,743156,740000,750000,6844,0.92,746839,3683,0.5,731000,760000,1400-8-18,2021-11-09
354,تسه9908,امتياز تسهيلات مسكن آبان99,476,9335,6965758317,740331,730000,752800,12469,1.68,746198,5867,0.79,730000,763000,1400-8-18,2021-11-09
355,قاسم,قاسم ايران,475,4286050,14906399870,3497,3450,3469,-28,-0.8,3478,-19,-0.54,3425,3599,1400-8-18,2021-11-09
356,سپيدما,صندوق س. سپيد دماوند-د,473,23149387,262541206696,11336,11341,11342,6,0.05,11341,5,0.04,11340,11342,1400-8-18,2021-11-09
357,وسنا,سرمايه گذاري نيروگاهي ايران,470,2203239,29320828378,12991,13380,13060,69,0.53,13308,317,2.44,13000,13380,1400-8-18,2021-11-09
358,پاكشو,گروه صنعتي پاكشو,468,7316785,39322007630,5390,5390,5400,10,0.19,5380,-10,-0.19,5310,5460,1400-8-18,2021-11-09
359,دروز,داروسازي‌ روزدارو,463,934197,28326834640,31670,32000,30090,-1580,-4.99,30320,-1350,-4.26,30090,32000,1400-8-18,2021-11-09
360,وپسا,س. پتروشيمي ساختمان  خليج فارس,461,6590132,12158955538,1884,1928,1840,-44,-2.34,1845,-39,-2.07,1828,1928,1400-8-18,2021-11-09
361,آسيا,بيمه آسيا,461,8380240,15076301552,1792,1760,1786,-6,-0.33,1798,6,0.33,1760,1830,1400-8-18,2021-11-09
362,حتوكا,حمل‌ونقل‌توكا,459,1221519,15808751180,12680,12500,13020,340,2.68,12940,260,2.05,12100,13280,1400-8-18,2021-11-09
363,فافق,صنايع مس افق كرمان,456,23522202,90701610912,3744,3856,3856,112,2.99,3856,112,2.99,3856,3856,1400-8-18,2021-11-09
364,ثپرديس,سرمايه گذاري مسكن پرديس,456,4094488,20942658512,5226,5067,4965,-261,-4.99,5115,-111,-2.12,4965,5330,1400-8-18,2021-11-09
365,كسرام,پارس‌ سرام‌,455,5110394,19452021628,3880,3940,3868,-12,-0.31,3806,-74,-1.91,3744,3940,1400-8-18,2021-11-09
366,زدشت,كشت و صنعت دشت خرم دره,455,852425,12465285140,14909,14488,14300,-609,-4.08,14683,-226,-1.52,14200,15100,1400-8-18,2021-11-09
367,شرنگي,شيميايي رنگين,453,133847,19759978367,146909,150000,151316,4407,3,147631,722,0.49,142502,151316,1400-8-18,2021-11-09
368,ولصنم,ليزينگ‌صنعت‌ومعدن‌,448,2985720,13742119236,4610,4455,4650,40,0.87,4603,-7,-0.15,4455,4750,1400-8-18,2021-11-09
369,خمحور,توليدمحورخودرو,441,7540536,18265034637,2500,2520,2375,-125,-5,2422,-78,-3.12,2375,2570,1400-8-18,2021-11-09
370,فرآور,فرآوري‌موادمعدني‌ايران‌,441,989048,27757999430,27740,27000,27960,220,0.79,28070,330,1.19,27000,28820,1400-8-18,2021-11-09
371,اوان,مبين وان كيش,440,1295108,32437301331,26015,26300,24715,-1300,-5,25046,-969,-3.72,24715,26360,1400-8-18,2021-11-09
372,سغرب,سيمان‌غرب‌,439,737983,11943152490,16430,16370,16000,-430,-2.62,16230,-200,-1.22,15930,16500,1400-8-18,2021-11-09
373,بالاس,مهندسي ساختمان تاسيسات راه آهن,438,430617,14163840866,33537,32500,32260,-1277,-3.81,32934,-603,-1.8,32000,34790,1400-8-18,2021-11-09
374,ثنوسا,نوسازي‌وساختمان‌تهران‌,437,11082104,69373971040,5970,6260,6260,290,4.86,6260,290,4.86,6260,6260,1400-8-18,2021-11-09
375,ضشنا1050,اختيارخ شپنا-7629-1400/10/19,434,18834,11090405000,444,539,594,150,33.78,589,145,32.66,520,690,1400-8-18,2021-11-09
376,ولانا,شركت ليزينگ آريا دانا,433,1000161,14724715213,15162,14760,14708,-454,-2.99,14722,-440,-2.9,14708,15180,1400-8-18,2021-11-09
377,اميد,تامين سرمايه اميد,433,3472996,25500320450,7330,7400,7340,10,0.14,7340,10,0.14,7330,7450,1400-8-18,2021-11-09
378,وصنا,گروه‌صنايع‌بهشهرايران‌,432,2260118,14576371490,6480,6600,6410,-70,-1.08,6450,-30,-0.46,6340,6600,1400-8-18,2021-11-09
379,فولاژ,فولاد آلياژي ايران,430,2036722,33190870740,16170,15690,16520,350,2.16,16220,50,0.31,15690,16590,1400-8-18,2021-11-09
380,ضخود1049,اختيارخ خودرو-1400-1400/10/08,426,14722,10393081000,680,670,692,12,1.76,706,26,3.82,610,750,1400-8-18,2021-11-09
381,دبالك,مواد اوليه دارويي البرز بالك,425,2468375,22029183082,8970,9000,8800,-170,-1.9,8925,-45,-0.5,8661,9250,1400-8-18,2021-11-09
382,سشرق,سيمان‌ شرق‌,423,2734752,21712597590,7990,8190,8000,10,0.13,7940,-50,-0.63,7780,8190,1400-8-18,2021-11-09
383,جم پيلن,پلي پروپيلن جم - جم پيلن,423,543926,62785573280,113880,114210,115500,1620,1.42,114930,1050,0.92,114210,116500,1400-8-18,2021-11-09
384,غپآذر,شير پگاه آذربايجان شرقي,421,631366,20021259934,33022,32200,31700,-1322,-4,31711,-1311,-3.97,31371,33200,1400-8-18,2021-11-09
385,شپارس,بين‌ المللي‌ محصولات‌  پارس‌,420,2320258,18521353310,7900,8000,7900,0,0,7980,80,1.01,7850,8100,1400-8-18,2021-11-09
386,خچرخش,چرخشگر,419,1977667,16435797330,8600,8800,8170,-430,-5,8310,-290,-3.37,8170,8800,1400-8-18,2021-11-09
387,سدور,سيمان‌ دورود,414,4122425,28673826690,6850,6900,6870,20,0.29,6960,110,1.61,6820,7090,1400-8-18,2021-11-09
388,چكاوه,صنايع‌كاغذسازي‌كاوه‌,414,939257,10057530540,10930,10710,10750,-180,-1.65,10780,-150,-1.37,10460,11150,1400-8-18,2021-11-09
389,نيرو,نيرو سرمايه,412,941620,36553971052,39876,39037,38701,-1175,-2.95,38820,-1056,-2.65,38680,40190,1400-8-18,2021-11-09
390,خريخت,صنايع‌ريخته‌گري‌ايران‌,410,9891912,38456302746,3954,3840,3930,-24,-0.61,3888,-66,-1.67,3822,3969,1400-8-18,2021-11-09
391,شكربن,كربن‌ ايران‌,408,199641,20567715010,105500,104860,101150,-4350,-4.12,103020,-2480,-2.35,100500,106960,1400-8-18,2021-11-09
392,وتعاون,بيمه  تعاون,408,10144280,18368551278,1783,1747,1836,53,2.97,1811,28,1.57,1730,1836,1400-8-18,2021-11-09
393,بزاگرس,نيروگاه زاگرس كوثر,408,3012259,12386440979,4064,4190,4050,-14,-0.34,4100,36,0.89,3980,4265,1400-8-18,2021-11-09
394,خبازرس,بازرسي مهندسي و صنعتي ايران,405,631645,14241439516,22760,22601,22546,-214,-0.94,22547,-213,-0.94,22078,23180,1400-8-18,2021-11-09
395,سبهان,سيمان‌ بهبهان‌,402,222896,11040608560,50260,50350,49060,-1200,-2.39,49740,-520,-1.03,48500,50380,1400-8-18,2021-11-09
396,بنيرو,نيروترانس‌,401,12048997,24042022114,1915,1891,2010,95,4.96,1995,80,4.18,1891,2010,1400-8-18,2021-11-09
397,ساروم,سيمان‌اروميه‌,400,534672,20607651610,39210,38800,38160,-1050,-2.68,38540,-670,-1.71,38060,39890,1400-8-18,2021-11-09
398,زفكا,كشت و دامداري فكا,399,2296613,18313626959,7809,7998,7989,180,2.31,7974,165,2.11,7851,8078,1400-8-18,2021-11-09
399,ميدكو,توسعه معادن وص.معدني خاورميانه,399,3724012,173868916220,46680,46680,46680,0,0,46690,10,0.02,46650,46980,1400-8-18,2021-11-09
400,ولراز,ليزينگ رازي,398,329205,7219823175,22471,21851,21806,-665,-2.96,21931,-540,-2.4,21797,22400,1400-8-18,2021-11-09
401,خاتم,صندوق س خاتم ايساتيس پويا-ثابت,394,17280613,212102257170,12268,12274,12275,7,0.06,12274,6,0.05,12273,12275,1400-8-18,2021-11-09
402,وتوسم,سرمايه‌گذاري‌توسعه‌ملي‌,394,1984136,16856151120,8380,8350,8540,160,1.91,8500,120,1.43,8350,8600,1400-8-18,2021-11-09
403,چفيبر,فيبر ايران‌,394,2513185,14289517730,5650,5470,5650,0,0,5690,40,0.71,5470,5850,1400-8-18,2021-11-09
404,غگرجي,بيسكويت‌  گرجي‌,392,3801201,8393638536,2252,2180,2212,-40,-1.78,2227,-25,-1.11,2180,2270,1400-8-18,2021-11-09
405,رنيك,جنرال مكانيك,391,793946,10492631496,13482,13304,12900,-582,-4.32,13311,-171,-1.27,12900,13520,1400-8-18,2021-11-09
406,تصميم,صندوق س با درآمد ثابت تصميم,391,11234638,201112888625,17897,17908,17909,12,0.07,17901,4,0.02,17900,17910,1400-8-18,2021-11-09
407,كطبس,ذغال‌سنگ‌ نگين‌ ط‌بس‌,390,226314,11854884110,52840,51320,51650,-1190,-2.25,52500,-340,-0.64,51120,53970,1400-8-18,2021-11-09
408,تايرا,تراكتورسازي‌ايران‌,389,1029509,23427783030,23550,23600,22500,-1050,-4.46,22910,-640,-2.72,22380,23790,1400-8-18,2021-11-09
409,شنفت,نفت‌ پارس‌,386,5611378,46801985580,7960,8140,8350,390,4.9,8280,320,4.02,7880,8350,1400-8-18,2021-11-09
410,تسه0002,امتيازتسهيلاتمسكن ارديبهشت1400,386,5559,4151869594,739357,730000,748000,8643,1.17,746873,7516,1.02,730000,760000,1400-8-18,2021-11-09
411,وآوا,سرمايه گذاري آوا نوين,386,3181721,9781284655,3109,3033,3091,-18,-0.58,3086,-23,-0.74,3033,3170,1400-8-18,2021-11-09
412,سكه0012پ01,تمام سكه طرح جديد0012رفاه,385,102900,123344580900,1202178,1200300,1205694,3516,0.29,1198684,-3494,-0.29,1194202,1206977,1400-8-18,2021-11-09
413,كمنگنز,معادن‌منگنزايران‌,385,443271,29972502930,67440,67600,66980,-460,-0.68,67620,180,0.27,66100,68760,1400-8-18,2021-11-09
414,سپاها,سيمان‌سپاهان‌,384,2381645,21073554120,8700,8720,8980,280,3.22,8850,150,1.72,8700,9080,1400-8-18,2021-11-09
415,كگهر,سنگ آهن گهرزمين,383,1058538,52351205558,47103,49458,49458,2355,5,48057,954,2.03,48995,49458,1400-8-18,2021-11-09
416,فنوال,نورد آلومينيوم‌,383,622647,14972803320,23490,23820,24050,560,2.38,24050,560,2.38,23490,24400,1400-8-18,2021-11-09
417,بنو,بيمه تجارت نو,382,1484789,13242134153,9100,8800,8776,-324,-3.56,8988,-112,-1.23,8700,9147,1400-8-18,2021-11-09
418,پاسا,ايران‌ياساتايرورابر,379,1021271,15131834590,15040,15300,14660,-380,-2.53,14820,-220,-1.46,14400,15300,1400-8-18,2021-11-09
419,سپر,صندوق س سپر سرمايه بيدار- ثابت,379,10016370,131294106114,13104,13109,13111,7,0.05,13108,4,0.03,13105,13120,1400-8-18,2021-11-09
420,تسه0001,امتيازتسهيلات مسكن فروردين1400,375,5241,3926871152,741852,733200,744500,2648,0.36,749260,7408,1,733200,760000,1400-8-18,2021-11-09
421,تسه9912,امتياز تسهيلات مسكن اسفند99,374,6131,4579537782,742674,721010,710000,-32674,-4.4,746948,4274,0.58,710000,759900,1400-8-18,2021-11-09
422,تپمپي,پمپ‌ سازي‌ ايران‌,372,1150620,17880097950,15430,15360,15690,260,1.69,15540,110,0.71,15200,15870,1400-8-18,2021-11-09
423,ثتوسا,س.توسعه و عمران استان اردبيل,367,997610,17904758111,18446,17893,17893,-553,-3,17948,-498,-2.7,17893,18500,1400-8-18,2021-11-09
424,شرانل,نفت ايرانول,366,443005,21542440528,47632,47632,49000,1368,2.87,48184,552,1.16,47005,49200,1400-8-18,2021-11-09
425,تسه9810,امتياز تسهيلات مسكن دي98,364,7578,5632685014,739225,735111,740001,776,0.1,743294,4069,0.55,718111,750000,1400-8-18,2021-11-09
426,ساينا,صنايع بهداشتي ساينا,359,137584,12859393616,97227,94810,93400,-3827,-3.94,93953,-3274,-3.37,92366,97000,1400-8-18,2021-11-09
427,فلات,گروه صنايع معادن فلات ايرانيان,355,1464107,18469433268,12963,12860,12577,-386,-2.98,12615,-348,-2.68,12575,13109,1400-8-18,2021-11-09
428,كساپا,سايپاشيشه‌,354,688106,13314475870,18820,19230,19200,380,2.02,19260,440,2.34,18610,19760,1400-8-18,2021-11-09
429,وثخوز,سرمايه گذاري و توسعه خوزستان,353,1359943,44621079789,34465,33000,32742,-1723,-5,32811,-1654,-4.8,32742,33700,1400-8-18,2021-11-09
430,غشاذر,پگاه‌آذربايجان‌غربي‌,353,3012202,17587758330,5660,5670,5940,280,4.95,5840,180,3.18,5580,5940,1400-8-18,2021-11-09
431,شپاس,نفت پاسارگاد,351,1030934,17932165039,17308,17100,17200,-108,-0.62,17394,86,0.5,16970,17899,1400-8-18,2021-11-09
432,زشگزا,شير و گوشت زاگرس شهركرد,351,2621345,13660479889,5121,4969,5190,69,1.35,5199,78,1.52,4969,5336,1400-8-18,2021-11-09
433,داوه,داروسازي آوه سينا,350,874195,10000070741,11572,11280,11357,-215,-1.86,11484,-88,-0.76,11125,11698,1400-8-18,2021-11-09
434,ثشرق,سرمايه گذاري مسكن شمال شرق,347,4066130,16509599529,3970,3810,4167,197,4.96,4060,90,2.27,3810,4167,1400-8-18,2021-11-09
435,غشهد,شهد ايران ‌,346,2823829,12740442630,4582,4685,4421,-161,-3.51,4527,-55,-1.2,4370,4685,1400-8-18,2021-11-09
436,زنگان,صنعت روي زنگان,346,452975,33478099247,70503,74020,74028,3525,5,73907,3404,4.83,71660,74028,1400-8-18,2021-11-09
437,ثزاگرس,سرمايه گذاري توسعه عمران زاگرس,345,397381,14673345255,37886,38600,35992,-1894,-5,36925,-961,-2.54,35992,39767,1400-8-18,2021-11-09
438,دشيمي,شيمي‌ داروئي‌ داروپخش‌,345,426774,11282720670,26080,26320,26120,40,0.15,26330,250,0.96,26000,27000,1400-8-18,2021-11-09
439,كاردان,صندوق س تجارت شاخصي كاردان,344,87185,18124513580,205270,202060,207560,2290,1.12,207890,2620,1.28,202060,210000,1400-8-18,2021-11-09
440,غبشهر,صنعتي‌ بهشهر,343,636806,16517116050,26440,26490,25860,-580,-2.19,26170,-270,-1.02,25510,26500,1400-8-18,2021-11-09
441,كفرا,فراورده‌ هاي‌ نسوزايران‌,343,776918,14431484720,17800,17610,18380,580,3.26,18490,690,3.88,17610,18690,1400-8-18,2021-11-09
442,خاهنح,ح . آهنگري تراكتورسازي‌ ايران‌,341,2999909,11273051336,3819,3986,3726,-93,-2.44,3758,-61,-1.6,3698,3986,1400-8-18,2021-11-09
443,دكپسول,توليد ژلاتين كپسول ايران,339,459195,14747680737,32283,31801,31760,-523,-1.62,32119,-164,-0.51,31300,32990,1400-8-18,2021-11-09
444,آكورد,صندوق س. آرمان آتي كوثر-د,338,7792246,273539952948,35087,35104,35106,19,0.05,35104,17,0.05,35104,35110,1400-8-18,2021-11-09
445,ثعمرا,عمران و توسعه شاهد,336,1943241,15011315961,7668,7650,7660,-8,-0.1,7724,56,0.73,7504,7990,1400-8-18,2021-11-09
446,تسه9911,امتياز تسهيلات مسكن بهمن99,335,4945,3691265219,742778,721050,743000,222,0.03,746464,3686,0.5,721050,759545,1400-8-18,2021-11-09
447,بهپاك,صنعتي بهپاك,332,2267015,13050896364,5817,5570,5711,-106,-1.82,5769,-48,-0.83,5561,5980,1400-8-18,2021-11-09
448,فاهواز,نورد و لوله اهواز,332,5358384,31550058969,5873,5900,5925,52,0.89,5888,15,0.26,5759,5986,1400-8-18,2021-11-09
449,وتوس,توسعه‌شهري‌توس‌گستر,331,1064701,12008476290,11530,11160,11260,-270,-2.34,11330,-200,-1.73,11000,11700,1400-8-18,2021-11-09
450,ددام,داروسازي زاگرس فارمد پارس,329,992007,10776114590,11170,10840,10990,-180,-1.61,10960,-210,-1.88,10620,11390,1400-8-18,2021-11-09
451,ولتجار,واسپاري تجارت وسرمايه ايرانيان,329,4631151,15226884639,3364,3275,3264,-100,-2.97,3288,-76,-2.26,3264,3436,1400-8-18,2021-11-09
452,سرود,سيمان‌شاهرود,328,1175018,27648122910,22970,22570,23600,630,2.74,23530,560,2.44,21930,24090,1400-8-18,2021-11-09
453,لخزر,پارس‌ خزر,328,92708,12662586730,134920,136340,138000,3080,2.28,136240,1320,0.98,131110,140000,1400-8-18,2021-11-09
454,غپاك,لبنيات‌ پاك‌,327,896717,11928729840,13280,13640,13010,-270,-2.03,13300,20,0.15,12850,13700,1400-8-18,2021-11-09
455,شكلر,نيروكلر,322,987347,32707038610,31630,31880,33210,1580,5,33130,1500,4.74,31880,33210,1400-8-18,2021-11-09
456,واحصا,احياء صنايع خراسان,322,450047,24063760924,54479,52846,53000,-1479,-2.71,53469,-1010,-1.85,52845,55000,1400-8-18,2021-11-09
457,شلرد,كود شيميايي اوره لردگان,319,3193321,34248367725,10413,10725,10725,312,3,10690,277,2.66,10725,10725,1400-8-18,2021-11-09
458,آوا,صندوق س.سهام آواي معيار-س,317,1098961,9086395397,8155,8165,8238,83,1.02,8268,113,1.39,8160,8350,1400-8-18,2021-11-09
459,وسبحان,سرمايه گذاري سبحان,316,3736434,11246305730,2950,2989,3001,51,1.73,2992,42,1.42,2861,3079,1400-8-18,2021-11-09
460,قهكمت,قندهكمتان‌,315,1984354,10528186560,5380,5500,5280,-100,-1.86,5330,-50,-0.93,5230,5590,1400-8-18,2021-11-09
461,پلاسك,پلاسكوكار,315,1845566,8738758727,4734,4860,4740,6,0.13,4735,1,0.02,4630,4860,1400-8-18,2021-11-09
462,لابسا,آبسال‌,315,359935,12105555960,34190,34000,33400,-790,-2.31,33770,-420,-1.23,33000,34400,1400-8-18,2021-11-09
463,كگاز,شيشه‌ و گاز,314,1807153,29003424260,16000,15340,16050,50,0.31,16050,50,0.31,15340,16490,1400-8-18,2021-11-09
464,اپرداز,آتيه داده پرداز,312,1968890,45940391297,23166,22979,23190,24,0.1,23333,167,0.72,22958,23740,1400-8-18,2021-11-09
465,قلرست,قند لرستان‌,312,563595,10530035650,18250,18690,18470,220,1.21,18540,290,1.59,17720,19160,1400-8-18,2021-11-09
466,غفارس,شير پاستوريزه پگاه فارس,311,1343411,9393567785,6978,6752,6992,14,0.2,6987,9,0.13,6752,7146,1400-8-18,2021-11-09
467,لپيام,گسترش صنايع پيام,309,423265,14675799171,34606,35599,35182,576,1.66,34673,67,0.19,33725,35599,1400-8-18,2021-11-09
468,قصفها,قنداصفهان‌,309,92888,8045153720,87290,85010,86160,-1130,-1.29,86930,-360,-0.41,85010,88610,1400-8-18,2021-11-09
469,دكوثر,داروسازي‌ كوثر,309,2250097,7483178788,3356,3231,3260,-96,-2.86,3341,-15,-0.45,3231,3422,1400-8-18,2021-11-09
470,لازما,كارخانه هاي صنعتي آزمايش,307,1040939,27912926727,26168,26950,26953,785,3,26815,647,2.47,26357,26953,1400-8-18,2021-11-09
471,فسازان,غلتك سازان سپاهان,306,487539,12615104690,25790,25140,26010,220,0.85,25860,70,0.27,24810,26300,1400-8-18,2021-11-09
472,تيپيكو,سرمايه گذاري دارويي تامين,304,930452,20347410660,21700,22180,21950,250,1.15,21740,40,0.18,21000,22180,1400-8-18,2021-11-09
473,غگلپا,شير پاستوريزه پگاه گلپايگان,300,222166,11530981373,53487,53200,50900,-2587,-4.84,52206,-1281,-2.39,50900,53200,1400-8-18,2021-11-09
474,كهمدا,شيشه‌ همدان‌,299,1083475,9779059890,9010,8820,8980,-30,-0.33,9020,10,0.11,8820,9210,1400-8-18,2021-11-09
475,غمهرا,توليدي‌مهرام‌,296,250838,11325090120,44910,44910,45170,260,0.58,45080,170,0.38,44120,46430,1400-8-18,2021-11-09
476,درازك,دارويي‌ رازك‌,295,428460,15008726000,36110,34940,35020,-1090,-3.02,35030,-1080,-2.99,34910,36130,1400-8-18,2021-11-09
477,شكبير,پتروشيمي اميركبير,293,395819,39394870039,96842,96850,99729,2887,2.98,97861,1019,1.05,96850,99747,1400-8-18,2021-11-09
478,كشرق,صنعتي و معدني شمال شرق شاهرود,292,483483,35849033060,71366,71989,74934,3568,5,74147,2781,3.9,68201,74934,1400-8-18,2021-11-09
479,وبشهر,توسعه‌ صنايع‌ بهشهر(هلدينگ,291,2129104,28959784120,13620,13490,13680,60,0.44,13610,-10,-0.07,13360,13680,1400-8-18,2021-11-09
480,والبر,سرمايه‌ گذاري‌ البرز(هلدينگ‌,291,1095778,9508885170,8640,8630,8590,-50,-0.58,8650,10,0.12,8480,8890,1400-8-18,2021-11-09
481,بموتو,موتوژن‌,290,445776,34163834040,77560,78960,76000,-1560,-2.01,76640,-920,-1.19,75180,78960,1400-8-18,2021-11-09
482,مبين,مبين انرژي خليج فارس,290,934099,23175947060,24610,25330,24820,210,0.85,24650,40,0.16,24600,25330,1400-8-18,2021-11-09
483,تسه9910,امتياز تسهيلات مسكن دي99,288,4353,3254357917,743044,743100,735000,-8044,-1.08,747613,4569,0.61,735000,756000,1400-8-18,2021-11-09
484,وپترو,سرمايه‌گذاري صنايع پتروشيمي‌,285,1139104,14351742050,12530,12490,12510,-20,-0.16,12600,70,0.56,12410,12880,1400-8-18,2021-11-09
485,پكرمان,گروه‌ صنعتي‌ بارز,285,764147,17474447860,23420,22860,22760,-660,-2.82,23000,-420,-1.79,22730,23300,1400-8-18,2021-11-09
486,درهآور,دارويي ره آورد تامين,285,415441,8637822051,21031,20155,20700,-331,-1.57,20898,-133,-0.63,20152,21765,1400-8-18,2021-11-09
487,دتماد,توليدمواداوليه‌داروپخش‌,283,893329,41317794880,46340,46200,45540,-800,-1.73,46250,-90,-0.19,45510,46800,1400-8-18,2021-11-09
488,وبيمه,سرمايه‌ گذاري‌ صنعت‌ بيمه‌,281,4038144,6493188554,1617,1587,1601,-16,-0.99,1613,-4,-0.25,1587,1649,1400-8-18,2021-11-09
489,قپيرا,فرآورده‌هاي‌غدايي‌وقندپيرانشهر,279,1432785,11635835760,8480,8400,8400,-80,-0.94,8190,-290,-3.42,8060,8400,1400-8-18,2021-11-09
490,كاريس,صندوق س.سپهر كاريزما-س,278,823686,11401556311,13710,13656,13754,44,0.32,13842,132,0.96,13656,13990,1400-8-18,2021-11-09
491,تسه9909,امتياز تسهيلات مسكن آذر99,278,4005,2985904821,741247,721010,731000,-10247,-1.38,745544,4297,0.58,721010,759990,1400-8-18,2021-11-09
492,وبوعلي,سرمايه‌گذاري‌بوعلي‌,278,1398111,5588072374,3954,4010,3981,27,0.68,3969,15,0.38,3905,4080,1400-8-18,2021-11-09
493,شوينده,مديريت صنعت شوينده ت.ص.بهشهر,277,859965,17632664170,20260,20900,20460,200,0.99,20500,240,1.18,20300,20900,1400-8-18,2021-11-09
494,قشهد,شهد,276,2332326,34320617130,14020,14720,14720,700,4.99,14720,700,4.99,14130,14720,1400-8-18,2021-11-09
495,ثغرب,شركت سرمايه گذاري مسكن شمالغرب,275,1949073,7760134511,4006,3866,3987,-19,-0.47,3994,-12,-0.3,3865,4097,1400-8-18,2021-11-09
496,واحيا,م .صنايع و معادن احياء سپاهان,275,372408,55598291004,149421,147000,149110,-311,-0.21,149303,-118,-0.08,147000,152000,1400-8-18,2021-11-09
497,سصوفي,سيمان‌ صوفيان‌,273,755970,12514366700,16160,15890,16680,520,3.22,16470,310,1.92,15890,16880,1400-8-18,2021-11-09
498,حپارسا,توسعه حمل و نقل ريلي پارسيان,272,1302734,46510954452,34036,34376,35737,1701,5,35703,1667,4.9,34376,35737,1400-8-18,2021-11-09
499,ركيش,كارت اعتباري ايران كيش,269,2948186,15649612130,5410,5410,5600,190,3.51,5310,-100,-1.85,5140,5600,1400-8-18,2021-11-09
500,دعبيد,لابراتوارداروسازي‌  دكترعبيدي‌,269,522599,11214874560,21760,20850,21460,-300,-1.38,21670,-90,-0.41,20850,22200,1400-8-18,2021-11-09
501,حآفرين,ريل پرداز نو آفرين,268,10488655,58421808350,5305,5570,5570,265,5,5570,265,5,5570,5570,1400-8-18,2021-11-09
502,سكه0012پ04,تمام سكه طرح جديد0012صادرات,267,66400,79482741800,1192675,1199500,1203799,11124,0.93,1197029,4354,0.37,1187200,1207985,1400-8-18,2021-11-09
503,كامياب,صندوق س. كامياب آشنا-د,266,3551401,38499158196,10837,10847,10842,5,0.05,10841,4,0.04,10838,10847,1400-8-18,2021-11-09
504,سفانو,سيمان فارس نو,265,309209,8069638470,26000,25800,26070,70,0.27,26050,50,0.19,25800,26500,1400-8-18,2021-11-09
505,تابا,تابان نيرو سپاهان,262,410382,12039941534,30054,29200,29153,-901,-3,29338,-716,-2.38,29153,30290,1400-8-18,2021-11-09
506,دفارا,داروسازي‌ فارابي‌,261,728028,10912745280,15180,14530,14760,-420,-2.77,15040,-140,-0.92,14530,15450,1400-8-18,2021-11-09
507,وآرين,شركت توسعه اقتصادي آرين,261,3158347,6898441912,2182,2153,2175,-7,-0.32,2183,1,0.05,2151,2235,1400-8-18,2021-11-09
508,افرا,افرانت,258,387801,6255989383,16236,15815,15850,-386,-2.38,16193,-43,-0.26,15425,16688,1400-8-18,2021-11-09
509,فيروزه,صندوق شاخص30 شركت فيروزه- سهام,255,98636,17802819930,178990,177880,179700,710,0.4,180490,1500,0.84,177880,181590,1400-8-18,2021-11-09
510,واميد,گروه مديريت سرمايه گذاري اميد,254,3446385,44042026120,12650,12660,12800,150,1.19,12700,50,0.4,12650,12900,1400-8-18,2021-11-09
511,وارس,سرمايه گذاري ارس صبا,254,1989484,22626860746,11644,11372,11600,-44,-0.38,11373,-271,-2.33,11295,11644,1400-8-18,2021-11-09
512,دحاوي,الحاوي,254,1774044,8507659071,4857,4986,4712,-145,-2.99,4806,-51,-1.05,4712,4986,1400-8-18,2021-11-09
513,چافست,افست‌,253,666058,6084501410,9000,9330,9100,100,1.11,9050,50,0.56,9020,9330,1400-8-18,2021-11-09
514,بميلا,توسعه بازرگاني آهن وفولادميلاد,253,1630534,14174687300,8867,8997,8647,-220,-2.48,8693,-174,-1.96,8601,8997,1400-8-18,2021-11-09
515,غچين,كشت‌ و صنعت‌ چين‌ چين,249,735539,10221059290,13820,13990,13970,150,1.09,13870,50,0.36,13820,14100,1400-8-18,2021-11-09
516,دابور,داروسازي‌ ابوريحان‌,248,327273,8235853110,25770,25600,24990,-780,-3.03,25430,-340,-1.32,24900,25770,1400-8-18,2021-11-09
517,كارين,صندوق س نگين سامان-ثابت,248,5447479,55006553928,10093,10099,10096,3,0.03,10098,5,0.05,10096,10099,1400-8-18,2021-11-09
518,وگردش,بانك گردشگري,246,3573650,39160056700,10639,10958,10958,319,3,10829,190,1.79,10958,10958,1400-8-18,2021-11-09
519,حسينا,توسعه خدمات دريايي وبندري سينا,245,337802,15212216592,45032,45999,46800,1768,3.93,45033,1,0,44000,46830,1400-8-18,2021-11-09
520,ثمسكن,سرمايه‌گذاري‌ مسكن‌,243,2582807,10742059231,4203,4101,4080,-123,-2.93,4171,-32,-0.76,4055,4300,1400-8-18,2021-11-09
521,دبالكح,ح.مواد اوليه دارويي البرز بالك,243,741744,4698454641,6461,6231,6390,-71,-1.1,6334,-127,-1.97,6138,6600,1400-8-18,2021-11-09
522,زمگسا,كشاورزي‌ ودامپروي‌ مگسال‌,240,483879,8572323100,18040,17900,17800,-240,-1.33,17860,-180,-1,17410,18170,1400-8-18,2021-11-09
523,فسا,پتروشيمي فسا,240,5619976,7128102036,1307,1280,1268,-39,-2.98,1278,-29,-2.22,1268,1290,1400-8-18,2021-11-09
524,دسينا,داروسازي‌ سينا,239,1046528,22211467800,21240,21240,21800,560,2.64,21220,-20,-0.09,20500,21900,1400-8-18,2021-11-09
525,كي بي سي,شركت كي بي سي,238,431306,7540635082,17697,17700,17300,-397,-2.24,17593,-104,-0.59,16850,18200,1400-8-18,2021-11-09
526,تسه9907,امتياز تسهيلات مسكن مهر99,238,6419,4773820413,743525,723299,750000,6475,0.87,743702,177,0.02,723299,759999,1400-8-18,2021-11-09
527,سفار,سيمان‌فارس‌,237,76830,4318520480,57550,56410,56810,-740,-1.29,57180,-370,-0.64,55000,59400,1400-8-18,2021-11-09
528,زعف0008پ10,زعفران0008نگين طلاي سرخ(پ),236,74472,16042897767,222850,211502,212010,-10840,-4.86,215422,-7428,-3.33,211502,222000,1400-8-18,2021-11-09
529,شدوص,دوده‌ صنعتي‌ پارس‌,231,944860,19765997020,20860,20560,21140,280,1.34,20920,60,0.29,19850,21460,1400-8-18,2021-11-09
530,ساربيل,سيمان آرتا اردبيل,230,320528,8303244960,25760,25000,26050,290,1.13,25840,80,0.31,25000,26590,1400-8-18,2021-11-09
531,ضخود1051,اختيارخ خودرو-1800-1400/10/08,229,9585,3278635000,338,270,350,12,3.55,342,4,1.18,270,375,1400-8-18,2021-11-09
532,سمازن,سيمان‌مازندران‌,228,1049341,14667865230,14230,14000,13870,-360,-2.53,13980,-250,-1.76,13810,14350,1400-8-18,2021-11-09
533,وصندوق,سرمايه‌گذاري‌صندوق‌بازنشستگي‌,226,1714694,33121646040,19060,19310,19380,320,1.68,19130,70,0.37,18910,19880,1400-8-18,2021-11-09
534,كاسپين,داروسازي كاسپين تامين,225,364041,9415459528,25596,25090,25580,-16,-0.06,25762,166,0.65,25090,26380,1400-8-18,2021-11-09
535,پسهند,صنايع‌ لاستيكي‌  سهند,225,440699,10371605220,23910,24130,23710,-200,-0.84,23660,-250,-1.05,23100,24200,1400-8-18,2021-11-09
536,كمينا,شيشه سازي مينا,221,862381,8285730287,9607,9747,9550,-57,-0.59,9608,1,0.01,9402,9785,1400-8-18,2021-11-09
537,وخاور,بانك خاورميانه,220,1935530,10465481560,5420,5510,5440,20,0.37,5420,0,0,5310,5510,1400-8-18,2021-11-09
538,تسه9902,امتياز تسهيلات مسكن ارديبهشت99,218,2716,2019312435,739360,740000,715000,-24360,-3.29,743488,4128,0.56,715000,755000,1400-8-18,2021-11-09
539,ضسپا8043,اختيارخ خساپا-2000-1400/08/26,218,10530,157100000,19,4,11,-8,-42.11,15,-4,-21.05,4,30,1400-8-18,2021-11-09
540,هجرت,پخش هجرت,217,542127,16221769054,29250,29250,29900,650,2.22,29922,672,2.3,28017,30480,1400-8-18,2021-11-09
541,پرداخت,به پرداخت ملت,217,507797,6849008530,13660,13700,13610,-50,-0.37,13590,-70,-0.51,13120,13930,1400-8-18,2021-11-09
542,ثباغ,شهر سازي و خانه سازي باغميشه,217,661194,5692576522,8771,8840,8714,-57,-0.65,8709,-62,-0.71,8452,8840,1400-8-18,2021-11-09
543,دالبر,البرزدارو,216,597621,7812417920,13270,12870,12900,-370,-2.79,13170,-100,-0.75,12800,13300,1400-8-18,2021-11-09
544,عيار,صندوق سكه طلاي مفيد,212,363758,11053533249,30532,30700,30510,-22,-0.07,30387,-145,-0.47,30303,30700,1400-8-18,2021-11-09
545,ضخود1050,اختيارخ خودرو-1600-1400/10/08,212,8667,4361410000,502,450,502,0,0,503,1,0.2,441,550,1400-8-18,2021-11-09
546,ولبهمن,شركت بهمن ليزينگ,208,1592355,10745781492,6910,7000,6761,-149,-2.16,6801,-109,-1.58,6572,7000,1400-8-18,2021-11-09
547,كميناح,ح . شيشه سازي مينا,207,1552769,10776758833,7049,6880,6838,-211,-2.99,6940,-109,-1.55,6838,7200,1400-8-18,2021-11-09
548,سپ,پرداخت الكترونيك سامان كيش,206,418973,12467348760,30280,28980,29800,-480,-1.59,30170,-110,-0.36,28980,30360,1400-8-18,2021-11-09
549,حگردش,ريل گردش ايرانيان,206,1690249,7022984595,3958,4155,4155,197,4.98,4080,122,3.08,4155,4155,1400-8-18,2021-11-09
550,وبهمن,سرمايه‌گذاري‌بهمن‌,205,709199,10737273470,15390,14940,15370,-20,-0.13,15230,-160,-1.04,14830,15860,1400-8-18,2021-11-09
551,ضخود1054,اختيارخ خودرو-3000-1400/10/08,204,9316,227509000,28,28,22,-6,-21.43,24,-4,-14.29,19,30,1400-8-18,2021-11-09
552,ساراب,سيمان‌ داراب‌,203,434503,7334498340,16890,16920,16860,-30,-0.18,16890,0,0,16700,17250,1400-8-18,2021-11-09
553,دارو,كارخانجات‌داروپخش‌,202,294204,8571198670,29720,30890,29120,-600,-2.02,29430,-290,-0.98,28510,30890,1400-8-18,2021-11-09
554,ثاصفا,شركت‌ ساختمان‌ اصفهان‌,200,426812,5229670014,12539,12650,12163,-376,-3,12382,-157,-1.25,12163,12650,1400-8-18,2021-11-09
555,بمپنا,توليد برق عسلويه  مپنا,199,2148046,10789935120,4996,5130,5000,4,0.08,5015,19,0.38,4911,5130,1400-8-18,2021-11-09
556,سخزر,سيمان‌ خزر,199,323771,6317839660,19900,18950,19210,-690,-3.47,19730,-170,-0.85,18950,20120,1400-8-18,2021-11-09
557,غشان,شيرپاستوريزه‌پگاه‌خراسان‌,197,8758574,45938720630,4996,5245,5245,249,4.98,5245,249,4.98,5245,5245,1400-8-18,2021-11-09
558,مداران,داده‌پردازي‌ايران‌,195,366311,5008992700,13930,13810,13650,-280,-2.01,13850,-80,-0.57,13400,14160,1400-8-18,2021-11-09
559,تماوند,تامين سرمايه دماوند,194,1839802,11158258825,6046,6106,5980,-66,-1.09,6058,12,0.2,5970,6227,1400-8-18,2021-11-09
560,سخوز,سيمان خوزستان,191,249924,5866443000,23970,24310,23330,-640,-2.67,23770,-200,-0.83,23000,24310,1400-8-18,2021-11-09
561,كپرور,فرآوري زغال سنگ پروده طبس,190,277764,8876348214,31703,31000,32150,447,1.41,31847,144,0.45,31000,32400,1400-8-18,2021-11-09
562,داسوه,داروسازي‌ اسوه‌,190,251021,6117481170,25220,24960,24290,-930,-3.69,24890,-330,-1.31,24000,25590,1400-8-18,2021-11-09
563,گوهر,صندوق سكه طلاي كيان,189,156797,9380920419,59770,60099,60095,325,0.54,59828,58,0.1,59422,60099,1400-8-18,2021-11-09
564,كقزوي,شيشه‌ قزوين‌,189,857296,7327082381,8493,8420,8501,8,0.09,8533,40,0.47,8420,8744,1400-8-18,2021-11-09
565,بسويچ,پارس‌سويچ‌,189,204965,3261932460,16360,16000,15820,-540,-3.3,16260,-100,-0.61,15680,16300,1400-8-18,2021-11-09
566,مارون,پتروشيمي مارون,188,28537,5180834329,183002,184400,182400,-602,-0.33,182926,-76,-0.04,179000,184799,1400-8-18,2021-11-09
567,سكرد,سيمان كردستان,188,572911,3051149410,5440,5270,5310,-130,-2.39,5420,-20,-0.37,5230,5490,1400-8-18,2021-11-09
568,شپاكسا,پاكسان‌,187,725612,12727410900,17400,17120,17570,170,0.98,17510,110,0.63,17110,17950,1400-8-18,2021-11-09
569,خديزل,بهمن  ديزل,187,200628,10227527595,51892,51892,51752,-140,-0.27,51433,-459,-0.88,49801,52500,1400-8-18,2021-11-09
570,بساما,بيمه سامان,184,426521,8629968436,20229,21190,20000,-229,-1.13,20231,2,0.01,19828,21190,1400-8-18,2021-11-09
571,قزوين,كارخانجات‌ قند قزوين‌,183,328744,9660922400,28740,27540,29750,1010,3.51,29150,410,1.43,27530,30170,1400-8-18,2021-11-09
572,وزمين,بانك ايران زمين,183,3401252,36136508933,10226,10520,10635,409,4,10624,398,3.89,10301,10635,1400-8-18,2021-11-09
573,لبوتان,گروه‌صنعتي‌بوتان‌,181,143286,6135996390,43120,41200,42800,-320,-0.74,43000,-120,-0.28,41200,44200,1400-8-18,2021-11-09
574,فبيرا,بسته‌ بندي‌ ايران‌,181,3706831,6216602144,1693,1671,1697,4,0.24,1683,-10,-0.59,1665,1715,1400-8-18,2021-11-09
575,نمرينو,ايران‌ مرينوس‌,180,58450,4561763980,78290,77500,76710,-1580,-2.02,78210,-80,-0.1,74670,79990,1400-8-18,2021-11-09
576,تكنو,تكنوتار,179,1217916,11839775180,9840,9500,9770,-70,-0.71,9750,-90,-0.91,9500,9830,1400-8-18,2021-11-09
577,وايرا,سرمايه گذاري صنايع ايران,178,1687854,8612093195,5259,5102,5102,-157,-2.99,5115,-144,-2.74,5102,5170,1400-8-18,2021-11-09
578,سكرما,سيمان‌ كرمان‌,178,921432,14714908640,15850,16000,15760,-90,-0.57,15960,110,0.69,15720,16480,1400-8-18,2021-11-09
579,تكنار,مجتمع معادن مس تكنار,178,186252,10239127470,56499,55120,54805,-1694,-3,54975,-1524,-2.7,54805,56170,1400-8-18,2021-11-09
580,آبين,كشت و صنعت آبشيرين,176,2156388,3826564085,1802,1749,1800,-2,-0.11,1791,-11,-0.61,1749,1818,1400-8-18,2021-11-09
581,فخاس,فولاد خراسان,175,422036,10295217680,24920,24260,24220,-700,-2.81,24860,-60,-0.24,24010,24800,1400-8-18,2021-11-09
582,سباقر,سيمان باقران,175,429021,6305833257,14813,15094,14590,-223,-1.51,14738,-75,-0.51,14560,15094,1400-8-18,2021-11-09
583,ماني,صندوق س. با درآمد ثابت ماني,175,5272796,55060394615,10437,10444,10444,7,0.07,10442,5,0.05,10441,10444,1400-8-18,2021-11-09
584,تسه9906,امتياز تسهيلات مسكن شهريور99,170,1906,1420049926,746622,749000,740010,-6612,-0.89,745042,-1580,-0.21,724444,759000,1400-8-18,2021-11-09
585,غبهنوش,بهنوش‌ ايران‌,169,288089,17720354390,58590,61510,61510,2920,4.98,61450,2860,4.88,61510,61510,1400-8-18,2021-11-09
586,كهرام,توليدي گرانيت بهسرام,167,102784,9476327662,90750,92565,92565,1815,2,92197,1447,1.59,90750,92565,1400-8-18,2021-11-09
587,سهرمز,سيمان‌هرمزگان‌,166,301061,4571671160,15550,15360,15290,-260,-1.67,15440,-110,-0.71,15050,15990,1400-8-18,2021-11-09
588,فافزا,فولاد افزا سپاهان,166,175598,8204397473,46549,47195,45890,-659,-1.42,46684,135,0.29,45161,47930,1400-8-18,2021-11-09
589,لوتوسح,ح . تامين سرمايه لوتوس پارسيان,164,1044975,4517177920,4310,4240,4340,30,0.7,4320,10,0.23,4240,4360,1400-8-18,2021-11-09
590,غپونه,نوش پونه مشهد,163,501303,6429269215,13058,13044,12667,-391,-2.99,12911,-147,-1.13,12667,13190,1400-8-18,2021-11-09
591,زعف0110پ11,زعفران0110نگين سحرخيز(پ),163,124688,34955333662,275491,267000,277998,2507,0.91,280342,4851,1.76,267000,288000,1400-8-18,2021-11-09
592,ثامان,سامان‌ گستراصفهان‌,163,447193,4643288520,10140,10550,10240,100,0.99,10210,70,0.69,10180,10620,1400-8-18,2021-11-09
593,حخزر,كشتيراني درياي خزر,162,430990,7497697729,16968,17810,17500,532,3.14,17176,208,1.23,16980,17816,1400-8-18,2021-11-09
594,تسه9904,امتياز تسهيلات مسكن تير99,161,1637,1220341819,742623,722112,749770,7147,0.96,745475,2852,0.38,722112,750000,1400-8-18,2021-11-09
595,ثجوان,تامين مسكن جوانان,159,1482519,8622968131,5988,5809,5809,-179,-2.99,5832,-156,-2.61,5809,5988,1400-8-18,2021-11-09
596,زگلدشت,كشت و دام گلدشت نمونه اصفهان,159,569568,5083078090,8849,8820,8980,131,1.48,8874,25,0.28,8667,9069,1400-8-18,2021-11-09
597,بفجر,فجر انرژي خليج فارس,159,583840,7234017980,12230,12600,12500,270,2.21,12240,10,0.08,12260,12600,1400-8-18,2021-11-09
598,پارسيان,بيمه پارسيان,157,653394,6231642390,9400,9490,9430,30,0.32,9440,40,0.43,9400,9640,1400-8-18,2021-11-09
599,تسه9903,امتياز تسهيلات مسكن خرداد99,157,1969,1481920237,745588,722222,780000,34412,4.62,752626,7038,0.94,722222,782867,1400-8-18,2021-11-09
600,زعف0008پ12,زعفران0008پوشالمعمول سحرخيز(پ),155,159430,29253651270,174751,183489,183489,8738,5,183489,8738,5,183489,183489,1400-8-18,2021-11-09
601,وبازار,صندوق س شاخصي بازارآشنا,154,612660,7796653350,12550,12550,12730,180,1.43,12730,180,1.43,12550,12840,1400-8-18,2021-11-09
602,فاما,صنعتي‌ آما,154,438471,8152028650,18550,17680,18530,-20,-0.11,18570,20,0.11,17680,18750,1400-8-18,2021-11-09
603,فن آوا,گروه فن آوا,154,726742,15320234578,20884,20300,20660,-224,-1.07,21081,197,0.94,20258,21510,1400-8-18,2021-11-09
604,شگل,گلتاش‌,152,453185,2967205080,6610,6440,6590,-20,-0.3,6600,-10,-0.15,6410,6800,1400-8-18,2021-11-09
605,سجام,مجتمع سيمان غرب آسيا,152,1549675,4372093745,2898,2812,2835,-63,-2.17,2863,-35,-1.21,2812,2939,1400-8-18,2021-11-09
606,اتكام,بيمه اتكايي امين,151,2117675,7836860752,3693,3700,3695,2,0.05,3697,4,0.11,3622,3776,1400-8-18,2021-11-09
607,دجابر,داروسازي‌ جابرابن‌حيان‌,148,2474021,38000962560,14630,15360,15360,730,4.99,15360,730,4.99,15360,15360,1400-8-18,2021-11-09
608,سقاين,سيمان‌ قائن‌,148,100199,4871981290,49130,49310,47780,-1350,-2.75,48970,-160,-0.33,47710,49820,1400-8-18,2021-11-09
609,داريوش,صندوق س. ثروت داريوش -س,147,690949,6778473595,9728,9760,9820,92,0.95,9810,82,0.84,9740,9899,1400-8-18,2021-11-09
610,وتوشه,سرمايه‌ گذاري‌ پارس‌ توشه‌,147,1573050,9385227400,5970,6070,5950,-20,-0.34,5970,0,0,5860,6120,1400-8-18,2021-11-09
611,لوتوس,تامين سرمايه لوتوس پارسيان,146,995840,5662928450,5640,5550,5700,60,1.06,5650,10,0.18,5550,5800,1400-8-18,2021-11-09
612,شاملا,معدني‌ املاح‌  ايران‌,146,285306,8631378890,30740,30600,30220,-520,-1.69,30470,-270,-0.88,29950,30970,1400-8-18,2021-11-09
613,رتكو,كنترل‌خوردگي‌تكين‌كو,145,351651,2998048850,8680,8410,8480,-200,-2.3,8650,-30,-0.35,8410,8820,1400-8-18,2021-11-09
614,تسه9812,امتياز تسهيلات مسكن اسفند98,143,1961,1462863890,742798,740010,745100,2302,0.31,745978,3180,0.43,713122,754500,1400-8-18,2021-11-09
615,واتي,سرمايه‌ گذاري‌ آتيه‌ دماوند,142,1807970,19918783000,10790,10530,10920,130,1.2,11020,230,2.13,10530,11150,1400-8-18,2021-11-09
616,سيلام,سيمان‌ ايلام‌,142,2626487,16106916560,5860,5990,6150,290,4.95,6110,250,4.27,5990,6150,1400-8-18,2021-11-09
617,شستان,پتروشيمي گلستان,141,1060451,4035749831,3737,3811,3811,74,1.98,3790,53,1.42,3691,3811,1400-8-18,2021-11-09
618,تسه9809,امتياز تسهيلات مسكن آذر98,137,2749,2051166837,734713,740000,746000,11287,1.54,746150,11437,1.56,730555,750000,1400-8-18,2021-11-09
619,زعف0008پ11,زعفران0008نگين سحرخيز(پ),136,88468,19649277703,219578,211600,223031,3453,1.57,222106,2528,1.15,211600,231997,1400-8-18,2021-11-09
620,شصفها,پتروشيمي‌ اصفهان‌,135,74722,9193687867,121768,121768,123000,1232,1.01,122559,791,0.65,121742,124203,1400-8-18,2021-11-09
621,سهگمت,سيمان‌هگمتان‌,134,394338,9282957760,22510,23630,23630,1120,4.98,23090,580,2.58,23130,23630,1400-8-18,2021-11-09
622,زرين,صندوق س. سهام زرين كوروش-س,134,401582,5460550476,13340,13580,13658,318,2.38,13598,258,1.93,13450,13740,1400-8-18,2021-11-09
623,دشيري,شيرين دارو,133,19378,2751102180,146337,141950,141947,-4390,-3,145060,-1277,-0.87,141947,144995,1400-8-18,2021-11-09
624,ومشان,س. فني و مهندسي مشانير,133,159903,8513148849,51761,52996,53313,1552,3,53239,1478,2.86,52270,53313,1400-8-18,2021-11-09
625,ضترا1135,اختيارخ شتران-6176-1400/11/10,131,4291,1364196721,104,110,140,36,34.62,140,36,34.62,110,150,1400-8-18,2021-11-09
626,سدشت,صنايع سيمان دشتستان,128,130532,4537193850,36300,34550,34550,-1750,-4.82,35870,-430,-1.18,34490,35760,1400-8-18,2021-11-09
627,تسه9905,امتياز تسهيلات مسكن مرداد99,128,1125,843858072,742741,740000,750000,7259,0.98,750096,7355,0.99,730201,760000,1400-8-18,2021-11-09
628,آساميد,صندوق س.مشترك آسمان اميد -د,127,3162917,42283193850,13361,13374,13370,9,0.07,13368,7,0.05,13367,13374,1400-8-18,2021-11-09
629,وكادو,تكادو,126,357960,6065040974,16825,16333,16990,165,0.98,16892,67,0.4,16333,17260,1400-8-18,2021-11-09
630,تشتاد,صنايع توليدي اشتاد ايران‌,125,575522,3186128100,5586,5740,5459,-127,-2.27,5570,-16,-0.29,5432,5740,1400-8-18,2021-11-09
631,سنوين,سرمايه گذاري اقتصاد نوين,125,411295,2864266192,7107,7270,6894,-213,-3,7065,-42,-0.59,6894,7270,1400-8-18,2021-11-09
632,سامان,بانك سامان,125,2145965,15620479235,7067,7279,7279,212,3,7166,99,1.4,7279,7279,1400-8-18,2021-11-09
633,غشوكوح,ح . شوكو پارس,124,549851,2943247413,5515,5371,5350,-165,-2.99,5353,-162,-2.94,5350,5420,1400-8-18,2021-11-09
634,بخاور,بيمه زندگي خاورميانه,122,1007234,4181134709,4177,4089,4120,-57,-1.36,4170,-7,-0.17,4072,4269,1400-8-18,2021-11-09
635,وپخش,داروپخش‌ (هلدينگ‌,122,88839,2657796030,30260,30110,30070,-190,-0.63,30240,-20,-0.07,29600,30130,1400-8-18,2021-11-09
636,تسه9811,امتياز تسهيلات مسكن بهمن98,121,1455,1088113078,740674,733020,749000,8326,1.12,747844,7170,0.97,722010,750000,1400-8-18,2021-11-09
637,زر,صندوق س.پشتوانه سكه طلاي زر,117,56256,2958665953,52685,52581,52796,111,0.21,52593,-92,-0.17,52380,52825,1400-8-18,2021-11-09
638,آكورد2,صندوق س. آرمان آتي كوثر-د,117,11700000,11700000,35087,1,1,-35086,-100,1,-35086,-100,1,1,1400-8-18,2021-11-09
639,كهربا,صندوق س.پشتوانه سكه طلا كهربا,115,3713721,38514152704,10398,10400,10412,14,0.13,10371,-27,-0.26,10370,10423,1400-8-18,2021-11-09
640,ارمغان,ص سرمايه گذاري ارمغان ايرانيان,115,1406341,14078960259,10011,10019,10011,0,0,10011,0,0,10007,10019,1400-8-18,2021-11-09
641,وآتوس,س.آرين توسكا قيمت اسمي 350ريال,113,92031,2338238551,24821,24158,25545,724,2.92,25001,180,0.73,24158,25565,1400-8-18,2021-11-09
642,سيدكو,سرمايه گذاري توسعه صنايع سيمان,112,567554,3542352300,6330,6230,6200,-130,-2.05,6310,-20,-0.32,6130,6330,1400-8-18,2021-11-09
643,كخاك,صنايع‌خاك‌چيني‌ايران‌,110,210530,6022097010,28630,28130,28890,260,0.91,28620,-10,-0.03,28110,29190,1400-8-18,2021-11-09
644,دسبحان,سبحان دارو,110,98666,1530886740,15400,15700,15410,10,0.06,15410,10,0.06,15210,15700,1400-8-18,2021-11-09
645,شزنگ,تجهيزنيروي‌زنگان‌,109,18346,2443228550,129297,133175,133175,3878,3,130146,849,0.66,133175,133175,1400-8-18,2021-11-09
646,دقاضي,داروسازي شهيد قاضي,105,221123,6290540310,29274,28770,28550,-724,-2.47,28743,-531,-1.81,28396,28770,1400-8-18,2021-11-09
647,ما,بيمه  ما,104,431647,2656463100,6210,6360,6120,-90,-1.45,6200,-10,-0.16,6100,6360,1400-8-18,2021-11-09
648,كصدف,كاشي صدف سرام استقلال آباده,103,316480,6520076370,21197,20713,20562,-635,-3,20791,-406,-1.92,20562,21100,1400-8-18,2021-11-09
649,گوهران,سرمايه گذاري توسعه گوهران اميد,103,628689,3212195579,5049,5023,5134,85,1.68,5062,13,0.26,5023,5140,1400-8-18,2021-11-09
650,تسه9901,امتياز تسهيلات مسكن فروردين99,101,822,612555683,737326,722179,740010,2684,0.36,745202,7876,1.07,722179,750000,1400-8-18,2021-11-09
651,آساس,صندوق س.آسمان آرماني سهام-س,100,35670,6198713084,171649,172550,173510,1861,1.08,173779,2130,1.24,172284,174550,1400-8-18,2021-11-09
652,زعف0008پ15,زعفران0008پوشالمعمول طلاسرخ(پ),100,182232,33437545799,174752,183489,183489,8737,5,183489,8737,5,183400,183489,1400-8-18,2021-11-09
653,اخزا004,اسنادخزانه-م4بودجه00-030522,99,269201,148705585389,552224,551111,552000,-224,-0.04,552396,172,0.03,550557,553525,1400-8-18,2021-11-09
654,دپارس,پارس‌ دارو,97,89725,2907437560,32210,32400,32040,-170,-0.53,32250,40,0.12,32000,33080,1400-8-18,2021-11-09
655,دكيمي,كيميدارو,95,205206,4173203450,19970,20590,20480,510,2.55,20070,100,0.5,20020,20590,1400-8-18,2021-11-09
656,ضشنا1049,اختيارخ شپنا-6540-1400/10/19,94,1157,1913711000,1327,1500,1511,184,13.87,1654,327,24.64,1470,1870,1400-8-18,2021-11-09
657,معيار ,سرمايه گذاري معيار صنعت پارس,94,93132,4598154131,48949,49985,48990,41,0.08,49140,191,0.39,48801,49985,1400-8-18,2021-11-09
658,تمحركه,ماشين سازي نيرو محركه,93,460467,9287619390,21231,20170,20170,-1061,-5,20170,-1061,-5,20170,20170,1400-8-18,2021-11-09
659,دفرا,فرآورده‌هاي‌ تزريقي‌ ايران‌,93,89672,2467173030,28110,27070,27950,-160,-0.57,28010,-100,-0.36,27070,28000,1400-8-18,2021-11-09
660,ضپال2007,اختيارخ اپال-32000-1401/02/12,91,1480,751682000,468,543,480,12,2.56,508,40,8.55,430,570,1400-8-18,2021-11-09
661,سپاس,صندوق س. پاداش سهامداري-ثابت,89,2217893,22216707778,10013,10016,10017,4,0.04,10017,4,0.04,10016,10020,1400-8-18,2021-11-09
662,زعف0008پ05,زعفران0008نگين زرين(پ),88,33707,7398727245,219755,215000,214102,-5653,-2.57,219501,-254,-0.12,214102,222959,1400-8-18,2021-11-09
663,اخزا910,اسنادخزانه-م10بودجه99-020807,88,219191,143303104665,653171,652200,653500,329,0.05,653782,611,0.09,652200,654010,1400-8-18,2021-11-09
664,فوكا,فولاد كاويان,88,2119476,31499652312,14430,14862,14862,432,2.99,14813,383,2.65,14862,14862,1400-8-18,2021-11-09
665,ثالوند,سرمايه گذاري مسكن الوند,84,405083,3406342947,8009,8409,8409,400,4.99,8092,83,1.04,8409,8409,1400-8-18,2021-11-09
666,ضشنا1048,اختيارخ شپنا-5450-1400/10/19,81,1272,3591936000,2337,2500,2980,643,27.51,2824,487,20.84,2500,2997,1400-8-18,2021-11-09
667,صايند,صندوق س. گنجينه آينده روشن-د,81,678950,6791241360,10000,10001,10001,1,0.01,10003,3,0.03,9971,10014,1400-8-18,2021-11-09
668,دسبحا,گروه دارويي سبحان,80,187173,3539379470,18570,18100,18420,-150,-0.81,18620,50,0.27,18100,19100,1400-8-18,2021-11-09
669,قمرو,قند مرودشت‌,78,168791,4269358170,25300,25500,25000,-300,-1.19,25300,0,0,25000,25900,1400-8-18,2021-11-09
670,وامين,س. امين توان آفرين ساز,76,203500,2593572480,12777,12777,12777,0,0,12775,-2,-0.02,12650,12800,1400-8-18,2021-11-09
671,وليز,ليزينگ‌ايران‌,75,510429,1460847798,2726,2862,2862,136,4.99,2738,12,0.44,2862,2862,1400-8-18,2021-11-09
672,آتيمس,صندوق س.آرمان آتيه درخشان مس-س,73,16484,3159380461,190741,189000,191500,759,0.4,191663,922,0.48,189000,194500,1400-8-18,2021-11-09
673,ثاژن,سخت آژند,72,2190646,13200832796,9016,6026,6026,-2990,-33.16,6026,-2990,-33.16,6026,6026,1400-8-18,2021-11-09
674,زعف0008پ08,زعفران0008نگين روستا(پ),72,28196,6147961399,223980,212002,217000,-6980,-3.12,218044,-5936,-2.65,212002,225733,1400-8-18,2021-11-09
675,سبجنو,سيمان‌ بجنورد,72,80273,2928083760,36790,36220,36700,-90,-0.24,36730,-60,-0.16,35530,36960,1400-8-18,2021-11-09
676,سمتاز,سيمان ممتازان كرمان,71,129589,2020949807,16009,15728,15530,-479,-2.99,15923,-86,-0.54,15529,16009,1400-8-18,2021-11-09
677,اخزا002,اسنادخزانه-م2بودجه00-031024,70,124585,62851766421,503943,502514,504551,608,0.12,504489,546,0.11,502514,505899,1400-8-18,2021-11-09
678,دارا,صندوق س. دارا الگوريتم-د,70,805910,8063591472,10001,10010,10005,4,0.04,10006,5,0.05,9990,10023,1400-8-18,2021-11-09
679,پارتا,مجتمع‌صنعتي‌آرتاويل‌تاير,68,108665,2710401816,25623,25000,24855,-768,-3,25539,-84,-0.33,24855,25407,1400-8-18,2021-11-09
680,صنوين,صندوق سرمايه‌گذاري صنوين-مختلط,66,25119,2533220790,100130,98130,100200,70,0.07,100850,720,0.72,98130,103040,1400-8-18,2021-11-09
681,وثوق,سرمايه گذاري وثوق امين,66,195876,2276274996,11980,11621,11621,-359,-3,11894,-86,-0.72,11621,11621,1400-8-18,2021-11-09
682,اخزا911,اسنادخزانه-م11بودجه99-020906,64,91636,58839412489,641942,639555,643000,1058,0.16,642099,157,0.02,639555,644900,1400-8-18,2021-11-09
683,ضسپا1114,اختيارخ خساپا-2000-1400/11/20,63,4032,726656000,186,218,174,-12,-6.45,180,-6,-3.23,174,220,1400-8-18,2021-11-09
684,قجام,فرآوردههاي غذايي وقندتربت‌جام‌,62,410764,2836736184,6771,6906,6906,135,1.99,6841,70,1.03,6906,6906,1400-8-18,2021-11-09
685,اخزا901,اسنادخزانه-م1بودجه99-010621,60,85121,71007789020,833580,836000,834244,664,0.08,834198,618,0.07,833000,836000,1400-8-18,2021-11-09
686,افق ملت,صندوق س در سهام افق ملت,59,18827,2748826700,144490,144500,147000,2510,1.74,146000,1510,1.05,144500,147220,1400-8-18,2021-11-09
687,اخزا006,اسنادخزانه-م6بودجه00-030723,59,141686,75477447720,531449,533969,533000,1551,0.29,532709,1260,0.24,531100,533969,1400-8-18,2021-11-09
688,لخانه,لوازم‌ خانگي‌ پارس‌,57,206803,3719377634,18539,17985,17983,-556,-3,18325,-214,-1.15,17983,18190,1400-8-18,2021-11-09
689,سكه0112پ03,تمام سكه طرح جديد0112سامان,57,9700,11633892900,1197890,1193000,1200700,2810,0.23,1199370,1480,0.12,1192000,1205000,1400-8-18,2021-11-09
690,سشمال,سيمان‌ شمال‌,54,690949,5691862240,8300,8370,8210,-90,-1.08,8280,-20,-0.24,8200,8380,1400-8-18,2021-11-09
691,فيروزا,صندوق بادرآمد ثابت فيروزه آسيا,53,1137137,29178967397,25660,25661,25660,0,0,25660,0,0,25660,25681,1400-8-18,2021-11-09
692,پلوله,گازلوله‌,53,341569,8852597722,25164,25918,25918,754,3,25816,652,2.59,25900,25918,1400-8-18,2021-11-09
693,اخزا902,اسنادخزانه-م2بودجه99-011019,53,69676,54238058980,776918,772745,778420,1502,0.19,778432,1514,0.19,772745,780000,1400-8-18,2021-11-09
694,لسرما,سرما آفرين‌,51,101248,1857900800,17480,18350,18350,870,4.98,17580,100,0.57,18350,18350,1400-8-18,2021-11-09
695,سكارون,سيمان كارون,51,27928,1559024744,57549,55823,55823,-1726,-3,57258,-291,-0.51,55823,55823,1400-8-18,2021-11-09
696,اخزا008,اسنادخزانه-م8بودجه00-030919,50,59435,30610874412,514150,510224,516499,2349,0.46,515031,881,0.17,510223,516999,1400-8-18,2021-11-09
697,وآفري,بيمه كارآفرين,49,680689,2200558620,3236,3144,3236,0,0,3235,-1,-0.03,3144,3294,1400-8-18,2021-11-09
698,فالوم,آلومتك‌,49,140610,3297445110,24176,23451,23451,-725,-3,23923,-253,-1.05,23451,23451,1400-8-18,2021-11-09
699,الماس,صندوق س.امين تدبيرگران فردا-س,49,2790,299909751,106793,107600,108659,1866,1.75,107495,702,0.66,106002,108680,1400-8-18,2021-11-09
700,اخزا809,اسنادخزانه-م9بودجه98-000923,45,89599,87719820421,977600,977413,979200,1600,0.16,979027,1427,0.15,977413,979489,1400-8-18,2021-11-09
701,سكه0011پ02,تمام سكه طرح جديد0011ملت,44,6200,7437985400,1198207,1209602,1204900,6693,0.56,1199675,1468,0.12,1193000,1209602,1400-8-18,2021-11-09
702,زعف0110پ10,زعفران0110نگين طلاي سرخ(پ),44,39340,10949118464,284329,269003,275000,-9329,-3.28,278320,-6009,-2.11,269003,285000,1400-8-18,2021-11-09
703,اخزا003,اسنادخزانه-م3بودجه00-030418,44,76059,42885087690,562618,561100,564880,2262,0.4,563840,1222,0.22,561100,564880,1400-8-18,2021-11-09
704,ضسپا8040,اختيارخ خساپا-1400-1400/08/26,43,1590,536029000,380,340,340,-40,-10.53,337,-43,-11.32,305,400,1400-8-18,2021-11-09
705,اخزا917,اسنادخزانه-م17بودجه99-010226,43,234310,209619698902,893295,892000,895000,1705,0.19,894625,1330,0.15,892000,895877,1400-8-18,2021-11-09
706,اخزا903,اسنادخزانه-م3بودجه99-011110,42,92111,70732665890,767600,767600,769000,1400,0.18,767907,307,0.04,767511,769000,1400-8-18,2021-11-09
707,ساروج,بين المللي ساروج بوشهر,41,137476,2366045084,16937,17106,17026,89,0.53,17001,64,0.38,16769,17375,1400-8-18,2021-11-09
708,اخزا001,اسنادخزانه-م1بودجه00-030821,41,107159,56205062488,523010,525000,524964,1954,0.37,524502,1492,0.29,522005,525700,1400-8-18,2021-11-09
709,اخزا914,اسنادخزانه-م14بودجه99-021025,40,124467,77733908039,624286,622803,624500,214,0.03,624534,248,0.04,622802,625000,1400-8-18,2021-11-09
710,كيان2,صندوق س. با درآمد ثابت كيان,40,4000000,4000000,31454,1,1,-31453,-100,1,-31453,-100,1,1,1400-8-18,2021-11-09
711,سكه0111پ05,تمام سكه طرح جديد0111آينده,39,11600,13950116300,1197975,1192000,1203000,5025,0.42,1202596,4621,0.39,1192000,1210000,1400-8-18,2021-11-09
712,اخزا909,اسنادخزانه-م9بودجه99-020316,36,78743,56131454211,712045,712000,712700,655,0.09,712844,799,0.11,712000,713380,1400-8-18,2021-11-09
713,بذر,صندوق س بذر اميد آفرين-سهام,36,10180,1038531780,99990,101000,103300,3310,3.31,102020,2030,2.03,101000,103320,1400-8-18,2021-11-09
714,گنجين,صندوق س. گنجينه يكم آويد-د,36,241941,3412788926,14098,14103,14109,11,0.08,14106,8,0.06,14103,14109,1400-8-18,2021-11-09
715,زعف0008پ16,زعفران0008نگين بيرجند(پ),34,8479,1866213750,216932,219999,219000,2068,0.95,220098,3166,1.46,213999,226900,1400-8-18,2021-11-09
716,اخزا908,اسنادخزانه-م8بودجه99-020606,33,72809,49364097931,677982,677004,678011,29,0,677994,12,0,677004,679000,1400-8-18,2021-11-09
717,وسخوز,شركت س استان خوزستان,33,941616,572502528,640,608,608,-32,-5,640,0,0,608,608,1400-8-18,2021-11-09
718,زعف0110پ05,زعفران0110نگين زرين(پ),33,10474,2974233819,280972,290000,280000,-972,-0.35,283963,2991,1.06,280000,294937,1400-8-18,2021-11-09
719,اخزا816,اسنادخزانه-م16بودجه98-010503,33,182873,157032856223,858011,858411,859500,1489,0.17,858699,688,0.08,858411,859500,1400-8-18,2021-11-09
720,زعف0008پ20,زعفران0008نگين وحدت جام(پ),31,10418,2328068014,214221,230487,220000,5779,2.7,223466,9245,4.32,211503,230487,1400-8-18,2021-11-09
721,ثروتم,صندوق س. ثروت آفرين پارسيان-س,31,76190,6784562040,88331,88543,89398,1067,1.21,89048,717,0.81,88543,89700,1400-8-18,2021-11-09
722,شساخت,مهندسي و ساختمان صنايع نفت,31,38040,1602074051,43414,42999,42112,-1302,-3,43365,-49,-0.11,42112,42999,1400-8-18,2021-11-09
723,حرهشا,رهشاد سپاهان (سهامي عام,30,12521,1334951457,112228,106617,106617,-5611,-5,111291,-937,-0.83,106617,106617,1400-8-18,2021-11-09
724,داريك,صندوق س.اعتماد داريك-د,30,844400,9981774616,11815,11821,11823,8,0.07,11821,6,0.05,11821,11823,1400-8-18,2021-11-09
725,اخزا007,اسنادخزانه-م7بودجه00-030912,30,147355,76113794907,514920,515001,515001,81,0.02,516533,1613,0.31,515000,518000,1400-8-18,2021-11-09
726,گكيش,توريستي ورفاهي آبادگران كيش,30,29879,1165041968,41044,38992,38992,-2052,-5,40792,-252,-0.61,38992,38992,1400-8-18,2021-11-09
727,ضبدر1165,اختيارخ شبندر-8000-1400/11/13,29,1223,588090000,333,480,480,147,44.14,481,148,44.44,450,490,1400-8-18,2021-11-09
728,اخزا005,اسنادخزانه-م5بودجه00-030626,28,43814,23585555588,538145,536526,539000,855,0.16,538311,166,0.03,536526,539000,1400-8-18,2021-11-09
729,فنفت,صنايع تجهيزات نفت,27,155495,2252500570,14934,14486,14486,-448,-3,14827,-107,-0.72,14486,14486,1400-8-18,2021-11-09
730,ضجار1022,اختيارخ وتجارت-2000-1400/10/15,25,868,218254000,257,243,245,-12,-4.67,251,-6,-2.33,240,309,1400-8-18,2021-11-09
731,زعف0110پ18,زعفران0110نگين بهرامن(پ),25,14152,3973356288,272978,280000,274000,1022,0.37,280763,7785,2.85,274000,286000,1400-8-18,2021-11-09
732,اخزا812,اسنادخزانه-م12بودجه98-001111,25,52224,49666493833,950919,950002,950992,73,0.01,951028,109,0.01,950002,952997,1400-8-18,2021-11-09
733,بايكا,كارخانجات كابلسازي ‌ايران‌,25,38356,725350316,19495,18911,18911,-584,-3,19451,-44,-0.23,18911,18911,1400-8-18,2021-11-09
734,قيستو,شركت قند بيستون,24,409384,9991425904,23696,24406,24406,710,3,24406,710,3,24406,24406,1400-8-18,2021-11-09
735,اخزا814,اسنادخزانه-م14بودجه98-010318,24,55321,48854728293,882510,883111,888887,6377,0.72,883114,604,0.07,883100,888887,1400-8-18,2021-11-09
736,اوصتا,صندوق انديشه ورزان صباتامين -د,23,529345,10823555657,20439,20447,20447,8,0.04,20447,8,0.04,20446,20449,1400-8-18,2021-11-09
737,شتولي,تولي‌پرس‌,23,34802,695239554,20809,19977,19977,-832,-4,20687,-122,-0.59,19977,19977,1400-8-18,2021-11-09
738,فنرژي,گسترش صنايع انرژي آذرآب,22,82752,1036882560,12785,12530,12530,-255,-1.99,12729,-56,-0.44,12530,12530,1400-8-18,2021-11-09
739,زعف0110پ21,زعفران0110نگين ملل(پ),21,16460,4678867298,274653,275000,280000,5347,1.95,284257,9604,3.5,270003,294933,1400-8-18,2021-11-09
740,فراز,صندوق س.سهام فراز داريك-س,20,143928,2040202475,14174,14175,14175,1,0.01,14175,1,0.01,14175,14200,1400-8-18,2021-11-09
741,امين يكم2,صندوق درآمد ثابت امين يكم فردا,20,20000000,20000000,10088,1,1,-10087,-99.99,1,-10087,-99.99,1,1,1400-8-18,2021-11-09
742,اخزا815,اسنادخزانه-م15بودجه98-010406,20,27848,24292212581,871961,872498,872105,144,0.02,872314,353,0.04,870005,872499,1400-8-18,2021-11-09
743,ضجار1023,اختيارخ وتجارت-2500-1400/10/15,20,955,56271000,60,62,64,4,6.67,59,-1,-1.67,50,64,1400-8-18,2021-11-09
744,اخزا810,اسنادخزانه-م10بودجه98-001006,20,111653,108519057385,970701,972345,972000,1299,0.13,971931,1230,0.13,971200,972345,1400-8-18,2021-11-09
745,سخند,صندوق س.سپهرخبرگان نفت-د,20,157300,1575606820,10011,10031,10015,4,0.04,10017,6,0.06,10015,10035,1400-8-18,2021-11-09
746,سي تيپ2ن11,گواهي سيمان تيپ2دورود(ن),20,466000,2736352000,5872,5872,5872,0,0,5872,0,0,5872,5872,1400-8-18,2021-11-09
747,ضبدر8079,اختيارخ شبندر-6011-1400/08/30,19,73,431874168,1007,1250,1220,213,21.15,1263,256,25.42,1101,1350,1400-8-18,2021-11-09
748,زير0103پ01,زيره سبز0103كيميابذر(پ),18,128,101778296,757843,795735,795735,37892,5,795143,37300,4.92,719951,795735,1400-8-18,2021-11-09
749,اخزا907,اسنادخزانه-م7بودجه99-020704,18,157728,105491509105,666001,669790,668000,1999,0.3,668819,2818,0.42,666100,674999,1400-8-18,2021-11-09
750,اوصتا2,صندوق انديشه ورزان صباتامين -د,17,58400000,58400000,20439,1,1,-20438,-100,1,-20438,-100,1,1,1400-8-18,2021-11-09
751,خاتم2,صندوق س خاتم ايساتيس پويا-ثابت,17,17000000,17000000,12268,1,1,-12267,-99.99,1,-12267,-99.99,1,1,1400-8-18,2021-11-09
752,جهرم,پتروشيمي جهرم,17,366540,515355240,1449,1406,1406,-43,-2.97,1447,-2,-0.14,1406,1406,1400-8-18,2021-11-09
753,اراد50,مرابحه عام دولت5-ش.خ0302,17,405000,405000400000,1000000,1000000,1000001,1,0,1000001,1,0,1000000,1000001,1400-8-18,2021-11-09
754,تپولا,مهندسي مرآت پولاد,17,19316,317844780,16963,16455,16455,-508,-2.99,16945,-18,-0.11,16455,16455,1400-8-18,2021-11-09
755,اخزا905,اسنادخزانه-م5بودجه99-020218,17,138699,100613097551,723945,721500,725000,1055,0.15,725406,1461,0.2,721500,727000,1400-8-18,2021-11-09
756,وملت,سرمايه گذاري ملت,16,115491,342661797,3027,2967,2967,-60,-1.98,3023,-4,-0.13,2967,2967,1400-8-18,2021-11-09
757,ضسپا8039,اختيارخ خساپا-1200-1400/08/26,16,698,377100000,555,555,530,-25,-4.5,540,-15,-2.7,518,585,1400-8-18,2021-11-09
758,غشوكو,شوكو پارس,15,9926,96252422,9996,9697,9697,-299,-2.99,9993,-3,-0.03,9697,9697,1400-8-18,2021-11-09
759,وسرضوي,س.سهام عدالت استان خراسان رضوي,15,529472,365865152,727,691,691,-36,-4.95,727,0,0,691,691,1400-8-18,2021-11-09
760,اخزا817,اسنادخزانه-م17بودجه98-010512,15,105373,90059142608,854013,854001,856000,1987,0.23,854670,657,0.08,854000,857000,1400-8-18,2021-11-09
761,طلا2,صندوق س.پشتوانه طلاي لوتوس,15,1500000,1500000,85644,1,1,-85643,-100,1,-85643,-100,1,1,1400-8-18,2021-11-09
762,ضترا1133,اختيارخ شتران-4411-1400/11/10,15,589,1468789300,977,1100,1100,123,12.59,1100,123,12.59,1100,1100,1400-8-18,2021-11-09
763,اخزا818,اسنادخزانه-م18بودجه98-010614,14,6917,5794503596,838900,839800,837100,-1800,-0.21,837719,-1181,-0.14,837003,839800,1400-8-18,2021-11-09
764,خفناور,مهندسي صنعتي روان فن آور,14,8572,340951300,41868,39775,39775,-2093,-5,41792,-76,-0.18,39775,39775,1400-8-18,2021-11-09
765,ضصاد1114,اختيارخ وبصادر-2500-1400/11/06,13,511,36021000,70,21,80,10,14.29,70,0,0,20,80,1400-8-18,2021-11-09
766,پادا,صندوق س.پاداش سرمايه پارس-س,13,5282,592453500,111178,112100,111300,122,0.11,112165,987,0.89,111300,112200,1400-8-18,2021-11-09
767,زعف0008پ18,زعفران0008نگين بهرامن(پ),13,12133,2822234509,226582,212610,233763,7181,3.17,232608,6026,2.66,212610,233764,1400-8-18,2021-11-09
768,سرو2,صندوق س سروسودمند مدبران-سهام,12,570000,570000,75310,1,1,-75309,-100,1,-75309,-100,1,1,1400-8-18,2021-11-09
769,سلار,شركت سيمان لارستان,12,31660,812110660,26444,25651,25651,-793,-3,26374,-70,-0.26,25651,25651,1400-8-18,2021-11-09
770,ساذري,آذريت‌,12,50812,519298640,9734,10220,10220,486,4.99,9758,24,0.25,10220,10220,1400-8-18,2021-11-09
771,ضپاس1011,اختيارخ وپارس-2000-1400/10/22,11,367,161222000,467,466,428,-39,-8.35,439,-28,-6,410,466,1400-8-18,2021-11-09
772,گپارس,امور رفاهي كارگزاران پارس,11,1161,152568171,138327,131411,131411,-6916,-5,138215,-112,-0.08,131411,131411,1400-8-18,2021-11-09
773,دمعيار,صندوق س. توازن معيار-د,11,146143,1474661430,10085,10094,10095,10,0.1,10091,6,0.06,10090,10095,1400-8-18,2021-11-09
774,اخزا811,اسنادخزانه-م11بودجه98-001013,11,7031,6802275492,966360,968999,968000,1640,0.17,967469,1109,0.11,966800,968999,1400-8-18,2021-11-09
775,اخزا918,اسنادخزانه-م18بودجه99-010323,11,38271,33671778070,878346,878009,880000,1654,0.19,879825,1479,0.17,878005,880000,1400-8-18,2021-11-09
776,ضملي1162,اختيارخ فملي-8000-1400/11/03,11,597,410940000,625,800,690,65,10.4,688,63,10.08,675,800,1400-8-18,2021-11-09
777,سي تيپ2ن02,گواهي سيمان تيپ2صوفيان(ن),11,210000,1036770000,4794,4937,4937,143,2.98,4937,143,2.98,4937,4937,1400-8-18,2021-11-09
778,برن0104پ01,برنج طارم0104تجارت مازندران(پ),11,5684,2489115484,426564,426565,435000,8436,1.98,437916,11352,2.66,426565,447892,1400-8-18,2021-11-09
779,سبرق021,سلف موازي برق صادراتي گيلان021,10,8420000,1604010000000,188100,190500,190500,2400,1.28,190500,2400,1.28,190500,190500,1400-8-18,2021-11-09
780,عيار2,صندوق سكه طلاي مفيد,10,100000,100000,30532,1,1,-30531,-100,1,-30531,-100,1,1,1400-8-18,2021-11-09
781,نگين,ص.س. زمين و ساختمان نگين شهرري,10,407,21302060,51380,52400,52400,1020,1.99,52340,960,1.87,52210,52400,1400-8-18,2021-11-09
782,زعف0008پ09,زعفران0008نگين نوين(پ),9,2330,513224100,222819,211502,223000,181,0.08,220268,-2551,-1.14,211502,223000,1400-8-18,2021-11-09
783,وسصفا,شركت س استان اصفهان,9,236026,163566018,729,693,693,-36,-4.94,729,0,0,693,693,1400-8-18,2021-11-09
784,اخزا820,اسنادخزانه-م20بودجه98-020806,8,40624,26593201850,653999,654490,655000,1001,0.15,654618,619,0.09,654490,655000,1400-8-18,2021-11-09
785,ضبدر8076,اختيارخ شبندر-3448-1400/08/30,8,21,351862080,3300,3600,3600,300,9.09,3577,277,8.39,3552,3600,1400-8-18,2021-11-09
786,كابگن,توليدي و صنعتي آبگينه‌,8,18715,111728550,5853,5970,5970,117,2,5858,5,0.09,5970,5970,1400-8-18,2021-11-09
787,زعف0110پ20,زعفران0110نگين وحدت جام(پ),8,1790,504222000,268768,283000,280000,11232,4.18,281688,12920,4.81,280000,289000,1400-8-18,2021-11-09
788,اطلس2,صندوق س.توسعه اندوخته آينده-س,8,80000,80000,255110,1,1,-255109,-100,1,-255109,-100,1,1,1400-8-18,2021-11-09
789,اخزا009,اسناد خزانه-م9بودجه00-031101,8,707,366328000,513100,514000,513500,400,0.08,518144,5044,0.98,513500,519000,1400-8-18,2021-11-09
790,كباده,توليد خاك نسوزاستقلال آباده,7,5257,120748033,22300,22969,22969,669,3,22308,8,0.04,22969,22969,1400-8-18,2021-11-09
791,ثهام,صندوق س ثروت هامرز-سهام,7,3383,38215289,11290,11290,11290,0,0,11296,6,0.05,11290,11335,1400-8-18,2021-11-09
792,آسام,صندوق س.آرمان سپهر آشنا-م,7,3760,462676700,122490,123000,123187,697,0.57,123052,562,0.46,123000,123500,1400-8-18,2021-11-09
793,اگ010155,گام بانك اقتصاد نوين0101,7,63700,57528500000,905000,900000,900000,-5000,-0.55,903116,-1884,-0.21,900000,905000,1400-8-18,2021-11-09
794,پست0008پ04,پسته فندقي32-30سبزدانه0008(پ),7,410,778316000,1976000,1877200,1900000,-76000,-3.85,1898332,-77668,-3.93,1877200,1900000,1400-8-18,2021-11-09
795,ضجار1021,اختيارخ وتجارت-1800-1400/10/15,7,302,131390000,470,450,420,-50,-10.64,435,-35,-7.45,420,470,1400-8-18,2021-11-09
796,ضفلا1163,اختيارخ فولاد-10000-1400/11/24,7,107,321000000,2905,3000,3000,95,3.27,3000,95,3.27,3000,3000,1400-8-18,2021-11-09
797,اخزا906,اسنادخزانه-م6بودجه99-020321,7,3000,2136011630,716401,712020,712000,-4401,-0.61,712004,-4397,-0.61,712000,712020,1400-8-18,2021-11-09
798,افاد61,منفعت دولت6-ش.خاص140109,6,130000,129999870000,999999,999999,999999,0,0,999999,0,0,999999,999999,1400-8-18,2021-11-09
799,ثنام,س ساختماني ب نام آوران مهندسي,6,2949,32745696,11447,11104,11104,-343,-3,11446,-1,-0.01,11104,11104,1400-8-18,2021-11-09
800,خعمرا,توسعه و عمران شهرستان نائين,6,79012,318655396,3841,4033,4033,192,5,3847,6,0.16,4033,4033,1400-8-18,2021-11-09
801,تصميم2,صندوق س با درآمد ثابت تصميم,6,6000000,6000000,17897,1,1,-17896,-99.99,1,-17896,-99.99,1,1,1400-8-18,2021-11-09
802,داراب,پتروشيمي داراب,6,22350,48521850,2238,2171,2171,-67,-2.99,2238,0,0,2171,2171,1400-8-18,2021-11-09
803,ضفلا1165,اختيارخ فولاد-14000-1400/11/24,6,410,331090000,785,800,800,15,1.91,808,23,2.93,800,820,1400-8-18,2021-11-09
804,ضذوب905,اختيارخ ذوب-5000-14000917,6,370,18460000,42,60,35,-7,-16.67,50,8,19.05,35,60,1400-8-18,2021-11-09
805,تملي703,تسهيلات مسكن ب. ملي-خرداد97,6,55,31834715,551251,578813,578813,27562,5,578813,27562,5,578813,578813,1400-8-18,2021-11-09
806,اخزا813,اسنادخزانه-م13بودجه98-010219,6,3276,2942680025,898173,898200,898338,165,0.02,898254,81,0.01,898101,898338,1400-8-18,2021-11-09
807,زعف0110پ16,زعفران0110نگين بيرجند(پ),6,2905,819220323,270108,281999,282011,11903,4.41,282004,11896,4.4,281999,282011,1400-8-18,2021-11-09
808,ضخود1055,اختيارخ خودرو-3500-1400/10/08,6,213,3279000,21,10,32,11,52.38,15,-6,-28.57,10,32,1400-8-18,2021-11-09
809,طخود1052,اختيارف خودرو-2000-1400/10/08,5,140,13800000,100,100,90,-10,-10,99,-1,-1,90,100,1400-8-18,2021-11-09
810,اراد61,مرابحه عام دولت61-ش.خ0309,5,42300,42300040000,1000000,1000000,1000001,1,0,1000001,1,0,1000000,1000001,1400-8-18,2021-11-09
811,اخزا723,اسنادخزانه-م23بودجه97-000824,5,63,62820450,995298,997495,997475,2177,0.22,997150,1852,0.19,995540,997495,1400-8-18,2021-11-09
812,گوهر2,صندوق سكه طلاي كيان,5,50000,50000,59770,1,1,-59769,-100,1,-59769,-100,1,1,1400-8-18,2021-11-09
813,تملي704,تسهيلات مسكن ب. ملي-تير97,5,41,25505526,610911,641456,641456,30545,5,622086,11175,1.83,580366,641456,1400-8-18,2021-11-09
814,ضذوب904,اختيارخ ذوب-4500-14000917,5,225,71600000,150,255,500,350,233.33,318,168,112,150,500,1400-8-18,2021-11-09
815,سيناد,صندوق س.سپهرسودمند سينا-د,5,14959,149869262,10017,10019,10019,2,0.02,10019,2,0.02,10018,10019,1400-8-18,2021-11-09
816,ضبدر1163,اختيارخ شبندر-6000-1400/11/13,4,40,71500000,1520,1700,1800,280,18.42,1787,267,17.57,1700,1800,1400-8-18,2021-11-09
817,طخود1051,اختيارف خودرو-1800-1400/10/08,4,101,3038000,33,40,30,-3,-9.09,30,-3,-9.09,28,40,1400-8-18,2021-11-09
818,اراد864,مرابحه عام دولت86-ش.خ020404,4,77000000,70846322000000,940000,920096,920069,-19931,-2.12,920082,-19918,-2.12,920069,920096,1400-8-18,2021-11-09
819,هفجر102,اختيارف ت بفجر8626-01/02/11,4,4450,4450,1,1,1,0,0,1,0,0,1,1,1400-8-18,2021-11-09
820,هفارس104,اختيارف ت فارس-11832-01/04/12,4,114041,114041,1,1,1,0,0,1,0,0,1,1,1400-8-18,2021-11-09
821,اخزا821,اسنادخزانه-م21بودجه98-020906,4,17573,11285582152,642114,642100,642304,190,0.03,642211,97,0.02,642100,642304,1400-8-18,2021-11-09
822,ثقزوي,شركت عمران و سازندگي قزوين,4,1778,50737008,29418,28536,28536,-882,-3,29413,-5,-0.02,28536,28536,1400-8-18,2021-11-09
823,سي تيپ2ن04,گواهي سيمان تيپ2فارس نو(ن),4,75000,466275000,6036,6217,6217,181,3,6217,181,3,6217,6217,1400-8-18,2021-11-09
824,ضپال2006,اختيارخ اپال-28000-1401/02/12,3,20,25800000,1287,1300,1280,-7,-0.54,1290,3,0.23,1280,1300,1400-8-18,2021-11-09
825,سي تيپ2ن10,گواهي سيمان تيپ 2غرب(ن),3,90000,431460000,4794,4794,4794,0,0,4794,0,0,4794,4794,1400-8-18,2021-11-09
826,اراد43,مرابحه عام دولت4-ش.خ 0205,3,53600,49783680000,924710,928800,928800,4090,0.44,928800,4090,0.44,928800,928800,1400-8-18,2021-11-09
827,ضفلا1160,اختيارخ فولاد-7000-1400/11/24,3,4,20214000,5300,5500,4607,-693,-13.08,5053,-247,-4.66,4607,5500,1400-8-18,2021-11-09
828,وسقم,شركت س استان قم,3,16000,20304000,1335,1269,1269,-66,-4.94,1335,0,0,1269,1269,1400-8-18,2021-11-09
829,ضشنا1051,اختيارخ شپنا-8719-1400/10/19,3,50,17300000,370,340,350,-20,-5.41,346,-24,-6.49,340,350,1400-8-18,2021-11-09
830,افران2,صندوق س افرا نماد پايدار-ثابت,3,29600000,29600000,14686,1,1,-14685,-99.99,1,-14685,-99.99,1,1,1400-8-18,2021-11-09
831,سي تيپ2ن12,گواهي سيمان تيپ2خزر(ن),3,120000,575280000,4794,4794,4794,0,0,4794,0,0,4794,4794,1400-8-18,2021-11-09
832,هنوري102,اختيارف ت نوري59561-01/02/15,3,1135,1135,1,1,1,0,0,1,0,0,1,1,1400-8-18,2021-11-09
833,كشم0101پ01,كشمش سبز0101خليل آباد(پ),3,45,28595250,660450,663450,627450,-33000,-5,635450,-25000,-3.79,627450,663450,1400-8-18,2021-11-09
834,افاد53,منفعت دولت5-ش.خاص كاريزما0108,3,3200,3198999900,964000,990000,1000000,36000,3.73,999687,35687,3.7,990000,1000000,1400-8-18,2021-11-09
835,طفلا1164,اختيارف فولاد-12000-1400/11/24,3,8,4400000,500,550,550,50,10,550,50,10,550,550,1400-8-18,2021-11-09
836,وسخراج,شركت س استان خراسان جنوبي,3,4900,10304700,2213,2103,2103,-110,-4.97,2213,0,0,2103,2103,1400-8-18,2021-11-09
837,ضترا1132,اختيارخ شتران-3970-1400/11/10,3,10,33936990,1100,1490,1500,400,36.36,1497,397,36.09,1490,1500,1400-8-18,2021-11-09
838,مبين015,اجاره اعتماد مبين تمدن011019,3,60000,60000000000,994500,1000000,1000000,5500,0.55,1000000,5500,0.55,1000000,1000000,1400-8-18,2021-11-09
839,ضمخا1037,اختيارخ اخابر-9000-1400/10/26,3,3,2020000,660,650,690,30,4.55,673,13,1.97,650,690,1400-8-18,2021-11-09
840,زعف0008پ19,زعفران0008نگين تروند قاينات(پ),3,2174,508200762,228198,233763,233763,5565,2.44,233763,5565,2.44,233763,233763,1400-8-18,2021-11-09
841,ضمخا1039,اختيارخ اخابر-12000-1400/10/26,3,200,7600000,1,38,38,37,3700,38,37,3700,38,38,1400-8-18,2021-11-09
842,پا ه 8,بار پايه هفته 8,2,150000,84000000,561,560,560,-1,-0.18,560,-1,-0.18,560,560,1400-8-18,2021-11-09
843,اراد24,مرابحه عام دولت2-ش.خ ساير0212,2,35000,35000000000,1000000,1000000,1000000,0,0,1000000,0,0,1000000,1000000,1400-8-18,2021-11-09
844,اراد404,مرابحه عام دولت4-ش.خ 0207,2,14000000,12903079000000,1000000,921422,921875,-78125,-7.81,921648,-78352,-7.84,921422,921875,1400-8-18,2021-11-09
845,نتوس,پشم‌ بافي‌ توس,2,820,10020400,12863,12220,12220,-643,-5,12862,-1,-0.01,12220,12220,1400-8-18,2021-11-09
846,اراد384,مرابحه عام دولت3-ش.خ 0105,2,2300000,2214067400000,978670,962657,962619,-16051,-1.64,962638,-16032,-1.64,962619,962657,1400-8-18,2021-11-09
847,ثروت,ص.خ.ثروت آفرين فيروزه 35%تاديه,2,2000,439794000,244330,219897,219897,-24433,-10,219897,-24433,-10,219897,219897,1400-8-18,2021-11-09
848,آريا2,پليمر آريا ساسول,2,2515000,305925500000,118276,120641,122300,4024,3.4,121640,3364,2.84,120641,122300,1400-8-18,2021-11-09
849,اراد42,مرابحه عام دولت4-ش.خ 0106,2,1000,979999500,958394,979999,980000,21606,2.25,979999,21605,2.25,979999,980000,1400-8-18,2021-11-09
850,ثبات4,صندوق س. ثبات ويستا -د,2,56312768,583062399872,10347,10354,10354,7,0.07,10354,7,0.07,10354,10354,1400-8-18,2021-11-09
851,صفارس412,صكوك اجاره خليج فارس- 3ماهه16%,2,10,10100000,1000000,1020000,1000000,0,0,1010000,10000,1,1000000,1020000,1400-8-18,2021-11-09
852,ضفلا1164,اختيارخ فولاد-12000-1400/11/24,2,3,4440000,1461,1400,1520,59,4.04,1480,19,1.3,1400,1520,1400-8-18,2021-11-09
853,اخزا904,اسنادخزانه-م4بودجه99-011215,2,430,323497307,752065,752305,752352,287,0.04,752319,254,0.03,752305,752352,1400-8-18,2021-11-09
854,ضملي1159,اختيارخ فملي-5000-1400/11/03,2,25,107500000,4300,4300,4300,0,0,4300,0,0,4300,4300,1400-8-18,2021-11-09
855,شپديس2,پتروشيمي پرديس,2,1050000,207375000000,193770,197500,197500,3730,1.92,197500,3730,1.92,197500,197500,1400-8-18,2021-11-09
856,صبا14044,اجاصبابدون ضامن بارتبه اعتباري,2,2000000,2000000000000,1000000,1000000,1000000,0,0,1000000,0,0,1000000,1000000,1400-8-18,2021-11-09
857,تملي801,تسهيلات مسكن ب. ملي-فروردين98,2,23,13110000,549000,570000,570000,21000,3.83,570000,21000,3.83,570000,570000,1400-8-18,2021-11-09
858,تملي705,تسهيلات مسكن ب. ملي-مرداد97,2,21,12156468,583044,612196,553892,-29152,-5,578879,-4165,-0.71,553892,612196,1400-8-18,2021-11-09
859,اراد314,مرابحه عام دولت3-ش.خ 0208,2,1430000,1230744000000,900000,905100,813000,-87000,-9.67,860660,-39340,-4.37,813000,905100,1400-8-18,2021-11-09
860,ضاريا1205,اختيارخ آريا-127000-14001215,2,10,250000000,24000,25000,25000,1000,4.17,25000,1000,4.17,25000,25000,1400-8-18,2021-11-09
861,وغدير2,سرمايه‌گذاري‌غدير(هلدينگ‌,2,9500000,150005000000,15510,15790,15790,280,1.81,15790,280,1.81,15790,15790,1400-8-18,2021-11-09
862,ضذوب903,اختيارخ ذوب-4000-14000917,2,65,54600000,250,840,840,590,236,840,590,236,840,840,1400-8-18,2021-11-09
863,كمند2,صندوق س. با درآمد ثابت كمند,1,15000000,15000000,10011,1,1,-10010,-99.99,1,-10010,-99.99,1,1,1400-8-18,2021-11-09
864,آوا2,صندوق س.سهام آواي معيار-س,1,500000,500000,8155,1,1,-8154,-99.99,1,-8154,-99.99,1,1,1400-8-18,2021-11-09
865,دامين2,داروسازي‌ امين‌,1,33516368,95488132432,2874,2849,2849,-25,-0.87,2849,-25,-0.87,2849,2849,1400-8-18,2021-11-09
866,اروند09,منفعت صبا اروند نوين 14001222,1,10,9568000,956800,956800,956800,0,0,956800,0,0,956800,956800,1400-8-18,2021-11-09
867,ضبدر1164,اختيارخ شبندر-7000-1400/11/13,1,67,67000000,1100,1000,1000,-100,-9.09,1000,-100,-9.09,1000,1000,1400-8-18,2021-11-09
868,كنور2,توسعه معدني و صنعتي صبانور,1,21600000,411912000000,18680,19070,19070,390,2.09,19070,390,2.09,19070,19070,1400-8-18,2021-11-09
869,کم ه 8,کم باري هفته 8,1,1000,519000,579,519,519,-60,-10.36,519,-60,-10.36,519,519,1400-8-18,2021-11-09
870,صفارس307,صكوك اجاره فارس307- 3ماهه18%,1,500,485000000,990000,970000,970000,-20000,-2.02,970000,-20000,-2.02,970000,970000,1400-8-18,2021-11-09
871,وسخراش,شركت س استان خراسان شمالي,1,10000,13010000,1369,1301,1301,-68,-4.97,1369,0,0,1301,1301,1400-8-18,2021-11-09
872,كهربا2,صندوق س.پشتوانه سكه طلا كهربا,1,5000000,5000000,10398,1,1,-10397,-99.99,1,-10397,-99.99,1,1,1400-8-18,2021-11-09
873,هماي2,صندوق س هماي آگاه-ثابت,1,5103000,5103000,10102,1,1,-10101,-99.99,1,-10101,-99.99,1,1,1400-8-18,2021-11-09
874,اخزا9172,اسنادخزانه-م17بودجه99-010226,1,100000,89700000000,893295,897000,897000,3705,0.41,897000,3705,0.41,897000,897000,1400-8-18,2021-11-09
875,ضپيك1032,اختيارخ تاپيكو-16000-00/10/15,1,100,77000000,700,770,770,70,10,770,70,10,770,770,1400-8-18,2021-11-09
876,تملي807,تسهيلات مسكن ب. ملي-مهر98,1,10,6805370,716354,680537,680537,-35817,-5,680537,-35817,-5,680537,680537,1400-8-18,2021-11-09
877,بتك,كارخانجات كابل سازي‌ تك‌,1,1014,36192702,34321,35693,35693,1372,4,34352,31,0.09,35693,35693,1400-8-18,2021-11-09
878,هرمز2,فولاد هرمزگان جنوب,1,8420000,149960200000,17796,17810,17810,14,0.08,17810,14,0.08,17810,17810,1400-8-18,2021-11-09
879,مشهد0212,مشاركت ش مشهد0212-3ماهه18%,1,160,160000160,1000001,1000001,1000001,0,0,1000001,0,0,1000001,1000001,1400-8-18,2021-11-09
880,كمند4,صندوق س. با درآمد ثابت كمند,1,150000000,1502550000000,10011,10017,10017,6,0.06,10017,6,0.06,10017,10017,1400-8-18,2021-11-09
881,اراد624,مرابحه عام دولت62-ش.خ0309,1,496000,496000000000,1000000,1000000,1000000,0,0,1000000,0,0,1000000,1000000,1400-8-18,2021-11-09
882,کم ر 8,کم باري روز 8,1,19000,11020000,580,580,580,0,0,580,0,0,580,580,1400-8-18,2021-11-09
883,ماهان01,منفعت هواپيمايي ماهان 14011123,1,8,7544000,952430,943000,943000,-9430,-0.99,943000,-9430,-0.99,943000,943000,1400-8-18,2021-11-09
884,ضپاس1010,اختيارخ وپارس-1800-1400/10/22,1,28,17500000,538,625,625,87,16.17,625,87,16.17,625,625,1400-8-18,2021-11-09
885,مكرما3042,مشاركت ش كرمانشاه304-3ماهه18%,1,86600,86600000000,1030000,1000000,1000000,-30000,-2.91,1000000,-30000,-2.91,1000000,1000000,1400-8-18,2021-11-09
886,ضبدر8073,اختيارخ شبندر-2167-1400/08/30,1,1,23326320,4300,4980,4980,680,15.81,4980,680,15.81,4980,4980,1400-8-18,2021-11-09
887,ضملي1161,اختيارخ فملي-7000-1400/11/03,1,1,2000000,2015,2000,2000,-15,-0.74,2000,-15,-0.74,2000,2000,1400-8-18,2021-11-09
888,زعف0110پ09,زعفران0110نگين نوين(پ),1,18,5220000,252000,290000,290000,38000,15.08,290000,38000,15.08,290000,290000,1400-8-18,2021-11-09
889,مكرما0342,مشاركت ش كرمانشاه034-3ماهه18%,1,71000,71000000000,1020000,1000000,1000000,-20000,-1.96,1000000,-20000,-1.96,1000000,1000000,1400-8-18,2021-11-09
890,داريوش2,صندوق س. ثروت داريوش -س,1,500000,500000,9728,1,1,-9727,-99.99,1,-9727,-99.99,1,1,1400-8-18,2021-11-09
891,ضجار1020,اختيارخ وتجارت-1600-1400/10/15,1,10,5900000,640,590,590,-50,-7.81,590,-50,-7.81,590,590,1400-8-18,2021-11-09
892,ضسپا1115,اختيارخ خساپا-2500-1400/11/20,1,100,20000000,80,200,200,120,150,200,120,150,200,200,1400-8-18,2021-11-09
893,کم ر 9,کم باري روز 9,1,19000,11020000,580,580,580,0,0,580,0,0,580,580,1400-8-18,2021-11-09
894,شسم,توليد سموم‌ علف‌ كش,1,39,4078308,100550,104572,104572,4022,4,100553,3,0,104572,104572,1400-8-18,2021-11-09
895,فولاد2,فولاد مباركه اصفهان,1,12600000,150318000000,11940,11930,11930,-10,-0.08,11930,-10,-0.08,11930,11930,1400-8-18,2021-11-09
896,پارسا306,صكوك اجاره پارسيان-6ماهه16%,1,500,484000000,983000,968000,968000,-15000,-1.53,968000,-15000,-1.53,968000,968000,1400-8-18,2021-11-09
897,شخارك2,پتروشيمي‌ خارك‌,1,400000,22028000000,55070,55070,55070,0,0,55070,0,0,55070,55070,1400-8-18,2021-11-09
898,هپارس102,اختيارف ت پارس-157010-01/02/05,1,12,12,1,1,1,0,0,1,0,0,1,1,1400-8-18,2021-11-09
899,سي تيپ2ن03,گواهي سيمان تيپ2اروميه(ن),1,20000,95880000,4794,4794,4794,0,0,4794,0,0,4794,4794,1400-8-18,2021-11-09
900,حاريا,كشتيراني آريا,1,350,5338900,15565,15254,15254,-311,-2,15565,0,0,15254,15254,1400-8-18,2021-11-09
901,اراد56,مرابحه عام دولت5-ش.خ 0308,1,1000,1000000000,1010000,1000000,1000000,-10000,-0.99,1000000,-10000,-0.99,1000000,1000000,1400-8-18,2021-11-09
902,طگل8080,اختيارف كگل-28000-1400/08/23,1,2,6000000,1000,3000,3000,2000,200,3000,2000,200,3000,3000,1400-8-18,2021-11-09
903,گواهي ظرفيت,گواهي ظرفيت نقدي,1,1800000,53118000000,28105,29510,29510,1405,5,28206,101,0.36,29510,29510,1400-8-18,2021-11-09
904,اراد22,مرابحه عام دولت2-ش.خ لوتوس0212,1,2000,1980000000,1000000,990000,990000,-10000,-1,990000,-10000,-1,990000,990000,1400-8-18,2021-11-09
905,فسديد,لوله‌وتجهيزات‌ سديد - ورشكسته,1,1839,190715334,105822,103706,103706,-2116,-2,105723,-99,-0.09,103706,103706,1400-8-18,2021-11-09
906,زعف0110پ19,زعفران0110نگين تروند قاينات(پ),1,20,5500040,291877,275002,275002,-16875,-5.78,275002,-16875,-5.78,275002,275002,1400-8-18,2021-11-09
907,صپا ه 8,بار پايه هفته 8صنعتي,1,9000,5040000,580,560,560,-20,-3.45,560,-20,-3.45,560,560,1400-8-18,2021-11-09
908,سي تيپ2ن06,گواهي سيمان تيپ 2شاهرود(ن),1,25000,119850000,4794,4794,4794,0,0,4794,0,0,4794,4794,1400-8-18,2021-11-09
909,تاپيكو2,س. نفت و گاز و پتروشيمي تأمين,1,10000000,146500000000,14400,14650,14650,250,1.74,14650,250,1.74,14650,14650,1400-8-18,2021-11-09
910,کم ر 1,کم باري روز 1,1,3000,1740000,234,580,580,346,147.86,580,346,147.86,580,580,1400-8-18,2021-11-09
911,فملي2,ملي‌ صنايع‌ مس‌ ايران‌,1,10000000,138500000000,13540,13850,13850,310,2.29,13850,310,2.29,13850,13850,1400-8-18,2021-11-09
912,تملي706,تسهيلات مسكن ب. ملي-شهريور97,1,9,5985000,648318,665000,665000,16682,2.57,665000,16682,2.57,665000,665000,1400-8-18,2021-11-09
913,واميد2,گروه مديريت سرمايه گذاري اميد,1,15000000,189750000000,12650,12650,12650,0,0,12650,0,0,12650,12650,1400-8-18,2021-11-09
914,وتوشه2,سرمايه‌ گذاري‌ پارس‌ توشه‌,1,5974494,35787219060,5970,5990,5990,20,0.34,5990,20,0.34,5990,5990,1400-8-18,2021-11-09
915,دمعيار2,صندوق س. توازن معيار-د,1,400000,400000,10085,1,1,-10084,-99.99,1,-10084,-99.99,1,1,1400-8-18,2021-11-09
916,اراد89,مرابحه عام دولت89-ش.خ041120,1,10000,10000000000,1000000,1000000,1000000,0,0,1000000,0,0,1000000,1000000,1400-8-18,2021-11-09
917,ضسان1054,اختيارخ پارسان-36000-00/10/12,1,1,4000000,6000,4000,4000,-2000,-33.33,4000,-2000,-33.33,4000,4000,1400-8-18,2021-11-09
918,اراد62,مرابحه عام دولت62-ش.خ0309,1,10000,10000000000,1000000,1000000,1000000,0,0,1000000,0,0,1000000,1000000,1400-8-18,2021-11-09
919,مشهد0012,مشاركت شهرداري مشهد-3ماهه20%,1,6,6000000,1000000,1000000,1000000,0,0,1000000,0,0,1000000,1000000,1400-8-18,2021-11-09
920,اراد544,مرابحه عام دولت5-ش.خ 0109,1,2000000,1896180000000,990000,948090,948090,-41910,-4.23,948090,-41910,-4.23,948090,948090,1400-8-18,2021-11-09
921,فارس2,صنايع پتروشيمي خليج فارس,1,36942000,459558480000,12490,12440,12440,-50,-0.4,12440,-50,-0.4,12440,12440,1400-8-18,2021-11-09
922,اراد75,مرابحه عام دولت75-ش.خ040226,1,1000,972500000,992500,972500,972500,-20000,-2.02,972500,-20000,-2.02,972500,972500,1400-8-18,2021-11-09
923,ضسپا8046,اختيارخ خساپا-3500-1400/08/26,1,15,15000,2,1,1,-1,-50,1,-1,-50,1,1,1400-8-18,2021-11-09
924,آرمان,بيمه آرمان,1,2600,15418000,6113,5930,5930,-183,-2.99,6113,0,0,5930,5930,1400-8-18,2021-11-09
925,شلرد022,كود شيميايي اوره لردگان,1,55000,55000000000,997000,1000000,1000000,3000,0.3,1000000,3000,0.3,1000000,1000000,1400-8-18,2021-11-09
926,ضمخا1040,اختيارخ اخابر-14000-1400/10/26,1,14,532000,1,38,38,37,3700,38,37,3700,38,38,1400-8-18,2021-11-09
927,اراد76,مرابحه عام دولت76-ش.خ030406,1,4000,3892000000,960000,973000,973000,13000,1.35,973000,13000,1.35,973000,973000,1400-8-18,2021-11-09
928,وسزنجان,شركت س استان زنجان,1,11000,14839000,1419,1349,1349,-70,-4.93,1419,0,0,1349,1349,1400-8-18,2021-11-09
929,اراد904,مرابحه عام دولت90-ش.خ050217,1,1000000,1000000000000,1000000,1000000,1000000,0,0,1000000,0,0,1000000,1000000,1400-8-18,2021-11-09
930,اراد764,مرابحه عام دولت76-ش.خ030406,1,3504000,3504000000000,960000,1000000,1000000,40000,4.17,1000000,40000,4.17,1000000,1000000,1400-8-18,2021-11-09
931,ضمخا1038,اختيارخ اخابر-10000-1400/10/26,1,5,1500000,1,300,300,299,29900,300,299,29900,300,300,1400-8-18,2021-11-09
932,شاراك2,پتروشيمي شازند,1,9140000,459559200000,48040,50280,50280,2240,4.66,50280,2240,4.66,50280,50280,1400-8-18,2021-11-09
933,اراد33,مرابحه عام دولت3-ش.خ 0303,1,500,469500000,900000,939000,939000,39000,4.33,939000,39000,4.33,939000,939000,1400-8-18,2021-11-09
934,تابان01,اجاره تابان تمدن14021206,1,200,183600000,900000,918000,918000,18000,2,918000,18000,2,918000,918000,1400-8-18,2021-11-09
935,ياقوت2,صندوق س ياقوت آگاه-ثابت,1,14787000,14787000,13520,1,1,-13519,-99.99,1,-13519,-99.99,1,1,1400-8-18,2021-11-09
936,افاد51,منفعت دولت5-ش.خاص كاردان0108,1,25000,24999975000,964904,999999,999999,35095,3.64,999999,35095,3.64,999999,999999,1400-8-18,2021-11-09
937,وبشهر2,توسعه‌ صنايع‌ بهشهر(هلدينگ,1,15000000,204300000000,13620,13620,13620,0,0,13620,0,0,13620,13620,1400-8-18,2021-11-09
938,طخود1050,اختيارف خودرو-1600-1400/10/08,1,100,2000000,11,20,20,9,81.82,20,9,81.82,20,20,1400-8-18,2021-11-09
939,ضغدر1133,اختيارخ وغدير-16000-1400/11/20,1,10,28000000,1250,2800,2800,1550,124,2800,1550,124,2800,2800,1400-8-18,2021-11-09
940,سي تيپ2ن07,گواهي سيمان تيپ 2تهران(ن),1,10000,62120000,6032,6212,6212,180,2.98,6212,180,2.98,6212,6212,1400-8-18,2021-11-09
941,ضبدر8074,اختيارخ شبندر-2595-1400/08/30,1,6,123798120,3348,4405,4405,1057,31.57,4405,1057,31.57,4405,4405,1400-8-18,2021-11-09
942,سي تيپ2ن05,گواهي سيمان تيپ 2خاش(ن),1,25000,174000000,6758,6960,6960,202,2.99,6960,202,2.99,6960,6960,1400-8-18,2021-11-09
943,ضفلا1162,اختيارخ فولاد-9000-1400/11/24,1,3,9600000,3711,3200,3200,-511,-13.77,3200,-511,-13.77,3200,3200,1400-8-18,2021-11-09
944,شبهرن2,نفت‌ بهران‌,1,15000000,185250000000,12050,12350,12350,300,2.49,12350,300,2.49,12350,12350,1400-8-18,2021-11-09
