,نماد,نام,تعداد,حجم,ارزش,دیروز,اولین,آخرین معامله - مقدار,آخرین معامله - تغییر,آخرین معامله - درصد,قیمت پایانی - مقدار,قیمت پایانی - تغییر,قیمت پایانی - درصد,کمترین,بیشترین,تاریخ,gregorian_date
0,پالايش,صندوق پالايشي يكم-سهام,17945,21593771,1534187148940,71390,71000,71350,-40,-0.06,71050,-340,-0.48,70510,71540,1400-10-11,2022-01-01
1,خودرو,ايران‌ خودرو,13392,483417009,920963999683,1997,1932,1898,-99,-4.96,1905,-92,-4.61,1898,1950,1400-10-11,2022-01-01
2,دارا يكم,صندوق واسطه گري مالي يكم-سهام,10493,7065646,782879660790,112910,111600,110490,-2420,-2.14,110800,-2110,-1.87,110050,111980,1400-10-11,2022-01-01
3,خاور,ايران خودرو ديزل,10386,615512464,838155843581,1306,1319,1371,65,4.98,1362,56,4.29,1258,1371,1400-10-11,2022-01-01
4,خپارس,پارس‌ خودرو,8142,383536482,417221375004,1084,1069,1078,-6,-0.55,1088,4,0.37,1055,1118,1400-10-11,2022-01-01
5,خساپا,سايپا,6842,228903227,375097680087,1711,1680,1626,-85,-4.97,1639,-72,-4.21,1626,1689,1400-10-11,2022-01-01
6,بركت,گروه دارويي بركت,6520,20836534,365622483840,17290,17190,17450,160,0.93,17550,260,1.5,16710,17900,1400-10-11,2022-01-01
7,فولاد,فولاد مباركه اصفهان,6498,54312297,572053019020,10820,10680,10480,-340,-3.14,10530,-290,-2.68,10450,10680,1400-10-11,2022-01-01
8,فملي,ملي‌ صنايع‌ مس‌ ايران‌,6456,68965439,497499808160,7230,7150,7240,10,0.14,7210,-20,-0.28,7090,7290,1400-10-11,2022-01-01
9,شبندر,پالايش نفت بندرعباس,6371,74112024,479453881140,6630,6510,6500,-130,-1.96,6470,-160,-2.41,6350,6570,1400-10-11,2022-01-01
10,كارين,صندوق س نگين سامان-ثابت,6301,328701676,3307732336627,10046,10064,10063,17,0.17,10063,17,0.17,10062,10065,1400-10-11,2022-01-01
11,فرابورس,فرابورس ايران,5974,22419003,420578544875,18985,18550,18480,-505,-2.66,18760,-225,-1.19,18200,19150,1400-10-11,2022-01-01
12,كالا,بورس كالاي ايران,5853,13635922,423690679830,30710,30100,30930,220,0.72,31070,360,1.17,29550,31800,1400-10-11,2022-01-01
13,شتران,پالايش نفت تهران,5611,55871698,229157019761,4236,4120,4100,-136,-3.21,4101,-135,-3.19,4051,4190,1400-10-11,2022-01-01
14,شپنا,پالايش نفت اصفهان,4935,40084145,245513082900,6290,6120,6130,-160,-2.54,6120,-170,-2.7,6010,6230,1400-10-11,2022-01-01
15,خگستر,گسترش‌سرمايه‌گذاري‌ايران‌خودرو,4929,163438104,377177126454,2413,2340,2293,-120,-4.97,2308,-105,-4.35,2293,2391,1400-10-11,2022-01-01
16,فجهان,مجتمع جهان فولاد سيرجان,4805,20067386,110375307410,5389,5500,5503,114,2.12,5500,111,2.06,5499,5508,1400-10-11,2022-01-01
17,كارين2,صندوق س نگين سامان-ثابت,4750,475000000,475000000,10046,1,1,-10045,-99.99,1,-10045,-99.99,1,1,1400-10-11,2022-01-01
18,وتجارت,بانك تجارت,4158,142064559,273529266913,1995,1950,1935,-60,-3.01,1925,-70,-3.51,1899,1980,1400-10-11,2022-01-01
19,پترول,گ.س.وت.ص.پتروشيمي خليج فارس,3998,78204856,184606413087,2474,2431,2351,-123,-4.97,2361,-113,-4.57,2351,2433,1400-10-11,2022-01-01
20,فسبزوار,پارس فولاد سبزوار,3936,2476379,85374519220,34410,34420,34410,0,0,34480,70,0.2,34220,35000,1400-10-11,2022-01-01
21,وبملت,بانك ملت,3887,80256897,253364951140,3238,3171,3148,-90,-2.78,3157,-81,-2.5,3126,3230,1400-10-11,2022-01-01
22,گدنا,تهيه توزيع غذاي دنا آفرين فدك,3526,9318215,117340409843,12668,13301,12190,-478,-3.77,12593,-75,-0.59,12035,13301,1400-10-11,2022-01-01
23,وسديد,گروه ‌صنعتي‌سديد,3467,67728914,74927689113,1078,1093,1099,21,1.95,1106,28,2.6,1055,1110,1400-10-11,2022-01-01
24,انرژي3,سايراشخاص بورس انرژي,3456,1716909,160980026050,94950,94000,93240,-1710,-1.8,93760,-1190,-1.25,93000,95660,1400-10-11,2022-01-01
25,وخارزم,سرمايه گذاري خوارزمي,3253,42307382,184358795038,4567,4500,4339,-228,-4.99,4358,-209,-4.58,4339,4510,1400-10-11,2022-01-01
26,كمند,صندوق س. با درآمد ثابت كمند,3221,119738587,1214582845642,10127,10144,10144,17,0.17,10144,17,0.17,10143,10144,1400-10-11,2022-01-01
27,كيان,صندوق س. با درآمد ثابت كيان,3193,29451869,953109225721,32327,32360,32361,34,0.11,32362,35,0.11,32359,32370,1400-10-11,2022-01-01
28,بورس,بورس اوراق بهادار تهران,3053,18508225,214458635540,11830,11500,11450,-380,-3.21,11590,-240,-2.03,11370,11850,1400-10-11,2022-01-01
29,وبصادر,بانك صادرات ايران,3020,140492427,267549672870,1959,1890,1899,-60,-3.06,1904,-55,-2.81,1890,1950,1400-10-11,2022-01-01
30,خزاميا,زامياد,2988,43789398,352728068280,8450,8150,8030,-420,-4.97,8060,-390,-4.62,8030,8230,1400-10-11,2022-01-01
31,ولپارس,ليزينگ پارسيان,2962,24579195,77051123542,3033,3098,3184,151,4.98,3135,102,3.36,3035,3184,1400-10-11,2022-01-01
32,خبهمن,گروه‌بهمن‌,2939,100533167,196372374202,2028,2001,1960,-68,-3.35,1953,-75,-3.7,1927,2010,1400-10-11,2022-01-01
33,وبرق,س.کارکنان صنعت برق زنجان وقزوي,2881,2645151,305313387059,113184,109789,115800,2616,2.31,115424,2240,1.98,109789,116579,1400-10-11,2022-01-01
34,غبهار,كشت وصنعت بهاران گلبهار خراسان,2786,13291035,230952643468,17085,17597,17597,512,3,17377,292,1.71,16573,17597,1400-10-11,2022-01-01
35,تسه0009,امتيازتسهيلات مسكن آذر 1400,2757,229251,236299484457,1032361,1030000,980743,-51618,-5,1030746,-1615,-0.16,980743,1040000,1400-10-11,2022-01-01
36,مديريت,س. و خدمات مديريت صند. ب كشوري,2697,4795282,44134761518,9315,9180,9265,-50,-0.54,9204,-111,-1.19,9130,9350,1400-10-11,2022-01-01
37,توسن,توسعه سامانه ي نرم افزاري نگين,2673,6343706,125047145955,20702,20939,19780,-922,-4.45,19712,-990,-4.78,19667,20939,1400-10-11,2022-01-01
38,كيسون,شركت كيسون,2636,75427017,129644767702,1677,1680,1698,21,1.25,1719,42,2.5,1660,1727,1400-10-11,2022-01-01
39,چخزر,صنايع چوب خزر كاسپين,2566,2099624,66971292668,30761,31196,31850,1089,3.54,31897,1136,3.69,29400,32299,1400-10-11,2022-01-01
40,تليسه,دامداري تليسه نمونه,2537,61381984,137522016780,2184,2180,2293,109,4.99,2240,56,2.56,2090,2293,1400-10-11,2022-01-01
41,ذوب,ذوب آهن اصفهان,2502,47410194,171712691914,3737,3640,3640,-97,-2.6,3622,-115,-3.08,3560,3682,1400-10-11,2022-01-01
42,حآفرين,ريل پرداز نو آفرين,2421,25769556,112361881648,4361,4280,4300,-61,-1.4,4360,-1,-0.02,4200,4500,1400-10-11,2022-01-01
43,كاما,باما,2373,20221853,136487587960,7080,6950,6740,-340,-4.8,6750,-330,-4.66,6730,6960,1400-10-11,2022-01-01
44,كيمياتك,آريان كيميا تك,2351,1024297,24463072650,24240,23720,23890,-350,-1.44,23880,-360,-1.49,23720,24480,1400-10-11,2022-01-01
45,اعتماد,صندوق س.اعتماد آفرين پارسيان-د,2345,50550010,2073897867720,40985,41026,41028,43,0.1,41027,42,0.1,41025,41028,1400-10-11,2022-01-01
46,سحرخيز,صندوق س. گروه زعفران سحرخيز,2244,6410258,120751529038,18229,18100,19250,1021,5.6,18837,608,3.34,18100,19343,1400-10-11,2022-01-01
47,آريا,پليمر آريا ساسول,2186,659461,73445381553,113907,112310,112250,-1657,-1.45,112003,-1904,-1.67,110800,113549,1400-10-11,2022-01-01
48,نوري,پتروشيمي نوري,2159,1635920,180360208120,114590,109100,109910,-4680,-4.08,110250,-4340,-3.79,109100,111990,1400-10-11,2022-01-01
49,ثنور,سرمايه گذاري كوه نور,2153,17506862,139545968184,7974,8200,7883,-91,-1.14,7971,-3,-0.04,7735,8212,1400-10-11,2022-01-01
50,امين يكم,صندوق درآمد ثابت امين يكم فردا,2105,52841343,530859919358,10034,10046,10050,16,0.16,10046,12,0.12,10045,10050,1400-10-11,2022-01-01
51,غصينو,صنعتي مينو,2085,6634078,119382821003,18803,17960,18100,-703,-3.74,17995,-808,-4.3,17863,18395,1400-10-11,2022-01-01
52,حكشتي,كشتيراني جمهوري اسلامي ايران,2048,9965673,142427846550,14250,14140,14070,-180,-1.26,14290,40,0.28,13910,14520,1400-10-11,2022-01-01
53,بهپاك,صنعتي بهپاك,2031,27137599,188335174425,6780,6950,6840,60,0.88,6940,160,2.36,6610,7119,1400-10-11,2022-01-01
54,بوعلي,پتروشيمي بوعلي سينا,2011,1195603,88767439330,76000,74800,74300,-1700,-2.24,74410,-1590,-2.09,73610,75170,1400-10-11,2022-01-01
55,حفارس,حمل و نقل بين المللي خليج فارس,1991,31108502,139808178199,4303,4518,4509,206,4.79,4494,191,4.44,4322,4518,1400-10-11,2022-01-01
56,شگويا,پتروشيمي تندگويان,1967,5602920,63357653356,11633,11600,11264,-369,-3.17,11443,-190,-1.63,11210,11600,1400-10-11,2022-01-01
57,سپيد,سپيد ماكيان,1938,1739409,104276056240,59820,60000,60000,180,0.3,59950,130,0.22,58900,60900,1400-10-11,2022-01-01
58,شاروم,پتروشيمي اروميه,1919,1972441,27837556637,14721,14452,14032,-689,-4.68,14113,-608,-4.13,13985,14500,1400-10-11,2022-01-01
59,شپديس,پتروشيمي پرديس,1915,2287484,406856624470,185060,183000,178000,-7060,-3.81,177860,-7200,-3.89,175810,183000,1400-10-11,2022-01-01
60,امين,تامين سرمايه امين,1885,958117,11798351600,12300,12320,12310,10,0.08,12300,0,0,12300,12330,1400-10-11,2022-01-01
61,ثاميد,توسعه و عمران اميد,1869,16409085,23162877696,1472,1433,1416,-56,-3.8,1412,-60,-4.08,1399,1468,1400-10-11,2022-01-01
62,ختوقا,قطعات‌ اتومبيل‌ ايران‌,1842,41286287,104335836009,2517,2415,2485,-32,-1.27,2527,10,0.4,2401,2598,1400-10-11,2022-01-01
63,غزر,صنعتي زر ماكارون,1835,1685528,15481079310,9370,9260,9190,-180,-1.92,9270,-100,-1.07,9130,9330,1400-10-11,2022-01-01
64,صبا,سرمايه گذاري صبا تامين,1834,15303146,94390169404,6264,6290,6199,-65,-1.04,6182,-82,-1.31,6050,6290,1400-10-11,2022-01-01
65,سپيدار,سپيدار سيستم آسيا,1825,407788,8130869039,20528,20101,20003,-525,-2.56,20199,-329,-1.6,19760,20601,1400-10-11,2022-01-01
66,شلرد,كود شيميايي اوره لردگان,1820,19821315,233559217507,11448,11791,11791,343,3,11783,335,2.93,11699,11791,1400-10-11,2022-01-01
67,وغدير,سرمايه‌گذاري‌غدير(هلدينگ‌,1746,11861923,174989437460,15160,14810,15050,-110,-0.73,14750,-410,-2.7,14660,15300,1400-10-11,2022-01-01
68,غكورش,صنعت غذايي كورش,1656,1164344,55936716180,48890,48650,47610,-1280,-2.62,48070,-820,-1.68,47110,48780,1400-10-11,2022-01-01
69,سرو,صندوق س سروسودمند مدبران-سهام,1651,1868094,130054674730,71450,70400,69400,-2050,-2.87,69620,-1830,-2.56,69400,70400,1400-10-11,2022-01-01
70,زاگرس,پتروشيمي زاگرس,1633,308123,65753114332,219869,218001,213300,-6569,-2.99,215486,-4383,-1.99,212802,218001,1400-10-11,2022-01-01
71,ثبهساز,بهساز كاشانه تهران,1623,6864262,10408660098,1553,1530,1541,-12,-0.77,1527,-26,-1.67,1491,1543,1400-10-11,2022-01-01
72,اتكاي,بيمه اتكايي ايرانيان,1560,26876478,292588851539,10531,10680,10800,269,2.55,10886,355,3.37,10290,11057,1400-10-11,2022-01-01
73,بپيوند,برق و انرژي پيوندگستر پارس,1535,940686,8842125008,9732,9600,9420,-312,-3.21,9529,-203,-2.09,9300,9650,1400-10-11,2022-01-01
74,خكاوه,سايپا ديزل,1525,39100826,154455751757,3840,3950,3940,100,2.6,3950,110,2.86,3800,3955,1400-10-11,2022-01-01
75,كچاد,معدني‌وصنعتي‌چادرملو,1517,4208044,128280231760,31140,31200,30550,-590,-1.89,30480,-660,-2.12,30150,31200,1400-10-11,2022-01-01
76,خودكفا,اقتصادي و خودكفايي آزادگان,1504,15644440,111460536156,6974,7050,7131,157,2.25,7125,151,2.17,6800,7183,1400-10-11,2022-01-01
77,وهامون,سرمايه گذاري هامون صبا,1501,6030453,16460784563,2818,2766,2726,-92,-3.26,2730,-88,-3.12,2713,2818,1400-10-11,2022-01-01
78,افران,صندوق س افرا نماد پايدار-ثابت,1495,32890095,497777287836,15110,15134,15135,25,0.17,15135,25,0.17,15134,15135,1400-10-11,2022-01-01
79,وسپهر,سرمايه گذاري مالي سپهرصادرات,1485,4180000,29511062104,7071,7060,7060,-11,-0.16,7067,-4,-0.06,7060,7061,1400-10-11,2022-01-01
80,كزغال,زغال سنگ پروده طبس,1441,693203,21853911595,32621,31770,31700,-921,-2.82,31672,-949,-2.91,31067,31990,1400-10-11,2022-01-01
81,شفن,پتروشيمي فناوران,1437,4184385,53279168190,13090,12900,12720,-370,-2.83,12930,-160,-1.22,12630,12950,1400-10-11,2022-01-01
82,فاراك,ماشين‌ سازي‌ اراك‌,1435,60010299,87611163481,1527,1464,1460,-67,-4.39,1460,-67,-4.39,1451,1488,1400-10-11,2022-01-01
83,قچار,فراوردههاي غذايي وقند چهارمحال,1432,19515858,168059632392,8232,8643,8643,411,4.99,8611,379,4.6,8300,8643,1400-10-11,2022-01-01
84,قثابت,قند ثابت‌ خراسان‌,1427,30861829,52762013261,1774,1740,1700,-74,-4.17,1710,-64,-3.61,1686,1764,1400-10-11,2022-01-01
85,سمايه,بانك سرمايه,1427,14910902,77473796879,5193,5348,5038,-155,-2.98,5196,3,0.06,5038,5348,1400-10-11,2022-01-01
86,سصفها,سيمان‌اصفهان‌,1422,4828169,128238291990,25450,25700,26720,1270,4.99,26560,1110,4.36,25640,26720,1400-10-11,2022-01-01
87,فجام,جام‌دارو,1418,23724528,109421012507,4511,4736,4430,-81,-1.8,4612,101,2.24,4390,4736,1400-10-11,2022-01-01
88,شفنح,ح . پتروشيمي فناوران,1391,7585958,67794162160,9280,9160,8950,-330,-3.56,8940,-340,-3.66,8790,9330,1400-10-11,2022-01-01
89,بترانس,ايران‌ ترانسفو,1372,33792346,68108372690,2097,2050,2018,-79,-3.77,2015,-82,-3.91,1993,2051,1400-10-11,2022-01-01
90,ولكار,ليزينگ كارآفرين,1359,10681551,43847102499,4043,3945,4020,-23,-0.57,4105,62,1.53,3945,4120,1400-10-11,2022-01-01
91,كماسه,تامين‌ ماسه‌ ريخته‌گري‌,1351,21235051,67201262750,3313,3259,3148,-165,-4.98,3165,-148,-4.47,3148,3337,1400-10-11,2022-01-01
92,نهال,صندوق س. طلاي سرخ نوويرا,1345,6100218,126272902994,20195,20270,20800,605,3,20700,505,2.5,20155,20990,1400-10-11,2022-01-01
93,وكبهمن,مديريت سرمايه گذاري كوثربهمن,1338,539982,5167290826,9733,9730,9640,-93,-0.96,9676,-57,-0.59,9392,9730,1400-10-11,2022-01-01
94,گشان,توسعه بين المللي پديده شانديز,1314,2662120,50451360001,19181,18801,18771,-410,-2.14,18952,-229,-1.19,18656,19670,1400-10-11,2022-01-01
95,كترام,توليدي‌ كاشي‌ تكسرام‌,1306,4479010,91194551620,19860,19750,20850,990,4.98,20360,500,2.52,18940,20850,1400-10-11,2022-01-01
96,ومدير,گ.مديريت ارزش سرمايه ص ب كشوري,1279,5636090,26544862682,4759,4789,4725,-34,-0.71,4710,-49,-1.03,4664,4789,1400-10-11,2022-01-01
97,فردا,صندوق س آواي فرداي زاگرس-ثابت,1278,59265851,718126224651,12097,12116,12117,20,0.17,12117,20,0.17,12116,12118,1400-10-11,2022-01-01
98,فاذر,صنايع‌ آذرآب‌,1274,43408264,39392594905,933,930,903,-30,-3.22,907,-26,-2.79,891,930,1400-10-11,2022-01-01
99,رافزا,رايان هم افزا,1273,159626,9629997551,62851,63550,60110,-2741,-4.36,61164,-1687,-2.68,59709,63550,1400-10-11,2022-01-01
100,غمهرا,توليدي‌مهرام‌,1272,9512668,99484516800,10540,11060,10100,-440,-4.17,10460,-80,-0.76,10020,11060,1400-10-11,2022-01-01
101,آگاس,صندوق س.هستي بخش آگاه-س,1252,1359624,105119449710,79170,78380,77279,-1891,-2.39,77315,-1855,-2.34,76933,78380,1400-10-11,2022-01-01
102,آبادا,توليد نيروي برق آبادان,1247,584691,5862096730,10240,10060,10010,-230,-2.25,10150,-90,-0.88,9950,10230,1400-10-11,2022-01-01
103,تاپكيش,تجارت الكترونيك پارسيان كيش,1244,4534895,80914412912,18426,18700,17505,-921,-5,17843,-583,-3.16,17505,19090,1400-10-11,2022-01-01
104,فنوال,نورد آلومينيوم‌,1238,6373104,156642990720,24270,24800,24500,230,0.95,24580,310,1.28,23550,25420,1400-10-11,2022-01-01
105,بگيلان,توسعه مسير برق گيلان,1222,203636,2780928604,14000,13810,13661,-339,-2.42,13959,-41,-0.29,13500,13814,1400-10-11,2022-01-01
106,كوير,توليدي فولاد سپيد فراب كوير,1222,11310155,58776522510,5220,5120,5190,-30,-0.57,5200,-20,-0.38,5080,5280,1400-10-11,2022-01-01
107,وسكرد,شركت س استان كردستان,1221,89765954,40632538114,461,454,455,-6,-1.3,453,-8,-1.74,446,465,1400-10-11,2022-01-01
108,كارا,صندوق س. كارا -د,1165,55308547,579519705835,10459,10481,10478,19,0.18,10478,19,0.18,10477,10481,1400-10-11,2022-01-01
109,لطيف,محصولات كاغذي لطيف,1161,352365,13213207581,38600,37020,37311,-1289,-3.34,37601,-999,-2.59,36926,39340,1400-10-11,2022-01-01
110,وآذر,سرمايه‌گذاري‌توسعه‌آذربايجان‌,1139,1785860,64674930070,36040,34300,37520,1480,4.11,36220,180,0.5,34300,37600,1400-10-11,2022-01-01
111,ثتوسا,س.توسعه و عمران استان اردبيل,1129,3777046,52796230179,13712,13027,14397,685,5,13978,266,1.94,13027,14397,1400-10-11,2022-01-01
112,قنيشا,قند  نيشابور,1119,1868081,82293363690,42750,42750,44080,1330,3.11,44050,1300,3.04,42740,44880,1400-10-11,2022-01-01
113,فگستر,گسترش صنايع روي ايرانيان,1108,1717397,17759467354,10631,10680,10210,-421,-3.96,10341,-290,-2.73,10107,10680,1400-10-11,2022-01-01
114,هاي وب,داده گسترعصرنوين-هاي وب,1108,8951051,73317595790,8400,8270,8190,-210,-2.5,8190,-210,-2.5,8070,8420,1400-10-11,2022-01-01
115,فنورد,نوردوقطعات‌ فولادي‌,1105,686763,117901782900,178600,169670,169770,-8830,-4.94,171680,-6920,-3.87,169670,184500,1400-10-11,2022-01-01
116,وملي,گروه‌ صنعتي‌ ملي‌ (هلدينگ‌,1096,372381,50895299420,140790,138890,134890,-5900,-4.19,136680,-4110,-2.92,134600,140000,1400-10-11,2022-01-01
117,فسرب,ملي‌ سرب‌وروي‌ ايران‌,1095,20678986,41309737530,2089,2055,1985,-104,-4.98,1998,-91,-4.36,1985,2055,1400-10-11,2022-01-01
118,فسازان,غلتك سازان سپاهان,1093,9458692,46652828947,4759,4850,4869,110,2.31,4932,173,3.64,4760,4996,1400-10-11,2022-01-01
119,ثشاهد,سرمايه‌ گذاري‌ شاهد,1090,8167354,81484467150,10130,10160,9990,-140,-1.38,9980,-150,-1.48,9840,10160,1400-10-11,2022-01-01
120,لپارس,پارس‌ الكتريك‌,1088,705089,66988104010,99900,97010,94910,-4990,-4.99,95010,-4890,-4.89,94910,98000,1400-10-11,2022-01-01
121,زبينا,كشاورزي و دامپروري بينالود,1084,17462834,40097863852,2315,2201,2368,53,2.29,2296,-19,-0.82,2200,2390,1400-10-11,2022-01-01
122,وساغربي,شركت س استان آذربايجان غربي,1074,63186940,28264601705,459,443,450,-9,-1.96,447,-12,-2.61,442,454,1400-10-11,2022-01-01
123,سيمرغ,سيمرغ,1068,2284118,54618120020,24220,24010,24210,-10,-0.04,23910,-310,-1.28,23350,24460,1400-10-11,2022-01-01
124,سفارس,سيمان فارس و خوزستان,1063,3595927,60755922910,17400,17130,16950,-450,-2.59,16900,-500,-2.87,16550,17140,1400-10-11,2022-01-01
125,شصدف,صنعتي دوده فام,1054,1014235,34249429248,34923,34200,34000,-923,-2.64,33769,-1154,-3.3,33501,34560,1400-10-11,2022-01-01
126,بپاس,بيمه پاسارگاد,1041,2088498,76363089743,37428,37003,36200,-1228,-3.28,36865,-563,-1.5,35930,37460,1400-10-11,2022-01-01
127,حريل,ريل پردازسير,1029,13465295,33907748339,2504,2525,2473,-31,-1.24,2518,14,0.56,2423,2603,1400-10-11,2022-01-01
128,ضخود2019,اختيارخ خودرو-2500-1401/02/07,1028,32333,5528861000,193,170,168,-25,-12.95,171,-22,-11.4,162,187,1400-10-11,2022-01-01
129,فارس,صنايع پتروشيمي خليج فارس,1025,8412476,90589798460,11010,10720,10800,-210,-1.91,10820,-190,-1.73,10670,10880,1400-10-11,2022-01-01
130,وليز,ليزينگ‌ايران‌,1018,16793917,33691547873,2018,2069,1970,-48,-2.38,2006,-12,-0.59,1930,2069,1400-10-11,2022-01-01
131,ونيرو,سرمايه‌گذاري‌نيرو,1017,28864794,61781888354,2137,2140,2164,27,1.26,2140,3,0.14,2081,2176,1400-10-11,2022-01-01
132,ثاباد,توريستي ورفاهي آبادگران ايران,1014,2648355,105914646480,38400,38470,40200,1800,4.69,39990,1590,4.14,38470,40320,1400-10-11,2022-01-01
133,شاوان,پالايش نفت لاوان,1010,1301294,168512201936,135502,131010,130380,-5122,-3.78,129496,-6006,-4.43,128727,134025,1400-10-11,2022-01-01
134,خنصير,مهندسي‌نصيرماشين‌,1010,5830054,104376500630,18820,17890,17880,-940,-4.99,17900,-920,-4.89,17880,18200,1400-10-11,2022-01-01
135,شبريز,پالايش نفت تبريز,1002,1883681,63779926030,34200,34500,34180,-20,-0.06,33980,-220,-0.64,33100,34570,1400-10-11,2022-01-01
136,دسانكو,داروسازي سبحان انكولوژي,992,4106259,51243252836,12169,12010,12620,451,3.71,12479,310,2.55,12010,12750,1400-10-11,2022-01-01
137,چكاپا,گروه صنايع كاغذ پارس,990,10234672,29615503279,3010,2910,2899,-111,-3.69,2894,-116,-3.85,2860,3000,1400-10-11,2022-01-01
138,تپكو,توليدتجهيزات‌سنگين‌هپكو,989,23833930,70991431440,3069,3015,2977,-92,-3,2979,-90,-2.93,2977,3031,1400-10-11,2022-01-01
139,فپنتا,سپنتا,979,112817,57072973820,502680,525000,500000,-2680,-0.53,505890,3210,0.64,482780,525000,1400-10-11,2022-01-01
140,كمرجان,بازرگاني و توليدي مرجان كار,973,6438859,38870727892,6301,6242,5990,-311,-4.94,6037,-264,-4.19,5986,6279,1400-10-11,2022-01-01
141,وگردش,بانك گردشگري,968,6858164,68874979053,10049,10190,10028,-21,-0.21,10043,-6,-0.06,9950,10190,1400-10-11,2022-01-01
142,كاوه,فولاد كاوه جنوب كيش,952,3736031,52891067650,14590,14070,14200,-390,-2.67,14320,-270,-1.85,13990,14440,1400-10-11,2022-01-01
143,فتوسا,توليد و توسعه سرب روي ايرانيان,943,493542,5230440725,10910,10752,10575,-335,-3.07,10798,-112,-1.03,10500,10800,1400-10-11,2022-01-01
144,ومعادن,توسعه‌معادن‌وفلزات‌,938,10392002,100678451490,9860,9600,9880,20,0.2,9710,-150,-1.52,9500,9890,1400-10-11,2022-01-01
145,ملت,بيمه ملت,938,63128521,74210846892,1179,1160,1179,0,0,1176,-3,-0.25,1155,1188,1400-10-11,2022-01-01
146,گكوثر,هتل پارسيان كوثر اصفهان,932,21143629,32163663240,1578,1567,1500,-78,-4.94,1521,-57,-3.61,1500,1589,1400-10-11,2022-01-01
147,زكوثر,سرمايه گذاري كشاورزي كوثر,929,2848806,42802778840,14890,14640,14770,-120,-0.81,15020,130,0.87,14220,15600,1400-10-11,2022-01-01
148,شاراك,پتروشيمي شازند,924,1706596,75994055880,45850,44290,44770,-1080,-2.36,44820,-1030,-2.25,44230,45200,1400-10-11,2022-01-01
149,تملتح,ح . تامين سرمايه بانك ملت,911,3989938,4926463317,1275,1231,1216,-59,-4.63,1235,-40,-3.14,1204,1275,1400-10-11,2022-01-01
150,وپويا,سرمايه گذاري پويا,907,2684940,9466197438,3658,3590,3500,-158,-4.32,3571,-87,-2.38,3487,3600,1400-10-11,2022-01-01
151,خزر,فنرسازي‌زر,901,4334999,38923900250,9390,9290,8940,-450,-4.79,8980,-410,-4.37,8930,9290,1400-10-11,2022-01-01
152,رنيك,جنرال مكانيك,896,6916373,78052331832,11076,11000,11629,553,4.99,11285,209,1.89,11000,11629,1400-10-11,2022-01-01
153,زعف0008پ10,زعفران0008نگين طلاي سرخ(پ),891,3082755,776864963350,257585,248000,268545,10960,4.25,252003,-5582,-2.17,245000,268545,1400-10-11,2022-01-01
154,كرماشا,صنايع پتروشيمي كرمانشاه,887,1281145,72264991290,56710,56710,56870,160,0.28,56430,-280,-0.49,55100,57080,1400-10-11,2022-01-01
155,وپارس,بانك‌پارسيان‌,880,22942642,44229914572,1964,1961,1911,-53,-2.7,1950,-14,-0.71,1894,1965,1400-10-11,2022-01-01
156,شبصير,توليدات پتروشيمي قائد بصير,873,447952,48289109062,110085,110000,108040,-2045,-1.86,107800,-2285,-2.08,105239,112999,1400-10-11,2022-01-01
157,وساپا,سرمايه‌گذاري‌ سايپا,866,10555057,43543789084,4316,4185,4101,-215,-4.98,4125,-191,-4.43,4101,4273,1400-10-11,2022-01-01
158,طلا,صندوق س.پشتوانه طلاي لوتوس,859,704886,64149050900,90477,91101,90900,423,0.47,91006,529,0.58,90700,91380,1400-10-11,2022-01-01
159,تاپيكو,س. نفت و گاز و پتروشيمي تأمين,857,6283558,92165418660,15000,14410,14760,-240,-1.6,14740,-260,-1.73,14410,14990,1400-10-11,2022-01-01
160,كدما,معدني‌ دماوند,856,723681,45972534210,66660,63700,63330,-3330,-5,63530,-3130,-4.7,63330,65100,1400-10-11,2022-01-01
161,حآسا,آسيا سير ارس,855,3987242,48919440378,12671,12500,12380,-291,-2.3,12269,-402,-3.17,12038,12800,1400-10-11,2022-01-01
162,ونوين,بانك‌اقتصادنوين‌,848,13492083,45658358320,3435,3410,3345,-90,-2.62,3384,-51,-1.48,3309,3429,1400-10-11,2022-01-01
163,البرز,بيمه البرز,827,23473237,40401940588,1789,1799,1705,-84,-4.7,1721,-68,-3.8,1700,1799,1400-10-11,2022-01-01
164,ماديرا,صنايع ماديران,826,4327042,23905416218,5635,5570,5453,-182,-3.23,5525,-110,-1.95,5406,5730,1400-10-11,2022-01-01
165,ثاخت,بين‌المللي‌توسعه‌ساختمان,824,18701541,33404477127,1845,1830,1782,-63,-3.41,1786,-59,-3.2,1768,1830,1400-10-11,2022-01-01
166,كلر,كلر پارس,819,371786,37867152037,102579,102569,102990,411,0.4,101852,-727,-0.71,100635,105000,1400-10-11,2022-01-01
167,فروي,ذوب روي اصفهان,818,1172426,19393974688,17114,16642,16390,-724,-4.23,16542,-572,-3.34,16350,16800,1400-10-11,2022-01-01
168,انار,صندوق س.انارنماد ارزش-درسهام,816,1906755,18327509103,10030,9852,9602,-428,-4.27,9612,-418,-4.17,9520,9852,1400-10-11,2022-01-01
169,پيزد,مجتمع صنايع لاستيك يزد,802,111260,5719667406,52120,52509,51215,-905,-1.74,51845,-275,-0.53,51100,52509,1400-10-11,2022-01-01
170,فسپا,گروه‌صنعتي‌سپاهان‌,800,3474385,60294301780,18180,18000,17280,-900,-4.95,17350,-830,-4.57,17280,18150,1400-10-11,2022-01-01
171,غگرجي,بيسكويت‌  گرجي‌,797,16942910,32947851930,1864,1956,1957,93,4.99,1945,81,4.35,1885,1957,1400-10-11,2022-01-01
172,رتاپ,تجارت الكترونيك  پارسيان,789,1954712,10395463290,5460,5420,5270,-190,-3.48,5360,-100,-1.83,5190,5460,1400-10-11,2022-01-01
173,رانفور,خدمات‌انفورماتيك‌,781,13409154,50861364833,3952,3802,3780,-172,-4.35,3804,-148,-3.74,3755,3883,1400-10-11,2022-01-01
174,خاذين,سايپاآذين‌,781,18911837,47681324004,2644,2542,2512,-132,-4.99,2521,-123,-4.65,2512,2580,1400-10-11,2022-01-01
175,غدام,خوراك‌  دام‌ پارس‌,769,357779,33750855100,99100,95000,94150,-4950,-4.99,94330,-4770,-4.81,94150,95800,1400-10-11,2022-01-01
176,حفاري,حفاري شمال,764,7720761,31450560726,4200,4116,4085,-115,-2.74,4074,-126,-3,4035,4170,1400-10-11,2022-01-01
177,كرازي,كارخانجات‌توليدي‌شيشه‌رازي‌,760,23377092,29845852016,1318,1302,1274,-44,-3.34,1277,-41,-3.11,1262,1302,1400-10-11,2022-01-01
178,اخابر,مخابرات ايران,759,8087516,59379267610,7580,7230,7350,-230,-3.03,7460,-120,-1.58,7210,7500,1400-10-11,2022-01-01
179,وسكرشا,س.سهام عدالت استان كرمانشاه,740,37066305,17014261919,464,456,466,2,0.43,459,-5,-1.08,447,467,1400-10-11,2022-01-01
180,شپارس,بين‌ المللي‌ محصولات‌  پارس‌,739,4378313,34551234270,7540,7910,7910,370,4.91,7890,350,4.64,7650,7910,1400-10-11,2022-01-01
181,پارند,صندوق س. پارند پايدار سپهر,739,19449173,197299755629,10129,10145,10144,15,0.15,10144,15,0.15,10144,10145,1400-10-11,2022-01-01
182,خمحركه,نيرو محركه‌,736,6194786,21540534927,3531,3400,3478,-53,-1.5,3477,-54,-1.53,3400,3560,1400-10-11,2022-01-01
183,اپال,فرآوري معدني اپال كاني پارس,735,559029,12726926360,22760,22760,22760,0,0,22760,0,0,22750,22830,1400-10-11,2022-01-01
184,شغدير,پتروشيمي غدير,730,410541,36587867940,90590,90250,89680,-910,-1,89430,-1160,-1.28,88500,90300,1400-10-11,2022-01-01
185,خكار,ايركا پارت صنعت,723,10736490,32298993444,3154,3030,2997,-157,-4.98,3008,-146,-4.63,2997,3078,1400-10-11,2022-01-01
186,فسازانح,ح . غلتك سازان سپاهان,721,5587091,17642687688,3050,3135,3052,2,0.07,3158,108,3.54,3040,3279,1400-10-11,2022-01-01
187,شيران,س. صنايع‌شيميايي‌ايران,717,2334096,49340773220,21610,21610,21340,-270,-1.25,21320,-290,-1.34,20920,21610,1400-10-11,2022-01-01
188,شلعاب,لعابيران‌,707,4611686,27097471090,6110,6050,5830,-280,-4.58,5880,-230,-3.76,5810,6190,1400-10-11,2022-01-01
189,آپ,آسان پرداخت پرشين,704,4462269,42306813990,9950,9700,9460,-490,-4.92,9480,-470,-4.72,9460,9870,1400-10-11,2022-01-01
190,شسپا,نفت سپاهان,700,8704415,29716330134,3504,3445,3430,-74,-2.11,3469,-35,-1,3395,3445,1400-10-11,2022-01-01
191,غپينو,پارس‌ مينو,700,10080923,21407435551,2208,2143,2110,-98,-4.44,2124,-84,-3.8,2098,2210,1400-10-11,2022-01-01
192,غمارگ,مارگارين‌,696,11664842,31498903350,2741,2700,2720,-21,-0.77,2700,-41,-1.5,2610,2771,1400-10-11,2022-01-01
193,غگلستا,شير پاستوريزه پگاه گلستان,686,5173852,52224057692,10341,10399,9995,-346,-3.35,10094,-247,-2.39,9824,10439,1400-10-11,2022-01-01
194,ثفارس,عمران‌وتوسعه‌فارس‌,682,4557576,31780872450,7140,7000,6890,-250,-3.5,6970,-170,-2.38,6840,7230,1400-10-11,2022-01-01
195,فخوز,فولاد  خوزستان,674,6761106,44443266830,6680,6650,6600,-80,-1.2,6640,-40,-0.6,6490,6750,1400-10-11,2022-01-01
196,وپسا,س. پتروشيمي ساختمان  خليج فارس,671,21196745,31099489885,1450,1470,1466,16,1.1,1467,17,1.17,1425,1493,1400-10-11,2022-01-01
197,كسرا,سراميك‌هاي‌صنعتي‌اردكان‌,670,3236010,46919823170,14660,15000,14400,-260,-1.77,14500,-160,-1.09,13930,15000,1400-10-11,2022-01-01
198,تملت,تامين سرمايه بانك ملت,667,4416625,11145044548,2550,2599,2515,-35,-1.37,2532,-18,-0.71,2425,2599,1400-10-11,2022-01-01
199,وبانك,سرمايه گذاري گروه توسعه ملي,667,5762938,48162041480,8580,8530,8470,-110,-1.28,8460,-120,-1.4,8230,8550,1400-10-11,2022-01-01
200,ديران,ايران‌دارو,658,2751163,52887539700,20170,19200,19170,-1000,-4.96,19220,-950,-4.71,19170,19690,1400-10-11,2022-01-01
201,ياقوت,صندوق س ياقوت آگاه-ثابت,657,12538369,174172652636,13871,13891,13894,23,0.17,13891,20,0.14,13891,13894,1400-10-11,2022-01-01
202,زماهان,مجتمع توليد گوشت مرغ ماهان,656,4138438,28848101085,6930,6790,7134,204,2.94,6971,41,0.59,6684,7140,1400-10-11,2022-01-01
203,حتايد,تايدواترخاورميانه,656,6236212,28872171849,4523,4555,4646,123,2.72,4630,107,2.37,4405,4740,1400-10-11,2022-01-01
204,فجر,فولاد اميركبيركاشان,650,1593526,38772871860,25460,25200,24190,-1270,-4.99,24330,-1130,-4.44,24190,25200,1400-10-11,2022-01-01
205,وكار,بانك‌ كارآفرين‌,649,18401858,44180945635,2466,2406,2361,-105,-4.26,2401,-65,-2.64,2355,2466,1400-10-11,2022-01-01
206,غبشهر,صنعتي‌ بهشهر,640,12937191,48448171052,3837,3750,3692,-145,-3.78,3745,-92,-2.4,3651,3840,1400-10-11,2022-01-01
207,سمازن,سيمان‌مازندران‌,640,4957556,70946987270,15020,14790,14270,-750,-4.99,14310,-710,-4.73,14270,14790,1400-10-11,2022-01-01
208,ارفع,شركت آهن و فولاد ارفع,639,1541999,22291358418,14672,14620,14447,-225,-1.53,14603,-69,-0.47,14210,14730,1400-10-11,2022-01-01
209,خراسان,پتروشيمي خراسان,638,474194,57815557250,125530,122030,120700,-4830,-3.85,123140,-2390,-1.9,120100,124990,1400-10-11,2022-01-01
210,قشكر,شكرشاهرود,625,11838026,24847168559,2172,2109,2169,-3,-0.14,2099,-73,-3.36,2065,2169,1400-10-11,2022-01-01
211,ضخود2020,اختيارخ خودرو-3000-1401/02/07,624,36203,2933901000,84,90,80,-4,-4.76,81,-3,-3.57,76,95,1400-10-11,2022-01-01
212,وصنعت,سرمايه گذاري توسعه صنعت وتجارت,612,3610294,23612448450,6710,6750,6470,-240,-3.58,6540,-170,-2.53,6410,6750,1400-10-11,2022-01-01
213,زدشت,كشت و صنعت دشت خرم دره,608,2173529,29945113632,13240,12851,13902,662,5,13777,537,4.06,12851,13902,1400-10-11,2022-01-01
214,توريل,توكاريل,602,3152556,25341266873,8256,8010,8173,-83,-1.01,8038,-218,-2.64,7844,8350,1400-10-11,2022-01-01
215,نطرين,عطرين نخ قم,602,3348131,25099382436,7572,7330,7380,-192,-2.54,7497,-75,-0.99,7252,7800,1400-10-11,2022-01-01
216,اطلس,صندوق س.توسعه اندوخته آينده-س,599,204643,49755558249,245776,245760,243299,-2477,-1.01,243133,-2643,-1.08,242251,246702,1400-10-11,2022-01-01
217,زشريف,كشت وصنعت شريف آباد,593,10446523,34028092275,3155,3110,3312,157,4.98,3257,102,3.23,3010,3312,1400-10-11,2022-01-01
218,غگل,گلوكوزان‌,590,7181870,22466441433,3279,3150,3116,-163,-4.97,3128,-151,-4.61,3116,3206,1400-10-11,2022-01-01
219,شجم,صنايع پتروشيمي تخت جمشيد,589,4264123,49972951913,12279,11800,11900,-379,-3.09,11719,-560,-4.56,11666,12164,1400-10-11,2022-01-01
220,وسكرمان,س.سهام عدالت استان كرمان,588,37287522,16848037603,463,450,452,-11,-2.38,457,-6,-1.3,446,458,1400-10-11,2022-01-01
221,غگيلا,شيرپاستوريزه پگاه گيلان,586,2794732,43434988166,16251,16250,15439,-812,-5,15542,-709,-4.36,15439,16250,1400-10-11,2022-01-01
222,ضخود2018,اختيارخ خودرو-2000-1401/02/07,585,16101,5505321000,391,380,325,-66,-16.88,342,-49,-12.53,322,380,1400-10-11,2022-01-01
223,وصنا,گروه‌صنايع‌بهشهرايران‌,583,6859458,19981504742,3013,2957,2933,-80,-2.66,2913,-100,-3.32,2863,2999,1400-10-11,2022-01-01
224,كسعدي,كاشي‌ سعدي‌,579,4389555,33285593540,7950,7750,7560,-390,-4.91,7580,-370,-4.65,7560,7850,1400-10-11,2022-01-01
225,بجهرم,توسعه مولد نيروگاهي جهرم,578,8363381,16500268797,2010,1965,1970,-40,-1.99,1978,-32,-1.59,1965,1997,1400-10-11,2022-01-01
226,كگل,معدني و صنعتي گل گهر,577,2138846,47215358800,22570,22710,22130,-440,-1.95,22370,-200,-0.89,21910,22710,1400-10-11,2022-01-01
227,سغدير,توسعه سرمايه و صنعت غدير,576,1846649,27744584471,15308,15308,15300,-8,-0.05,15024,-284,-1.86,14693,15400,1400-10-11,2022-01-01
228,حپترو,حمل و نقل پتروشيمي( سهامي عام,575,1346798,30596937510,22050,23000,23090,1040,4.72,22720,670,3.04,22210,23130,1400-10-11,2022-01-01
229,پتاير,ايران‌ تاير,574,7899124,15188412831,1964,1970,1905,-59,-3,1923,-41,-2.09,1892,1970,1400-10-11,2022-01-01
230,شرنگي,شيميايي رنگين,572,171472,34314159326,194609,199999,200220,5611,2.88,200115,5506,2.83,195000,200447,1400-10-11,2022-01-01
231,ثتران,سرمايه گذاري مسكن تهران,572,9133303,28293360322,3237,3240,3076,-161,-4.97,3098,-139,-4.29,3076,3240,1400-10-11,2022-01-01
232,سشرق,سيمان‌ شرق‌,570,4800509,33807903100,7300,7420,7110,-190,-2.6,7040,-260,-3.56,6940,7420,1400-10-11,2022-01-01
233,تاصيكو,سرمايه گذاري صدرتامين,568,4241387,36953920180,8880,8840,8800,-80,-0.9,8820,-60,-0.68,8600,8850,1400-10-11,2022-01-01
234,كگهر,سنگ آهن گهرزمين,568,739658,35460840849,47887,48110,48200,313,0.65,47903,16,0.03,47800,48535,1400-10-11,2022-01-01
235,رمپنا,گروه مپنا (سهامي عام),568,3137747,51273297210,16450,16100,16610,160,0.97,16400,-50,-0.3,15660,16750,1400-10-11,2022-01-01
236,كبافق,معادن‌ بافق‌,567,1342214,40104229990,31380,30310,29890,-1490,-4.75,29880,-1500,-4.78,29820,30750,1400-10-11,2022-01-01
237,ورنا,سرمايه‌گذاري‌ رنا(هلدينگ‌,565,6761293,20147206948,3108,3007,2955,-153,-4.92,2980,-128,-4.12,2953,3107,1400-10-11,2022-01-01
238,خوساز,محورسازان‌ايران‌خودرو,564,3585143,25956407750,7390,7090,7180,-210,-2.84,7240,-150,-2.03,7030,7560,1400-10-11,2022-01-01
239,شيراز,پتروشيمي‌شيراز,558,548013,41980440840,78730,76620,75800,-2930,-3.72,77810,-920,-1.17,75550,77300,1400-10-11,2022-01-01
240,خموتور,موتورسازان‌تراكتورسازي‌ايران‌,558,4529881,22669406920,5190,5020,4940,-250,-4.82,5000,-190,-3.66,4940,5250,1400-10-11,2022-01-01
241,قرن,پديده شيمي قرن,556,985849,20610254740,21400,20840,20780,-620,-2.9,20910,-490,-2.29,20670,21350,1400-10-11,2022-01-01
242,وسين,بيمه سينا,555,7134016,21937343265,3170,3076,3075,-95,-3,3075,-95,-3,3075,3128,1400-10-11,2022-01-01
243,ريشمك,توليد و صادرات ريشمك,554,928150,30408999445,31503,30120,33078,1575,5,32763,1260,4,30120,33078,1400-10-11,2022-01-01
244,فمراد,آلومراد,554,1226979,16390660070,13020,13390,13260,240,1.84,13360,340,2.61,13070,13540,1400-10-11,2022-01-01
245,خمهرح,ح . مهركام‌پارس‌,549,9846803,5924862325,638,613,597,-41,-6.43,602,-36,-5.64,596,630,1400-10-11,2022-01-01
246,پارس,پتروشيمي پارس,547,334500,60572374790,183070,184500,180940,-2130,-1.16,181850,-1220,-0.67,179020,184500,1400-10-11,2022-01-01
247,ضجار1022,اختيارخ وتجارت-2000-1400/10/15,539,26480,541127000,55,40,18,-37,-67.27,20,-35,-63.64,15,46,1400-10-11,2022-01-01
248,سخاش,سيمان‌خاش‌,538,232935,19410078060,87010,88420,83050,-3960,-4.55,83330,-3680,-4.23,82660,88420,1400-10-11,2022-01-01
249,غشهداب,كشت و صنعت شهداب ناب خراسان,527,8489665,22699368857,2740,2640,2683,-57,-2.08,2674,-66,-2.41,2640,2709,1400-10-11,2022-01-01
250,شفارس,صنايع‌ شيميايي‌ فارس‌,525,11422548,11474504424,1035,1046,1001,-34,-3.29,1011,-24,-2.32,986,1046,1400-10-11,2022-01-01
251,هرمز,فولاد هرمزگان جنوب,525,1564671,23957691989,15568,15300,15600,32,0.21,15516,-52,-0.33,15050,15670,1400-10-11,2022-01-01
252,ختور,رادياتور ايران‌,523,2115172,25454911110,12660,12030,12030,-630,-4.98,12030,-630,-4.98,12030,12300,1400-10-11,2022-01-01
253,سبزوا,سيمان لار سبزوار,520,6034778,11142358725,1913,1859,1836,-77,-4.03,1862,-51,-2.67,1818,1914,1400-10-11,2022-01-01
254,سامان,بانك سامان,517,6548730,45440553427,6920,6920,7050,130,1.88,6939,19,0.27,6730,7078,1400-10-11,2022-01-01
255,بكهنوج,توليد برق ماهتاب كهنوج,513,16424277,18039658143,1148,1103,1091,-57,-4.97,1098,-50,-4.36,1091,1136,1400-10-11,2022-01-01
256,غويتا,ويتانا,512,3631390,18731348112,5422,5300,5151,-271,-5,5158,-264,-4.87,5151,5410,1400-10-11,2022-01-01
257,قاسم,قاسم ايران,508,5403148,18843748247,3600,3501,3529,-71,-1.97,3488,-112,-3.11,3431,3600,1400-10-11,2022-01-01
258,فباهنر,مس‌ شهيدباهنر,502,855121,23809219810,28590,28000,27970,-620,-2.17,27980,-610,-2.13,27460,28110,1400-10-11,2022-01-01
259,همراه,شركت ارتباطات سيار ايران,501,5177075,41431536140,8190,8180,8090,-100,-1.22,8120,-70,-0.85,7900,8180,1400-10-11,2022-01-01
260,ولغدر,ليزينگ‌خودروغدير,500,4124310,33049234760,7720,7800,8100,380,4.92,8010,290,3.76,7800,8100,1400-10-11,2022-01-01
261,ولانا,شركت ليزينگ آريا دانا,499,1609607,17810970100,11013,11300,11000,-13,-0.12,11065,52,0.47,10798,11300,1400-10-11,2022-01-01
262,بالاس,مهندسي ساختمان تاسيسات راه آهن,493,654290,18051334554,28134,28300,26728,-1406,-5,27589,-545,-1.94,26728,29430,1400-10-11,2022-01-01
263,خرينگ,رينگ‌سازي‌مشهد,490,1180808,29839267560,26500,25600,25180,-1320,-4.98,25270,-1230,-4.64,25180,26360,1400-10-11,2022-01-01
264,بالبر,كابل‌ البرز,490,1282567,34000561900,27670,26460,26290,-1380,-4.99,26510,-1160,-4.19,26290,27640,1400-10-11,2022-01-01
265,هماي,صندوق س هماي آگاه-ثابت,489,4559383,45879529052,10051,10056,10068,17,0.17,10063,12,0.12,10056,10068,1400-10-11,2022-01-01
266,ورازي,بيمه رازي,485,18418601,24764746814,1307,1307,1346,39,2.98,1345,38,2.91,1307,1346,1400-10-11,2022-01-01
267,ثنوسا,نوسازي‌وساختمان‌تهران‌,483,7852175,39499806200,5257,5200,5000,-257,-4.89,5030,-227,-4.32,5000,5200,1400-10-11,2022-01-01
268,سنير,سيمان‌ سفيد ني‌ريز,481,779388,21785164870,29390,28880,27930,-1460,-4.97,27950,-1440,-4.9,27930,28880,1400-10-11,2022-01-01
269,فاسمين,كالسيمين‌,477,2181720,36565834120,17100,16700,16700,-400,-2.34,16790,-310,-1.81,16600,17060,1400-10-11,2022-01-01
270,زكشت,كشاورزي مكانيزه اصفهان كشت,476,1543919,27733371813,17397,16710,18266,869,5,17963,566,3.25,16710,18266,1400-10-11,2022-01-01
271,ميهن,بيمه ميهن,475,4403549,9976029739,2233,2339,2233,0,0,2254,21,0.94,2150,2339,1400-10-11,2022-01-01
272,شكلر,نيروكلر,475,627776,25034018730,41720,40390,39700,-2020,-4.84,39880,-1840,-4.41,39640,41100,1400-10-11,2022-01-01
273,دتوليد,داروسازي توليد دارو,474,2029852,16033915150,8121,8106,7840,-281,-3.46,7899,-222,-2.73,7718,8228,1400-10-11,2022-01-01
274,وگستر,گسترش سرمايه گذاري ايرانيان,471,2209672,11713806894,5241,5138,5310,69,1.32,5287,46,0.88,5100,5399,1400-10-11,2022-01-01
275,فافق,صنايع مس افق كرمان,464,7875909,25462639024,3141,3200,3235,94,2.99,3233,92,2.93,3200,3235,1400-10-11,2022-01-01
276,وفتخار,سرمايه گذاري افتخار سهام,463,2466694,4135848792,1644,1693,1688,44,2.68,1667,23,1.4,1641,1693,1400-10-11,2022-01-01
277,ولساپا,ليزينگ رايان‌ سايپا,460,11221185,16947737601,1564,1515,1500,-64,-4.09,1510,-54,-3.45,1497,1549,1400-10-11,2022-01-01
278,فزرين,زرين معدن آسيا,458,1421874,16355466245,12033,11600,11432,-601,-4.99,11503,-530,-4.4,11432,11800,1400-10-11,2022-01-01
279,ثرود,سرمايه‌گذاري مسكن زاينده رود,457,2542055,14762089330,5638,5555,5900,262,4.65,5800,162,2.87,5555,5900,1400-10-11,2022-01-01
280,وپاسار,بانك  پاسارگاد,455,9057422,126799484250,14010,14150,14000,-10,-0.07,14000,-10,-0.07,13980,14150,1400-10-11,2022-01-01
281,كفپارس,فرآورده‌هاي‌ نسوز پارس‌,454,4849159,14057183163,2971,2860,2900,-71,-2.39,2902,-69,-2.32,2860,2969,1400-10-11,2022-01-01
282,پارسان,گسترش نفت و گاز پارسيان,453,1845181,62162051570,34070,33200,33870,-200,-0.59,33870,-200,-0.59,33200,34180,1400-10-11,2022-01-01
283,خفنر,فنرسازي‌خاور,450,1899655,13008845790,7130,7000,6800,-330,-4.63,6880,-250,-3.51,6780,7000,1400-10-11,2022-01-01
284,غسالم,سالمين‌,449,3896727,10617597762,2832,2832,2711,-121,-4.27,2753,-79,-2.79,2702,2832,1400-10-11,2022-01-01
285,فردا2,صندوق س آواي فرداي زاگرس-ثابت,449,44900000,44900000,12097,1,1,-12096,-99.99,1,-12096,-99.99,1,1,1400-10-11,2022-01-01
286,خمهر,مهركام‌پارس‌,448,15202369,25954958159,1786,1740,1707,-79,-4.42,1707,-79,-4.42,1697,1740,1400-10-11,2022-01-01
287,وساخت,سرمايه‌ گذاري‌ ساختمان‌ايران‌,447,556853,19662326600,36130,36200,35300,-830,-2.3,35310,-820,-2.27,34870,36200,1400-10-11,2022-01-01
288,دتوزيع,توزيع دارو پخش,447,1021391,26962541749,27608,26549,26250,-1358,-4.92,26398,-1210,-4.38,26228,27390,1400-10-11,2022-01-01
289,بكاب,صنايع‌جوشكاب‌يزد,444,209976,17011360590,84710,83490,80480,-4230,-4.99,81020,-3690,-4.36,80480,83490,1400-10-11,2022-01-01
290,تبرك,گروه كارخانجات صنعتي تبرك,437,2363518,18979941122,8000,8060,8113,113,1.41,8030,30,0.38,7900,8140,1400-10-11,2022-01-01
291,حتوكا,حمل‌ونقل‌توكا,437,2407822,27032061700,10780,10680,11310,530,4.92,11230,450,4.17,10500,11310,1400-10-11,2022-01-01
292,مرقام,ايران‌ارقام‌,433,2215796,22344959900,10170,10170,10090,-80,-0.79,10080,-90,-0.88,9750,10390,1400-10-11,2022-01-01
293,خمحور,توليدمحورخودرو,432,6740553,19748933871,3073,2950,2920,-153,-4.98,2930,-143,-4.65,2920,3009,1400-10-11,2022-01-01
294,چفيبر,فيبر ايران‌,432,5329862,37174771700,7260,7260,6900,-360,-4.96,6970,-290,-3.99,6900,7280,1400-10-11,2022-01-01
295,كامياب,صندوق س. كامياب آشنا-د,430,6960267,77778129219,11155,11175,11175,20,0.18,11175,20,0.18,11174,11175,1400-10-11,2022-01-01
296,فولاي,صنايع فولاد آلياژي يزد,427,1609555,23584445517,15219,15000,14600,-619,-4.07,14653,-566,-3.72,14570,15000,1400-10-11,2022-01-01
297,فلوله,لوله‌وماشين‌سازي‌ايران‌,424,24957311,25434795977,1039,1020,1020,-19,-1.83,1019,-20,-1.92,1012,1030,1400-10-11,2022-01-01
298,ثغرب,شركت سرمايه گذاري مسكن شمالغرب,422,8142386,30816774820,3609,3761,3789,180,4.99,3785,176,4.88,3649,3789,1400-10-11,2022-01-01
299,فرآور,فرآوري‌موادمعدني‌ايران‌,420,1048566,29082076920,28540,28880,27700,-840,-2.94,27740,-800,-2.8,27200,28880,1400-10-11,2022-01-01
300,دماوند,توليد نيروي برق دماوند,419,897911,17042726037,19059,18900,19000,-59,-0.31,19027,-32,-0.17,18510,19200,1400-10-11,2022-01-01
301,خريخت,صنايع‌ريخته‌گري‌ايران‌,414,4788026,12042660939,2620,2620,2600,-20,-0.76,2532,-88,-3.36,2489,2620,1400-10-11,2022-01-01
302,فنفت,صنايع تجهيزات نفت,412,1542051,27064765428,17048,17000,17559,511,3,17551,503,2.95,17000,17559,1400-10-11,2022-01-01
303,شفا,سرمايه گذاري شفادارو,405,1854373,24916059180,14080,13600,13380,-700,-4.97,13440,-640,-4.55,13380,13990,1400-10-11,2022-01-01
304,غبهنوش,بهنوش‌ ايران‌,404,416571,26812534440,67710,64360,64330,-3380,-4.99,64360,-3350,-4.95,64330,66000,1400-10-11,2022-01-01
305,آسيا,بيمه آسيا,397,10970622,18623968170,1740,1720,1712,-28,-1.61,1698,-42,-2.41,1682,1755,1400-10-11,2022-01-01
306,ضخود2015,اختيارخ خودرو-1400-1401/02/07,395,18010,12733790000,792,770,700,-92,-11.62,707,-85,-10.73,700,770,1400-10-11,2022-01-01
307,زشگزا,شير و گوشت زاگرس شهركرد,394,4066239,20607297528,4990,4800,5080,90,1.8,5068,78,1.56,4800,5190,1400-10-11,2022-01-01
308,جم پيلن,پلي پروپيلن جم - جم پيلن,392,155770,19204471100,123300,121000,124800,1500,1.22,123300,0,0,121000,125700,1400-10-11,2022-01-01
309,تپمپي,پمپ‌ سازي‌ ايران‌,391,1140112,22773992730,20750,20290,20180,-570,-2.75,19980,-770,-3.71,19720,20750,1400-10-11,2022-01-01
310,وهور,مديريت انرژي اميد  تابان هور,389,7896604,10045764794,1297,1297,1259,-38,-2.93,1290,-7,-0.54,1253,1304,1400-10-11,2022-01-01
311,چكاوه,صنايع‌كاغذسازي‌كاوه‌,389,1903770,14495903630,7550,7600,7670,120,1.59,7610,60,0.79,7400,7790,1400-10-11,2022-01-01
312,چدن,توليدي چدن سازان,386,3893082,9140664469,2403,2335,2375,-28,-1.17,2369,-34,-1.41,2315,2430,1400-10-11,2022-01-01
313,بشهاب,لامپ‌  پارس‌ شهاب‌,383,255824,35074786100,134480,139900,135390,910,0.68,137110,2630,1.96,132000,139900,1400-10-11,2022-01-01
314,كمنگنز,معادن‌منگنزايران‌,382,333435,19950127370,60140,58810,59820,-320,-0.53,59830,-310,-0.52,58810,60780,1400-10-11,2022-01-01
315,مفاخر,توسعه فناوري اطلاعات خوارزمي,382,814579,22641444624,26739,27890,28075,1336,5,27795,1056,3.95,25967,28075,1400-10-11,2022-01-01
316,سبهان,سيمان‌ بهبهان‌,382,195086,8498993860,43840,44300,43140,-700,-1.6,43680,-160,-0.36,43000,44650,1400-10-11,2022-01-01
317,غاذر,كشت‌وصنعت‌پياذر,378,854303,28038218580,33530,32170,33340,-190,-0.57,32820,-710,-2.12,32150,33900,1400-10-11,2022-01-01
318,فاهواز,نورد و لوله اهواز,376,2685505,14852390252,5541,5434,5530,-11,-0.2,5531,-10,-0.18,5431,5625,1400-10-11,2022-01-01
319,وهنر,گروه توسعه هنر ايران,374,4108826,9935711586,2486,2461,2412,-74,-2.98,2418,-68,-2.74,2412,2461,1400-10-11,2022-01-01
320,تنوين,تامين سرمايه نوين,374,7233943,43416753610,5970,6000,5970,0,0,6000,30,0.5,5720,6050,1400-10-11,2022-01-01
321,دجابر,داروسازي‌ جابرابن‌حيان‌,363,1198194,13501295780,11750,11220,11360,-390,-3.32,11300,-450,-3.83,11170,11800,1400-10-11,2022-01-01
322,بنيرو,نيروترانس‌,360,5760003,10857928272,1849,1910,1861,12,0.65,1875,26,1.41,1850,1939,1400-10-11,2022-01-01
323,شبهرن,نفت‌ بهران‌,359,1953482,21659585820,11230,11250,11100,-130,-1.16,11170,-60,-0.53,10980,11250,1400-10-11,2022-01-01
324,دانا,بيمه دانا,359,12743491,57843611036,4540,4410,4566,26,0.57,4539,-1,-0.02,4410,4626,1400-10-11,2022-01-01
325,وخاور,بانك خاورميانه,358,5677760,28004129441,4980,4920,4886,-94,-1.89,4953,-27,-0.54,4881,4970,1400-10-11,2022-01-01
326,سكه0012پ01,تمام سكه طرح جديد0012رفاه,358,107100,138365517100,1285979,1298855,1291000,5021,0.39,1291928,5949,0.46,1287126,1298855,1400-10-11,2022-01-01
327,غديس,پاكديس,353,2403319,26328130769,11521,11040,10945,-576,-5,10955,-566,-4.91,10945,11329,1400-10-11,2022-01-01
328,شپاكسا,پاكسان‌,353,851954,17188921250,21230,20580,20170,-1060,-4.99,20180,-1050,-4.95,20170,20580,1400-10-11,2022-01-01
329,فروس,فروسيليس‌ ايران‌,349,2140340,13400423660,6440,6560,6210,-230,-3.57,6280,-160,-2.48,6180,6560,1400-10-11,2022-01-01
330,بموتو,موتوژن‌,348,177171,13257367040,77380,78300,74420,-2960,-3.83,75720,-1660,-2.15,73710,78300,1400-10-11,2022-01-01
331,آكورد,صندوق س. آرمان آتي كوثر-د,347,9752345,351551739275,35994,36051,36048,54,0.15,36048,54,0.15,36047,36051,1400-10-11,2022-01-01
332,وآوا,سرمايه گذاري آوا نوين,346,3132123,8051558191,2698,2670,2564,-134,-4.97,2626,-72,-2.67,2564,2670,1400-10-11,2022-01-01
333,سصوفي,سيمان‌ صوفيان‌,346,1512333,21729308740,15040,14570,14450,-590,-3.92,14370,-670,-4.45,14290,14950,1400-10-11,2022-01-01
334,حبندرح,ح.دريايي وكشتيراني خط دريابندر,344,1250794,13474158919,10854,10529,10820,-34,-0.31,10772,-82,-0.76,10529,10854,1400-10-11,2022-01-01
335,بايكا,كارخانجات كابلسازي ‌ايران‌,343,735630,12146245027,16058,16539,16539,481,3,16511,453,2.82,16201,16539,1400-10-11,2022-01-01
336,دلر,داروسازي‌ اكسير,342,369535,15051298880,41020,41100,41050,30,0.07,40780,-240,-0.59,39850,41980,1400-10-11,2022-01-01
337,سنيرح,ح . سيمان‌ سفيدني‌ريز,342,701760,13585902970,20650,19110,19180,-1470,-7.12,19360,-1290,-6.25,19110,20100,1400-10-11,2022-01-01
338,شتوكا,توكا رنگ فولاد سپاهان,341,1874492,28988093423,14766,15200,15504,738,5,15465,699,4.73,14900,15504,1400-10-11,2022-01-01
339,وشهر,بانك شهر,339,5644901,23045481541,4159,4100,4035,-124,-2.98,4090,-69,-1.66,4035,4158,1400-10-11,2022-01-01
340,قتربت,قند تربت حيدريه,338,49678,2591550790,52129,52885,51573,-556,-1.07,52139,10,0.02,51404,52885,1400-10-11,2022-01-01
341,كفراح,ح . فراورده‌ هاي‌ نسوزايران‌,338,1702829,7818516313,4950,4601,4497,-453,-9.15,4591,-359,-7.25,4484,4700,1400-10-11,2022-01-01
342,اهرم,صندوق س سهامي كاريزما- اهرمي,338,1990468,19916562444,10000,10000,10060,60,0.6,10006,6,0.06,9999,10060,1400-10-11,2022-01-01
343,خشرق,الكتريك‌ خودرو شرق‌,337,2293131,25658213090,11750,11190,11170,-580,-4.94,11190,-560,-4.77,11170,11460,1400-10-11,2022-01-01
344,آوا,صندوق س.سهام آواي معيار-س,336,1210842,9197839259,7778,7754,7605,-173,-2.22,7596,-182,-2.34,7520,7800,1400-10-11,2022-01-01
345,وسپه,سرمايه‌گذاري‌ سپه‌,331,1785551,15143333530,8610,8430,8400,-210,-2.44,8560,-50,-0.58,8320,8640,1400-10-11,2022-01-01
346,وثنو,سرمايه گذاري ساختماني نوين,330,3396707,13855008460,4184,4109,4059,-125,-2.99,4079,-105,-2.51,4059,4243,1400-10-11,2022-01-01
347,سرچشمه,سرمايه گذاري مس سرچشمه,327,2425300,12214042086,5194,5203,4998,-196,-3.77,5061,-133,-2.56,4993,5203,1400-10-11,2022-01-01
348,ساوه,سيمان ساوه,326,76927,3599505944,47535,45890,46929,-606,-1.27,47354,-181,-0.38,45320,47510,1400-10-11,2022-01-01
349,زعف0008پ16,زعفران0008نگين بيرجند(پ),326,1437435,349653763941,249669,243001,268545,18876,7.56,243248,-6421,-2.57,242971,268545,1400-10-11,2022-01-01
350,كاردان,صندوق س تجارت شاخصي كاردان,326,49442,9216740530,191960,188900,185620,-6340,-3.3,186420,-5540,-2.89,185510,190580,1400-10-11,2022-01-01
351,واميد,گروه مديريت سرمايه گذاري اميد,323,2659442,38408111550,14420,14440,14470,50,0.35,14430,10,0.07,14330,14830,1400-10-11,2022-01-01
352,ثشرق,سرمايه گذاري مسكن شمال شرق,323,3678106,12778604522,3431,3350,3506,75,2.19,3467,36,1.05,3298,3602,1400-10-11,2022-01-01
353,ولملت,واسپاري ملت,322,3925701,12613277939,3284,3287,3167,-117,-3.56,3223,-61,-1.86,3165,3319,1400-10-11,2022-01-01
354,ومهان,گروه توسعه مالي مهر آيندگان,321,2498100,11098444527,4583,4422,4432,-151,-3.29,4554,-29,-0.63,4405,4539,1400-10-11,2022-01-01
355,لسرما,سرما آفرين‌,321,886015,17273562310,20150,19700,19160,-990,-4.91,19500,-650,-3.23,19150,20370,1400-10-11,2022-01-01
356,خلنت,لنت‌ ترمزايران‌,320,198321,11316393290,59640,57360,56660,-2980,-5,57610,-2030,-3.4,56660,60200,1400-10-11,2022-01-01
357,سپر,صندوق س سپر سرمايه بيدار- ثابت,320,6694441,90233774437,13463,13480,13479,16,0.12,13479,16,0.12,13463,13504,1400-10-11,2022-01-01
358,ستران,سيمان‌ تهران‌,320,639788,13017347260,21090,21280,20400,-690,-3.27,20420,-670,-3.18,20150,21280,1400-10-11,2022-01-01
359,كروي,توسعه‌ معادن‌ روي‌ ايران‌,320,689236,15663680440,23410,22700,22710,-700,-2.99,22920,-490,-2.09,22380,23190,1400-10-11,2022-01-01
360,شپترو,پتروشيمي آبادان,317,5238388,14712022186,2848,2848,2782,-66,-2.32,2809,-39,-1.37,2781,2848,1400-10-11,2022-01-01
361,سلار,شركت سيمان لارستان,315,1104888,25969144986,24052,23350,24320,268,1.11,23504,-548,-2.28,23331,24400,1400-10-11,2022-01-01
362,سدور,سيمان‌ دورود,314,3304858,17724687980,5590,5640,5360,-230,-4.11,5360,-230,-4.11,5320,5640,1400-10-11,2022-01-01
363,قمرو,قند مرودشت‌,311,935355,21631240190,23540,24400,23000,-540,-2.29,23130,-410,-1.74,22600,24400,1400-10-11,2022-01-01
364,غنوش,نوش‌ مازندران‌,311,1475876,20647574380,14720,13990,13990,-730,-4.96,13990,-730,-4.96,13990,14000,1400-10-11,2022-01-01
365,ولشرقح,ح . ليزينگ ايران و شرق,310,7101205,5513822601,815,781,775,-40,-4.91,776,-39,-4.79,775,815,1400-10-11,2022-01-01
366,وبيمه,سرمايه‌ گذاري‌ صنعت‌ بيمه‌,308,4703476,7435897288,1552,1593,1607,55,3.54,1566,14,0.9,1552,1619,1400-10-11,2022-01-01
367,بكام,كارخانجات توليدي شهيد قندي,308,6115132,9426428255,1572,1572,1550,-22,-1.4,1552,-20,-1.27,1510,1572,1400-10-11,2022-01-01
368,غپآذر,شير پگاه آذربايجان شرقي,307,590802,18199589013,32355,31490,30998,-1357,-4.19,30805,-1550,-4.79,30738,31490,1400-10-11,2022-01-01
369,فايرا,آلومينيوم‌ايران‌,307,551331,8973637100,17010,16610,16380,-630,-3.7,16900,-110,-0.65,16160,16610,1400-10-11,2022-01-01
370,كفرا,فراورده‌ هاي‌ نسوزايران‌,306,1933722,13770405420,7420,7580,7120,-300,-4.04,7130,-290,-3.91,7050,7580,1400-10-11,2022-01-01
371,آريان,سرمايه گذاري پارس آريان,306,3102322,42684443831,14150,13826,13726,-424,-3,13978,-172,-1.22,13726,14100,1400-10-11,2022-01-01
372,كسرام,پارس‌ سرام‌,305,2276839,9987354826,4491,4300,4400,-91,-2.03,4420,-71,-1.58,4300,4470,1400-10-11,2022-01-01
373,غمينو,شركت صنايع غذايي مينو شرق,302,2939961,12004909907,4277,4080,4064,-213,-4.98,4115,-162,-3.79,4064,4260,1400-10-11,2022-01-01
374,مدير,ص.س.مديريت ثروت ص.بازنشستگي-س,301,902916,8546711372,9615,9450,9433,-182,-1.89,9466,-149,-1.55,9402,9528,1400-10-11,2022-01-01
375,شگل,گلتاش‌,298,1575366,9662619540,6240,6160,6100,-140,-2.24,6170,-70,-1.12,6040,6280,1400-10-11,2022-01-01
376,تسه0008,امتيازتسهيلات مسكن آبان1400,295,7016,7482327119,1056969,1010000,1079999,23030,2.18,1066466,9497,0.9,1004121,1109817,1400-10-11,2022-01-01
377,زمگسا,كشاورزي‌ ودامپروي‌ مگسال‌,294,852418,15608583020,18260,17650,18700,440,2.41,18310,50,0.27,17360,18800,1400-10-11,2022-01-01
378,ثعمرا,عمران و توسعه شاهد,293,1964442,13747819794,7340,7340,6973,-367,-5,7012,-328,-4.47,6973,7340,1400-10-11,2022-01-01
379,بزاگرس,نيروگاه زاگرس كوثر,291,3392604,11056710804,3416,3247,3246,-170,-4.98,3295,-121,-3.54,3246,3379,1400-10-11,2022-01-01
380,كيميا,معدني كيمياي زنجان گستران,290,1270809,15901865979,12909,12620,12440,-469,-3.63,12513,-396,-3.07,12264,12990,1400-10-11,2022-01-01
381,وايران,ليزينگ ايرانيان,290,2103087,6011151532,2916,2916,2880,-36,-1.23,2892,-24,-0.82,2800,2940,1400-10-11,2022-01-01
382,لبوتان,گروه‌صنعتي‌بوتان‌,289,370979,16978178850,48090,46000,45690,-2400,-4.99,45770,-2320,-4.82,45690,47190,1400-10-11,2022-01-01
383,ولصنم,ليزينگ‌صنعت‌ومعدن‌,287,1708902,6269934474,3785,3670,3607,-178,-4.7,3735,-50,-1.32,3604,3785,1400-10-11,2022-01-01
384,ختراك,ريخته‌گري‌ تراكتورسازي‌ ايران‌,285,3047447,15149819710,5204,5130,4950,-254,-4.88,4970,-234,-4.5,4950,5130,1400-10-11,2022-01-01
385,شكام,صنايع شيميايي كيمياگران امروز,278,1096100,32513761694,31134,31498,29690,-1444,-4.64,29663,-1471,-4.72,29578,31498,1400-10-11,2022-01-01
386,بكامح,ح.كارخانجات توليدي شهيد قندي,276,5431341,2970129106,575,575,547,-28,-4.87,547,-28,-4.87,535,576,1400-10-11,2022-01-01
387,اتكام,بيمه اتكايي امين,276,3481713,16947005502,4939,4840,4899,-40,-0.81,4867,-72,-1.46,4693,5057,1400-10-11,2022-01-01
388,تسه0006,امتيازتسهيلات مسكن شهريور1400,274,6704,7165174593,1053553,1106230,1060000,6447,0.61,1068791,15238,1.45,1000876,1106230,1400-10-11,2022-01-01
389,وسكاب,س.ص.بازنشستگي كاركنان بانكها,273,2026881,6063022905,3028,2970,2973,-55,-1.82,3013,-15,-0.5,2970,3015,1400-10-11,2022-01-01
390,دكيمي,كيميدارو,272,1255398,23860661790,18110,19010,19010,900,4.97,19010,900,4.97,18890,19010,1400-10-11,2022-01-01
391,تسه9810,امتياز تسهيلات مسكن دي98,272,7396,7612562409,1028721,1000001,977285,-51436,-5,1029281,560,0.05,977285,1069990,1400-10-11,2022-01-01
392,تشتاد,صنايع توليدي اشتاد ايران‌,272,2067754,9758048133,4595,4732,4732,137,2.98,4713,118,2.57,4510,4732,1400-10-11,2022-01-01
393,ارزش,صندوق س ارزش آفرين بيدار-سهام,270,1551868,14442975880,9540,9410,9320,-220,-2.31,9310,-230,-2.41,9260,9410,1400-10-11,2022-01-01
394,وجامي,سرمايه گذاري جامي,270,1136480,4797686008,4225,4215,4162,-63,-1.49,4223,-2,-0.05,4160,4280,1400-10-11,2022-01-01
395,اميد,تامين سرمايه اميد,270,2266084,19966504930,8750,8850,8800,50,0.57,8790,40,0.46,8760,8890,1400-10-11,2022-01-01
396,وسبحان,سرمايه گذاري سبحان,270,6918392,16522334192,2415,2430,2409,-6,-0.25,2388,-27,-1.12,2341,2430,1400-10-11,2022-01-01
397,زملارد,كشاورزي و دامپروري ملارد شير,268,565560,4672656720,7869,8262,8262,393,4.99,7986,117,1.49,8262,8262,1400-10-11,2022-01-01
398,ساينا,صنايع بهداشتي ساينا,267,91001,7403333183,84833,86000,80592,-4241,-5,83043,-1790,-2.11,80592,86000,1400-10-11,2022-01-01
399,پكرمان,گروه‌ صنعتي‌ بارز,265,1505105,28812161630,20140,19140,19140,-1000,-4.97,19140,-1000,-4.97,19140,19850,1400-10-11,2022-01-01
400,كساوه,صنايع‌ كاشي‌ و سراميك‌ سينا,264,431688,18137675900,43710,43000,41530,-2180,-4.99,42020,-1690,-3.87,41530,43000,1400-10-11,2022-01-01
401,ميدكو,توسعه معادن وص.معدني خاورميانه,264,4718820,217925519000,46200,46200,46190,-10,-0.02,46180,-20,-0.04,46170,46210,1400-10-11,2022-01-01
402,سپيدما,صندوق س. سپيد دماوند-د,263,11065828,128607298461,11606,11622,11623,17,0.15,11622,16,0.14,11622,11623,1400-10-11,2022-01-01
403,گوهر,صندوق سكه طلاي كيان,262,159486,10212226640,63763,64400,63904,141,0.22,64032,269,0.42,63501,64400,1400-10-11,2022-01-01
404,خموتورح,ح . موتورسازان‌تراكتورسازي‌,261,2941673,7492554368,2663,2580,2520,-143,-5.37,2547,-116,-4.36,2450,2688,1400-10-11,2022-01-01
405,دامين,داروسازي‌ امين‌,260,1999149,4902674033,2533,2440,2461,-72,-2.84,2506,-27,-1.07,2407,2514,1400-10-11,2022-01-01
406,دروز,داروسازي‌ روزدارو,260,1220836,31672326410,24740,25540,25970,1230,4.97,25940,1200,4.85,25130,25970,1400-10-11,2022-01-01
407,ودي,بيمه  دي,259,1796997,7253586038,4144,4070,4000,-144,-3.47,4091,-53,-1.28,3994,4207,1400-10-11,2022-01-01
408,وتوكا,سرمايه‌گذاري‌توكافولاد(هلدينگ,257,1130890,8603587150,7770,7650,7610,-160,-2.06,7670,-100,-1.29,7500,7780,1400-10-11,2022-01-01
409,بمپنا,توليد برق عسلويه  مپنا,257,1453767,8930175815,6438,6450,6117,-321,-4.99,6299,-139,-2.16,6117,6450,1400-10-11,2022-01-01
410,دزهراوي,داروسازي‌زهراوي‌,255,1376237,5820290571,4376,4380,4180,-196,-4.48,4317,-59,-1.35,4167,4380,1400-10-11,2022-01-01
411,ثپرديس,سرمايه گذاري مسكن پرديس,255,3950212,14879918635,3829,3651,3799,-30,-0.78,3767,-62,-1.62,3650,3978,1400-10-11,2022-01-01
412,وثوق,سرمايه گذاري وثوق امين,255,1516304,14263765848,9594,9594,9307,-287,-2.99,9407,-187,-1.95,9307,9794,1400-10-11,2022-01-01
413,زنگان,صنعت روي زنگان,254,142796,8082331676,57332,56917,56500,-832,-1.45,56933,-399,-0.7,56002,58180,1400-10-11,2022-01-01
414,ثعتما,س. ساختماني اعتماد گستر,249,645475,14730353085,24006,22806,22806,-1200,-5,22821,-1185,-4.94,22806,23190,1400-10-11,2022-01-01
415,كهمدا,شيشه‌ همدان‌,248,1155973,10807975360,9620,9440,9340,-280,-2.91,9420,-200,-2.08,9300,9580,1400-10-11,2022-01-01
416,تيپيكو,سرمايه گذاري دارويي تامين,248,1005232,18589781860,18660,18600,18280,-380,-2.04,18620,-40,-0.21,18260,19050,1400-10-11,2022-01-01
417,ثالوند,سرمايه گذاري مسكن الوند,247,815360,4907792222,6118,5991,6000,-118,-1.93,6085,-33,-0.54,5955,6130,1400-10-11,2022-01-01
418,شاملا,معدني‌ املاح‌  ايران‌,247,881853,11290304160,13240,13340,12580,-660,-4.98,12900,-340,-2.57,12580,13340,1400-10-11,2022-01-01
419,دبالك,مواد اوليه دارويي البرز بالك,245,908981,6716174856,7624,7332,7349,-275,-3.61,7515,-109,-1.43,7260,7630,1400-10-11,2022-01-01
420,وحكمت,بيمه حكمت صبا,242,3164811,10508775608,3232,3185,3328,96,2.97,3321,89,2.75,3185,3328,1400-10-11,2022-01-01
421,پرديسح,ح .  سرمايه گذاري پرديس,242,2770458,3523886378,1301,1270,1274,-27,-2.08,1272,-29,-2.23,1257,1296,1400-10-11,2022-01-01
422,كاذر,فرآورده‌هاي‌نسوزآذر,241,698583,8992521350,13230,13000,12840,-390,-2.95,13010,-220,-1.66,12670,13180,1400-10-11,2022-01-01
423,وتوسم,سرمايه‌گذاري‌توسعه‌ملي‌,240,1341770,11541676010,8780,8800,8540,-240,-2.73,8650,-130,-1.48,8530,8800,1400-10-11,2022-01-01
424,فسا,پتروشيمي فسا,236,3871212,3558598826,944,918,916,-28,-2.97,935,-9,-0.95,916,939,1400-10-11,2022-01-01
425,فولاژ,فولاد آلياژي ايران,236,778732,13358763300,17510,17160,17300,-210,-1.2,17450,-60,-0.34,17000,17550,1400-10-11,2022-01-01
426,شزنگ,تجهيزنيروي‌زنگان‌,236,106019,12304010823,119432,118999,115850,-3582,-3,116055,-3377,-2.83,115850,118999,1400-10-11,2022-01-01
427,غگلپا,شير پاستوريزه پگاه گلپايگان,235,204037,11984234764,59353,60520,57510,-1843,-3.11,58855,-498,-0.84,57001,61353,1400-10-11,2022-01-01
428,زگلدشت,كشت و دام گلدشت نمونه اصفهان,234,1305403,11992840410,9328,8888,9000,-328,-3.52,9214,-114,-1.22,8880,9499,1400-10-11,2022-01-01
429,افق,فروشگاههاي زنجيره اي افق كوروش,234,254747,10590504300,41980,42480,41500,-480,-1.14,41890,-90,-0.21,41100,42480,1400-10-11,2022-01-01
430,شنفت,نفت‌ پارس‌,230,1220551,12103749150,10320,9860,9880,-440,-4.26,10250,-70,-0.68,9860,10000,1400-10-11,2022-01-01
431,پكوير,كوير تاير,229,1182394,6526643030,5610,5610,5420,-190,-3.39,5570,-40,-0.71,5400,5610,1400-10-11,2022-01-01
432,اپرداز,آتيه داده پرداز,229,508827,10939503186,21809,21850,21200,-609,-2.79,21580,-229,-1.05,20800,22500,1400-10-11,2022-01-01
433,زعف0008پ20,زعفران0008نگين وحدت جام(پ),228,875190,219083079204,250057,253000,268545,18488,7.39,250326,269,0.11,242973,268545,1400-10-11,2022-01-01
434,آساميد,صندوق س.مشترك آسمان اميد -د,228,3387215,46616865385,13736,13761,13764,28,0.2,13763,27,0.2,13761,13764,1400-10-11,2022-01-01
435,خكرمان,گروه اقتصادي كرمان خودرو,227,3135861,9915444281,3224,3259,3145,-79,-2.45,3162,-62,-1.92,3128,3259,1400-10-11,2022-01-01
436,وپترو,سرمايه‌گذاري صنايع پتروشيمي‌,227,1060543,11617190200,10940,11050,11060,120,1.1,10950,10,0.09,10720,11070,1400-10-11,2022-01-01
437,اخزا002,اسنادخزانه-م2بودجه00-031024,226,432221,216101350300,498380,498990,500010,1630,0.33,499980,1600,0.32,496210,501470,1400-10-11,2022-01-01
438,بنو,بيمه تجارت نو,225,2336725,15350583108,6567,6570,6570,3,0.05,6569,2,0.03,6554,6580,1400-10-11,2022-01-01
439,شكربن,كربن‌ ايران‌,225,92634,8237338030,91820,88180,88350,-3470,-3.78,90180,-1640,-1.79,87720,91800,1400-10-11,2022-01-01
440,عيار,صندوق سكه طلاي مفيد,225,251383,8193892936,32505,32495,32780,275,0.85,32595,90,0.28,32490,32780,1400-10-11,2022-01-01
441,دتماد,توليدمواداوليه‌داروپخش‌,224,291531,11706148020,40750,40100,40800,50,0.12,40280,-470,-1.15,39560,41160,1400-10-11,2022-01-01
442,ونيكي,سرمايه‌گذاري‌ ملي‌ايران‌,223,1165200,10859156370,9540,9340,9310,-230,-2.41,9500,-40,-0.42,9250,9520,1400-10-11,2022-01-01
443,ساروم,سيمان‌اروميه‌,223,449984,17629212010,39420,40000,39480,60,0.15,39180,-240,-0.61,38510,40000,1400-10-11,2022-01-01
444,پلاسك,پلاسكوكار,223,2108410,8900374535,4375,4487,4201,-174,-3.98,4281,-94,-2.15,4178,4487,1400-10-11,2022-01-01
445,اوان,مبين وان كيش,223,940959,9286607999,10327,10057,9930,-397,-3.84,10030,-297,-2.88,9811,10059,1400-10-11,2022-01-01
446,صنوين,صندوق سرمايه‌گذاري صنوين-مختلط,223,69453,7840504850,119130,116800,113590,-5540,-4.65,112890,-6240,-5.24,107290,118000,1400-10-11,2022-01-01
447,وساشرقي,شركت س استان آذربايجان شرقي,221,11191487,5051330385,454,449,454,0,0,454,0,0,440,460,1400-10-11,2022-01-01
448,خاهن,آهنگري‌ تراكتورسازي‌ ايران‌,220,1185578,5117307029,4496,4350,4340,-156,-3.47,4459,-37,-0.82,4272,4401,1400-10-11,2022-01-01
449,غفارس,شير پاستوريزه پگاه فارس,215,1163353,6068466215,5416,5339,5150,-266,-4.91,5332,-84,-1.55,5146,5339,1400-10-11,2022-01-01
450,وسگيلا,شركت س استان گيلان,214,11860082,5360987231,460,454,454,-6,-1.3,458,-2,-0.43,449,458,1400-10-11,2022-01-01
451,ضخود2016,اختيارخ خودرو-1600-1401/02/07,214,10808,5926505000,646,522,546,-100,-15.48,548,-98,-15.17,522,560,1400-10-11,2022-01-01
452,مداران,داده‌پردازي‌ايران‌,213,521889,7847163530,14790,14800,15050,260,1.76,14920,130,0.88,14800,15480,1400-10-11,2022-01-01
453,پخش,پخش البرز,213,372755,8837180140,23692,23040,23590,-102,-0.43,23701,9,0.04,23040,24200,1400-10-11,2022-01-01
454,زفكا,كشت و دامداري فكا,213,1431281,11328098435,7964,8178,7861,-103,-1.29,7927,-37,-0.46,7740,8178,1400-10-11,2022-01-01
455,حبندر,دريايي و کشتيراني خط دريابندر,212,270390,3779579324,14400,13968,13968,-432,-3,14236,-164,-1.14,13968,14627,1400-10-11,2022-01-01
456,فوكا,فولاد كاويان,209,1033501,14572184649,14436,14006,14200,-236,-1.63,14291,-145,-1,14006,14380,1400-10-11,2022-01-01
457,شدوص,دوده‌ صنعتي‌ پارس‌,209,830243,10328002390,12740,12750,12700,-40,-0.31,12530,-210,-1.65,12110,12750,1400-10-11,2022-01-01
458,خديزل,بهمن  ديزل,208,169180,9011134610,53074,54002,52510,-564,-1.06,53154,80,0.15,52000,54499,1400-10-11,2022-01-01
459,ماني,صندوق س. با درآمد ثابت ماني,208,2675511,28761362077,10727,10750,10750,23,0.21,10750,23,0.21,10749,10751,1400-10-11,2022-01-01
460,ددام,داروسازي زاگرس فارمد پارس,206,625297,5016908190,8320,8040,8000,-320,-3.85,8220,-100,-1.2,7920,8260,1400-10-11,2022-01-01
461,مبين,مبين انرژي خليج فارس,205,873288,21758083370,25420,24980,25290,-130,-0.51,25330,-90,-0.35,24610,25420,1400-10-11,2022-01-01
462,شسينا,صنايع‌شيميايي‌سينا,205,3090206,9406587064,3204,3044,3044,-160,-4.99,3098,-106,-3.31,3044,3044,1400-10-11,2022-01-01
463,غپاك,لبنيات‌ پاك‌,203,399251,5023844910,12620,12140,12430,-190,-1.51,12610,-10,-0.08,12140,12790,1400-10-11,2022-01-01
464,فلامي,لاميران‌,202,307771,5815337840,18970,18550,19040,70,0.37,18940,-30,-0.16,18550,19270,1400-10-11,2022-01-01
465,وملل,اعتباري ملل,201,1580536,14603641217,9248,9000,9247,-1,-0.01,9245,-3,-0.03,8902,9299,1400-10-11,2022-01-01
466,كحافظ,كاشي‌ وسراميك‌ حافظ‌,201,1422424,5608409736,4027,3999,3915,-112,-2.78,3995,-32,-0.79,3852,4000,1400-10-11,2022-01-01
467,ومشان,س. فني و مهندسي مشانير,201,156011,6218460520,39668,40399,40319,651,1.64,39859,191,0.48,39256,40399,1400-10-11,2022-01-01
468,كطبس,ذغال‌سنگ‌ نگين‌ ط‌بس‌,200,230326,10457875590,47570,46100,45210,-2360,-4.96,45990,-1580,-3.32,45200,47000,1400-10-11,2022-01-01
469,اعتلاح,ح سرمايه گذاري اعتلاء البرز,200,1858752,2708603403,1525,1495,1459,-66,-4.33,1457,-68,-4.46,1449,1540,1400-10-11,2022-01-01
470,وبشهر,توسعه‌ صنايع‌ بهشهر(هلدينگ,200,1531302,10713386620,7200,7300,7000,-200,-2.78,7150,-50,-0.69,6930,7300,1400-10-11,2022-01-01
471,سخزر,سيمان‌ خزر,199,553960,9204874040,17430,16670,16560,-870,-4.99,16910,-520,-2.98,16560,17160,1400-10-11,2022-01-01
472,تصميم,صندوق س با درآمد ثابت تصميم,198,1302272,23961164140,18379,18397,18400,21,0.11,18400,21,0.11,18397,18400,1400-10-11,2022-01-01
473,پلاستح,ح.كارخانجات توليدي پلاستيران,198,3527512,11560504205,3378,3277,3277,-101,-2.99,3277,-101,-2.99,3277,3365,1400-10-11,2022-01-01
474,داوه,داروسازي آوه سينا,197,806913,7345249719,9067,8904,9200,133,1.47,9085,18,0.2,8904,9250,1400-10-11,2022-01-01
475,تسه0007,امتيازتسهيلات مسكن مهر1400,196,2930,3155474416,1051916,1104511,1000001,-51915,-4.94,1076954,25038,2.38,1000001,1104511,1400-10-11,2022-01-01
476,ثمسكن,سرمايه‌گذاري‌ مسكن‌,195,2569692,9116135778,3683,3612,3538,-145,-3.94,3598,-85,-2.31,3499,3680,1400-10-11,2022-01-01
477,سپاها,سيمان‌سپاهان‌,194,890570,6436307140,7480,7510,7240,-240,-3.21,7370,-110,-1.47,7190,7510,1400-10-11,2022-01-01
478,وبوعلي,سرمايه‌گذاري‌بوعلي‌,194,1512630,5567976664,3774,3774,3685,-89,-2.36,3739,-35,-0.93,3591,3774,1400-10-11,2022-01-01
479,پاكشو,گروه صنعتي پاكشو,192,1493540,8921365430,6170,5970,5950,-220,-3.57,6150,-20,-0.32,5930,6050,1400-10-11,2022-01-01
480,وتوس,توسعه‌شهري‌توس‌گستر,191,567058,4778759320,8680,8330,8390,-290,-3.34,8600,-80,-0.92,8330,8650,1400-10-11,2022-01-01
481,ولشرق,ليزينگ ايران و شرق,191,2728551,6036388949,2257,2155,2220,-37,-1.64,2239,-18,-0.8,2155,2270,1400-10-11,2022-01-01
482,حپارسا,توسعه حمل و نقل ريلي پارسيان,190,220199,6479895151,29193,28521,28882,-311,-1.07,29293,100,0.34,28521,30050,1400-10-11,2022-01-01
483,كنور,توسعه معدني و صنعتي صبانور,189,505343,9557086190,19280,18920,19120,-160,-0.83,19240,-40,-0.21,18700,19140,1400-10-11,2022-01-01
484,سفار,سيمان‌فارس‌,187,65613,3492218780,54730,53700,53720,-1010,-1.85,54370,-360,-0.66,52330,54520,1400-10-11,2022-01-01
485,وآرين,شركت توسعه اقتصادي آرين,186,1801619,3243980896,1772,1790,1820,48,2.71,1781,9,0.51,1751,1820,1400-10-11,2022-01-01
486,وتوشه,سرمايه‌ گذاري‌ پارس‌ توشه‌,186,919911,5016467690,5340,5520,5300,-40,-0.75,5380,40,0.75,5300,5520,1400-10-11,2022-01-01
487,سيستم,همكاران سيستم,185,3438397,17607666460,5378,5370,5110,-268,-4.98,5160,-218,-4.05,5110,5370,1400-10-11,2022-01-01
488,دكپسول,توليد ژلاتين كپسول ايران,180,221017,6651901691,30070,30000,30010,-60,-0.2,30082,12,0.04,29300,30470,1400-10-11,2022-01-01
489,كاريس,صندوق س.سپهر كاريزما-س,179,702291,9370490946,13549,13425,13334,-215,-1.59,13343,-206,-1.52,13300,13425,1400-10-11,2022-01-01
490,قپيرا,فرآورده‌هاي‌غدايي‌وقندپيرانشهر,179,1857071,15978662280,8220,8500,8630,410,4.99,8600,380,4.62,8250,8630,1400-10-11,2022-01-01
491,سدشت,صنايع سيمان دشتستان,179,105074,2759300080,26190,26050,26100,-90,-0.34,26200,10,0.04,25150,27000,1400-10-11,2022-01-01
492,داسوه,داروسازي‌ اسوه‌,179,215154,6065530020,29010,27590,27900,-1110,-3.83,28670,-340,-1.17,27590,28930,1400-10-11,2022-01-01
493,شرانل,نفت ايرانول,178,152188,7129988791,47799,47001,47000,-799,-1.67,47618,-181,-0.38,46500,47330,1400-10-11,2022-01-01
494,شاملاح,ح . معدني‌ املاح‌  ايران‌,176,676302,5233272860,8050,7800,7650,-400,-4.97,7740,-310,-3.85,7600,8100,1400-10-11,2022-01-01
495,بسويچ,پارس‌سويچ‌,175,589019,7861680380,14030,13610,13330,-700,-4.99,13650,-380,-2.71,13330,13610,1400-10-11,2022-01-01
496,كلوند,كاشي‌ الوند,174,379214,8397837270,22790,22550,22020,-770,-3.38,22420,-370,-1.62,22000,22550,1400-10-11,2022-01-01
497,ضخود2017,اختيارخ خودرو-1800-1401/02/07,174,8735,3816623000,489,460,433,-56,-11.45,437,-52,-10.63,425,460,1400-10-11,2022-01-01
498,تكمبا,كمباين‌ سازي‌ ايران‌,172,1196278,4313624803,3740,3564,3650,-90,-2.41,3700,-40,-1.07,3555,3709,1400-10-11,2022-01-01
499,وپخش,داروپخش‌ (هلدينگ‌,171,167365,5678660300,33540,33950,33460,-80,-0.24,33590,50,0.15,33400,34020,1400-10-11,2022-01-01
500,سقاين,سيمان‌ قائن‌,171,290140,11978553920,41340,41890,41780,440,1.06,41300,-40,-0.1,40000,41900,1400-10-11,2022-01-01
501,غشاذر,پگاه‌آذربايجان‌غربي‌,169,1070632,5350893854,4946,5090,4961,15,0.3,4964,18,0.36,4872,5101,1400-10-11,2022-01-01
502,تايرا,تراكتورسازي‌ايران‌,169,226861,4640144230,21120,20370,20680,-440,-2.08,21000,-120,-0.57,20070,21020,1400-10-11,2022-01-01
503,ضملت1133,اختيارخ وبملت-3000-1400/11/13,168,4792,1469326000,347,320,314,-33,-9.51,307,-40,-11.53,285,330,1400-10-11,2022-01-01
504,واعتبار,سرمايه گذاري اعتبار ايران,168,1903018,6001924101,3316,3340,3151,-165,-4.98,3248,-68,-2.05,3151,3340,1400-10-11,2022-01-01
505,ولملتح,ح . واسپاري ملت,167,3333977,4845432391,1515,1450,1414,-101,-6.67,1453,-62,-4.09,1414,1514,1400-10-11,2022-01-01
506,خكمك,كمك‌فنرايندامين‌,167,736800,16483106730,23540,22370,22370,-1170,-4.97,22370,-1170,-4.97,22370,23390,1400-10-11,2022-01-01
507,كساپا,سايپاشيشه‌,166,458970,7031978450,15500,16010,15240,-260,-1.68,15420,-80,-0.52,15200,16010,1400-10-11,2022-01-01
508,حخزر,كشتيراني درياي خزر,165,435653,5870764774,14083,13500,13401,-682,-4.84,13835,-248,-1.76,13379,14050,1400-10-11,2022-01-01
509,سخوز,سيمان خوزستان,165,178174,4023761280,23510,23020,22650,-860,-3.66,23250,-260,-1.11,22400,23490,1400-10-11,2022-01-01
510,تماوند,تامين سرمايه دماوند,164,8497517,47687692219,5743,5685,5614,-129,-2.25,5612,-131,-2.28,5571,5700,1400-10-11,2022-01-01
511,سغرب,سيمان‌غرب‌,164,393908,5531880550,13830,14400,14030,200,1.45,13910,80,0.58,13540,14400,1400-10-11,2022-01-01
512,والبر,سرمايه‌ گذاري‌ البرز(هلدينگ‌,163,591121,4297200750,7440,7360,7260,-180,-2.42,7410,-30,-0.4,7220,7370,1400-10-11,2022-01-01
513,نمرينو,ايران‌ مرينوس‌,163,235963,18860423330,79250,78050,80070,820,1.03,79930,680,0.86,77650,80450,1400-10-11,2022-01-01
514,پكويرح,ح. كوير تاير,161,820853,2632121812,3295,3206,3180,-115,-3.49,3207,-88,-2.67,3150,3366,1400-10-11,2022-01-01
515,وارس,سرمايه گذاري ارس صبا,161,756199,8324560746,10764,10611,11000,236,2.19,10963,199,1.85,10611,11086,1400-10-11,2022-01-01
516,كفرآور,فرآورده هاي سيمان شرق,160,842819,15144269481,18498,19000,18100,-398,-2.15,17969,-529,-2.86,17944,19000,1400-10-11,2022-01-01
517,آرمان,بيمه آرمان,160,464392,2373417191,5183,5028,5028,-155,-2.99,5166,-17,-0.33,5028,5324,1400-10-11,2022-01-01
518,چافست,افست‌,157,428391,3460491520,8130,8130,7900,-230,-2.83,8120,-10,-0.12,7840,8250,1400-10-11,2022-01-01
519,بفجرح,ح . فجر انرژي خليج فارس,157,1258714,11200603620,8820,8720,8820,0,0,8900,80,0.91,8710,9000,1400-10-11,2022-01-01
520,فافزا,فولاد افزا سپاهان,157,178647,5255168575,30131,30131,30098,-33,-0.11,29746,-385,-1.28,29228,30140,1400-10-11,2022-01-01
521,حشكوه,دليجان طلايي شكوه پارس,156,1242844,4260911052,3455,3455,3450,-5,-0.14,3444,-11,-0.32,3352,3487,1400-10-11,2022-01-01
522,زيتون,صندوق س زيتون نماد پايا- مختلط,156,817345,7932353786,9811,9839,9744,-67,-0.68,9705,-106,-1.08,9630,9839,1400-10-11,2022-01-01
523,ركيش,كارت اعتباري ايران كيش,155,1040098,6076398490,5690,5920,5820,130,2.28,5750,60,1.05,5560,5950,1400-10-11,2022-01-01
524,پرديس,سرمايه گذاري پرديس,155,768118,2645519351,3509,3509,3433,-76,-2.17,3497,-12,-0.34,3400,3558,1400-10-11,2022-01-01
525,نوين,بيمه نوين,154,1402463,5216367702,3728,3729,3739,11,0.3,3725,-3,-0.08,3611,3767,1400-10-11,2022-01-01
526,گنگين,اقتصادي نگين گردشگري ايرانيان,154,1152827,33517919062,28432,27600,29284,852,3,29049,617,2.17,27600,29284,1400-10-11,2022-01-01
527,پاسا,ايران‌ياساتايرورابر,153,427714,5618333040,13240,13150,13340,100,0.76,13200,-40,-0.3,12900,13400,1400-10-11,2022-01-01
528,خپويش,سازه‌ پويش‌,153,104283,6917726780,69510,69670,66070,-3440,-4.95,67980,-1530,-2.2,66040,69670,1400-10-11,2022-01-01
529,غشان,شيرپاستوريزه‌پگاه‌خراسان‌,153,1099830,4339019970,4008,4100,3931,-77,-1.92,3990,-18,-0.45,3920,4100,1400-10-11,2022-01-01
530,كگاز,شيشه‌ و گاز,152,561147,8587893790,15750,15500,15290,-460,-2.92,15490,-260,-1.65,15200,16300,1400-10-11,2022-01-01
531,كمينا,شيشه سازي مينا,151,699278,6135084072,9020,8750,8750,-270,-2.99,8864,-156,-1.73,8750,8940,1400-10-11,2022-01-01
532,دفارا,داروسازي‌ فارابي‌,150,299882,3719097570,12900,12420,12690,-210,-1.63,12770,-130,-1.01,12330,12690,1400-10-11,2022-01-01
533,خچرخش,چرخشگر,149,607444,4333325270,7380,7480,7290,-90,-1.22,7310,-70,-0.95,7050,7480,1400-10-11,2022-01-01
534,تسه0005,امتيازتسهيلات مسكن مرداد 1400,149,2809,3020979053,1057264,1040522,1004401,-52863,-5,1075464,18200,1.72,1004401,1110127,1400-10-11,2022-01-01
535,وصندوقح,ح.سرمايه گذاري صندوق بازنشستگي,148,1003303,11103057680,11120,10790,11120,0,0,11070,-50,-0.45,10790,11230,1400-10-11,2022-01-01
536,فيروزه,صندوق شاخص30 شركت فيروزه- سهام,148,94447,16229227830,175200,176990,171000,-4200,-2.4,171830,-3370,-1.92,171000,176990,1400-10-11,2022-01-01
537,غشهد,شهد ايران ‌,147,968128,4371265416,4679,4530,4519,-160,-3.42,4630,-49,-1.05,4446,4744,1400-10-11,2022-01-01
538,غچين,كشت‌ و صنعت‌ چين‌ چين,146,422191,4859627040,11540,11420,11400,-140,-1.21,11530,-10,-0.09,11400,11740,1400-10-11,2022-01-01
539,سكارون,سيمان كارون,145,160590,6287400055,39937,41135,38739,-1198,-3,39433,-504,-1.26,38739,41135,1400-10-11,2022-01-01
540,زرين,صندوق س. سهام زرين كوروش-س,143,379326,4915376577,13129,13100,12782,-347,-2.64,12958,-171,-1.3,12756,13100,1400-10-11,2022-01-01
541,كخاكح,ح . صنايع‌خاك‌چيني‌ايران‌,143,411697,3887385140,9650,9540,9540,-110,-1.14,9440,-210,-2.18,9350,9540,1400-10-11,2022-01-01
542,دابور,داروسازي‌ ابوريحان‌,143,311998,6798880370,22120,21670,21900,-220,-0.99,21970,-150,-0.68,21130,22060,1400-10-11,2022-01-01
543,دعبيد,لابراتوارداروسازي‌  دكترعبيدي‌,142,244977,4514190580,18920,19190,18600,-320,-1.69,18850,-70,-0.37,18200,19190,1400-10-11,2022-01-01
544,شفارا,پتروشيمي فارابي,142,1879044,11548499980,6329,6140,6140,-189,-2.99,6146,-183,-2.89,6140,6350,1400-10-11,2022-01-01
545,شراز,پالايش نفت شيراز,142,60124,6590145641,111131,111131,110163,-968,-0.87,110908,-223,-0.2,108800,111131,1400-10-11,2022-01-01
546,غپونه,نوش پونه مشهد,141,408276,4538230587,11164,10840,11498,334,2.99,11142,-22,-0.2,10840,11498,1400-10-11,2022-01-01
547,لابسا,آبسال‌,141,202022,6575724970,33470,32700,32560,-910,-2.72,33060,-410,-1.22,32320,33410,1400-10-11,2022-01-01
548,لخزر,پارس‌ خزر,141,43091,4729379770,111100,113300,112960,1860,1.67,110670,-430,-0.39,109000,113300,1400-10-11,2022-01-01
549,شصفها,پتروشيمي‌ اصفهان‌,140,105426,12336682678,116944,119282,115501,-1443,-1.23,117009,65,0.06,114632,119282,1400-10-11,2022-01-01
550,فاما,صنعتي‌ آما,138,379247,7152717830,19800,19010,18820,-980,-4.95,19330,-470,-2.37,18810,19460,1400-10-11,2022-01-01
551,كپشير,پشم‌شيشه‌ايران‌,138,281565,3033682720,10900,10890,10700,-200,-1.83,10870,-30,-0.28,10520,10990,1400-10-11,2022-01-01
552,زعف0110پ20,زعفران0110نگين وحدت جام(پ),137,79687,30858278733,368687,370000,396933,28246,7.66,387244,18557,5.03,368000,396933,1400-10-11,2022-01-01
553,حسينا,توسعه خدمات دريايي وبندري سينا,137,271545,12228524652,44769,43501,45380,611,1.36,44983,214,0.48,43500,45550,1400-10-11,2022-01-01
554,شوينده,مديريت صنعت شوينده ت.ص.بهشهر,137,437967,8754587240,20130,20130,19900,-230,-1.14,20050,-80,-0.4,19550,20790,1400-10-11,2022-01-01
555,كي بي سي,شركت كي بي سي,136,368625,5902652431,15898,15760,15952,54,0.34,15943,45,0.28,15700,16300,1400-10-11,2022-01-01
556,وثخوز,سرمايه گذاري و توسعه خوزستان,135,214744,5722053872,27468,26646,26644,-824,-3,26964,-504,-1.83,26644,27200,1400-10-11,2022-01-01
557,سهرمز,سيمان‌هرمزگان‌,132,416049,6871677880,16260,16630,16590,330,2.03,16380,120,0.74,16270,16630,1400-10-11,2022-01-01
558,زقيام,كشت و دام قيام اصفهان,132,4349311,5671501544,1242,1304,1304,62,4.99,1264,22,1.77,1304,1304,1400-10-11,2022-01-01
559,كوثر,بيمه كوثر,131,1255337,4757404238,3859,3858,3771,-88,-2.28,3846,-13,-0.34,3721,3858,1400-10-11,2022-01-01
560,تسه0004,امتيازتسهيلات مسكن تير1400,130,2477,2702813776,1056214,1050000,1003404,-52810,-5,1091164,34950,3.31,1003404,1109024,1400-10-11,2022-01-01
561,درهآور,دارويي ره آورد تامين,130,147832,3299769334,22581,22600,21810,-771,-3.41,22523,-58,-0.26,21780,23000,1400-10-11,2022-01-01
562,فبيرا,بسته‌ بندي‌ ايران‌,130,979823,1676305535,1702,1693,1728,26,1.53,1703,1,0.06,1693,1731,1400-10-11,2022-01-01
563,پرداخت,به پرداخت ملت,126,205595,2580509070,12600,12560,12600,0,0,12590,-10,-0.08,12330,12840,1400-10-11,2022-01-01
564,رتكو,كنترل‌خوردگي‌تكين‌كو,126,462550,3338613330,7220,7300,7110,-110,-1.52,7220,0,0,6990,7430,1400-10-11,2022-01-01
565,ومعلم,بيمه معلم,126,1265028,2435487388,1953,1904,1918,-35,-1.79,1948,-5,-0.26,1904,2001,1400-10-11,2022-01-01
566,قيستو,شركت قند بيستون,125,560604,11152414921,20417,19805,20100,-317,-1.55,19894,-523,-2.56,19805,20700,1400-10-11,2022-01-01
567,ولبهمن,شركت بهمن ليزينگ,125,645277,4071352267,6377,6350,6368,-9,-0.14,6358,-19,-0.3,6209,6400,1400-10-11,2022-01-01
568,سفانو,سيمان فارس نو,124,725439,18846936470,25630,25480,25400,-230,-0.9,25980,350,1.37,24800,26620,1400-10-11,2022-01-01
569,آبين,كشت و صنعت آبشيرين,124,1430700,2378289416,1693,1655,1650,-43,-2.54,1686,-7,-0.41,1644,1720,1400-10-11,2022-01-01
570,اعتلا,شركت سرمايه گذاري اعتلاء البرز,124,1006526,3460111939,3546,3539,3438,-108,-3.05,3520,-26,-0.73,3400,3546,1400-10-11,2022-01-01
571,دشيمي,شيمي‌ داروئي‌ داروپخش‌,123,237278,5203773570,22350,22220,21800,-550,-2.46,22200,-150,-0.67,21700,22450,1400-10-11,2022-01-01
572,دسبحا,گروه دارويي سبحان,122,206095,3831540050,19420,18580,18470,-950,-4.89,19290,-130,-0.67,18450,19200,1400-10-11,2022-01-01
573,فخاس,فولاد خراسان,122,174492,3890699850,22670,21710,21900,-770,-3.4,22660,-10,-0.04,21710,22560,1400-10-11,2022-01-01
574,ضخود2021,اختيارخ خودرو-3500-1401/02/07,120,8941,349059000,51,50,40,-11,-21.57,39,-12,-23.53,39,50,1400-10-11,2022-01-01
575,قصفها,قنداصفهان‌,120,170747,13944907490,77790,81670,81670,3880,4.99,81230,3440,4.42,81670,81670,1400-10-11,2022-01-01
576,سپ,پرداخت الكترونيك سامان كيش,116,117841,3763592730,31330,31370,32180,850,2.71,31370,40,0.13,31360,32200,1400-10-11,2022-01-01
577,بفجر,فجر انرژي خليج فارس,114,699482,7727141710,11250,11170,10990,-260,-2.31,11230,-20,-0.18,10990,11170,1400-10-11,2022-01-01
578,تابا,تابان نيرو سپاهان,113,391613,8057437475,19976,20575,20575,599,3,20575,599,3,20575,20575,1400-10-11,2022-01-01
579,تسه0003,امتيازتسهيلات مسكن خرداد1400,113,2060,2256659385,1061545,1031000,1022001,-39544,-3.73,1095466,33921,3.2,1021000,1114622,1400-10-11,2022-01-01
580,بميلا,توسعه بازرگاني آهن وفولادميلاد,112,828237,6720635889,8192,8021,8150,-42,-0.51,8139,-53,-0.65,8020,8192,1400-10-11,2022-01-01
581,اخزا006,اسنادخزانه-م6بودجه00-030723,110,247247,130852827430,526810,528990,530970,4160,0.79,529240,2430,0.46,525260,530980,1400-10-11,2022-01-01
582,پارسيان,بيمه پارسيان,108,579309,5003247880,8630,8630,8650,20,0.23,8630,0,0,8550,8730,1400-10-11,2022-01-01
583,ثبات,صندوق س. ثبات ويستا -د,108,3182694,33975072507,10656,10675,10675,19,0.18,10675,19,0.18,10674,10675,1400-10-11,2022-01-01
584,فيروزا,صندوق بادرآمد ثابت فيروزه آسيا,107,3167389,82571897299,26058,26070,26071,13,0.05,26069,11,0.04,25351,26080,1400-10-11,2022-01-01
585,تسه9912,امتياز تسهيلات مسكن اسفند99,106,2080,2300219457,1068711,1072000,1122146,53435,5,1105875,37164,3.48,1072000,1122146,1400-10-11,2022-01-01
586,ما,بيمه  ما,106,416090,1988787397,4677,4860,4721,44,0.94,4690,13,0.28,4690,4897,1400-10-11,2022-01-01
587,زر,صندوق س.پشتوانه سكه طلاي زر,105,42556,2391222719,55810,55825,56160,350,0.63,56190,380,0.68,55825,56380,1400-10-11,2022-01-01
588,بساما,بيمه سامان,103,261532,5153490919,19924,19140,19924,0,0,19854,-70,-0.35,19140,20300,1400-10-11,2022-01-01
589,ثاصفا,شركت‌ ساختمان‌ اصفهان‌,103,387949,2843269192,7517,7490,7351,-166,-2.21,7426,-91,-1.21,7292,7570,1400-10-11,2022-01-01
590,صايند,صندوق س. گنجينه آينده روشن-د,103,831200,8310746620,10170,10003,9999,-171,-1.68,9998,-172,-1.69,9995,10004,1400-10-11,2022-01-01
591,اخزا001,اسنادخزانه-م1بودجه00-030821,102,338126,176041059360,518050,516220,521730,3680,0.71,520640,2590,0.5,516220,521790,1400-10-11,2022-01-01
592,شدوصح,ح . دوده‌ صنعتي‌ پارس‌,102,465938,3485855930,7740,7440,7450,-290,-3.75,7480,-260,-3.36,7360,7650,1400-10-11,2022-01-01
593,شتوكاح,ح . توكا رنگ فولاد سپاهان,102,661156,8276668283,11938,12085,12534,596,4.99,12518,580,4.86,12085,12534,1400-10-11,2022-01-01
594,كخاك,صنايع‌خاك‌چيني‌ايران‌,101,235036,3237453260,13960,13500,13750,-210,-1.5,13930,-30,-0.21,13500,14190,1400-10-11,2022-01-01
595,تسه9902,امتياز تسهيلات مسكن ارديبهشت99,101,1814,1953480234,1055204,1100000,1010000,-45204,-4.28,1076891,21687,2.06,1002444,1107964,1400-10-11,2022-01-01
596,هجرت,پخش هجرت,100,63859,1678019527,27119,27100,26220,-899,-3.32,27022,-97,-0.36,26111,27100,1400-10-11,2022-01-01
597,دالبر,البرزدارو,100,398946,4658823030,11820,11820,11600,-220,-1.86,11780,-40,-0.34,11560,11990,1400-10-11,2022-01-01
598,وكادو,تكادو,99,395477,5819547781,15119,14903,14691,-428,-2.83,14878,-241,-1.59,14666,14940,1400-10-11,2022-01-01
599,تسه0002,امتيازتسهيلاتمسكن ارديبهشت1400,99,783,847326524,1058143,1111050,1030000,-28143,-2.66,1082154,24011,2.27,1030000,1111050,1400-10-11,2022-01-01
600,تسه0001,امتيازتسهيلات مسكن فروردين1400,96,1139,1248249366,1063049,1116201,1009897,-53152,-5,1095917,32868,3.09,1009897,1116201,1400-10-11,2022-01-01
601,تسه9908,امتياز تسهيلات مسكن آبان99,96,1366,1460725320,1051537,1011050,998962,-52575,-5,1069345,17808,1.69,998961,1104113,1400-10-11,2022-01-01
602,تسه9811,امتياز تسهيلات مسكن بهمن98,94,1443,1561764202,1070997,1031522,1060020,-10977,-1.02,1082304,11307,1.06,1031522,1124546,1400-10-11,2022-01-01
603,گوهران,سرمايه گذاري توسعه گوهران اميد,94,670954,3659145391,5453,5453,5453,0,0,5453,0,0,5450,5535,1400-10-11,2022-01-01
604,اوصتا,صندوق انديشه ورزان صباتامين -د,93,750934,15813138694,21028,21057,21058,30,0.14,21058,30,0.14,21057,21058,1400-10-11,2022-01-01
605,دحاوي,الحاوي,93,960100,3977819934,4217,4287,4121,-96,-2.28,4187,-30,-0.71,4099,4287,1400-10-11,2022-01-01
606,الماس,صندوق س.امين تدبيرگران فردا-س,92,37687,3738149465,100185,100391,99483,-702,-0.7,99189,-996,-0.99,98000,100500,1400-10-11,2022-01-01
607,زعف0110پ05,زعفران0110نگين زرين(پ),92,53247,20585272022,372510,375000,396933,24423,6.56,386600,14090,3.78,373001,396933,1400-10-11,2022-01-01
608,خصدرا,صنعتي‌ دريايي‌ ايران‌,91,1410574,3041197544,2222,2156,2156,-66,-2.97,2213,-9,-0.41,2156,2156,1400-10-11,2022-01-01
609,وملت,سرمايه گذاري ملت,91,549941,1235972878,2262,2236,2304,42,1.86,2258,-4,-0.18,2217,2304,1400-10-11,2022-01-01
610,وبهمن,سرمايه‌گذاري‌بهمن‌,90,180898,2497367110,14250,13740,13900,-350,-2.46,14180,-70,-0.49,13540,14280,1400-10-11,2022-01-01
611,تكنار,مجتمع معادن مس تكنار,90,49984,2484132445,50957,49500,50050,-907,-1.78,50636,-321,-0.63,49429,50979,1400-10-11,2022-01-01
612,لوتوس,تامين سرمايه لوتوس پارسيان,90,1172621,6706491210,5720,5790,5750,30,0.52,5720,0,0,5700,5790,1400-10-11,2022-01-01
613,شخارك,پتروشيمي‌ خارك‌,90,80374,4068309050,51150,50500,50720,-430,-0.84,51130,-20,-0.04,50000,50830,1400-10-11,2022-01-01
614,ضسپا1112,اختيارخ خساپا-1600-1400/11/20,89,3166,606952000,251,200,175,-76,-30.28,192,-59,-23.51,175,228,1400-10-11,2022-01-01
615,پلوله,گازلوله‌,89,257701,5963132328,23848,23134,23133,-715,-3,23413,-435,-1.82,23133,23680,1400-10-11,2022-01-01
616,كاسپين,داروسازي كاسپين تامين,89,307886,6814541712,22631,21751,22000,-631,-2.79,22400,-231,-1.02,21710,22747,1400-10-11,2022-01-01
617,برن0104پ01,برنج طارم0104تجارت مازندران(پ),89,6404,3431664827,511750,527500,536000,24250,4.74,535863,24113,4.71,509001,537337,1400-10-11,2022-01-01
618,ساربيل,سيمان آرتا اردبيل,86,84951,1822891950,21630,21400,21410,-220,-1.02,21610,-20,-0.09,21400,21640,1400-10-11,2022-01-01
619,ولراز,ليزينگ رازي,86,236654,4361262363,18975,18610,18406,-569,-3,18551,-424,-2.23,18406,19250,1400-10-11,2022-01-01
620,سجامح,ح.مجتمع سيمان غرب آسيا,86,826973,656201696,786,775,781,-5,-0.64,793,7,0.89,773,809,1400-10-11,2022-01-01
621,ساراب,سيمان‌ داراب‌,86,156610,2590494710,16690,16690,16350,-340,-2.04,16660,-30,-0.18,16300,16700,1400-10-11,2022-01-01
622,مارون,پتروشيمي مارون,86,11789,2034183843,173537,175100,171010,-2527,-1.46,173517,-20,-0.01,170251,175100,1400-10-11,2022-01-01
623,ثامان,سامان‌ گستراصفهان‌,85,378338,3323258240,9010,8710,8700,-310,-3.44,8960,-50,-0.55,8700,8900,1400-10-11,2022-01-01
624,ثاژن,سخت آژند,85,803817,3114526507,3842,3800,3918,76,1.98,3862,20,0.52,3800,3918,1400-10-11,2022-01-01
625,سشمال,سيمان‌ شمال‌,84,367437,2771380930,7500,7430,7510,10,0.13,7510,10,0.13,7430,7590,1400-10-11,2022-01-01
626,كشرق,صنعتي و معدني شمال شرق شاهرود,82,39001,2588873816,69233,66091,67680,-1553,-2.24,68719,-514,-0.74,66000,68597,1400-10-11,2022-01-01
627,وبازار,صندوق س شاخصي بازارآشنا,82,341033,4028517040,12020,11850,11770,-250,-2.08,11810,-210,-1.75,11760,11860,1400-10-11,2022-01-01
628,خاتم,صندوق س خاتم ايساتيس پويا-ثابت,80,835221,10504349468,12567,12577,12578,11,0.09,12577,10,0.08,12576,12578,1400-10-11,2022-01-01
629,كيان2,صندوق س. با درآمد ثابت كيان,80,8000000,8000000,32327,1,1,-32326,-100,1,-32326,-100,1,1,1400-10-11,2022-01-01
630,غشوكو,شوكو پارس,79,147755,1128044543,7866,7890,7631,-235,-2.99,7839,-27,-0.34,7631,7890,1400-10-11,2022-01-01
631,دارو,كارخانجات‌داروپخش‌,79,144156,4125382230,29060,28960,28990,-70,-0.24,28950,-110,-0.38,28050,29250,1400-10-11,2022-01-01
632,زعف0008پ05,زعفران0008نگين زرين(پ),79,62010,16552451564,256306,262000,268545,12239,4.78,266932,10626,4.15,245005,268545,1400-10-11,2022-01-01
633,شپاس,نفت پاسارگاد,79,351882,5469512950,15662,15788,15550,-112,-0.72,15619,-43,-0.27,15500,15788,1400-10-11,2022-01-01
634,ثزاگرس,سرمايه گذاري توسعه عمران زاگرس,79,40164,1301060806,32696,31810,32599,-97,-0.3,32656,-40,-0.12,31810,33652,1400-10-11,2022-01-01
635,كپرور,فرآوري زغال سنگ پروده طبس,78,86068,2352645642,28038,28815,27210,-828,-2.95,27925,-113,-0.4,27005,28815,1400-10-11,2022-01-01
636,وصندوق,سرمايه‌گذاري‌صندوق‌بازنشستگي‌,78,195950,2453088500,12680,12490,12490,-190,-1.5,12680,0,0,12470,12650,1400-10-11,2022-01-01
637,واتي,سرمايه‌ گذاري‌ آتيه‌ دماوند,78,277308,2725954520,10110,9870,9850,-260,-2.57,10070,-40,-0.4,9720,10100,1400-10-11,2022-01-01
638,سبجنو,سيمان‌ بجنورد,78,87246,3261560240,37210,37210,36940,-270,-0.73,37250,40,0.11,36030,37990,1400-10-11,2022-01-01
639,ويسا,سرمايه گذاري ايساتيس پويا,77,1455729,11404722581,7827,7611,7652,-175,-2.24,7834,7,0.09,7611,7900,1400-10-11,2022-01-01
640,پلاست,كارخانجات توليدي پلاستيران,77,428352,2953989032,7109,6896,6896,-213,-3,7044,-65,-0.91,6896,6901,1400-10-11,2022-01-01
641,سجام,مجتمع سيمان غرب آسيا,77,690062,1427514359,2128,2128,2065,-63,-2.96,2119,-9,-0.42,2065,2128,1400-10-11,2022-01-01
642,وامين,س. امين توان آفرين ساز,76,128963,1591527000,12530,12530,12330,-200,-1.6,12524,-6,-0.05,12200,12530,1400-10-11,2022-01-01
643,كقزوي,شيشه‌ قزوين‌,76,1201253,10127764043,8186,8431,8431,245,2.99,8427,241,2.94,8431,8431,1400-10-11,2022-01-01
644,غشصفا,شيرپاستوريزه‌پگاه‌اصفهان‌,76,135219,3494058960,27190,25840,25840,-1350,-4.97,26860,-330,-1.21,25840,25840,1400-10-11,2022-01-01
645,لازما,كارخانه هاي صنعتي آزمايش,75,110189,2766407649,25873,25391,25097,-776,-3,25654,-219,-0.85,25097,25600,1400-10-11,2022-01-01
646,قشرين,قند شيرين خراسان,75,347613,2119048848,6284,6096,6096,-188,-2.99,6243,-41,-0.65,6096,6096,1400-10-11,2022-01-01
647,وآفري,بيمه كارآفرين,74,4269160,16328049721,3715,3760,3826,111,2.99,3825,110,2.96,3760,3826,1400-10-11,2022-01-01
648,سكرد,سيمان كردستان,74,202165,927346018,4565,4566,4640,75,1.64,4566,1,0.02,4566,4680,1400-10-11,2022-01-01
649,كهربا,صندوق س.پشتوانه سكه طلا كهربا,73,2599063,28844598073,11023,11139,11032,9,0.08,11098,75,0.68,11030,11139,1400-10-11,2022-01-01
650,سرود,سيمان‌شاهرود,72,217093,4541631670,21460,20550,20840,-620,-2.89,21290,-170,-0.79,20550,21320,1400-10-11,2022-01-01
651,سپاس,صندوق س. پاداش سهامداري-ثابت,70,524651,5322459561,10130,10142,10146,16,0.16,10145,15,0.15,10142,10146,1400-10-11,2022-01-01
652,تكنو,تكنوتار,69,131935,857398240,6760,6560,6510,-250,-3.7,6740,-20,-0.3,6430,6660,1400-10-11,2022-01-01
653,اخزا004,اسنادخزانه-م4بودجه00-030522,68,137981,76007918160,548180,550000,552000,3820,0.7,550860,2680,0.49,549400,552000,1400-10-11,2022-01-01
654,دپارس,پارس‌ دارو,68,31023,872896550,28470,28540,28380,-90,-0.32,28450,-20,-0.07,27280,29090,1400-10-11,2022-01-01
655,وايرا,سرمايه گذاري صنايع ايران,67,209655,900936550,4399,4283,4282,-117,-2.66,4390,-9,-0.2,4270,4350,1400-10-11,2022-01-01
656,ضشنا1050,اختيارخ شپنا-7629-1400/10/19,66,2428,17869230,7,4,4,-3,-42.86,4,-3,-42.86,3,5,1400-10-11,2022-01-01
657,تسه9910,امتياز تسهيلات مسكن دي99,64,1149,1260467954,1050203,1050203,1050203,0,0,1097013,46810,4.46,1050203,1102713,1400-10-11,2022-01-01
658,بخاور,بيمه زندگي خاورميانه,64,1033764,2222165579,2234,2180,2140,-94,-4.21,2221,-13,-0.58,2123,2200,1400-10-11,2022-01-01
659,سكه0012پ04,تمام سكه طرح جديد0012صادرات,64,25100,32404498700,1285106,1288000,1293000,7894,0.61,1291016,5910,0.46,1287001,1293000,1400-10-11,2022-01-01
660,پسهند,صنايع‌ لاستيكي‌  سهند,61,102003,2908799680,29510,29000,28570,-940,-3.19,29310,-200,-0.68,28210,29990,1400-10-11,2022-01-01
661,دارا,صندوق س. دارا الگوريتم-د,60,1696232,16972622840,9986,10007,10007,21,0.21,10006,20,0.2,10006,10012,1400-10-11,2022-01-01
662,آكورد2,صندوق س. آرمان آتي كوثر-د,60,6000000,6000000,35994,1,1,-35993,-100,1,-35993,-100,1,1,1400-10-11,2022-01-01
663,زعف0110پ10,زعفران0110نگين طلاي سرخ(پ),60,108816,43112076969,380131,377100,396933,16802,4.42,396192,16061,4.23,377100,396933,1400-10-11,2022-01-01
664,تسه9907,امتياز تسهيلات مسكن مهر99,59,867,936125580,1049394,1045021,1040000,-9394,-0.9,1079730,30336,2.89,1040000,1101863,1400-10-11,2022-01-01
665,زعف0110پ18,زعفران0110نگين بهرامن(پ),59,56147,21853629612,369684,370000,396933,27249,7.37,389222,19538,5.29,370000,396933,1400-10-11,2022-01-01
666,وزمين,بانك ايران زمين,59,389270,3254789251,8456,8288,8300,-156,-1.84,8433,-23,-0.27,8288,8598,1400-10-11,2022-01-01
667,تسه9909,امتياز تسهيلات مسكن آذر99,58,874,933920919,1064851,1054002,1030000,-34851,-3.27,1068559,3708,0.35,1030000,1118093,1400-10-11,2022-01-01
668,دابورح,ح . داروسازي‌ ابوريحان‌,57,1286257,24604412400,19890,19500,19200,-690,-3.47,19130,-760,-3.82,19100,19500,1400-10-11,2022-01-01
669,اخزا917,اسنادخزانه-م17بودجه99-010226,57,151652,139985661260,921260,921010,924500,3240,0.35,923070,1810,0.2,920360,924500,1400-10-11,2022-01-01
670,كصدف,كاشي صدف سرام استقلال آباده,56,132954,2677656935,19604,20148,20192,588,3,19744,140,0.71,19605,20192,1400-10-11,2022-01-01
671,ولتجار,واسپاري تجارت وسرمايه ايرانيان,56,287216,744953963,2662,2606,2584,-78,-2.93,2657,-5,-0.19,2583,2730,1400-10-11,2022-01-01
672,قشهد,شهد,55,237611,3580797770,14360,15070,15070,710,4.94,14520,160,1.11,15070,15070,1400-10-11,2022-01-01
673,نتوس,پشم‌ بافي‌ توس,54,109764,1247361426,11689,11899,11339,-350,-2.99,11647,-42,-0.36,11339,11899,1400-10-11,2022-01-01
674,تسه9911,امتياز تسهيلات مسكن بهمن99,53,803,872462283,1059899,1089900,1008999,-50900,-4.8,1086503,26604,2.51,1008999,1112893,1400-10-11,2022-01-01
675,تسه9903,امتياز تسهيلات مسكن خرداد99,52,549,587213343,1050040,1030022,1010000,-40040,-3.81,1069605,19565,1.86,1010000,1102542,1400-10-11,2022-01-01
676,اخزا003,اسنادخزانه-م3بودجه00-030418,52,124504,70105832860,561570,561990,563900,2330,0.41,563080,1510,0.27,561950,564000,1400-10-11,2022-01-01
677,ضجار1020,اختيارخ وتجارت-1600-1400/10/15,50,1565,497229000,403,312,330,-73,-18.11,318,-85,-21.09,300,330,1400-10-11,2022-01-01
678,لپيام,گسترش صنايع پيام,50,71164,1851544952,27387,26018,26018,-1369,-5,27120,-267,-0.97,26018,26018,1400-10-11,2022-01-01
679,غالبر,لبنيات‌ كالبر,49,205606,2344656540,11990,11410,11400,-590,-4.92,11890,-100,-0.83,11400,11410,1400-10-11,2022-01-01
680,ارمغان,ص سرمايه گذاري ارمغان ايرانيان,49,408653,4141187488,10124,10140,10137,13,0.13,10134,10,0.1,10132,10140,1400-10-11,2022-01-01
681,سيدكو,سرمايه گذاري توسعه صنايع سيمان,48,588116,3465813680,5930,6100,5890,-40,-0.67,5920,-10,-0.17,5820,6100,1400-10-11,2022-01-01
682,سكرما,سيمان‌ كرمان‌,48,109358,1641751780,15140,15450,14920,-220,-1.45,15130,-10,-0.07,14710,15450,1400-10-11,2022-01-01
683,تسه9812,امتياز تسهيلات مسكن اسفند98,46,537,592583317,1074881,1097224,1042011,-32870,-3.06,1103507,28626,2.66,1040000,1128625,1400-10-11,2022-01-01
684,تسه9904,امتياز تسهيلات مسكن تير99,46,591,636361878,1055963,1050000,1062002,6039,0.57,1076754,20791,1.97,1050000,1108761,1400-10-11,2022-01-01
685,شكبير,پتروشيمي اميركبير,46,28970,2691815763,93884,93200,92950,-934,-0.99,93858,-26,-0.03,91800,94000,1400-10-11,2022-01-01
686,معيار ,سرمايه گذاري معيار صنعت پارس,45,18392,737139207,40616,40694,40488,-128,-0.32,40576,-40,-0.1,39400,40694,1400-10-11,2022-01-01
687,تسه9901,امتياز تسهيلات مسكن فروردين99,45,514,573414857,1067495,1021010,1120869,53374,5,1115593,48098,4.51,1021010,1120869,1400-10-11,2022-01-01
688,ولقمان,سرمايه گذاري لقمان,44,232476,592832707,2628,2550,2550,-78,-2.97,2623,-5,-0.19,2550,2551,1400-10-11,2022-01-01
689,كبورس,كارگزاران بورس اوراق بهادار,44,2720000,30572800000,11830,11240,11240,-590,-4.99,11540,-290,-2.45,11240,11240,1400-10-11,2022-01-01
690,شساخت,مهندسي و ساختمان صنايع نفت,44,135673,5998940655,44194,44194,44499,305,0.69,44197,3,0.01,44194,45000,1400-10-11,2022-01-01
691,آساس,صندوق س.آسمان آرماني سهام-س,43,23151,3838065678,169221,167002,165900,-3321,-1.96,165784,-3437,-2.03,165301,167500,1400-10-11,2022-01-01
692,قلرست,قند لرستان‌,42,72753,1150224930,15060,15810,15810,750,4.98,15110,50,0.33,15810,15810,1400-10-11,2022-01-01
693,اخزا815,اسنادخزانه-م15بودجه98-010406,41,112165,101018138790,898900,898910,901000,2100,0.23,900620,1720,0.19,898900,902000,1400-10-11,2022-01-01
694,زعف0110پ11,زعفران0110نگين سحرخيز(پ),40,28035,11087076455,378239,377100,396933,18694,4.94,395473,17234,4.56,377100,396933,1400-10-11,2022-01-01
695,دسينا,داروسازي‌ سينا,40,111135,2286785650,20920,20610,20450,-470,-2.25,20870,-50,-0.24,20400,20990,1400-10-11,2022-01-01
696,آتيمس,صندوق س.آرمان آتيه درخشان مس-س,38,13560,2468846894,182223,182326,181900,-323,-0.18,182068,-155,-0.09,181890,182970,1400-10-11,2022-01-01
697,ضجار1021,اختيارخ وتجارت-1800-1400/10/15,37,1239,145751000,195,151,120,-75,-38.46,118,-77,-39.49,111,164,1400-10-11,2022-01-01
698,قهكمت,قندهكمتان‌,36,879578,4212299042,4561,4789,4789,228,5,4622,61,1.34,4789,4789,1400-10-11,2022-01-01
699,سكه0111پ05,تمام سكه طرح جديد0111آينده,36,21500,27548654600,1286522,1270100,1291000,4478,0.35,1281333,-5189,-0.4,1270100,1299891,1400-10-11,2022-01-01
700,اخزا914,اسنادخزانه-م14بودجه99-021025,36,152823,96875059510,630180,630100,634000,3820,0.61,633900,3720,0.59,629000,634870,1400-10-11,2022-01-01
701,اخزا910,اسنادخزانه-م10بودجه99-020807,35,26080,17327266980,662840,661100,665000,2160,0.33,664390,1550,0.23,661100,665900,1400-10-11,2022-01-01
702,اخزا005,اسنادخزانه-م5بودجه00-030626,35,68042,36644183800,536760,538990,540000,3240,0.6,538550,1790,0.33,535990,540000,1400-10-11,2022-01-01
703,شستان,پتروشيمي گلستان,35,348016,1238588944,3490,3559,3559,69,1.98,3507,17,0.49,3559,3559,1400-10-11,2022-01-01
704,زعف0110پ16,زعفران0110نگين بيرجند(پ),35,50838,19552247574,366220,372500,396800,30580,8.35,384599,18379,5.02,372500,396933,1400-10-11,2022-01-01
705,اخزا903,اسنادخزانه-م3بودجه99-011110,33,64418,51016965110,791030,791620,793300,2270,0.29,791970,940,0.12,791600,793300,1400-10-11,2022-01-01
706,سهگمت,سيمان‌هگمتان‌,33,27862,572133310,20990,20770,20570,-420,-2,20970,-20,-0.1,20240,21000,1400-10-11,2022-01-01
707,تسه9906,امتياز تسهيلات مسكن شهريور99,32,349,381758050,1052588,1055887,999959,-52629,-5,1093863,41275,3.92,999959,1105217,1400-10-11,2022-01-01
708,اخزا902,اسنادخزانه-م2بودجه99-011019,32,33606,27010884100,800460,801090,804000,3540,0.44,803750,3290,0.41,801090,804000,1400-10-11,2022-01-01
709,تسه9905,امتياز تسهيلات مسكن مرداد99,31,197,212828925,1056086,1030080,1064300,8214,0.78,1080350,24264,2.3,1030080,1108890,1400-10-11,2022-01-01
710,سدبير,س. تدبيرگران فارس وخوزستان,31,22246,869640632,41149,39092,39092,-2057,-5,41023,-126,-0.31,39092,39092,1400-10-11,2022-01-01
711,داريوش,صندوق س. ثروت داريوش -س,31,81124,784919981,9777,9750,9690,-87,-0.89,9676,-101,-1.03,9620,9750,1400-10-11,2022-01-01
712,ثمين,صندوق س. ثروت افزون ثمين-س,31,159260,1636327140,10550,10500,10250,-300,-2.84,10275,-275,-2.61,10250,10500,1400-10-11,2022-01-01
713,ثروتم,صندوق س. ثروت آفرين پارسيان-س,31,8980,766292800,86959,85830,85593,-1366,-1.57,85333,-1626,-1.87,85000,85831,1400-10-11,2022-01-01
714,خبازرس,بازرسي مهندسي و صنعتي ايران,31,16193,359063582,22859,22174,22174,-685,-3,22834,-25,-0.11,22174,22174,1400-10-11,2022-01-01
715,اخزا901,اسنادخزانه-م1بودجه99-010621,30,23854,20526299290,859180,859990,860760,1580,0.18,860500,1320,0.15,859050,865950,1400-10-11,2022-01-01
716,سكه0011پ02,تمام سكه طرح جديد0011ملت,30,5200,6715324400,1286846,1290009,1291988,5142,0.4,1291408,4562,0.35,1288501,1293000,1400-10-11,2022-01-01
717,دقاضي,داروسازي شهيد قاضي,30,28853,725241603,24720,25300,25361,641,2.59,24750,30,0.12,24500,25363,1400-10-11,2022-01-01
718,دمعيار,صندوق س. توازن معيار-د,30,265169,2579384684,9775,9741,9740,-35,-0.36,9727,-48,-0.49,9655,9741,1400-10-11,2022-01-01
719,سكه0112پ03,تمام سكه طرح جديد0112سامان,28,3900,5036973500,1288554,1297000,1293000,4446,0.35,1291532,2978,0.23,1290000,1297000,1400-10-11,2022-01-01
720,ضبدر1163,اختيارخ شبندر-6000-1400/11/13,28,297,243424000,1029,700,895,-134,-13.02,820,-209,-20.31,700,901,1400-10-11,2022-01-01
721,غدشت,دشت‌ مرغاب‌,28,16095,328177050,21460,20390,20390,-1070,-4.99,21440,-20,-0.09,20390,20390,1400-10-11,2022-01-01
722,اخزا812,اسنادخزانه-م12بودجه98-001111,27,2306,2269320140,981590,985000,983740,2150,0.22,984090,2500,0.25,983700,985000,1400-10-11,2022-01-01
723,زعف0110پ21,زعفران0110نگين ملل(پ),27,58391,23107889363,369150,370101,396933,27783,7.53,395744,26594,7.2,370101,396933,1400-10-11,2022-01-01
724,گنجين,صندوق س. گنجينه يكم آويد-د,27,132835,1924894460,14468,14488,14498,30,0.21,14491,23,0.16,14488,14498,1400-10-11,2022-01-01
725,ضملت1134,اختيارخ وبملت-3500-1400/11/13,27,690,54415000,115,80,72,-43,-37.39,79,-36,-31.3,72,81,1400-10-11,2022-01-01
726,اراد50,مرابحه عام دولت5-ش.خ0302,26,610100,610100341000,1000000,1000000,1000010,10,0,1000000,0,0,1000000,1000010,1400-10-11,2022-01-01
727,ضسپا1114,اختيارخ خساپا-2000-1400/11/20,26,1232,76225000,72,70,53,-19,-26.39,62,-10,-13.89,51,70,1400-10-11,2022-01-01
728,ضصاد1113,اختيارخ وبصادر-2000-1400/11/06,25,1305,107658000,131,84,88,-43,-32.82,82,-49,-37.4,80,88,1400-10-11,2022-01-01
729,پست0108پ10,پسته فندقي34-32مه ولات0108(پ),25,2515,5357361467,2054683,2130000,2157417,102734,5,2130163,75480,3.67,2130000,2157417,1400-10-11,2022-01-01
730,افرا,افرانت,25,24514,561615740,24115,22910,22910,-1205,-5,24068,-47,-0.19,22910,22910,1400-10-11,2022-01-01
731,اخزا009,اسناد خزانه-م9بودجه00-031101,24,13855,6914221150,496140,498940,499000,2860,0.58,499040,2900,0.58,498010,502000,1400-10-11,2022-01-01
732,ضشنا1048,اختيارخ شپنا-5450-1400/10/19,24,633,696945845,604,550,620,16,2.65,600,-4,-0.66,540,700,1400-10-11,2022-01-01
733,اخزا918,اسنادخزانه-م18بودجه99-010323,24,59341,53818626310,906340,906800,907750,1410,0.16,906940,600,0.07,906600,907770,1400-10-11,2022-01-01
734,قنقش,قند نقش جهان,24,14565,1890609825,132454,129805,129805,-2649,-2,131760,-694,-0.52,129805,129805,1400-10-11,2022-01-01
735,ضملي1159,اختيارخ فملي-5000-1400/11/03,22,136,575664000,2400,2200,2100,-300,-12.5,2116,-284,-11.83,2000,2230,1400-10-11,2022-01-01
736,ضسپا1113,اختيارخ خساپا-1800-1400/11/20,21,795,81488000,136,120,90,-46,-33.82,103,-33,-24.26,81,120,1400-10-11,2022-01-01
737,داريك,صندوق س.اعتماد داريك-د,21,476420,5768999960,12102,12108,12110,8,0.07,12109,7,0.06,12108,12110,1400-10-11,2022-01-01
738,اخزا911,اسنادخزانه-م11بودجه99-020906,21,21965,14313392920,649380,649990,653000,3620,0.56,651650,2270,0.35,649990,653010,1400-10-11,2022-01-01
739,ضسپا1111,اختيارخ خساپا-1400-1400/11/20,20,1001,317243000,377,330,310,-67,-17.77,317,-60,-15.92,310,330,1400-10-11,2022-01-01
740,افق ملت,صندوق س در سهام افق ملت,19,9426,1312304200,139890,140000,140100,210,0.15,139220,-670,-0.48,139000,140100,1400-10-11,2022-01-01
741,زعف0008پ15,زعفران0008پوشالمعمول طلاسرخ(پ),19,3118,732242066,227004,217410,240294,13290,5.85,234844,7840,3.45,217410,240294,1400-10-11,2022-01-01
742,هفارس104,اختيارف ت فارس-11832-01/04/12,19,344612,344612,1,1,1,0,0,1,0,0,1,1,1400-10-11,2022-01-01
743,زعف0110پ08,زعفران0110نگين روستا(پ),19,24106,9379940731,376086,379999,396933,20847,5.54,389112,13026,3.46,379989,396933,1400-10-11,2022-01-01
744,زعف0110پ19,زعفران0110نگين تروند قاينات(پ),17,15518,6125717624,366601,369999,396933,30332,8.27,394749,28148,7.68,369999,396933,1400-10-11,2022-01-01
745,اخزا909,اسنادخزانه-م9بودجه99-020316,16,61863,44962172640,725590,725010,726800,1210,0.17,726800,1210,0.17,725010,727880,1400-10-11,2022-01-01
746,اخزا007,اسنادخزانه-م7بودجه00-030912,16,63605,32682449440,512660,513800,514510,1850,0.36,513830,1170,0.23,512680,517480,1400-10-11,2022-01-01
747,حگردش,ريل گردش ايرانيان,15,311649,1193927319,3949,3831,3831,-118,-2.99,3934,-15,-0.38,3831,3831,1400-10-11,2022-01-01
748,اخزا907,اسنادخزانه-م7بودجه99-020704,15,50686,34274052900,675590,676000,678500,2910,0.43,676200,610,0.09,675590,678500,1400-10-11,2022-01-01
749,هكشو208,اختيارف ت پاكشو10000-02/08/29,15,383818,190757546,455,497,497,42,9.23,497,42,9.23,497,497,1400-10-11,2022-01-01
750,فالوم,آلومتك‌,15,38843,893544372,24214,23004,23004,-1210,-5,23004,-1210,-5,23004,23004,1400-10-11,2022-01-01
751,اخزا908,اسنادخزانه-م8بودجه99-020606,15,60370,41689465200,687960,690400,691160,3200,0.47,690570,2610,0.38,690390,691970,1400-10-11,2022-01-01
752,ثجوان,تامين مسكن جوانان,15,101949,452959407,4580,4443,4443,-137,-2.99,4574,-6,-0.13,4443,4443,1400-10-11,2022-01-01
753,ثهام,صندوق س ثروت هامرز-سهام,15,68043,748651425,10998,11000,10990,-8,-0.07,11003,5,0.05,10990,11149,1400-10-11,2022-01-01
754,فراز,صندوق س.سهام فراز داريك-س,14,118255,1682408074,14226,14227,14226,0,0,14227,1,0.01,14226,14229,1400-10-11,2022-01-01
755,امين يكم2,صندوق درآمد ثابت امين يكم فردا,14,14000000,14000000,10034,1,1,-10033,-99.99,1,-10033,-99.99,1,1,1400-10-11,2022-01-01
756,اخزا818,اسنادخزانه-م18بودجه98-010614,14,14792,12788309010,864050,869990,864500,450,0.05,864540,490,0.06,864500,869990,1400-10-11,2022-01-01
757,ضصاد1114,اختيارخ وبصادر-2500-1400/11/06,13,588,8987000,28,20,11,-17,-60.71,15,-13,-46.43,3,20,1400-10-11,2022-01-01
758,اخزا817,اسنادخزانه-م17بودجه98-010512,13,37422,32987243400,879260,880000,881400,2140,0.24,881490,2230,0.25,880000,882000,1400-10-11,2022-01-01
759,عيار2,صندوق سكه طلاي مفيد,13,130000,130000,32505,1,1,-32504,-100,1,-32504,-100,1,1,1400-10-11,2022-01-01
760,جهرم,پتروشيمي جهرم,13,177570,226046610,1339,1273,1273,-66,-4.93,1337,-2,-0.15,1273,1273,1400-10-11,2022-01-01
761,نگين,ص.س. زمين و ساختمان نگين شهرري,13,21894,1168575320,51830,53350,53380,1550,2.99,53370,1540,2.97,53350,53380,1400-10-11,2022-01-01
762,اخزا008,اسنادخزانه-م8بودجه00-030919,13,19768,10120674720,510300,514000,512490,2190,0.43,511970,1670,0.33,511910,514000,1400-10-11,2022-01-01
763,زعف0008پ11,زعفران0008نگين سحرخيز(پ),12,2428,652027260,272221,268545,268545,-3676,-1.35,268545,-3676,-1.35,268545,268545,1400-10-11,2022-01-01
764,ضفلا1163,اختيارخ فولاد-10000-1400/11/24,12,117,146630000,1579,1500,1250,-329,-20.84,1253,-326,-20.65,1200,1500,1400-10-11,2022-01-01
765,بذر,صندوق س بذر اميد آفرين-سهام,12,8873,857893800,98830,97750,97900,-930,-0.94,96690,-2140,-2.17,96650,97900,1400-10-11,2022-01-01
766,قجام,فرآوردههاي غذايي وقندتربت‌جام‌,12,75523,446718545,6035,5915,5915,-120,-1.99,5915,-120,-1.99,5915,5915,1400-10-11,2022-01-01
767,زعف0008پ18,زعفران0008نگين بهرامن(پ),12,13913,3731038164,254525,255000,268545,14020,5.51,268169,13644,5.36,255000,268545,1400-10-11,2022-01-01
768,ساروج,بين المللي ساروج بوشهر,12,26250,436878115,16510,16675,16510,0,0,16514,4,0.02,16510,17180,1400-10-11,2022-01-01
769,وسنا,سرمايه گذاري نيروگاهي ايران,12,75104,709131968,9733,9442,9442,-291,-2.99,9442,-291,-2.99,9442,9442,1400-10-11,2022-01-01
770,ضجار1019,اختيارخ وتجارت-1400-1400/10/15,12,84,40752000,428,510,517,89,20.79,485,57,13.32,455,520,1400-10-11,2022-01-01
771,كباده,توليد خاك نسوزاستقلال آباده,12,41212,1367496584,32216,33182,33182,966,3,32344,128,0.4,33182,33182,1400-10-11,2022-01-01
772,ضملي1160,اختيارخ فملي-6000-1400/11/03,12,118,272486000,1167,1105,1300,133,11.4,1155,-12,-1.03,1100,1300,1400-10-11,2022-01-01
773,اطلس2,صندوق س.توسعه اندوخته آينده-س,11,110000,110000,245776,1,1,-245775,-100,1,-245775,-100,1,1,1400-10-11,2022-01-01
774,طسپا1112,اختيارف خساپا-1600-1400/11/20,11,600,34035000,45,50,60,15,33.33,57,12,26.67,50,65,1400-10-11,2022-01-01
775,وحافظ,بيمه حافظ,11,57223,393064787,7081,6869,6869,-212,-2.99,7072,-9,-0.13,6869,6869,1400-10-11,2022-01-01
776,اخزا905,اسنادخزانه-م5بودجه99-020218,11,9058,6743792110,743250,744700,748560,5310,0.71,744510,1260,0.17,744500,748560,1400-10-11,2022-01-01
777,نهال2,صندوق س. طلاي سرخ نوويرا,10,1000000,1000000,20195,1,1,-20194,-100,1,-20194,-100,1,1,1400-10-11,2022-01-01
778,ضپال2007,اختيارخ اپال-32000-1401/02/12,10,78,16169000,273,240,215,-58,-21.25,207,-66,-24.18,201,240,1400-10-11,2022-01-01
779,اراد42,مرابحه عام دولت4-ش.خ 0106,10,16900,16415500000,971000,975000,970000,-1000,-0.1,971330,330,0.03,970000,979000,1400-10-11,2022-01-01
780,كرونا2,تامين مالي جمعي صرفا اهداي سود,10,1754,17540000,10000,10000,10000,0,0,10000,0,0,10000,10000,1400-10-11,2022-01-01
781,سمتاز,سيمان ممتازان كرمان,10,19550,284696402,15011,14570,14561,-450,-3,14998,-13,-0.09,14561,14570,1400-10-11,2022-01-01
782,گكيش,توريستي ورفاهي آبادگران كيش,10,4316,106596568,25461,24698,24698,-763,-3,24698,-763,-3,24698,24698,1400-10-11,2022-01-01
783,اخزا816,اسنادخزانه-م16بودجه98-010503,9,10991,9740532160,885890,885890,886010,120,0.01,886230,340,0.04,885890,890000,1400-10-11,2022-01-01
784,واحصا,احياء صنايع خراسان,9,1750,74922750,44137,42813,42813,-1324,-3,42813,-1324,-3,42813,42813,1400-10-11,2022-01-01
785,خفناور,مهندسي صنعتي روان فن آور,9,13778,509413994,38116,36973,36973,-1143,-3,36973,-1143,-3,36973,36973,1400-10-11,2022-01-01
786,ضمخا1034,اختيارخ اخابر-6000-1400/10/26,9,30,39750000,1013,1200,1350,337,33.27,1325,312,30.8,1200,1350,1400-10-11,2022-01-01
787,اخزا814,اسنادخزانه-م14بودجه98-010318,9,265,242137000,911380,914500,913100,1720,0.19,913720,2340,0.26,913000,914500,1400-10-11,2022-01-01
788,تپولا,مهندسي مرآت پولاد,9,15411,232459524,15550,15084,15084,-466,-3,15539,-11,-0.07,15084,15084,1400-10-11,2022-01-01
789,زعف0008پ19,زعفران0008نگين تروند قاينات(پ),9,16592,4454109355,255059,260001,268545,13486,5.29,268449,13390,5.25,260001,268545,1400-10-11,2022-01-01
790,زير0103پ01,زيره سبز0103كيميابذر(پ),9,444,448207740,1046670,1049999,995400,-51270,-4.9,1009477,-37193,-3.55,995400,1049999,1400-10-11,2022-01-01
791,سيلام,سيمان‌ ايلام‌,9,28149,185783400,6940,6600,6600,-340,-4.9,6940,0,0,6600,6600,1400-10-11,2022-01-01
792,ثنام,س ساختماني ب نام آوران مهندسي,9,20405,215293155,11106,10551,10551,-555,-5,10551,-555,-5,10551,10551,1400-10-11,2022-01-01
793,ضملت1131,اختيارخ وبملت-2000-1400/11/13,8,100,122950000,1268,1241,1229,-39,-3.08,1229,-39,-3.08,1110,1250,1400-10-11,2022-01-01
794,كارا2,صندوق س. كارا -د,8,62200000,62200000,10459,1,1,-10458,-99.99,1,-10458,-99.99,1,1,1400-10-11,2022-01-01
795,زعف0008پ12,زعفران0008پوشالمعمول سحرخيز(پ),8,2216,530292228,229531,220000,240294,10763,4.69,239302,9771,4.26,220000,240294,1400-10-11,2022-01-01
796,هبساز103,اختيارف ت ثبهساز-2346-01/03/18,8,200000,119600000,568,598,598,30,5.28,598,30,5.28,598,598,1400-10-11,2022-01-01
797,آسام,صندوق س.آرمان سپهر آشنا-م,8,67360,8099042000,120006,120100,120366,360,0.3,120235,229,0.19,119600,120366,1400-10-11,2022-01-01
798,اراد61,مرابحه عام دولت61-ش.خ0309,8,120000,120000000000,1000010,1000000,1000000,-10,0,1000000,-10,0,1000000,1000000,1400-10-11,2022-01-01
799,ويستا,صندوق س. ويستا -س,8,9331,96273620,10366,10300,10250,-116,-1.12,10318,-48,-0.46,10250,10405,1400-10-11,2022-01-01
800,سخواف,سيمان مجد خواف,8,10711,76037389,7472,7099,7099,-373,-4.99,7099,-373,-4.99,7099,7099,1400-10-11,2022-01-01
801,ضصاد1112,اختيارخ وبصادر-1800-1400/11/06,8,205,30953000,236,160,152,-84,-35.59,151,-85,-36.02,145,170,1400-10-11,2022-01-01
802,ضفلا1160,اختيارخ فولاد-7000-1400/11/24,7,22,81700000,2200,3000,3900,1700,77.27,3714,1514,68.82,3000,3900,1400-10-11,2022-01-01
803,ضكاريس903,اختيارخ كاريس-16000-14010930,7,64,97898000,1582,1799,1500,-82,-5.18,1530,-52,-3.29,1500,1799,1400-10-11,2022-01-01
804,افران2,صندوق س افرا نماد پايدار-ثابت,7,91500000,91500000,15110,1,1,-15109,-99.99,1,-15109,-99.99,1,1,1400-10-11,2022-01-01
805,شليا,شركت مواد ويژه ليا,7,1045,37413090,37686,35802,35802,-1884,-5,37679,-7,-0.02,35802,35802,1400-10-11,2022-01-01
806,اخزا906,اسنادخزانه-م6بودجه99-020321,7,21111,15325801030,726000,726010,726010,10,0,725960,-40,-0.01,725100,726010,1400-10-11,2022-01-01
807,شرق1400,مشاركت ليزينگ ايران وشرق140010,6,6872,6873216000,1001000,1003000,1001000,0,0,1000180,-820,-0.08,1000000,1003000,1400-10-11,2022-01-01
808,غناب,روغن‌ نباتي‌ ناب,6,375,54306750,140600,144818,144818,4218,3,140622,22,0.02,144818,144818,1400-10-11,2022-01-01
809,دشيري,شيرين دارو,6,955,104937310,113280,109882,109882,-3398,-3,113243,-37,-0.03,109882,109882,1400-10-11,2022-01-01
810,سخند,صندوق س.سپهرخبرگان نفت-د,6,48500,491218000,10113,10128,10128,15,0.15,10128,15,0.15,10128,10129,1400-10-11,2022-01-01
811,پويا,ص.ج.پويا الگوريتم20%تاديه,6,6000,1452890000,229900,252890,240000,10100,4.39,242148,12248,5.33,240000,252890,1400-10-11,2022-01-01
812,طخود2017,اختيارف خودرو-1800-1401/02/07,6,101,10095000,90,100,100,10,11.11,100,10,11.11,95,100,1400-10-11,2022-01-01
813,زعف0008پ08,زعفران0008نگين روستا(پ),6,74,19872330,272221,268545,268545,-3676,-1.35,268545,-3676,-1.35,268545,268545,1400-10-11,2022-01-01
814,اخزا813,اسنادخزانه-م13بودجه98-010219,6,1084,1008662000,927470,930500,930500,3030,0.33,930500,3030,0.33,930500,930500,1400-10-11,2022-01-01
815,فكمند,گسترش قطعه سازي كمند,5,7928,281753192,36638,35539,35539,-1099,-3,36606,-32,-0.09,35539,35539,1400-10-11,2022-01-01
816,لخانه,لوازم‌ خانگي‌ پارس‌,5,3467,52434908,15591,15124,15124,-467,-3,15588,-3,-0.02,15124,15124,1400-10-11,2022-01-01
817,ضمخا1035,اختيارخ اخابر-7000-1400/10/26,5,107,56520000,1200,900,510,-690,-57.5,528,-672,-56,510,900,1400-10-11,2022-01-01
818,داراب,پتروشيمي داراب,5,24889,52714902,2229,2118,2118,-111,-4.98,2228,-1,-0.04,2118,2118,1400-10-11,2022-01-01
819,حرهشا,رهشاد سپاهان (سهامي عام,5,815,76960450,97350,94430,94430,-2920,-3,94430,-2920,-3,94430,94430,1400-10-11,2022-01-01
820,سيناد,صندوق س.سپهرسودمند سينا-د,5,9880,98928440,10010,10013,10013,3,0.03,10013,3,0.03,10013,10013,1400-10-11,2022-01-01
821,شمواد,توليد مواداوليه الياف مصنوعي,5,1068,43783728,41832,40996,40996,-836,-2,40996,-836,-2,40996,40996,1400-10-11,2022-01-01
822,طخود2018,اختيارف خودرو-2000-1401/02/07,5,54,10600000,150,190,200,50,33.33,196,46,30.67,190,200,1400-10-11,2022-01-01
823,ضترا1131,اختيارخ شتران-3529-1400/11/10,5,75,165207625,701,981,777,76,10.84,972,271,38.66,777,995,1400-10-11,2022-01-01
824,كشم0101پ01,كشمش سبز0101خليل آباد(پ),5,53,33782338,633500,640000,634022,522,0.08,637403,3903,0.62,634001,640000,1400-10-11,2022-01-01
825,ضسپا1109,اختيارخ خساپا-1000-1400/11/20,4,60,37700000,710,700,600,-110,-15.49,628,-82,-11.55,600,700,1400-10-11,2022-01-01
826,ضپنا2011,اختيارخ رمپنا-10000-1401/02/07,4,50,401000000,8000,7700,8000,0,0,8020,20,0.25,7700,8200,1400-10-11,2022-01-01
827,سنوين,سرمايه گذاري اقتصاد نوين,4,8000,52264000,6735,6533,6533,-202,-3,6533,-202,-3,6533,6533,1400-10-11,2022-01-01
828,زعف0110پ09,زعفران0110نگين نوين(پ),4,4936,1959194112,370000,396933,396933,26933,7.28,396919,26919,7.28,396000,396933,1400-10-11,2022-01-01
829,فنرژي,گسترش صنايع انرژي آذرآب,4,2942,34150736,12091,11608,11608,-483,-3.99,11608,-483,-3.99,11608,11608,1400-10-11,2022-01-01
830,ساذري,آذريت‌,4,2757,25008747,9351,9071,9071,-280,-2.99,9071,-280,-2.99,9071,9071,1400-10-11,2022-01-01
831,تملي807,تسهيلات مسكن ب. ملي-مهر98,4,25,13905850,529747,556234,556234,26487,5,556234,26487,5,556234,556234,1400-10-11,2022-01-01
832,كهربا2,صندوق س.پشتوانه سكه طلا كهربا,4,37400000,37400000,11023,1,1,-11022,-99.99,1,-11022,-99.99,1,1,1400-10-11,2022-01-01
833,ثنظام,س. ساختماني نظام مهندسي ايران,4,10961,219329610,20628,20010,20010,-618,-3,20010,-618,-3,20010,20010,1400-10-11,2022-01-01
834,سپيدما2,صندوق س. سپيد دماوند-د,4,4000000,4000000,11606,1,1,-11605,-99.99,1,-11605,-99.99,1,1,1400-10-11,2022-01-01
835,پارتا,مجتمع‌صنعتي‌آرتاويل‌تاير,4,1856,41334976,23443,22271,22271,-1172,-5,22271,-1172,-5,22271,22271,1400-10-11,2022-01-01
836,ضپاس1010,اختيارخ وپارس-1800-1400/10/22,4,74,9760000,102,100,220,118,115.69,132,30,29.41,100,220,1400-10-11,2022-01-01
837,پادا,صندوق س.پاداش سرمايه پارس-س,4,301,32105200,107839,107000,106900,-939,-0.87,106662,-1177,-1.09,105200,107000,1400-10-11,2022-01-01
838,ضپاس1011,اختيارخ وپارس-2000-1400/10/22,3,12,132000,50,11,11,-39,-78,11,-39,-78,11,11,1400-10-11,2022-01-01
839,آگاس2,صندوق س.هستي بخش آگاه-س,3,300000,300000,79170,1,1,-79169,-100,1,-79169,-100,1,1,1400-10-11,2022-01-01
840,ضملي1161,اختيارخ فملي-7000-1400/11/03,3,10,7980000,539,350,405,-134,-24.86,399,-140,-25.97,350,405,1400-10-11,2022-01-01
841,اوج,صندوق س.اوج دماوند-س,3,6506,65398312,10135,10052,10052,-83,-0.82,10052,-83,-0.82,10052,10052,1400-10-11,2022-01-01
842,ضملت1132,اختيارخ وبملت-2500-1400/11/13,3,38,27900000,784,740,738,-46,-5.87,734,-50,-6.38,730,740,1400-10-11,2022-01-01
843,سفاسي,شركت فارسيت اهواز,3,9700,32737500,3479,3375,3375,-104,-2.99,3479,0,0,3375,3375,1400-10-11,2022-01-01
844,طخود2016,اختيارف خودرو-1600-1401/02/07,3,160,8000000,1,50,50,49,4900,50,49,4900,50,50,1400-10-11,2022-01-01
845,ضاريان1204,اختيارخ آريان-18000-14001211,3,25,5000000,850,200,200,-650,-76.47,200,-650,-76.47,200,200,1400-10-11,2022-01-01
846,ضبدر1165,اختيارخ شبندر-8000-1400/11/13,3,59,8340000,150,250,149,-1,-0.67,141,-9,-6,80,250,1400-10-11,2022-01-01
847,خفولا,خدمات فني فولاد يزد,3,5260,118386820,23203,22507,22507,-696,-3,23195,-8,-0.03,22507,22507,1400-10-11,2022-01-01
848,وسخوز,شركت س استان خوزستان,3,28329,17082387,634,603,603,-31,-4.89,634,0,0,603,603,1400-10-11,2022-01-01
849,اخزا821,اسنادخزانه-م21بودجه98-020906,3,759,496729010,650580,650500,654500,3920,0.6,654450,3870,0.59,650500,654500,1400-10-11,2022-01-01
850,ثقزوي,شركت عمران و سازندگي قزوين,3,567,15657138,28468,27614,27614,-854,-3,27614,-854,-3,27614,27614,1400-10-11,2022-01-01
851,ضشنا1049,اختيارخ شپنا-6540-1400/10/19,2,6,385350,124,30,40,-84,-67.74,35,-89,-71.77,30,40,1400-10-11,2022-01-01
852,ضترا1133,اختيارخ شتران-4411-1400/11/10,2,11,7277070,276,295,260,-16,-5.8,292,16,5.8,260,295,1400-10-11,2022-01-01
853,ضفلا1164,اختيارخ فولاد-12000-1400/11/24,2,15,3330000,372,222,222,-150,-40.32,222,-150,-40.32,222,222,1400-10-11,2022-01-01
854,ضشنا1046,اختيارخ شپنا-4360-1400/10/19,2,2,4038835,1567,1200,1001,-566,-36.12,1100,-467,-29.8,1001,1200,1400-10-11,2022-01-01
855,نخو0102پ01,نخود متوسط0102شيري(پ),2,50,15410750,293539,308215,308215,14676,5,308215,14676,5,308215,308215,1400-10-11,2022-01-01
856,سفارود,كارخانه فارسيت درود,2,664,10154552,15930,15293,15293,-637,-4,15293,-637,-4,15293,15293,1400-10-11,2022-01-01
857,خعمرا,توسعه و عمران شهرستان نائين,2,2010,10375620,5012,5162,5162,150,2.99,5162,150,2.99,5162,5162,1400-10-11,2022-01-01
858,وكار2,بانك‌ كارآفرين‌,2,90000000,232200000000,2466,2580,2580,114,4.62,2580,114,4.62,2580,2580,1400-10-11,2022-01-01
859,زعف0008پ09,زعفران0008نگين نوين(پ),2,28,7519260,272221,268545,268545,-3676,-1.35,268545,-3676,-1.35,268545,268545,1400-10-11,2022-01-01
860,كابگن,توليدي و صنعتي آبگينه‌,2,851,5208120,6060,6120,6120,60,0.99,6120,60,0.99,6120,6120,1400-10-11,2022-01-01
861,پرند,صندوق س. پروژه آرمان پرند مپنا,2,110000,829570000,7299,7555,7407,108,1.48,7542,243,3.33,7407,7555,1400-10-11,2022-01-01
862,پا ر 54,بار پايه روز 54,2,72000,36720000,570,510,510,-60,-10.53,510,-60,-10.53,510,510,1400-10-11,2022-01-01
863,اعتماد2,صندوق س.اعتماد آفرين پارسيان-د,2,14400000,14400000,40985,1,1,-40984,-100,1,-40984,-100,1,1,1400-10-11,2022-01-01
864,ضجار1023,اختيارخ وتجارت-2500-1400/10/15,2,80,80000,1,1,1,0,0,1,0,0,1,1,1400-10-11,2022-01-01
865,ضصاد1111,اختيارخ وبصادر-1600-1400/11/06,2,2,724000,409,370,354,-55,-13.45,362,-47,-11.49,354,370,1400-10-11,2022-01-01
866,هپارس102,اختيارف ت پارس-157010-01/02/05,2,500,500,1,1,1,0,0,1,0,0,1,1,1400-10-11,2022-01-01
867,زر2,صندوق س.پشتوانه سكه طلاي زر,2,200000,200000,55810,1,1,-55809,-100,1,-55809,-100,1,1,1400-10-11,2022-01-01
868,هاميد104,اختيارف ت ثاميد-2050-01/04/20,2,50001,18750375,397,375,375,-22,-5.54,375,-22,-5.54,375,375,1400-10-11,2022-01-01
869,حاريا,كشتيراني آريا,2,341,5070670,15173,14870,14870,-303,-2,14870,-303,-2,14870,14870,1400-10-11,2022-01-01
870,ونچر,ص.ج.فيروزه40%تاديه,2,2000,880000000,448634,440000,440000,-8634,-1.92,440000,-8634,-1.92,440000,440000,1400-10-11,2022-01-01
871,گپارس,امور رفاهي كارگزاران پارس,2,87,10668114,126414,122622,122622,-3792,-3,122622,-3792,-3,122622,122622,1400-10-11,2022-01-01
872,دومينو4,اجاره دومينو14040208,2,3,2928900,957160,976300,976300,19140,2,976300,19140,2,976300,976300,1400-10-11,2022-01-01
873,ضملت1136,اختيارخ وبملت-4500-1400/11/13,2,2,120000,12,70,50,38,316.67,60,48,400,50,70,1400-10-11,2022-01-01
874,اراد314,مرابحه عام دولت3-ش.خ 0208,2,1326142,1186807747030,907200,894367,895500,-11700,-1.29,894933,-12267,-1.35,894367,895500,1400-10-11,2022-01-01
875,اراد354,مرابحه عام دولت3-ش.خ 0103,2,540300,531655200000,976250,984000,984000,7750,0.79,984000,7750,0.79,984000,984000,1400-10-11,2022-01-01
876,وسرضوي,س.سهام عدالت استان خراسان رضوي,2,15295,10538255,725,689,689,-36,-4.97,725,0,0,689,689,1400-10-11,2022-01-01
877,اراد614,مرابحه عام دولت61-ش.خ0309,2,750000,750000000000,1000010,1000000,1000000,-10,0,1000000,-10,0,1000000,1000000,1400-10-11,2022-01-01
878,ضپال2006,اختيارخ اپال-28000-1401/02/12,2,104,92500000,1053,900,889,-164,-15.57,889,-164,-15.57,889,900,1400-10-11,2022-01-01
879,اروند09,منفعت صبا اروند نوين 14001222,1,1000,959500000,956800,959500,959500,2700,0.28,959500,2700,0.28,959500,959500,1400-10-11,2022-01-01
880,اخزا9182,اسنادخزانه-م18بودجه99-010323,1,381483,347645457900,906340,911300,911300,4960,0.55,911300,4960,0.55,911300,911300,1400-10-11,2022-01-01
881,ضداريوش903,اختيارخ داريوش-10500-14010915,1,1,1999000,1781,1999,1999,218,12.24,1999,218,12.24,1999,1999,1400-10-11,2022-01-01
882,تملي705,تسهيلات مسكن ب. ملي-مرداد97,1,1,565000,592750,565000,565000,-27750,-4.68,565000,-27750,-4.68,565000,565000,1400-10-11,2022-01-01
883,اراد874,مرابحه عام دولت87-ش.خ030304,1,400000,371600000000,927000,929000,929000,2000,0.22,929000,2000,0.22,929000,929000,1400-10-11,2022-01-01
884,شگويات.ف0104,اختيارف.تبعي شگويا010408,1,10000,10000,1,1,1,0,0,1,0,0,1,1,1400-10-11,2022-01-01
885,كمند2,صندوق س. با درآمد ثابت كمند,1,39600000,39600000,10127,1,1,-10126,-99.99,1,-10126,-99.99,1,1,1400-10-11,2022-01-01
886,ضكاريس900,اختيارخ كاريس-10000-14010930,1,100,500000000,5357,5000,5000,-357,-6.66,5000,-357,-6.66,5000,5000,1400-10-11,2022-01-01
887,اراد92,مرابحه عام دولت92-ش.خ020825,1,10000,9537000000,929670,953700,953700,24030,2.58,953700,24030,2.58,953700,953700,1400-10-11,2022-01-01
888,بتك,كارخانجات كابل سازي‌ تك‌,1,141,5073039,34596,35979,35979,1383,4,34600,4,0.01,35979,35979,1400-10-11,2022-01-01
889,ضبدر1162,اختيارخ شبندر-5000-1400/11/13,1,1,2000000,1911,2000,2000,89,4.66,2000,89,4.66,2000,2000,1400-10-11,2022-01-01
890,افران4,صندوق س افرا نماد پايدار-ثابت,1,99121126,1499999999758,15110,15133,15133,23,0.15,15133,23,0.15,15133,15133,1400-10-11,2022-01-01
891,صگل039,صكوك اجاره گل گهر039-3ماهه20%,1,9,9355500,1000000,1039500,1039500,39500,3.95,1039500,39500,3.95,1039500,1039500,1400-10-11,2022-01-01
892,اخزا9172,اسنادخزانه-م17بودجه99-010226,1,217000,200508000000,921260,924000,924000,2740,0.3,924000,2740,0.3,924000,924000,1400-10-11,2022-01-01
893,ضفار1132,اختيارخ فارس-9400-1400/11/06,1,2,3000000,629,1500,1500,871,138.47,1500,871,138.47,1500,1500,1400-10-11,2022-01-01
894,تملي709,تسهيلات مسكن ب. ملي-آذر97,1,3,1684338,590995,561446,561446,-29549,-5,561446,-29549,-5,561446,561446,1400-10-11,2022-01-01
895,ضصاد1110,اختيارخ وبصادر-1400-1400/11/06,1,1,520000,535,520,520,-15,-2.8,520,-15,-2.8,520,520,1400-10-11,2022-01-01
896,شكف,كف,1,54,5051376,95453,93544,93544,-1909,-2,93544,-1909,-2,93544,93544,1400-10-11,2022-01-01
897,غگز,گز سكه,1,50000,450000000,9000,9000,9000,0,0,9000,0,0,9000,9000,1400-10-11,2022-01-01
898,ضصاد3011,اختيارخ وبصادر-1200-1401/03/11,1,1,990000,1,990,990,989,98900,990,989,98900,990,990,1400-10-11,2022-01-01
899,ضخوز1023,اختيارخ فخوز-5833-1400/10/12,1,3,14112000,1000,1960,1960,960,96,1960,960,96,1960,1960,1400-10-11,2022-01-01
900,ضخوز1025,اختيارخ فخوز-7500-1400/10/12,1,4,2688000,999,280,280,-719,-71.97,280,-719,-71.97,280,280,1400-10-11,2022-01-01
901,ضپنا2014,اختيارخ رمپنا-16000-1401/02/07,1,2,7400000,2990,3700,3700,710,23.75,3700,710,23.75,3700,3700,1400-10-11,2022-01-01
902,ضشنا1051,اختيارخ شپنا-8719-1400/10/19,1,1,9175,1,5,5,4,400,5,4,400,5,5,1400-10-11,2022-01-01
903,ضپنا2013,اختيارخ رمپنا-14000-1401/02/07,1,1,4400000,5360,4400,4400,-960,-17.91,4400,-960,-17.91,4400,4400,1400-10-11,2022-01-01
904,اراد35,مرابحه عام دولت3-ش.خ 0103,1,5000,4907500000,976250,981500,981500,5250,0.54,981500,5250,0.54,981500,981500,1400-10-11,2022-01-01
905,طكاريس903,اختيارف كاريس-16000-14010930,1,5,5500000,1,1100,1100,1099,109900,1100,1099,109900,1100,1100,1400-10-11,2022-01-01
906,اوصتا4,صندوق انديشه ورزان صباتامين -د,1,268383311,5651347379727,21028,21057,21057,29,0.14,21057,29,0.14,21057,21057,1400-10-11,2022-01-01
907,صنفت3122,صكوك منفعت نفت312-6ماهه 18/5%,1,900000,900000000000,994950,1000000,1000000,5050,0.51,1000000,5050,0.51,1000000,1000000,1400-10-11,2022-01-01
908,مبين012,اجاره اعتماد مبين تمدن010710,1,21000,21000000000,1000000,1000000,1000000,0,0,1000000,0,0,1000000,1000000,1400-10-11,2022-01-01
909,ضجار2014,اختيارخ وتجارت-2500-1401/02/21,1,1,200000,335,200,200,-135,-40.3,200,-135,-40.3,200,200,1400-10-11,2022-01-01
910,ضفلا1165,اختيارخ فولاد-14000-1400/11/24,1,1,160000,187,160,160,-27,-14.44,160,-27,-14.44,160,160,1400-10-11,2022-01-01
911,اراد76,مرابحه عام دولت76-ش.خ030406,1,1000,915000000,930000,915000,915000,-15000,-1.61,915000,-15000,-1.61,915000,915000,1400-10-11,2022-01-01
912,اراد674,مرابحه عام دولت67-ش.خ0310,1,70000,70000000000,1000000,1000000,1000000,0,0,1000000,0,0,1000000,1000000,1400-10-11,2022-01-01
913,شتهران,داروسازي تهران شيمي,1,2350,17253700,7199,7342,7342,143,1.99,7199,0,0,7342,7342,1400-10-11,2022-01-01
914,ضفلا1162,اختيارخ فولاد-9000-1400/11/24,1,10,23500000,2295,2350,2350,55,2.4,2350,55,2.4,2350,2350,1400-10-11,2022-01-01
915,ياقوت2,صندوق س ياقوت آگاه-ثابت,1,10413000,10413000,13871,1,1,-13870,-99.99,1,-13870,-99.99,1,1,1400-10-11,2022-01-01
916,سپرمي,پرميت‌,1,50,619200,12262,12384,12384,122,0.99,12262,0,0,12384,12384,1400-10-11,2022-01-01
917,ضبدر3011,اختيارخ شبندر-5000-1401/03/29,1,1,2800000,1,2800,2800,2799,279900,2800,2799,279900,2800,2800,1400-10-11,2022-01-01
918,زيتون2,صندوق س زيتون نماد پايا- مختلط,1,1000000,1000000,9811,1,1,-9810,-99.99,1,-9810,-99.99,1,1,1400-10-11,2022-01-01
919,وسخراج,شركت س استان خراسان جنوبي,1,3000,6297000,2209,2099,2099,-110,-4.98,2209,0,0,2099,2099,1400-10-11,2022-01-01
920,وشمال,س. چشم انداز توسعه شمال,1,70,5026280,73269,71804,71804,-1465,-2,71804,-1465,-2,71804,71804,1400-10-11,2022-01-01
921,مشهد0012,مشاركت شهرداري مشهد-3ماهه20%,1,7,7000000,1000000,1000000,1000000,0,0,1000000,0,0,1000000,1000000,1400-10-11,2022-01-01
922,طملت1133,اختيارف وبملت-3000-1400/11/13,1,1,80000,20,80,80,60,300,80,60,300,80,80,1400-10-11,2022-01-01
923,ضسپا1110,اختيارخ خساپا-1200-1400/11/20,1,1,530000,540,530,530,-10,-1.85,530,-10,-1.85,530,530,1400-10-11,2022-01-01
924,اراد934,مرابحه عام دولت93-ش.خ010809,1,990000,960953400000,962000,970660,970660,8660,0.9,970660,8660,0.9,970660,970660,1400-10-11,2022-01-01
925,ثبات2,صندوق س. ثبات ويستا -د,1,2500000,2500000,10656,1,1,-10655,-99.99,1,-10655,-99.99,1,1,1400-10-11,2022-01-01
926,اراد93,مرابحه عام دولت93-ش.خ010809,1,10000,9706600000,962000,970660,970660,8660,0.9,970660,8660,0.9,970660,970660,1400-10-11,2022-01-01
927,تملي612,تسهيلات مسكن بانك ملي-اسفند96,1,2,1092026,574750,546013,546013,-28737,-5,546013,-28737,-5,546013,546013,1400-10-11,2022-01-01
928,اراد924,مرابحه عام دولت92-ش.خ020825,1,990000,944163000000,929670,953700,953700,24030,2.58,953700,24030,2.58,953700,953700,1400-10-11,2022-01-01
929,ضپاس1013,اختيارخ وپارس-3000-1400/10/22,1,22,44000,1,2,2,1,100,2,1,100,2,2,1400-10-11,2022-01-01
930,گواهي ظرفيت,گواهي ظرفيت نقدي,1,1000000,31409000000,29914,31409,31409,1495,5,29974,60,0.2,31409,31409,1400-10-11,2022-01-01
931,اخزا0012,اسنادخزانه-م1بودجه00-030821,1,498908,260679430000,518050,522500,522500,4450,0.86,522500,4450,0.86,522500,522500,1400-10-11,2022-01-01
932,فسديد,لوله‌وتجهيزات‌ سديد - ورشكسته,1,50,5028350,101582,100567,100567,-1015,-1,100567,-1015,-1,100567,100567,1400-10-11,2022-01-01
933,امين يكم4,صندوق درآمد ثابت امين يكم فردا,1,615556916,6183884778136,10034,10046,10046,12,0.12,10046,12,0.12,10046,10046,1400-10-11,2022-01-01
934,صغدير4082,صكوك اجاره غدير408-بدون ضامن,1,500000,500000000000,1005000,1000000,1000000,-5000,-0.5,1000000,-5000,-0.5,1000000,1000000,1400-10-11,2022-01-01
935,اخزا904,اسنادخزانه-م4بودجه99-011215,1,2650,2055605000,775000,775700,775700,700,0.09,775700,700,0.09,775700,775700,1400-10-11,2022-01-01
936,ضترا1135,اختيارخ شتران-6176-1400/11/10,1,10,249370,45,11,11,-34,-75.56,11,-34,-75.56,11,11,1400-10-11,2022-01-01
937,صبا14044,اجاصبابدون ضامن بارتبه اعتباري,1,1000000,1000000000000,1000000,1000000,1000000,0,0,1000000,0,0,1000000,1000000,1400-10-11,2022-01-01
938,وسصفا,شركت س استان اصفهان,1,20000,13860000,729,693,693,-36,-4.94,729,0,0,693,693,1400-10-11,2022-01-01
939,اخزا820,اسنادخزانه-م20بودجه98-020806,1,10,6625000,661040,662500,662500,1460,0.22,662500,1460,0.22,662500,662500,1400-10-11,2022-01-01
940,ضبدر3009,اختيارخ شبندر-4000-1401/03/29,1,1,3600000,1,3600,3600,3599,359900,3600,3599,359900,3600,3600,1400-10-11,2022-01-01
941,ضصاد3012,اختيارخ وبصادر-1400-1401/03/11,1,1,790000,1,790,790,789,78900,790,789,78900,790,790,1400-10-11,2022-01-01
942,زير0103پ04,زيره سبز0103شركت مينوبذر(پ),1,30,33005040,1030000,1100168,1100168,70168,6.81,1100168,70168,6.81,1100168,1100168,1400-10-11,2022-01-01
