,نماد,نام,تعداد,حجم,ارزش,دیروز,اولین,آخرین معامله - مقدار,آخرین معامله - تغییر,آخرین معامله - درصد,قیمت پایانی - مقدار,قیمت پایانی - تغییر,قیمت پایانی - درصد,کمترین,بیشترین,تاریخ,gregorian_date
0,امينح,ح . تامين سرمايه امين,26491,29847461,174555905080,5460,6110,5970,510,9.34,5850,390,7.14,5570,6110,1400-1-21,2021-04-10
1,امين,تامين سرمايه امين,15848,19970878,151671203720,7380,7520,7650,270,3.66,7590,210,2.85,7300,7800,1400-1-21,2021-04-10
2,پالايش,صندوق پالايشي يكم-سهام,11461,7060314,501913653430,73800,71590,70850,-2950,-4,71090,-2710,-3.67,70850,71590,1400-1-21,2021-04-10
3,بپيوند,برق و انرژي پيوندگستر پارس,10040,12050086,164362199951,13080,12900,13864,784,5.99,13640,560,4.28,12900,13864,1400-1-21,2021-04-10
4,دارا يكم,صندوق واسطه گري مالي يكم-سهام,9655,5256956,656434358130,129580,126880,124400,-5180,-4,124870,-4710,-3.63,124400,126880,1400-1-21,2021-04-10
5,آبادا,توليد نيروي برق آبادان,9256,10487012,145050715080,13700,13430,13980,280,2.04,13830,130,0.95,13430,14200,1400-1-21,2021-04-10
6,بوعلي,پتروشيمي بوعلي سينا,8880,4154523,173359093450,41790,40960,41460,-330,-0.79,41730,-60,-0.14,40960,42470,1400-1-21,2021-04-10
7,اپال,فرآوري معدني اپال كاني پارس,8630,29619250,514207479350,17650,17390,17300,-350,-1.98,17360,-290,-1.64,17300,17500,1400-1-21,2021-04-10
8,بگيلان,توسعه مسير برق گيلان,8141,4584341,101637657799,21743,21315,22100,357,1.64,22171,428,1.97,21310,22644,1400-1-21,2021-04-10
9,شستا,سرمايه گذاري تامين اجتماعي,7512,42237904,457605349120,11050,10850,10830,-220,-1.99,10830,-220,-1.99,10830,11000,1400-1-21,2021-04-10
10,غپاك,لبنيات‌ پاك‌,6788,25300545,797250550150,30070,29650,31870,1800,5.99,31510,1440,4.79,29650,31870,1400-1-21,2021-04-10
11,وهور,مديريت انرژي اميد  تابان هور,5638,118734992,261766025792,2186,2230,2170,-16,-0.73,2205,19,0.87,2143,2309,1400-1-21,2021-04-10
12,سيتا,سرمايه گذاري سيمان تامين,5465,7763751,116481786660,15010,15000,15000,-10,-0.07,15000,-10,-0.07,15000,15030,1400-1-21,2021-04-10
13,كمند,صندوق س. با درآمد ثابت كمند,4834,201034020,2017444124396,10024,10034,10034,10,0.1,10035,11,0.11,10033,10037,1400-1-21,2021-04-10
14,امين يكم,صندوق درآمد ثابت امين يكم فردا,4070,150884467,1536639298333,10172,10182,10184,12,0.12,10184,12,0.12,10180,10187,1400-1-21,2021-04-10
15,بكهنوج,توليد برق ماهتاب كهنوج,3836,62703196,107940082253,1714,1734,1696,-18,-1.05,1721,7,0.41,1681,1775,1400-1-21,2021-04-10
16,نمرينو,ايران‌ مرينوس‌,3334,2916053,332327207220,109820,116400,107630,-2190,-1.99,113960,4140,3.77,107630,116400,1400-1-21,2021-04-10
17,خودكفا,اقتصادي و خودكفايي آزادگان,3115,8949898,205926411186,22797,23480,22600,-197,-0.86,23009,212,0.93,22470,23480,1400-1-21,2021-04-10
18,وكبهمن,مديريت سرمايه گذاري كوثربهمن,3036,1480339,16555946255,11397,11170,11170,-227,-1.99,11325,-72,-0.63,11170,11295,1400-1-21,2021-04-10
19,اعتماد,صندوق س.اعتماد آفرين پارسيان-د,2815,87453060,3131698656020,35783,35807,35811,28,0.08,35810,27,0.08,35806,35812,1400-1-21,2021-04-10
20,وپاسار,بانك  پاسارگاد,2723,39324305,522951881860,13290,13290,13310,20,0.15,13300,10,0.08,13280,13340,1400-1-21,2021-04-10
21,آريا,پليمر آريا ساسول,2277,1756150,146300746822,85007,83307,83307,-1700,-2,83308,-1699,-2,83307,84000,1400-1-21,2021-04-10
22,خزاميا,زامياد,2258,17860285,155498081060,8860,8690,8690,-170,-1.92,8710,-150,-1.69,8690,8900,1400-1-21,2021-04-10
23,وخارزمح,ح.سرمايه گذاري خوارزمي,2132,8616638,32961416220,3970,3830,3820,-150,-3.78,3830,-140,-3.53,3820,3900,1400-1-21,2021-04-10
24,تسه9912,امتياز تسهيلات مسكن اسفند99,2051,28412,14493609530,501895,526791,505001,3106,0.62,510123,8228,1.64,490005,526989,1400-1-21,2021-04-10
25,غگيلا,شيرپاستوريزه پگاه گيلان,1906,48045,1163457720,22846,24216,24216,1370,6,22876,30,0.13,24216,24216,1400-1-21,2021-04-10
26,كيان,صندوق س. با درآمد ثابت كيان,1795,28193705,786698456119,27860,27904,27903,43,0.15,27903,43,0.15,27902,27905,1400-1-21,2021-04-10
27,بميلا,توسعه بازرگاني آهن وفولادميلاد,1769,5144167,76897059398,14555,14610,14871,316,2.17,14948,393,2.7,14600,15272,1400-1-21,2021-04-10
28,فولاد,فولاد مباركه اصفهان,1740,20230451,252279732970,12720,12470,12470,-250,-1.97,12470,-250,-1.97,12470,12530,1400-1-21,2021-04-10
29,وملل,اعتباري ملل,1494,29941556,399252425717,13332,13310,13359,27,0.2,13334,2,0.02,13200,13400,1400-1-21,2021-04-10
30,بپاس,بيمه پاسارگاد,1433,2417890,214694724731,90131,88329,88329,-1802,-2,88794,-1337,-1.48,88329,91000,1400-1-21,2021-04-10
31,آگاس,صندوق س.هستي بخش آگاه-س,1420,4804628,309348096737,66538,65710,64000,-2538,-3.81,64385,-2153,-3.24,63900,65710,1400-1-21,2021-04-10
32,نيرو,نيرو سرمايه,1395,1267845,68875935813,53229,54825,53501,272,0.51,54325,1096,2.06,53500,54825,1400-1-21,2021-04-10
33,آوا,صندوق س.سهام آواي معيار-س,1351,9553373,58115742617,6316,6280,6064,-252,-3.99,6083,-233,-3.69,6064,6280,1400-1-21,2021-04-10
34,نوري,پتروشيمي نوري,1344,3175579,183276093520,58880,57710,57710,-1170,-1.99,57710,-1170,-1.99,57710,58800,1400-1-21,2021-04-10
35,صبا,سرمايه گذاري صبا تامين,1343,8802954,66943880833,7756,7620,7601,-155,-2,7670,-86,-1.11,7601,7755,1400-1-21,2021-04-10
36,فملي,ملي‌ صنايع‌ مس‌ ايران‌,1330,7236004,84516526720,11910,11680,11680,-230,-1.93,11740,-170,-1.43,11680,11680,1400-1-21,2021-04-10
37,خودرو,ايران‌ خودرو,1330,20540882,48476481520,2400,2360,2360,-40,-1.67,2380,-20,-0.83,2360,2360,1400-1-21,2021-04-10
38,كچاد,معدني‌وصنعتي‌چادرملو,1307,6094801,140740229330,23460,23270,23000,-460,-1.96,23090,-370,-1.58,23000,23500,1400-1-21,2021-04-10
39,معيار ,سرمايه گذاري معيار صنعت پارس,1291,2288817,119078424883,50751,52273,52273,1522,3,52026,1275,2.51,49810,52273,1400-1-21,2021-04-10
40,غبشهر,صنعتي‌ بهشهر,1260,3108456,77838791210,25130,24630,24630,-500,-1.99,25040,-90,-0.36,24630,26150,1400-1-21,2021-04-10
41,كگل,معدني و صنعتي گل گهر,1217,6764974,99635150420,14910,14900,14620,-290,-1.95,14760,-150,-1.01,14620,14910,1400-1-21,2021-04-10
42,پيزد,مجتمع صنايع لاستيك يزد,1210,225995,14885172265,67209,65865,65865,-1344,-2,66801,-408,-0.61,65865,65900,1400-1-21,2021-04-10
43,البرز,بيمه البرز,1189,15710571,59373077500,3810,3870,3740,-70,-1.84,3780,-30,-0.79,3740,3900,1400-1-21,2021-04-10
44,كاوه,فولاد كاوه جنوب كيش,1156,9936009,197445203870,20260,19860,19890,-370,-1.83,19870,-390,-1.92,19860,20250,1400-1-21,2021-04-10
45,افق,فروشگاههاي زنجيره اي افق كوروش,1156,1563213,108172254990,69560,68190,69200,-360,-0.52,69200,-360,-0.52,68170,69970,1400-1-21,2021-04-10
46,سرو,صندوق س سروسودمند مدبران-سهام,1133,1505571,99034669810,67090,66020,65600,-1490,-2.22,65780,-1310,-1.95,65420,66600,1400-1-21,2021-04-10
47,فخوز,فولاد  خوزستان,1130,12866317,180962617950,14340,14060,14060,-280,-1.95,14060,-280,-1.95,14060,14150,1400-1-21,2021-04-10
48,فايرا,آلومينيوم‌ايران‌,1112,6197111,107858483830,17750,17400,17400,-350,-1.97,17400,-350,-1.97,17400,17650,1400-1-21,2021-04-10
49,امين يكم2,صندوق درآمد ثابت امين يكم فردا,1080,108000000,108000000,10172,1,1,-10171,-99.99,1,-10171,-99.99,1,1,1400-1-21,2021-04-10
50,ساراب,سيمان‌ داراب‌,1065,5078683,84385248720,16570,16250,17040,470,2.84,16620,50,0.3,16240,17100,1400-1-21,2021-04-10
51,سكه0012پ01,تمام سكه طرح جديد0012رفاه,1064,552500,568558846000,1074726,1050000,1020192,-54534,-5.07,1029066,-45660,-4.25,1020192,1050000,1400-1-21,2021-04-10
52,خكرمان,گروه اقتصادي كرمان خودرو,1032,14665230,58973367853,4101,4100,4019,-82,-2,4021,-80,-1.95,4019,4100,1400-1-21,2021-04-10
53,پارند,صندوق س. پارند پايدار سپهر,1022,33284471,374142745826,11225,11230,11240,15,0.13,11241,16,0.14,11230,11260,1400-1-21,2021-04-10
54,وارس,سرمايه گذاري ارس صبا,1009,3057577,50380636777,16196,16466,16110,-86,-0.53,16477,281,1.73,15873,16681,1400-1-21,2021-04-10
55,شصدف,صنعتي دوده فام,943,24803,785386995,29873,31665,31665,1792,6,29900,27,0.09,31665,31665,1400-1-21,2021-04-10
56,ضخود2007,اختيارخ خودرو-3000-1400/02/08,914,46912,560001000,21,22,9,-12,-57.14,12,-9,-42.86,9,22,1400-1-21,2021-04-10
57,شرنگي,شيميايي رنگين,874,671637,150613142232,228647,224075,224500,-4147,-1.81,224248,-4399,-1.92,224075,230000,1400-1-21,2021-04-10
58,بركت,گروه دارويي بركت,865,5579205,174126988050,31840,31210,31210,-630,-1.98,31210,-630,-1.98,31210,31210,1400-1-21,2021-04-10
59,فلوله,لوله‌وماشين‌سازي‌ايران‌,790,2119920,47969694000,22750,23100,22300,-450,-1.98,22630,-120,-0.53,22300,23430,1400-1-21,2021-04-10
60,وثنو,سرمايه گذاري ساختماني نوين,788,6131232,37334297472,5857,5999,6149,292,4.99,6089,232,3.96,5770,6149,1400-1-21,2021-04-10
61,ميدكو,هلدينگ صنايع  معدني خاورميانه,774,5673536,182655700293,32187,32188,32209,22,0.07,32194,7,0.02,32187,32490,1400-1-21,2021-04-10
62,حكشتي,كشتيراني جمهوري اسلامي ايران,764,4576962,85732798290,19110,18730,18730,-380,-1.99,18830,-280,-1.47,18730,19000,1400-1-21,2021-04-10
63,سامان,بانك سامان,757,9055764,89162353837,9996,9801,9797,-199,-1.99,9846,-150,-1.5,9797,10120,1400-1-21,2021-04-10
64,وبملت,بانك ملت,748,21642958,83758890940,3940,3870,3870,-70,-1.78,3890,-50,-1.27,3870,3910,1400-1-21,2021-04-10
65,شپنا,پالايش نفت اصفهان,747,17770402,221063800880,12690,12440,12440,-250,-1.97,12440,-250,-1.97,12440,12440,1400-1-21,2021-04-10
66,فنورد,نوردوقطعات‌ فولادي‌,743,367017,63516421230,176240,172720,172720,-3520,-2,173060,-3180,-1.8,172720,177000,1400-1-21,2021-04-10
67,وصنعت,سرمايه گذاري توسعه صنعت وتجارت,722,8246282,50226309500,6210,6110,6090,-120,-1.93,6090,-120,-1.93,6090,6120,1400-1-21,2021-04-10
68,اتكاي,بيمه اتكايي ايرانيان,708,5020468,93323815605,18684,19000,18497,-187,-1,18589,-95,-0.51,18311,19000,1400-1-21,2021-04-10
69,تاپيكو,س. نفت و گاز و پتروشيمي تأمين,704,8720176,97786901120,11430,11210,11210,-220,-1.92,11250,-180,-1.57,11210,11300,1400-1-21,2021-04-10
70,مدير,ص.س.مديريت ثروت ص.بازنشستگي-س,698,2120067,17187329711,8328,8265,8020,-308,-3.7,8107,-221,-2.65,8010,8380,1400-1-21,2021-04-10
71,كگهر,سنگ آهن گهرزمين,694,860509,41064530498,47703,47850,47703,0,0,47709,6,0.01,47690,48700,1400-1-21,2021-04-10
72,شكف,كف,682,772219,83277687036,107853,110010,105696,-2157,-2,107842,-11,-0.01,105696,110010,1400-1-21,2021-04-10
73,شتولي,تولي‌پرس‌,681,925858,32368717570,35585,37008,35000,-585,-1.64,34961,-624,-1.75,34162,37008,1400-1-21,2021-04-10
74,ضخود2006,اختيارخ خودرو-2500-1400/02/08,634,31690,2601254000,98,99,70,-28,-28.57,82,-16,-16.33,70,99,1400-1-21,2021-04-10
75,طلا,صندوق س.پشتوانه طلاي لوتوس,624,270310,20302462102,77411,75501,74735,-2676,-3.46,75108,-2303,-2.98,74712,76000,1400-1-21,2021-04-10
76,سمازن,سيمان‌مازندران‌,610,6509736,82954596480,12990,12750,12740,-250,-1.92,12740,-250,-1.92,12740,13000,1400-1-21,2021-04-10
77,تسه9911,امتياز تسهيلات مسكن بهمن99,606,17087,8767267053,501224,510099,516000,14776,2.95,513096,11872,2.37,492108,526284,1400-1-21,2021-04-10
78,سيستم,همكاران سيستم,603,1493750,39414116370,26870,26370,26340,-530,-1.97,26480,-390,-1.45,26340,27470,1400-1-21,2021-04-10
79,ومهان,گروه توسعه مالي مهر آيندگان,593,5092499,65121178839,13034,12800,12774,-260,-1.99,12788,-246,-1.89,12774,12998,1400-1-21,2021-04-10
80,شلرد,كود شيميايي اوره لردگان,574,8114979,54088288445,6792,6660,6657,-135,-1.99,6665,-127,-1.87,6657,6792,1400-1-21,2021-04-10
81,افران,صندوق س افرا نماد پايدار-ثابت,571,22865632,298544677694,13042,13058,13058,16,0.12,13056,14,0.11,13052,13059,1400-1-21,2021-04-10
82,گوهران,سرمايه گذاري توسعه گوهران اميد,547,1748525,12653570546,7291,7146,7146,-145,-1.99,7277,-14,-0.19,7146,7355,1400-1-21,2021-04-10
83,خگستر,گسترش‌سرمايه‌گذاري‌ايران‌خودرو,531,8509314,23570799780,2820,2770,2770,-50,-1.77,2800,-20,-0.71,2770,2770,1400-1-21,2021-04-10
84,وحكمت,بيمه حكمت صبا,491,9192972,35184412486,3901,3840,3823,-78,-2,3827,-74,-1.9,3823,3939,1400-1-21,2021-04-10
85,ثباغ,شهر سازي و خانه سازي باغميشه,485,1707289,27669164883,16505,16175,16175,-330,-2,16337,-168,-1.02,16175,16490,1400-1-21,2021-04-10
86,وپارس,بانك‌پارسيان‌,481,14424447,39378740310,2780,2730,2730,-50,-1.8,2760,-20,-0.72,2730,2730,1400-1-21,2021-04-10
87,هرمز,فولاد هرمزگان جنوب,475,3472030,48122400097,14139,14000,13878,-261,-1.85,14025,-114,-0.81,13857,14125,1400-1-21,2021-04-10
88,ارزش,صندوق س ارزش آفرين بيدار-سهام,470,1958253,17901623810,9340,9240,9210,-130,-1.39,9140,-200,-2.14,9100,9240,1400-1-21,2021-04-10
89,بجهرم,توسعه مولد نيروگاهي جهرم,469,6469820,18215423010,2872,2815,2815,-57,-1.98,2851,-21,-0.73,2815,2826,1400-1-21,2021-04-10
90,تملت,تامين سرمايه بانك ملت,464,4956042,26371327640,5420,5320,5320,-100,-1.85,5370,-50,-0.92,5320,5350,1400-1-21,2021-04-10
91,ارفع,شركت آهن و فولاد ارفع,464,1861968,27112289665,14776,14501,14481,-295,-2,14693,-83,-0.56,14481,14850,1400-1-21,2021-04-10
92,دشيميح,ح . شيمي‌ داروئي‌ داروپخش‌,455,733303,12803132460,18060,17810,17340,-720,-3.99,17460,-600,-3.32,17340,18060,1400-1-21,2021-04-10
93,حتايد,تايدواترخاورميانه,446,1652802,43376616250,26770,26320,26240,-530,-1.98,26300,-470,-1.76,26240,26600,1400-1-21,2021-04-10
94,پترول,گ.س.وت.ص.پتروشيمي خليج فارس,442,2418375,23071297500,9730,9540,9540,-190,-1.95,9680,-50,-0.51,9540,9540,1400-1-21,2021-04-10
95,تصميم,صندوق س با درآمد ثابت تصميم,441,3463823,55719558580,16076,16084,16100,24,0.15,16086,10,0.06,16081,16100,1400-1-21,2021-04-10
96,آكورد,صندوق س. آرمان آتي كوثر-د,438,2920346,92070591712,31480,31534,31530,50,0.16,31527,47,0.15,31525,31534,1400-1-21,2021-04-10
97,شسپا,نفت سپاهان,416,2633854,38922150210,15070,14990,14770,-300,-1.99,14870,-200,-1.33,14770,14990,1400-1-21,2021-04-10
98,ومشان,س. فني و مهندسي مشانير,413,198094,14836424502,75670,74158,74157,-1513,-2,75090,-580,-0.77,74157,77700,1400-1-21,2021-04-10
99,وپخش,داروپخش‌ (هلدينگ‌,407,217354,21734153400,101060,99040,99040,-2020,-2,100590,-470,-0.47,99040,102800,1400-1-21,2021-04-10
100,زاگرس,پتروشيمي زاگرس,403,204631,40942684818,204142,200120,200060,-4082,-2,202445,-1697,-0.83,200060,201510,1400-1-21,2021-04-10
101,لوتوس,تامين سرمايه لوتوس پارسيان,398,6260623,61685890360,10050,9860,9850,-200,-1.99,9850,-200,-1.99,9850,9990,1400-1-21,2021-04-10
102,تسه9910,امتياز تسهيلات مسكن دي99,394,11913,6103157242,500876,484122,505001,4125,0.82,512311,11435,2.28,484122,525919,1400-1-21,2021-04-10
103,فارس,صنايع پتروشيمي خليج فارس,386,4883433,46783288140,9770,9580,9580,-190,-1.94,9690,-80,-0.82,9580,9580,1400-1-21,2021-04-10
104,شتران,پالايش نفت تهران,370,1160869,11283646680,9910,9720,9720,-190,-1.92,9890,-20,-0.2,9720,9720,1400-1-21,2021-04-10
105,آسيا,بيمه آسيا,360,13650199,29074923870,2170,2130,2130,-40,-1.84,2150,-20,-0.92,2130,2130,1400-1-21,2021-04-10
106,تنوين,تامين سرمايه نوين,360,5480742,40544402440,7450,7450,7400,-50,-0.67,7410,-40,-0.54,7370,7450,1400-1-21,2021-04-10
107,ياقوت,صندوق س ياقوت آگاه-ثابت,360,2974200,36350187162,12202,12220,12231,29,0.24,12222,20,0.16,12219,12235,1400-1-21,2021-04-10
108,شگلح,ح . گلتاش‌,359,1540489,9887050520,6610,6500,6350,-260,-3.93,6420,-190,-2.87,6350,6600,1400-1-21,2021-04-10
109,كارين,صندوق س نگين سامان-ثابت,339,16103784,163340373672,10130,10146,10140,10,0.1,10143,13,0.13,10140,10147,1400-1-21,2021-04-10
110,دامين,داروسازي‌ امين‌,339,4215956,22218088120,4980,5270,5270,290,5.82,5100,120,2.41,5270,5270,1400-1-21,2021-04-10
111,دعبيد,لابراتوارداروسازي‌  دكترعبيدي‌,338,870635,20299809680,23780,23310,23310,-470,-1.98,23590,-190,-0.8,23310,23950,1400-1-21,2021-04-10
112,ونوين,بانك‌اقتصادنوين‌,333,7023305,30483774270,4420,4340,4340,-80,-1.81,4370,-50,-1.13,4340,4370,1400-1-21,2021-04-10
113,تمحركه,ماشين سازي نيرو محركه,312,994367,21469377897,20963,21591,21591,628,3,21591,628,3,21591,21591,1400-1-21,2021-04-10
114,فنوال,نورد آلومينيوم‌,311,3797184,98582520030,26480,25960,25960,-520,-1.96,25960,-520,-1.96,25960,26500,1400-1-21,2021-04-10
115,شاراك,پتروشيمي شازند,309,1476632,35365898120,24420,23940,23940,-480,-1.97,24210,-210,-0.86,23940,24200,1400-1-21,2021-04-10
116,تماوند,تامين سرمايه دماوند,303,2238074,35836278937,16281,15980,16100,-181,-1.11,16012,-269,-1.65,15956,16254,1400-1-21,2021-04-10
117,حسينا,توسعه خدمات دريايي وبندري سينا,301,826660,58441607309,72089,70660,70648,-1441,-2,70696,-1393,-1.93,70648,72100,1400-1-21,2021-04-10
118,وبانك,سرمايه گذاري گروه توسعه ملي,299,4167930,35052291300,8580,8410,8410,-170,-1.98,8510,-70,-0.82,8410,8410,1400-1-21,2021-04-10
119,تسه9908,امتياز تسهيلات مسكن آبان99,296,5542,2818564160,502771,486666,500000,-2771,-0.55,508582,5811,1.16,486666,527909,1400-1-21,2021-04-10
120,وشهر,بانك شهر,291,5182166,30378433810,6106,5862,5862,-244,-4,5903,-203,-3.32,5862,5991,1400-1-21,2021-04-10
121,وسينا,بانك سينا,290,11926382,37842546130,3230,3190,3170,-60,-1.86,3190,-40,-1.24,3170,3230,1400-1-21,2021-04-10
122,كاريس,صندوق س.سپهر كاريزما-س,289,1388985,15582099122,11447,11300,11125,-322,-2.81,11218,-229,-2,11120,11490,1400-1-21,2021-04-10
123,پارسيان,بيمه پارسيان,287,3685082,38904744480,10760,10610,10550,-210,-1.95,10600,-160,-1.49,10550,10850,1400-1-21,2021-04-10
124,تسه9802,امتياز تسهيلات مسكن ارديبهشت98,282,3508,1727797466,482685,480000,492081,9396,1.95,492531,9846,2.04,480000,499990,1400-1-21,2021-04-10
125,سخوز,سيمان خوزستان,281,1664676,37189926960,22790,22340,22340,-450,-1.97,22450,-340,-1.49,22340,22420,1400-1-21,2021-04-10
126,جم پيلن,پلي پروپيلن جم - جم پيلن,277,383086,29895616750,79620,78310,78030,-1590,-2,78860,-760,-0.95,78030,79800,1400-1-21,2021-04-10
127,ذوب,سهامي ذوب آهن  اصفهان,275,3640982,14061472484,3940,3862,3862,-78,-1.98,3928,-12,-0.3,3862,3862,1400-1-21,2021-04-10
128,سجامح,ح.مجتمع سيمان غرب آسيا,274,1627824,3089733135,1920,1954,1885,-35,-1.82,1898,-22,-1.15,1882,1954,1400-1-21,2021-04-10
129,عيار,صندوق سكه طلاي مفيد,273,234958,6187940439,27056,26690,26100,-956,-3.53,26336,-720,-2.66,26100,26690,1400-1-21,2021-04-10
130,شپديس,پتروشيمي پرديس,272,648350,60648013450,95440,93540,93540,-1900,-1.99,94270,-1170,-1.23,93540,94900,1400-1-21,2021-04-10
131,وخارزم,سرمايه گذاري خوارزمي,272,3833264,20661292960,5490,5390,5390,-100,-1.82,5450,-40,-0.73,5390,5390,1400-1-21,2021-04-10
132,دالبرح,ح . البرزدارو,265,188022,1894737980,10170,9950,10010,-160,-1.57,10080,-90,-0.88,9950,10940,1400-1-21,2021-04-10
133,كاردان,صندوق س تجارت شاخصي كاردان,261,169868,25606623550,156010,154500,149770,-6240,-4,150740,-5270,-3.38,149770,154500,1400-1-21,2021-04-10
134,تيپيكو,سرمايه گذاري دارويي تامين,253,919791,37548751100,41650,40830,40820,-830,-1.99,41210,-440,-1.06,40820,41170,1400-1-21,2021-04-10
135,كخاك,صنايع‌خاك‌چيني‌ايران‌,251,303160,12458305080,41920,41090,41090,-830,-1.98,41710,-210,-0.5,41090,41600,1400-1-21,2021-04-10
136,ومعادن,توسعه‌معادن‌وفلزات‌,242,2157016,25302179840,11960,11730,11730,-230,-1.92,11910,-50,-0.42,11730,11750,1400-1-21,2021-04-10
137,فيروزه,صندوق شاخص30 شركت فيروزه- سهام,241,138688,17840054320,133700,132760,128610,-5090,-3.81,128630,-5070,-3.79,128360,132760,1400-1-21,2021-04-10
138,فسازان,غلتك سازان سپاهان,239,763740,26437647750,35260,35200,34560,-700,-1.99,34910,-350,-0.99,34560,35200,1400-1-21,2021-04-10
139,شپارس,بين‌ المللي‌ محصولات‌  پارس‌,234,774474,17699675630,23210,23450,22750,-460,-1.98,23080,-130,-0.56,22750,23450,1400-1-21,2021-04-10
140,خساپا,سايپا,233,3617170,8174804200,2300,2260,2260,-40,-1.74,2300,0,0,2260,2260,1400-1-21,2021-04-10
141,سحرخيز,صندوق س. گروه زعفران سحرخيز,230,690672,6515940122,9457,9520,9416,-41,-0.43,9434,-23,-0.24,9385,9520,1400-1-21,2021-04-10
142,فراز,صندوق س.سهام فراز داريك-س,229,330101,3360594835,10000,10180,10180,180,1.8,10181,181,1.81,10180,10200,1400-1-21,2021-04-10
143,شوينده,مديريت صنعت شوينده ت.ص.بهشهر,226,440680,12907952890,29880,29300,29400,-480,-1.61,29720,-160,-0.54,29290,29400,1400-1-21,2021-04-10
144,پارس,پتروشيمي پارس,225,398113,57904430330,148400,145440,145440,-2960,-1.99,146660,-1740,-1.17,145440,148000,1400-1-21,2021-04-10
145,سپاس,صندوق س. پاداش سهامداري-ثابت,220,6367332,63886612193,10015,10034,10033,18,0.18,10033,18,0.18,10033,10035,1400-1-21,2021-04-10
146,اطلس,صندوق س.توسعه اندوخته آينده-س,217,72395,14893441358,208693,208700,205005,-3688,-1.77,205725,-2968,-1.42,205000,208999,1400-1-21,2021-04-10
147,آساس,صندوق س.آسمان آرماني سهام-س,217,72503,11569091020,162466,161500,157505,-4961,-3.05,159567,-2899,-1.78,157501,161860,1400-1-21,2021-04-10
148,وغدير,سرمايه‌گذاري‌غدير(هلدينگ‌,216,1148059,12341634250,10960,10750,10750,-210,-1.92,10940,-20,-0.18,10750,10750,1400-1-21,2021-04-10
149,ارمغان,ص سرمايه گذاري ارمغان ايرانيان,213,3632838,36471558881,10020,10032,10038,18,0.18,10039,19,0.19,10032,10048,1400-1-21,2021-04-10
150,شبندر,پالايش نفت بندرعباس,212,956961,23742202410,25310,24810,24810,-500,-1.98,25210,-100,-0.4,24810,24810,1400-1-21,2021-04-10
151,خپارس,پارس‌ خودرو,212,3859964,21963195160,5800,5690,5690,-110,-1.9,5750,-50,-0.86,5690,5690,1400-1-21,2021-04-10
152,همراه,شركت ارتباطات سيار ايران,212,924894,24242352610,26740,26210,26210,-530,-1.98,26610,-130,-0.49,26210,26690,1400-1-21,2021-04-10
153,بخاور,بيمه زندگي خاورميانه,210,1463467,9940748814,6922,6800,6800,-122,-1.76,6896,-26,-0.38,6784,6890,1400-1-21,2021-04-10
154,شرانل,نفت ايرانول,207,776038,29132992597,38305,37756,37539,-766,-2,37851,-454,-1.19,37539,37757,1400-1-21,2021-04-10
155,آساميد,صندوق س.مشترك آسمان اميد -د,207,8227133,97767163434,11875,11876,11888,13,0.11,11884,9,0.08,11876,11888,1400-1-21,2021-04-10
156,خريخت,صنايع‌ريخته‌گري‌ايران‌,202,3385755,11173267080,3360,3300,3300,-60,-1.79,3350,-10,-0.3,3300,3320,1400-1-21,2021-04-10
157,زر,صندوق س.پشتوانه سكه طلاي زر,199,198435,8812719494,45385,44700,44000,-1385,-3.05,44411,-974,-2.15,44000,44710,1400-1-21,2021-04-10
158,وبازار,صندوق س شاخصي بازارآشنا,197,1130089,10624179500,9500,9400,9400,-100,-1.05,9400,-100,-1.05,9400,9500,1400-1-21,2021-04-10
159,كوير,توليدي فولاد سپيد فراب كوير,195,4247858,91923647120,22540,21640,21640,-900,-3.99,21660,-880,-3.9,21640,21640,1400-1-21,2021-04-10
160,تسه9803,امتياز تسهيلات مسكن خرداد98,193,1747,909900849,511524,513000,522000,10476,2.05,520836,9312,1.82,504000,530000,1400-1-21,2021-04-10
161,ضسپا3004,اختيارخ خساپا-2500-1400/03/26,193,9817,1487754000,165,155,132,-33,-20,152,-13,-7.88,132,170,1400-1-21,2021-04-10
162,تسه9909,امتياز تسهيلات مسكن آذر99,187,1946,997615983,498891,500555,505012,6121,1.23,512650,13759,2.76,490444,523835,1400-1-21,2021-04-10
163,وتجارت,بانك تجارت,185,3034142,8161841980,2740,2690,2690,-50,-1.82,2740,0,0,2690,2690,1400-1-21,2021-04-10
164,شفن,پتروشيمي فناوران,183,108561,34438806030,323700,317230,317230,-6470,-2,321430,-2270,-0.7,317230,317230,1400-1-21,2021-04-10
165,وخاور,بانك خاورميانه,182,2693116,24211260870,9170,8990,8990,-180,-1.96,9090,-80,-0.87,8990,9000,1400-1-21,2021-04-10
166,خاتم,صندوق س خاتم ايساتيس پويا-ثابت,178,2136130,23287550288,10873,10872,10929,56,0.52,10902,29,0.27,10872,10930,1400-1-21,2021-04-10
167,شگويا,پتروشيمي تندگويان,177,4394399,40560302770,9418,9230,9230,-188,-2,9332,-86,-0.91,9230,9230,1400-1-21,2021-04-10
168,پترولح,ح . گروه پتروشيمي س. ايرانيان,177,1627628,12429348580,7930,7830,7620,-310,-3.91,7640,-290,-3.66,7620,7830,1400-1-21,2021-04-10
169,نهال,صندوق س. طلاي سرخ نوويرا,176,323604,3006956346,9341,9300,9330,-11,-0.12,9292,-49,-0.52,8550,9330,1400-1-21,2021-04-10
170,كاما,باما,173,536086,7070974340,13450,13190,13190,-260,-1.93,13420,-30,-0.22,13190,13190,1400-1-21,2021-04-10
171,تسه9810,امتياز تسهيلات مسكن دي98,170,4024,2031659555,492118,471022,496100,3982,0.81,504886,12768,2.59,471022,516723,1400-1-21,2021-04-10
172,فاذر,صنايع‌ آذرآب‌,167,229544,5470033520,24310,23830,23830,-480,-1.97,24260,-50,-0.21,23830,23830,1400-1-21,2021-04-10
173,ضخود2005,اختيارخ خودرو-2000-1400/02/08,166,7024,2537960000,416,360,350,-66,-15.87,361,-55,-13.22,350,410,1400-1-21,2021-04-10
174,قشرين,قند شيرين خراسان,165,397250,6194319250,15911,15593,15593,-318,-2,15811,-100,-0.63,15593,15593,1400-1-21,2021-04-10
175,سمتاز,سيمان ممتازان كرمان,160,626038,12578502192,20496,21100,20087,-409,-2,20237,-259,-1.26,20087,21100,1400-1-21,2021-04-10
176,گوهر,صندوق سكه طلاي كيان,159,104583,5418142201,52880,52516,51300,-1580,-2.99,51807,-1073,-2.03,51300,52537,1400-1-21,2021-04-10
177,تسه9902,امتياز تسهيلات مسكن ارديبهشت99,157,2178,1100503830,494249,482000,500011,5762,1.17,505282,11033,2.23,472222,518000,1400-1-21,2021-04-10
178,خصدرا,صنعتي‌ دريايي‌ ايران‌,151,5011572,15360468180,3127,3065,3065,-62,-1.98,3097,-30,-0.96,3065,3065,1400-1-21,2021-04-10
179,سيدكو,سرمايه گذاري توسعه صنايع سيمان,151,1970185,12215540000,6320,6200,6200,-120,-1.9,6290,-30,-0.47,6200,6270,1400-1-21,2021-04-10
180,آريان,سرمايه گذاري پارس آريان,150,8040991,93669504159,11886,11649,11649,-237,-1.99,11649,-237,-1.99,11649,11649,1400-1-21,2021-04-10
181,دسينا,داروسازي‌ سينا,149,543215,12956580000,24330,23850,23880,-450,-1.85,24200,-130,-0.53,23850,23960,1400-1-21,2021-04-10
182,سپر,صندوق س سپر سرمايه بيدار- ثابت,147,1804901,21193811522,11741,11745,11742,1,0.01,11742,1,0.01,11741,11745,1400-1-21,2021-04-10
183,تسه9907,امتياز تسهيلات مسكن مهر99,145,1590,804899982,502026,490122,495001,-7025,-1.4,506226,4200,0.84,490122,522999,1400-1-21,2021-04-10
184,واتي,سرمايه‌ گذاري‌ آتيه‌ دماوند,144,838592,10150629760,12270,12260,12030,-240,-1.96,12240,-30,-0.24,12030,12260,1400-1-21,2021-04-10
185,درازك,دارويي‌ رازك‌,143,425004,14195579610,34060,33390,33380,-680,-2,33870,-190,-0.56,33380,33900,1400-1-21,2021-04-10
186,مارون,پتروشيمي مارون,143,84389,13084261176,158158,159500,155000,-3158,-2,157743,-415,-0.26,154995,159500,1400-1-21,2021-04-10
187,ضسپا3003,اختيارخ خساپا-2000-1400/03/26,134,4329,1412676000,368,306,311,-57,-15.49,326,-42,-11.41,301,380,1400-1-21,2021-04-10
188,وتوسم,سرمايه‌گذاري‌توسعه‌ملي‌,131,1363324,12147216840,9090,8910,8910,-180,-1.98,9050,-40,-0.44,8910,8910,1400-1-21,2021-04-10
189,وبصادر,بانك صادرات ايران,131,1337334,3263094960,2480,2440,2440,-40,-1.61,2480,0,0,2440,2440,1400-1-21,2021-04-10
190,غگل,گلوكوزان‌,130,951975,3141517500,3360,3300,3300,-60,-1.79,3360,0,0,3300,3300,1400-1-21,2021-04-10
191,شخارك,پتروشيمي‌ خارك‌,130,686628,30772103240,45720,44950,44810,-910,-1.99,45440,-280,-0.61,44810,44950,1400-1-21,2021-04-10
192,شصفها,پتروشيمي‌ اصفهان‌,129,277506,35566936688,130696,129948,128083,-2613,-2,128166,-2530,-1.94,128083,129948,1400-1-21,2021-04-10
193,ثمسكن,سرمايه‌گذاري‌ مسكن‌,128,2675734,14208147540,5410,5310,5310,-100,-1.85,5380,-30,-0.55,5310,5310,1400-1-21,2021-04-10
194,گكوثر,هتل پارسيان كوثر اصفهان,125,3909163,9596995165,2505,2455,2455,-50,-2,2495,-10,-0.4,2455,2455,1400-1-21,2021-04-10
195,اتكام,شركت بيمه اتكايي امين,123,1095367,5259427329,4895,4798,4798,-97,-1.98,4885,-10,-0.2,4798,4880,1400-1-21,2021-04-10
196,بترانس,ايران‌ ترانسفو,122,1991677,5855530380,2990,2940,2940,-50,-1.67,2980,-10,-0.33,2940,2940,1400-1-21,2021-04-10
197,سكه0011پ02,تمام سكه طرح جديد0011ملت,121,30700,31721648800,1073963,1039520,1022000,-51963,-4.84,1033278,-40685,-3.79,1020193,1049000,1400-1-21,2021-04-10
198,سكرما,سيمان‌ كرمان‌,120,742219,12061509980,16580,16260,16250,-330,-1.99,16500,-80,-0.48,16250,16650,1400-1-21,2021-04-10
199,ضخود2008,اختيارخ خودرو-3500-1400/02/08,117,7602,25030000,5,4,3,-2,-40,3,-2,-40,3,4,1400-1-21,2021-04-10
200,شساخت,مهندسي و ساختمان صنايع نفت,114,647889,23286001509,36633,35910,35901,-732,-2,36188,-445,-1.21,35901,36370,1400-1-21,2021-04-10
201,صايند,صندوق س. گنجينه آينده روشن-د,114,475110,4678915480,9833,9860,9870,37,0.38,9848,15,0.15,9589,9878,1400-1-21,2021-04-10
202,شيراز,پتروشيمي‌شيراز,114,2048118,114343147930,56600,55470,55470,-1130,-2,55830,-770,-1.36,55470,56290,1400-1-21,2021-04-10
203,ماديرا,صنايع ماديران,113,473489,3976834111,8570,8399,8399,-171,-2,8556,-14,-0.16,8399,8399,1400-1-21,2021-04-10
204,زپارس,ملي كشت و صنعت و دامپروري پارس,112,205168,33988666580,169040,165660,165660,-3380,-2,166700,-2340,-1.38,165660,171690,1400-1-21,2021-04-10
205,زرين,صندوق س. سهام زرين كوروش-س,108,288529,2802572850,9907,9980,9574,-333,-3.36,9713,-194,-1.96,9550,9980,1400-1-21,2021-04-10
206,سشمال,سيمان‌ شمال‌,104,1389923,15761726820,11570,11340,11340,-230,-1.99,11500,-70,-0.61,11340,11340,1400-1-21,2021-04-10
207,دفرا,فرآورده‌هاي‌ تزريقي‌ ايران‌,102,214579,5632698750,26780,26250,26250,-530,-1.98,26720,-60,-0.22,26250,26250,1400-1-21,2021-04-10
208,كرماشا,صنايع پتروشيمي كرمانشاه,101,378970,13917091390,37460,36720,36720,-740,-1.98,37260,-200,-0.53,36720,37480,1400-1-21,2021-04-10
209,اخزا902,اسنادخزانه-م2بودجه99-011019,100,170297,121418009088,712352,710509,711500,-852,-0.12,712978,626,0.09,708800,715450,1400-1-21,2021-04-10
210,سجام,مجتمع سيمان غرب آسيا,100,2729130,13492818720,5150,4944,4944,-206,-4,5005,-145,-2.82,4944,4944,1400-1-21,2021-04-10
211,آتيمس,صندوق س.آرمان آتيه درخشان مس-س,100,45405,8143140550,182074,181000,180000,-2074,-1.14,179345,-2729,-1.5,178420,184444,1400-1-21,2021-04-10
212,ثاخت,بين‌المللي‌توسعه‌ساختمان,98,1055650,2649681500,2560,2510,2510,-50,-1.95,2560,0,0,2510,2510,1400-1-21,2021-04-10
213,وسپهر,سرمايه گذاري مالي سپهرصادرات,96,192105,1973686770,10483,10274,10274,-209,-1.99,10479,-4,-0.04,10274,10274,1400-1-21,2021-04-10
214,تسه9906,امتياز تسهيلات مسكن شهريور99,95,654,330231056,493938,490522,514999,21061,4.26,504940,11002,2.23,490522,518634,1400-1-21,2021-04-10
215,تسه9905,امتياز تسهيلات مسكن مرداد99,95,929,485340167,527677,501294,502000,-25677,-4.87,522433,-5244,-0.99,501294,553333,1400-1-21,2021-04-10
216,دروز,داروسازي‌ روزدارو,94,932720,35014308800,38300,37540,37540,-760,-1.98,37760,-540,-1.41,37540,37540,1400-1-21,2021-04-10
217,تسه9904,امتياز تسهيلات مسكن تير99,94,714,362994976,502249,485009,491510,-10739,-2.14,508396,6147,1.22,485009,527361,1400-1-21,2021-04-10
218,اخزا901,اسنادخزانه-م1بودجه99-010621,90,75040,57070421931,757567,759999,761303,3736,0.49,760533,2966,0.39,759999,761999,1400-1-21,2021-04-10
219,پتاير,ايران‌ تاير,90,285443,1036158090,3700,3630,3630,-70,-1.89,3700,0,0,3630,3630,1400-1-21,2021-04-10
220,اخزا903,اسنادخزانه-م3بودجه99-011110,90,146680,103458701667,705563,703077,704850,-713,-0.1,705336,-227,-0.03,703077,707000,1400-1-21,2021-04-10
221,دماوند,توليد نيروي برق دماوند,87,92536,4175779536,46046,45126,45126,-920,-2,45969,-77,-0.17,45126,45126,1400-1-21,2021-04-10
222,زعف0008پ05,زعفران0008نگين زرين(پ),87,78119,9567098263,121509,122000,122520,1011,0.83,122468,959,0.79,122000,123000,1400-1-21,2021-04-10
223,فجر,فولاد اميركبيركاشان,86,86751,5024617920,59100,57920,57920,-1180,-2,58980,-120,-0.2,57920,57920,1400-1-21,2021-04-10
224,تسه9903,امتياز تسهيلات مسكن خرداد99,84,824,446500281,541242,514180,568303,27061,5,541869,627,0.12,514180,568304,1400-1-21,2021-04-10
225,وسكاب,س.ص.بازنشستگي كاركنان بانكها,84,1055966,5469903880,5280,5180,5180,-100,-1.89,5270,-10,-0.19,5180,5180,1400-1-21,2021-04-10
226,لبوتان,گروه‌صنعتي‌بوتان‌,82,193859,12298414960,64730,63440,63440,-1290,-1.99,64410,-320,-0.49,63440,63440,1400-1-21,2021-04-10
227,اخزا910,اسنادخزانه-م10بودجه99-020807,81,70573,43354510037,613458,610647,613835,377,0.06,614321,863,0.14,610644,615000,1400-1-21,2021-04-10
228,سمايه,بانك سرمايه,81,3099254,16937423110,5692,5465,5465,-227,-3.99,5492,-200,-3.51,5465,5465,1400-1-21,2021-04-10
229,وبهمن,سرمايه‌گذاري‌بهمن‌,81,899161,13613297540,15440,15140,15140,-300,-1.94,15360,-80,-0.52,15140,15140,1400-1-21,2021-04-10
230,سپيدار,سپيدار سيستم آسيا,80,305495,18470533195,61694,60461,60461,-1233,-2,61229,-465,-0.75,60461,60461,1400-1-21,2021-04-10
231,ونفت,سرمايه‌گذاري‌ صنعت‌ نفت‌,80,1236183,20174506560,16650,16320,16320,-330,-1.98,16510,-140,-0.84,16320,16320,1400-1-21,2021-04-10
232,وآرين,شركت توسعه اقتصادي آرين,80,950879,3674196456,4024,3864,3864,-160,-3.98,3993,-31,-0.77,3864,3864,1400-1-21,2021-04-10
233,چكارن,كارتن‌ ايران‌,80,1793565,6044314050,3430,3370,3370,-60,-1.75,3420,-10,-0.29,3370,3370,1400-1-21,2021-04-10
234,صنوين,صندوق سرمايه‌گذاري صنوين-مختلط,79,15542,1663085150,105140,107000,107200,2060,1.96,107010,1870,1.78,104820,109000,1400-1-21,2021-04-10
235,ساروج,بين المللي ساروج بوشهر,79,643096,12372594304,19631,19239,19500,-131,-0.67,19384,-247,-1.26,19239,19500,1400-1-21,2021-04-10
236,ضخود2013,اختيارخ خودرو-7000-1400/02/08,79,3950,7950000,2,2,3,1,50,2,0,0,1,3,1400-1-21,2021-04-10
237,وساپا,سرمايه‌گذاري‌ سايپا,77,352535,1879011550,5430,5330,5330,-100,-1.84,5430,0,0,5330,5330,1400-1-21,2021-04-10
238,خديزل,بهمن  ديزل,76,381068,14927576764,39972,39173,39173,-799,-2,39729,-243,-0.61,39173,39173,1400-1-21,2021-04-10
239,وبشهر,توسعه‌ صنايع‌ بهشهر(هلدينگ,76,1253958,14746546080,11990,11760,11760,-230,-1.92,11920,-70,-0.58,11760,11760,1400-1-21,2021-04-10
240,تسه9901,امتياز تسهيلات مسكن فروردين99,76,1011,524963000,530643,521939,549000,18357,3.46,519251,-11392,-2.15,504111,549000,1400-1-21,2021-04-10
241,وآيند,بانك  آينده,75,464765,7394411150,16572,15910,15910,-662,-3.99,16521,-51,-0.31,15910,15910,1400-1-21,2021-04-10
242,سكه0112پ03,تمام سكه طرح جديد0112سامان,74,19200,19798024300,1073218,1041701,1023000,-50218,-4.68,1031147,-42071,-3.92,1022000,1041701,1400-1-21,2021-04-10
243,بفجر,فجر انرژي خليج فارس,74,519636,12024597300,23610,23150,23140,-470,-1.99,23520,-90,-0.38,23140,23460,1400-1-21,2021-04-10
244,شپلي,پلي اكريل ايران,72,290287,2519110586,9039,8678,8678,-361,-3.99,8966,-73,-0.81,8678,8678,1400-1-21,2021-04-10
245,زعف0008پ20,زعفران0008نگين وحدت جام(پ),72,43729,5270798640,119776,120999,122000,2224,1.86,120533,757,0.63,120000,122599,1400-1-21,2021-04-10
246,اوصتا,صندوق انديشه ورزان صباتامين -د,71,3679222,67469624512,18321,18339,18340,19,0.1,18338,17,0.09,18336,18340,1400-1-21,2021-04-10
247,تسه9812,امتياز تسهيلات مسكن اسفند98,71,562,288245850,495033,471020,519784,24751,5,512893,17860,3.61,471020,519784,1400-1-21,2021-04-10
248,قرن,پديده شيمي قرن,70,25919,1624602920,63950,62680,62680,-1270,-1.99,63910,-40,-0.06,62680,62680,1400-1-21,2021-04-10
249,كدما,معدني‌ دماوند,70,14890,2218758900,152050,149010,149010,-3040,-2,151910,-140,-0.09,149010,149010,1400-1-21,2021-04-10
250,فسپا,گروه‌صنعتي‌سپاهان‌,68,302805,11285542350,38030,37270,37270,-760,-2,37850,-180,-0.47,37270,37270,1400-1-21,2021-04-10
251,واعتبار,سرمايه گذاري اعتبار ايران,68,2024093,18399017470,9270,9090,9090,-180,-1.94,9200,-70,-0.76,9090,9100,1400-1-21,2021-04-10
252,كفرآور,فرآورده هاي سيمان شرق,67,311983,7210863079,24076,23113,23113,-963,-4,23714,-362,-1.5,23113,23113,1400-1-21,2021-04-10
253,ونيرو,سرمايه‌گذاري‌نيرو,67,583750,1570287500,2740,2690,2690,-50,-1.82,2740,0,0,2690,2690,1400-1-21,2021-04-10
254,تسه9811,امتياز تسهيلات مسكن بهمن98,67,822,445809504,546694,519360,573999,27305,4.99,542347,-4347,-0.8,519360,573999,1400-1-21,2021-04-10
255,تاصيكو,سرمايه گذاري صدرتامين,66,2211877,23600727590,10880,10670,10670,-210,-1.93,10840,-40,-0.37,10670,10670,1400-1-21,2021-04-10
256,چخزر,صنايع چوب خزر كاسپين,65,403744,22375088736,56549,55419,55419,-1130,-2,56033,-516,-0.91,55419,55419,1400-1-21,2021-04-10
257,پكوير,كوير تاير,65,255250,3305487500,13210,12950,12950,-260,-1.97,13190,-20,-0.15,12950,12950,1400-1-21,2021-04-10
258,سكه0012پ04,تمام سكه طرح جديد0012صادرات,63,13400,13840849100,1072395,1050000,1020192,-52203,-4.87,1032899,-39496,-3.68,1020192,1050000,1400-1-21,2021-04-10
259,گشان,توسعه بين المللي پديده شانديز,63,72754,2070142316,29034,28454,28454,-580,-2,28963,-71,-0.24,28454,28454,1400-1-21,2021-04-10
260,تسه9804,امتياز تسهيلات مسكن تير98,62,552,293824559,511766,495500,537354,25588,5,532291,20525,4.01,495500,537354,1400-1-21,2021-04-10
261,زعف0008پ11,زعفران0008نگين سحرخيز(پ),62,102793,13118421816,123612,127990,126000,2388,1.93,127620,4008,3.24,124100,128046,1400-1-21,2021-04-10
262,سفارس,سيمان فارس و خوزستان,61,452766,8448613560,19040,18660,18660,-380,-2,18970,-70,-0.37,18660,18660,1400-1-21,2021-04-10
263,خلنت,لنت‌ ترمزايران‌,61,15952,1461043680,93450,91590,91590,-1860,-1.99,93390,-60,-0.06,91590,91590,1400-1-21,2021-04-10
264,افق ملت,صندوق س در سهام افق ملت,61,21663,2706562100,125830,125000,124600,-1230,-0.98,124940,-890,-0.71,124600,125200,1400-1-21,2021-04-10
265,قپيرا,فرآورده‌هاي‌غدايي‌وقندپيرانشهر,61,257468,26745775840,106000,103880,103880,-2120,-2,104840,-1160,-1.09,103880,103880,1400-1-21,2021-04-10
266,پرداخت,به پرداخت ملت,61,1503857,49131008190,33330,32670,32670,-660,-1.98,32670,-660,-1.98,32670,32670,1400-1-21,2021-04-10
267,انرژي3,سايراشخاص بورس انرژي,59,8118,2045573640,257120,251980,251980,-5140,-2,256950,-170,-0.07,251980,251980,1400-1-21,2021-04-10
268,زملارد,كشاورزي و دامپروري ملارد شير,59,77141,2905670047,38435,37667,37667,-768,-2,38389,-46,-0.12,37667,37667,1400-1-21,2021-04-10
269,كنور,توسعه معدني و صنعتي صبانور,59,335575,15725044500,47810,46860,46860,-950,-1.99,47540,-270,-0.56,46860,46860,1400-1-21,2021-04-10
270,فيروزا,صندوق بادرآمد ثابت فيروزه آسيا,58,87443,1980925000,22663,22670,22654,-9,-0.04,22654,-9,-0.04,22642,22674,1400-1-21,2021-04-10
271,وسپه,سرمايه‌گذاري‌ سپه‌,57,205903,1398081370,6920,6790,6790,-130,-1.88,6920,0,0,6790,6790,1400-1-21,2021-04-10
272,اخزا909,اسنادخزانه-م9بودجه99-020316,57,143778,94596915859,656538,657300,658000,1462,0.22,657937,1399,0.21,657201,659000,1400-1-21,2021-04-10
273,سيمرغ,سيمرغ,57,796435,14463259600,18530,18160,18160,-370,-2,18420,-110,-0.59,18160,18160,1400-1-21,2021-04-10
274,شبريز,پالايش نفت تبريز,57,145089,4206130110,29580,28990,28990,-590,-1.99,29550,-30,-0.1,28990,28990,1400-1-21,2021-04-10
275,تسه9809,امتياز تسهيلات مسكن آذر98,57,783,388413436,496331,472000,521000,24669,4.97,496058,-273,-0.06,472000,521147,1400-1-21,2021-04-10
276,وپترو,سرمايه‌گذاري صنايع پتروشيمي‌,56,508264,7136026560,14320,14040,14040,-280,-1.96,14280,-40,-0.28,14040,14040,1400-1-21,2021-04-10
277,رمپنا,گروه مپنا (سهامي عام),56,1070167,18556695780,17690,17340,17340,-350,-1.98,17630,-60,-0.34,17340,17340,1400-1-21,2021-04-10
278,فردا,صندوق س آواي فرداي زاگرس-ثابت,56,293511,3076682019,10460,10469,10482,22,0.21,10482,22,0.21,10469,10484,1400-1-21,2021-04-10
279,اخزا908,اسنادخزانه-م8بودجه99-020606,56,186727,117900126974,632728,629136,631300,-1428,-0.23,631404,-1324,-0.21,629136,632999,1400-1-21,2021-04-10
280,غفارس,شير پاستوريزه پگاه فارس,55,387376,7001433824,18442,18074,18074,-368,-2,18389,-53,-0.29,18074,18074,1400-1-21,2021-04-10
281,حفاري,حفاري شمال,55,268976,1958145280,7420,7280,7280,-140,-1.89,7410,-10,-0.13,7280,7280,1400-1-21,2021-04-10
282,دارا,صندوق س. دارا الگوريتم-د,55,758192,7647182598,10079,10094,10085,6,0.06,10086,7,0.07,10051,10094,1400-1-21,2021-04-10
283,وملي,گروه‌ صنعتي‌ ملي‌ (هلدينگ‌,54,37291,6495719290,177740,174190,174190,-3550,-2,177270,-470,-0.26,174190,174190,1400-1-21,2021-04-10
284,فروي,ذوب روي اصفهان,53,17141,1064576087,63374,62107,62107,-1267,-2,63346,-28,-0.04,62107,62107,1400-1-21,2021-04-10
285,فاراك,ماشين‌ سازي‌ اراك‌,53,496145,1265169750,2600,2550,2550,-50,-1.92,2600,0,0,2550,2550,1400-1-21,2021-04-10
286,تسه9808,امتياز تسهيلات مسكن آبان98,53,427,220545365,507060,481820,532413,25353,5,516500,9440,1.86,481820,532413,1400-1-21,2021-04-10
287,واحيا,م .صنايع و معادن احياء سپاهان,52,42719,6391073167,152645,149593,149593,-3052,-2,152321,-324,-0.21,149593,152642,1400-1-21,2021-04-10
288,سصوفي,سيمان‌ صوفيان‌,52,550849,11088590370,20540,20130,20130,-410,-2,20450,-90,-0.44,20130,20130,1400-1-21,2021-04-10
289,قثابت,قند ثابت‌ خراسان‌,52,110848,7288256000,68480,65750,65750,-2730,-3.99,68070,-410,-0.6,65750,65750,1400-1-21,2021-04-10
290,ضشنا2002,اختيارخ شپنا-12000-1400/02/27,52,1403,1722834000,1569,1300,1160,-409,-26.07,1228,-341,-21.73,1126,1357,1400-1-21,2021-04-10
291,دشيري,شيرين دارو,52,55053,13500757296,250236,245232,245232,-5004,-2,246789,-3447,-1.38,245232,245232,1400-1-21,2021-04-10
292,سبزوا,سيمان لار سبزوار,51,538822,1924672184,3644,3572,3572,-72,-1.98,3641,-3,-0.08,3572,3572,1400-1-21,2021-04-10
293,سرود,سيمان‌شاهرود,50,396085,7763266000,19990,19600,19600,-390,-1.95,19930,-60,-0.3,19600,19600,1400-1-21,2021-04-10
294,دارا2,صندوق س. دارا الگوريتم-د,50,5000000,5000000,10079,1,1,-10078,-99.99,1,-10078,-99.99,1,1,1400-1-21,2021-04-10
295,رافزا,رايان هم افزا,48,4352,483959808,113473,111204,111204,-2269,-2,113451,-22,-0.02,111204,111204,1400-1-21,2021-04-10
296,ولساپا,ليزينگ رايان‌ سايپا,47,248661,842960790,3450,3390,3390,-60,-1.74,3450,0,0,3390,3390,1400-1-21,2021-04-10
297,اخزا914,اسنادخزانه-م14بودجه99-021025,46,49730,28911497045,580224,584000,583280,3056,0.53,581369,1145,0.2,581000,584000,1400-1-21,2021-04-10
298,شكبير,پتروشيمي اميركبير,46,27275,2390769764,89420,87810,87632,-1788,-2,89377,-43,-0.05,87632,87810,1400-1-21,2021-04-10
299,شاوان,پالايش نفت لاوان,45,37110,3206044230,88156,86393,86393,-1763,-2,88041,-115,-0.13,86393,86393,1400-1-21,2021-04-10
300,غشهداب,كشت و صنعت شهداب ناب خراسان,45,459939,1802500941,3998,3919,3919,-79,-1.98,3995,-3,-0.08,3919,3919,1400-1-21,2021-04-10
301,چكاپا,گروه صنايع كاغذ پارس,44,186127,954831510,5230,5130,5130,-100,-1.91,5230,0,0,5130,5130,1400-1-21,2021-04-10
302,غسالم,سالمين‌,44,183910,788973900,4370,4290,4290,-80,-1.83,4370,0,0,4290,4290,1400-1-21,2021-04-10
303,اخزا815,اسنادخزانه-م15بودجه98-010406,43,121924,97205799107,795374,795500,795611,237,0.03,797265,1891,0.24,795500,803989,1400-1-21,2021-04-10
304,تسه9806,امتياز تسهيلات مسكن شهريور98,43,254,130670499,492824,476200,517465,24641,5,514451,21627,4.39,476200,517465,1400-1-21,2021-04-10
305,فوكا,فولاد كاويان,43,460517,5540940544,12277,12032,12032,-245,-2,12230,-47,-0.38,12032,12032,1400-1-21,2021-04-10
306,فباهنر,مس‌ شهيدباهنر,43,172519,4551051220,26910,26380,26380,-530,-1.97,26860,-50,-0.19,26380,26380,1400-1-21,2021-04-10
307,تسه9805,امتياز تسهيلات مسكن مرداد98,42,280,149244966,518231,504910,533200,14969,2.89,533018,14787,2.85,504910,544142,1400-1-21,2021-04-10
308,ستران,سيمان‌ تهران‌,42,48381,1141307790,24070,23590,23590,-480,-1.99,24060,-10,-0.04,23590,23590,1400-1-21,2021-04-10
309,سباقر,سيمان باقران,40,243910,4231350680,17702,17348,17348,-354,-2,17626,-76,-0.43,17348,17348,1400-1-21,2021-04-10
310,مبين,مبين انرژي خليج فارس,40,1214432,20232437120,16990,16660,16660,-330,-1.94,16930,-60,-0.35,16660,16660,1400-1-21,2021-04-10
311,ما,بيمه  ما,39,538768,3911455680,7400,7260,7260,-140,-1.89,7390,-10,-0.14,7260,7260,1400-1-21,2021-04-10
312,زعف0008پ10,زعفران0008نگين طلاي سرخ(پ),38,24959,3087294564,121989,122000,123900,1911,1.57,123695,1706,1.4,121800,127000,1400-1-21,2021-04-10
313,ونيكي,سرمايه‌گذاري‌ ملي‌ايران‌,38,44234,471092100,10860,10650,10650,-210,-1.93,10860,0,0,10650,10650,1400-1-21,2021-04-10
314,قجامح,ح.فرآورده غذايي وقندتربت‌جام,38,191462,1149920772,6128,6006,6006,-122,-1.99,6006,-122,-1.99,6006,6006,1400-1-21,2021-04-10
315,ختوقا,قطعات‌ اتومبيل‌ ايران‌,38,271537,684273240,2570,2520,2520,-50,-1.95,2570,0,0,2520,2520,1400-1-21,2021-04-10
316,اخزا817,اسنادخزانه-م17بودجه98-010512,38,22522,17607606769,783863,772222,783560,-303,-0.04,781796,-2067,-0.26,770000,784998,1400-1-21,2021-04-10
317,زعف0008پ08,زعفران0008نگين روستا(پ),37,10440,1269705252,121804,124900,123000,1196,0.98,121619,-185,-0.15,121000,124900,1400-1-21,2021-04-10
318,ختور,رادياتور ايران‌,37,74917,1445898100,19690,19300,19300,-390,-1.98,19680,-10,-0.05,19300,19300,1400-1-21,2021-04-10
319,وساخت,سرمايه‌ گذاري‌ ساختمان‌ايران‌,37,45766,2279146800,50810,49800,49800,-1010,-1.99,50760,-50,-0.1,49800,49800,1400-1-21,2021-04-10
320,بذر,صندوق س بذر اميد آفرين-سهام,36,13064,1269100670,97330,97130,98200,870,0.89,97140,-190,-0.2,97130,98200,1400-1-21,2021-04-10
321,دكوثر,داروسازي‌ كوثر,35,19872,403997760,20740,20330,20330,-410,-1.98,20740,0,0,20330,20330,1400-1-21,2021-04-10
322,اخابر,مخابرات ايران,34,245202,2532936660,10540,10330,10330,-210,-1.99,10540,0,0,10330,10330,1400-1-21,2021-04-10
323,بكام,كارخانجات توليدي شهيد قندي,34,338955,1318534950,3960,3890,3890,-70,-1.77,3960,0,0,3890,3890,1400-1-21,2021-04-10
324,غزر,صنعتي زر ماكارون,33,73373,1931911090,26860,26330,26330,-530,-1.97,26840,-20,-0.07,26330,26330,1400-1-21,2021-04-10
325,كزغال,زغال سنگ پروده طبس,33,9286,329541568,36212,35488,35488,-724,-2,36207,-5,-0.01,35488,35488,1400-1-21,2021-04-10
326,وبوعلي,سرمايه‌گذاري‌بوعلي‌,32,259062,1499968980,5900,5790,5790,-110,-1.86,5900,0,0,5790,5790,1400-1-21,2021-04-10
327,پلوله,گازلوله‌,32,230925,5764811700,23776,24964,24964,1188,5,24102,326,1.37,24964,24964,1400-1-21,2021-04-10
328,تسه9807,امتياز تسهيلات مسكن مهر98,32,166,84048468,496638,472100,521469,24831,5,506316,9678,1.95,472100,521469,1400-1-21,2021-04-10
329,واميد,گروه مديريت سرمايه گذاري اميد,32,682363,8693304620,13000,12740,12740,-260,-2,12980,-20,-0.15,12740,12740,1400-1-21,2021-04-10
330,كمينا,شيشه سازي مينا,31,506121,13504320522,27226,26682,26682,-544,-2,26851,-375,-1.38,26682,26682,1400-1-21,2021-04-10
331,وسين,بيمه سينا,31,68797,952603464,14122,13900,13840,-282,-2,14109,-13,-0.09,13840,13900,1400-1-21,2021-04-10
332,نوين,بيمه نوين,31,163040,968620640,6062,5941,5941,-121,-2,6060,-2,-0.03,5941,5941,1400-1-21,2021-04-10
333,خمحركه,نيرو محركه‌,31,200177,918812430,4680,4590,4590,-90,-1.92,4680,0,0,4590,4590,1400-1-21,2021-04-10
334,خبازرس,بازرسي مهندسي و صنعتي ايران,31,202482,6855635556,34548,33858,33858,-690,-2,34307,-241,-0.7,33858,33858,1400-1-21,2021-04-10
335,وتوصا,گروه س توسعه صنعتي ايران,30,500832,6175258560,12580,12330,12330,-250,-1.99,12550,-30,-0.24,12330,12330,1400-1-21,2021-04-10
336,جوين,كشت و صنعت جوين,30,132669,675683217,5196,5093,5093,-103,-1.98,5192,-4,-0.08,5093,5093,1400-1-21,2021-04-10
337,سخند,صندوق س.سپهرخبرگان نفت-د,30,728470,7306618400,10016,10030,10030,14,0.14,10030,14,0.14,10030,10035,1400-1-21,2021-04-10
338,وثوق,سرمايه گذاري وثوق امين,30,45966,868849332,19287,18902,18902,-385,-2,19270,-17,-0.09,18902,18902,1400-1-21,2021-04-10
339,وتوشه,سرمايه‌ گذاري‌ پارس‌ توشه‌,29,74150,1606830500,22110,21670,21670,-440,-1.99,22100,-10,-0.05,21670,21670,1400-1-21,2021-04-10
340,ولپارس,ليزينگ پارسيان,29,62960,312911200,5070,4970,4970,-100,-1.97,5070,0,0,4970,4970,1400-1-21,2021-04-10
341,دمعيار,صندوق س. توازن معيار-د,29,449888,4546671651,10089,10105,10110,21,0.21,10106,17,0.17,10103,10110,1400-1-21,2021-04-10
342,شسينا,صنايع‌شيميايي‌سينا,29,5490,716774400,133220,130560,130560,-2660,-2,133180,-40,-0.03,130560,130560,1400-1-21,2021-04-10
343,سهگمت,سيمان‌هگمتان‌,29,106256,2629836000,25250,24750,24750,-500,-1.98,25220,-30,-0.12,24750,24750,1400-1-21,2021-04-10
344,پخش,پخش البرز,28,118580,3811161200,32795,32140,32140,-655,-2,32744,-51,-0.16,32140,32140,1400-1-21,2021-04-10
345,فرابورس,فرابورس ايران,28,15998,495890006,31629,30997,30997,-632,-2,31623,-6,-0.02,30997,30997,1400-1-21,2021-04-10
346,كخاكح,ح . صنايع‌خاك‌چيني‌ايران‌,28,388289,14762747780,38020,38020,38020,0,0,38020,0,0,38020,38020,1400-1-21,2021-04-10
347,كرازي,كارخانجات‌توليدي‌شيشه‌رازي‌,27,85265,1855366400,22200,21760,21760,-440,-1.98,22180,-20,-0.09,21760,21760,1400-1-21,2021-04-10
348,اخزا907,اسنادخزانه-م7بودجه99-020704,27,74468,46460189670,625459,619299,623400,-2059,-0.33,623895,-1564,-0.25,619299,625498,1400-1-21,2021-04-10
349,تايرا,تراكتورسازي‌ايران‌,27,83179,2389732670,29310,28730,28730,-580,-1.98,29280,-30,-0.1,28730,28730,1400-1-21,2021-04-10
350,ضخود2009,اختيارخ خودرو-4000-1400/02/08,27,1296,3469000,4,3,3,-1,-25,3,-1,-25,2,5,1400-1-21,2021-04-10
351,تليسه,دامداري تليسه نمونه,27,255705,1096463040,4375,4288,4288,-87,-1.99,4373,-2,-0.05,4288,4288,1400-1-21,2021-04-10
352,خراسان,پتروشيمي خراسان,26,258805,19125689500,75400,73900,73900,-1500,-1.99,74860,-540,-0.72,73900,73900,1400-1-21,2021-04-10
353,اخزا904,اسنادخزانه-م4بودجه99-011215,26,104530,73166766648,699085,693001,700000,915,0.13,699959,874,0.13,693000,700000,1400-1-21,2021-04-10
354,زگلدشت,كشت و دام گلدشت نمونه اصفهان,26,363126,5031110730,14137,13855,13855,-282,-1.99,14108,-29,-0.21,13855,13855,1400-1-21,2021-04-10
355,پلاسك,پلاسكوكار,26,508971,3751116270,7520,7370,7370,-150,-1.99,7510,-10,-0.13,7370,7370,1400-1-21,2021-04-10
356,اخزا911,اسنادخزانه-م11بودجه99-020906,26,25081,15151840822,603975,604006,607000,3025,0.5,604116,141,0.02,601230,614990,1400-1-21,2021-04-10
357,ثنور,سرمايه گذاري كوه نور,25,186138,1869570072,10248,10044,10044,-204,-1.99,10229,-19,-0.19,10044,10044,1400-1-21,2021-04-10
358,غصينو,صنعتي مينو,25,19987,1331893706,67997,66638,66638,-1359,-2,67979,-18,-0.03,66638,66638,1400-1-21,2021-04-10
359,غپينو,پارس‌ مينو,25,443526,2843001660,6540,6410,6410,-130,-1.99,6530,-10,-0.15,6410,6410,1400-1-21,2021-04-10
360,ضملي3003,اختيارخ فملي-12000-1400/03/02,25,202,163523000,1104,1000,800,-304,-27.54,810,-294,-26.63,616,1000,1400-1-21,2021-04-10
361,شلعاب,لعابيران‌,25,169616,3667097920,22060,21620,21620,-440,-1.99,22030,-30,-0.14,21620,21620,1400-1-21,2021-04-10
362,سرچشمه,سرمايه گذاري مس سرچشمه,25,97553,647751920,6775,6640,6640,-135,-1.99,6773,-2,-0.03,6640,6640,1400-1-21,2021-04-10
363,آسام,صندوق س.آرمان سپهر آشنا-م,24,9130,958448430,106821,103110,104005,-2816,-2.64,104978,-1843,-1.73,103110,105999,1400-1-21,2021-04-10
364,پارسان,گسترش نفت و گاز پارسيان,24,20824,414605840,20310,19910,19910,-400,-1.97,20310,0,0,19910,19910,1400-1-21,2021-04-10
365,ضفلا3004,اختيارخ فولاد-8560-1400/03/19,24,141,170075000,1244,1300,1200,-44,-3.54,1206,-38,-3.05,1200,1300,1400-1-21,2021-04-10
366,بموتو,موتوژن‌,24,28460,1616528000,57950,56800,56800,-1150,-1.98,57910,-40,-0.07,56800,56800,1400-1-21,2021-04-10
367,بورس,بورس اوراق بهادار تهران,24,19525,698799750,36520,35790,35790,-730,-2,36510,-10,-0.03,35790,35790,1400-1-21,2021-04-10
368,فسرب,ملي‌ سرب‌وروي‌ ايران‌,23,16590,1291033800,79400,77820,77820,-1580,-1.99,79360,-40,-0.05,77820,77820,1400-1-21,2021-04-10
369,دانا,بيمه دانا,23,442344,2884082880,6650,6520,6520,-130,-1.95,6640,-10,-0.15,6520,6520,1400-1-21,2021-04-10
370,دزهراوي,داروسازي‌زهراوي‌,23,182119,1560759830,8740,8570,8570,-170,-1.95,8730,-10,-0.11,8570,8570,1400-1-21,2021-04-10
371,ضپاس2001,اختيارخ وپارس-2500-1400/02/29,23,496,135397000,356,345,270,-86,-24.16,273,-83,-23.31,270,349,1400-1-21,2021-04-10
372,پكرمان,گروه‌ صنعتي‌ بارز,23,305459,8085499730,27010,26470,26470,-540,-2,26920,-90,-0.33,26470,26470,1400-1-21,2021-04-10
373,كالا,بورس كالاي ايران,22,25942,844671520,33220,32560,32560,-660,-1.99,33210,-10,-0.03,32560,32560,1400-1-21,2021-04-10
374,اخزا808,اسنادخزانه-م8بودجه98-000817,22,42735,38205912085,893382,894000,895501,2119,0.24,894019,637,0.07,890460,895501,1400-1-21,2021-04-10
375,چدن,توليدي چدن سازان,22,37641,913170660,24750,24260,24260,-490,-1.98,24740,-10,-0.04,24260,24260,1400-1-21,2021-04-10
376,وهنر,گروه توسعه هنر ايران,22,876662,7280677910,8651,8305,8305,-346,-4,8520,-131,-1.51,8305,8305,1400-1-21,2021-04-10
377,ضملت3001,اختيارخ وبملت-3500-1400/03/19,22,1343,730730000,683,750,524,-159,-23.28,544,-139,-20.35,524,750,1400-1-21,2021-04-10
378,اخزا818,اسنادخزانه-م18بودجه98-010614,22,64943,49709342909,762113,762500,766999,4886,0.64,765430,3317,0.44,762000,767000,1400-1-21,2021-04-10
379,ضپاس2002,اختيارخ وپارس-3000-1400/02/29,21,708,83205000,171,130,106,-65,-38.01,118,-53,-30.99,101,130,1400-1-21,2021-04-10
380,حفارس,حمل و نقل بين المللي خليج فارس,21,100347,477651720,4850,4760,4760,-90,-1.86,4850,0,0,4760,4760,1400-1-21,2021-04-10
381,قصفها,قنداصفهان‌,21,10192,1584448320,158630,155460,155460,-3170,-2,158530,-100,-0.06,155460,155460,1400-1-21,2021-04-10
382,هاي وب,داده گسترعصرنوين-هاي وب,20,24337,251401210,10540,10330,10330,-210,-1.99,10540,0,0,10330,10330,1400-1-21,2021-04-10
383,غالبر,لبنيات‌ كالبر,20,18986,376872100,20250,19850,19850,-400,-1.98,20250,0,0,19850,19850,1400-1-21,2021-04-10
384,وپويا,سرمايه گذاري پويا,20,38617,251705606,6651,6518,6518,-133,-2,6650,-1,-0.02,6518,6518,1400-1-21,2021-04-10
385,زنجان,صنايع كشاورزي وكود زنجان,20,230455,2120416455,9388,9201,9201,-187,-1.99,9368,-20,-0.21,9201,9201,1400-1-21,2021-04-10
386,اخزا811,اسنادخزانه-م11بودجه98-001013,20,190471,165932073406,869904,872000,871167,1263,0.15,871167,1263,0.15,865001,872100,1400-1-21,2021-04-10
387,دارو,كارخانجات‌داروپخش‌,20,29871,997093980,34060,33380,33380,-680,-2,34050,-10,-0.03,33380,33380,1400-1-21,2021-04-10
388,آكورد2,صندوق س. آرمان آتي كوثر-د,20,2000000,2000000,31480,1,1,-31479,-100,1,-31479,-100,1,1,1400-1-21,2021-04-10
389,ولبهمن,شركت بهمن ليزينگ,20,1115984,8752662512,8003,7843,7843,-160,-2,7974,-29,-0.36,7843,7843,1400-1-21,2021-04-10
390,وصنا,گروه‌صنايع‌بهشهرايران‌,20,131697,730918350,5660,5550,5550,-110,-1.94,5660,0,0,5550,5550,1400-1-21,2021-04-10
391,والبر,سرمايه‌ گذاري‌ البرز(هلدينگ‌,20,13709,246487820,18340,17980,17980,-360,-1.96,18340,0,0,17980,17980,1400-1-21,2021-04-10
392,شپترو,پتروشيمي آبادان,20,84184,447774696,5427,5319,5319,-108,-1.99,5425,-2,-0.04,5319,5319,1400-1-21,2021-04-10
393,اخزا806,اسنادخزانه-م6بودجه98-000519,18,32430,30397205474,936920,937000,937400,480,0.05,937317,397,0.04,937000,938500,1400-1-21,2021-04-10
394,تكشا,گسترش‌صنايع‌وخدمات‌كشاورزي‌,18,4904,224358000,46680,45750,45750,-930,-1.99,46680,0,0,45750,45750,1400-1-21,2021-04-10
395,غگلپا,شير پاستوريزه پگاه گلپايگان,18,12843,887887962,70544,69134,69134,-1410,-2,70518,-26,-0.04,69134,69134,1400-1-21,2021-04-10
396,كسرام,پارس‌ سرام‌,18,31382,251056000,8330,8000,8000,-330,-3.96,8330,0,0,8000,8000,1400-1-21,2021-04-10
397,اخزا820,اسنادخزانه-م20بودجه98-020806,18,102432,62865180400,612057,611000,615000,2943,0.48,613726,1669,0.27,611000,616440,1400-1-21,2021-04-10
398,دسبحا,گروه دارويي سبحان,18,26644,512820840,19490,19290,19110,-380,-1.95,19490,0,0,19110,19290,1400-1-21,2021-04-10
399,غچين,كشت‌ و صنعت‌ چين‌ چين,17,240264,4711577040,20010,19610,19610,-400,-2,19970,-40,-0.2,19610,19610,1400-1-21,2021-04-10
400,رتاپ,تجارت الكترونيك  پارسيان,17,209087,1515880750,7390,7250,7250,-140,-1.89,7390,0,0,7250,7250,1400-1-21,2021-04-10
401,بمپنا,توليد برق عسلويه  مپنا,17,9778,685105348,71495,70066,70066,-1429,-2,71475,-20,-0.03,70066,70066,1400-1-21,2021-04-10
402,ولتجار,واسپاري تجارت وسرمايه ايرانيان,17,118055,966634340,8355,8188,8188,-167,-2,8347,-8,-0.1,8188,8188,1400-1-21,2021-04-10
403,دتوليد,داروسازي توليد دارو,17,17713,465798761,26833,26297,26297,-536,-2,26828,-5,-0.02,26297,26297,1400-1-21,2021-04-10
404,اميد,تامين سرمايه اميد,17,453427,3468716550,7800,7650,7650,-150,-1.92,7790,-10,-0.13,7650,7650,1400-1-21,2021-04-10
405,شنفت,نفت‌ پارس‌,17,15344,757226400,50350,49350,49350,-1000,-1.99,50330,-20,-0.04,49350,49350,1400-1-21,2021-04-10
406,لابسا,آبسال‌,17,16210,853618600,53730,52660,52660,-1070,-1.99,53710,-20,-0.04,52660,52660,1400-1-21,2021-04-10
407,اخزا814,اسنادخزانه-م14بودجه98-010318,17,113697,91715567078,806209,806700,805100,-1109,-0.14,806667,458,0.06,803001,806700,1400-1-21,2021-04-10
408,شزنگ,تجهيزنيروي‌زنگان‌,16,4807,1085564810,235239,225830,225830,-9409,-4,234707,-532,-0.23,225830,225830,1400-1-21,2021-04-10
409,بكاب,صنايع‌جوشكاب‌يزد,16,1120,387710400,360590,346170,346170,-14420,-4,360470,-120,-0.03,346170,346170,1400-1-21,2021-04-10
410,داريك,صندوق س.اعتماد داريك-د,16,45731,480935120,10516,10517,10518,2,0.02,10517,1,0.01,10515,10520,1400-1-21,2021-04-10
411,پرديس,سرمايه گذاري پرديس,16,54258,289737720,5440,5340,5340,-100,-1.84,5440,0,0,5340,5340,1400-1-21,2021-04-10
412,خمحور,توليدمحورخودرو,16,251151,16284630840,66160,64840,64840,-1320,-2,65720,-440,-0.67,64840,64840,1400-1-21,2021-04-10
413,شاروم,پتروشيمي اروميه,16,121191,2350378254,19789,19394,19394,-395,-2,19770,-19,-0.1,19394,19394,1400-1-21,2021-04-10
414,دلر,داروسازي‌ اكسير,16,73939,2632228400,36320,35600,35600,-720,-1.98,36280,-40,-0.11,35600,35600,1400-1-21,2021-04-10
415,لپارس,پارس‌ الكتريك‌,16,44322,4094466360,94260,92380,92380,-1880,-1.99,94100,-160,-0.17,92380,92380,1400-1-21,2021-04-10
416,سپاها,سيمان‌سپاهان‌,16,66308,578205760,8890,8720,8720,-170,-1.91,8890,0,0,8720,8720,1400-1-21,2021-04-10
417,ودي,بيمه  دي,16,15026,318085394,21601,21169,21169,-432,-2,21598,-3,-0.01,21169,21169,1400-1-21,2021-04-10
418,اخزا816,اسنادخزانه-م16بودجه98-010503,16,9189,7220434445,780872,784988,786001,5129,0.66,785769,4897,0.63,777636,788000,1400-1-21,2021-04-10
419,زكوثر,سرمايه گذاري كشاورزي كوثر,16,25173,534926250,21680,21250,21250,-430,-1.98,21680,0,0,21250,21250,1400-1-21,2021-04-10
420,سمگا,گروه سرمايه گذاري ميراث فرهنگي,15,15389,465855808,30889,30272,30272,-617,-2,30884,-5,-0.02,30272,30272,1400-1-21,2021-04-10
421,سشرق,سيمان‌ شرق‌,15,22031,154657620,7160,7020,7020,-140,-1.96,7160,0,0,7020,7020,1400-1-21,2021-04-10
422,سخاش,سيمان‌خاش‌,15,2036,311446920,156090,152970,152970,-3120,-2,156070,-20,-0.01,152970,152970,1400-1-21,2021-04-10
423,شپاكسا,پاكسان‌,15,36399,1006068360,28200,27640,27640,-560,-1.99,28190,-10,-0.04,27640,27640,1400-1-21,2021-04-10
424,برن0003پ01,برنج طارم0003تجارت مازندران(پ),15,2129,578484300,271296,271500,273000,1704,0.63,271716,420,0.15,270500,274990,1400-1-21,2021-04-10
425,كهمدا,شيشه‌ همدان‌,15,22593,226607790,10230,10030,10030,-200,-1.96,10230,0,0,10030,10030,1400-1-21,2021-04-10
426,ثروتم,صندوق س. ثروت آفرين پارسيان-س,14,4180,308752950,75595,74143,73458,-2137,-2.83,73864,-1731,-2.29,73458,74143,1400-1-21,2021-04-10
427,ضملت3002,اختيارخ وبملت-4000-1400/03/19,14,1055,345457000,434,380,290,-144,-33.18,327,-107,-24.65,282,380,1400-1-21,2021-04-10
428,تكنار,مجتمع معادن مس تكنار,14,3069,372923397,126576,121513,121513,-5063,-4,126478,-98,-0.08,121513,121513,1400-1-21,2021-04-10
429,شفارا,پتروشيمي فارابي,14,48780,189607860,3966,3887,3887,-79,-1.99,3965,-1,-0.03,3887,3887,1400-1-21,2021-04-10
430,زعف0008پ16,زعفران0008نگين بيرجند(پ),14,11000,1334840000,120590,120200,122300,1710,1.42,121349,759,0.63,120200,122300,1400-1-21,2021-04-10
431,وپست,پست بانك ايران,14,28054,641875520,23340,22880,22880,-460,-1.97,23330,-10,-0.04,22880,22880,1400-1-21,2021-04-10
432,غدشت,دشت‌ مرغاب‌,14,2323,657664530,288880,283110,283110,-5770,-2,288800,-80,-0.03,283110,283110,1400-1-21,2021-04-10
433,كحافظ,كاشي‌ وسراميك‌ حافظ‌,14,19112,225330480,12030,11790,11790,-240,-2,12030,0,0,11790,11790,1400-1-21,2021-04-10
434,ساوه,سيمان ساوه,14,1909,110525373,59078,57897,57897,-1181,-2,59075,-3,-0.01,57897,57897,1400-1-21,2021-04-10
435,تكمبا,كمباين‌ سازي‌ ايران‌,14,211392,1667882880,8050,7890,7890,-160,-1.99,8040,-10,-0.12,7890,7890,1400-1-21,2021-04-10
436,شگل,گلتاش‌,14,78470,794116400,10320,10120,10120,-200,-1.94,10320,0,0,10120,10120,1400-1-21,2021-04-10
437,وصندوق,سرمايه‌گذاري‌صندوق‌بازنشستگي‌,14,105437,1536217090,14860,14570,14570,-290,-1.95,14860,0,0,14570,14570,1400-1-21,2021-04-10
438,غويتا,ويتانا,13,15066,268671978,18196,17833,17833,-363,-1.99,18194,-2,-0.01,17833,17833,1400-1-21,2021-04-10
439,فزرين,زرين معدن آسيا,13,67720,1808394880,27248,26704,26704,-544,-2,27228,-20,-0.07,26704,26704,1400-1-21,2021-04-10
440,خرينگ,رينگ‌سازي‌مشهد,13,9426,488172540,52840,51790,51790,-1050,-1.99,52830,-10,-0.02,51790,51790,1400-1-21,2021-04-10
441,ضمخا7070,اختيارخ اخابر-19700-1400/07/28,13,72,64952000,900,601,880,-20,-2.22,902,2,0.22,550,999,1400-1-21,2021-04-10
442,ثنوسا,نوسازي‌وساختمان‌تهران‌,13,12229,152984790,13030,12510,12510,-520,-3.99,13030,0,0,12510,12510,1400-1-21,2021-04-10
443,رنيك,جنرال مكانيك,13,14956,330722028,22564,22113,22113,-451,-2,22561,-3,-0.01,22113,22113,1400-1-21,2021-04-10
444,دسبحان,سبحان دارو,13,34653,755088870,22230,21790,21790,-440,-1.98,22220,-10,-0.04,21790,21790,1400-1-21,2021-04-10
445,هجرت,پخش هجرت,13,42078,1178604780,28581,28010,28010,-571,-2,28567,-14,-0.05,28010,28010,1400-1-21,2021-04-10
446,ورنا,سرمايه‌گذاري‌ رنا(هلدينگ‌,13,30340,167476800,5630,5520,5520,-110,-1.95,5630,0,0,5520,5520,1400-1-21,2021-04-10
447,زعف0008پ09,زعفران0008نگين نوين(پ),13,3243,396135612,121050,125344,123000,1950,1.61,122151,1101,0.91,121000,125344,1400-1-21,2021-04-10
448,اخزا809,اسنادخزانه-م9بودجه98-000923,13,70954,62307919969,877007,878000,880201,3194,0.36,878145,1138,0.13,878000,882000,1400-1-21,2021-04-10
449,آگاس2,صندوق س.هستي بخش آگاه-س,13,3900000,3900000,66538,1,1,-66537,-100,1,-66537,-100,1,1,1400-1-21,2021-04-10
450,فاسمين,كالسيمين‌,13,16696,287505120,17570,17220,17220,-350,-1.99,17570,0,0,17220,17220,1400-1-21,2021-04-10
451,اخزا813,اسنادخزانه-م13بودجه98-010219,13,3994,3256485089,814625,815000,815201,576,0.07,815344,719,0.09,815000,816000,1400-1-21,2021-04-10
452,دالبر,البرزدارو,13,37676,560995640,15190,14890,14890,-300,-1.97,15190,0,0,14890,14890,1400-1-21,2021-04-10
453,قنيشا,قند  نيشابور,13,51995,3424390700,67200,65860,65860,-1340,-1.99,67110,-90,-0.13,65860,65860,1400-1-21,2021-04-10
454,ضجار2003,اختيارخ وتجارت-3000-1400/02/22,13,422,25763000,84,77,62,-22,-26.19,61,-23,-27.38,50,77,1400-1-21,2021-04-10
455,غبهار,كشت وصنعت بهاران گلبهار خراسان,12,12986,426668016,34224,32856,32856,-1368,-4,34194,-30,-0.09,32856,32856,1400-1-21,2021-04-10
456,كمند2,صندوق س. با درآمد ثابت كمند,12,170000000,170000000,10024,1,1,-10023,-99.99,1,-10023,-99.99,1,1,1400-1-21,2021-04-10
457,شجم,صنايع پتروشيمي تخت جمشيد,12,325307,3368553985,10566,10355,10355,-211,-2,10540,-26,-0.25,10355,10355,1400-1-21,2021-04-10
458,سغرب,سيمان‌غرب‌,12,104972,3927002520,38170,37410,37410,-760,-1.99,38110,-60,-0.16,37410,37410,1400-1-21,2021-04-10
459,زبينا,كشاورزي و دامپروري بينالود,12,81504,312649344,3914,3836,3836,-78,-1.99,3914,0,0,3836,3836,1400-1-21,2021-04-10
460,واحصا,احياء صنايع خراسان,12,8104,566939632,72872,69958,69958,-2914,-4,72786,-86,-0.12,69958,69958,1400-1-21,2021-04-10
461,كفپارس,فرآورده‌هاي‌ نسوز پارس‌,12,191610,869909400,4630,4540,4540,-90,-1.94,4630,0,0,4540,4540,1400-1-21,2021-04-10
462,اخزا821,اسنادخزانه-م21بودجه98-020906,12,7378,4479153977,605679,604500,605010,-669,-0.11,607096,1417,0.23,604500,609989,1400-1-21,2021-04-10
463,فسا,پتروشيمي فسا,12,65951,112182651,1771,1701,1701,-70,-3.95,1771,0,0,1701,1701,1400-1-21,2021-04-10
464,زشريف,كشت وصنعت شريف آباد,12,39587,211948798,5463,5354,5354,-109,-2,5463,0,0,5354,5354,1400-1-21,2021-04-10
465,زدشت,كشت و صنعت دشت خرم دره,11,7217,208773376,29518,28928,28928,-590,-2,29515,-3,-0.01,28928,28928,1400-1-21,2021-04-10
466,اراد61,مرابحه عام دولت61-ش.خ0309,11,132700,132700000000,1000000,1000000,1000000,0,0,1000000,0,0,1000000,1000000,1400-1-21,2021-04-10
467,كبافق,معادن‌ بافق‌,11,4940,243097400,50210,49210,49210,-1000,-1.99,50210,0,0,49210,49210,1400-1-21,2021-04-10
468,زفكا,كشت و دامداري فكا,11,225657,2925191691,13227,12963,12963,-264,-2,13211,-16,-0.12,12963,12963,1400-1-21,2021-04-10
469,گدنا,تهيه توزيع غذاي دنا آفرين فدك,11,3685,122688390,33973,33294,33294,-679,-2,33971,-2,-0.01,33294,33294,1400-1-21,2021-04-10
470,ثرود,سرمايه‌گذاري مسكن زاينده رود,11,7558,158188940,21357,20930,20930,-427,-2,21356,-1,0,20930,20930,1400-1-21,2021-04-10
471,شاملا,معدني‌ املاح‌  ايران‌,11,28189,1407476770,50940,49930,49930,-1010,-1.98,50910,-30,-0.06,49930,49930,1400-1-21,2021-04-10
472,اخزا906,اسنادخزانه-م6بودجه99-020321,11,3710,2707550718,723528,716293,730000,6472,0.89,729798,6270,0.87,706121,730763,1400-1-21,2021-04-10
473,زعف0008پ12,زعفران0008پوشالمعمول سحرخيز(پ),11,1420,129545460,88321,92000,90000,1679,1.9,91229,2908,3.29,87000,92738,1400-1-21,2021-04-10
474,گنجين,صندوق س. گنجينه يكم آويد-د,11,105500,1329551326,12581,12590,12603,22,0.17,12602,21,0.17,12590,12603,1400-1-21,2021-04-10
475,كيان2,صندوق س. با درآمد ثابت كيان,11,1100000,1100000,27860,1,1,-27859,-100,1,-27859,-100,1,1,1400-1-21,2021-04-10
476,ضشنا2004,اختيارخ شپنا-16000-1400/02/27,11,401,45779000,234,300,111,-123,-52.56,114,-120,-51.28,111,300,1400-1-21,2021-04-10
477,غنوش,نوش‌ مازندران‌,11,4721,264848100,57240,56100,56100,-1140,-1.99,57230,-10,-0.02,56100,56100,1400-1-21,2021-04-10
478,وكار,بانك‌ كارآفرين‌,11,89199,224781480,2570,2520,2520,-50,-1.95,2570,0,0,2520,2520,1400-1-21,2021-04-10
479,تملي701,تسهيلات مسكن ب. ملي-فروردين97,11,251,123166760,502390,477271,500000,-2390,-0.48,490704,-11686,-2.33,477271,527509,1400-1-21,2021-04-10
480,كي بي سي,شركت كي بي سي,11,52272,1425980160,27836,27280,27280,-556,-2,27820,-16,-0.06,27280,27280,1400-1-21,2021-04-10
481,ساينا,صنايع بهداشتي ساينا,11,1667,256357928,156922,153784,153784,-3138,-2,156906,-16,-0.01,153784,153784,1400-1-21,2021-04-10
482,دپارس,پارس‌ دارو,10,14431,1215811750,85960,84250,84250,-1710,-1.99,85920,-40,-0.05,84250,84250,1400-1-21,2021-04-10
483,دتوزيع,توزيع دارو پخش,10,141309,7295218434,52679,51626,51626,-1053,-2,52522,-157,-0.3,51626,51626,1400-1-21,2021-04-10
484,بهپاك,صنعتي بهپاك,10,20301,884900289,44478,43589,43589,-889,-2,44462,-16,-0.04,43589,43589,1400-1-21,2021-04-10
485,كپارس,كاشي‌ پارس‌,10,1249,190110290,155310,152210,152210,-3100,-2,155300,-10,-0.01,152210,152210,1400-1-21,2021-04-10
486,حريل,ريل پردازسير,10,21387,120708228,5759,5644,5644,-115,-2,5759,0,0,5644,5644,1400-1-21,2021-04-10
487,تكنو,تكنوتار,10,50750,1103812500,22190,21750,21750,-440,-1.98,22180,-10,-0.05,21750,21750,1400-1-21,2021-04-10
488,ضخود2011,اختيارخ خودرو-5000-1400/02/08,10,1000,2300000,4,3,2,-2,-50,2,-2,-50,2,3,1400-1-21,2021-04-10
489,عيار2,صندوق سكه طلاي مفيد,10,100000,100000,27056,1,1,-27055,-100,1,-27055,-100,1,1,1400-1-21,2021-04-10
490,ضمخا7071,اختيارخ اخابر-23700-1400/07/28,10,469,87443000,196,186,183,-13,-6.63,186,-10,-5.1,183,190,1400-1-21,2021-04-10
491,كيميا,معدني كيمياي زنجان گستران,10,53950,940726150,17792,17437,17437,-355,-2,17785,-7,-0.04,17437,17437,1400-1-21,2021-04-10
492,حخزر,كشتيراني درياي خزر,10,5800,163507800,28766,28191,28191,-575,-2,28764,-2,-0.01,28191,28191,1400-1-21,2021-04-10
493,الماس,صندوق س.امين تدبيرگران فردا-س,10,916,100613089,113013,110003,110001,-3012,-2.67,109840,-3173,-2.81,109001,112800,1400-1-21,2021-04-10
494,شراز,پالايش نفت شيراز,10,6733,749919765,113649,111380,111377,-2272,-2,113614,-35,-0.03,111377,111390,1400-1-21,2021-04-10
495,بزاگرس,نيروگاه زاگرس كوثر,10,173278,1218490896,7175,7032,7032,-143,-1.99,7171,-4,-0.06,7032,7032,1400-1-21,2021-04-10
496,گكيشح,ح.توريستي ورفاهي آبادگران كيش,9,9586,327390658,34849,34153,34153,-696,-2,34153,-696,-2,34153,34153,1400-1-21,2021-04-10
497,سپرمي,پرميت‌,9,11564,104168512,8919,9008,9008,89,1,8921,2,0.02,9008,9008,1400-1-21,2021-04-10
498,شكربن,كربن‌ ايران‌,9,1474,133455960,92380,90540,90540,-1840,-1.99,92370,-10,-0.01,90540,90540,1400-1-21,2021-04-10
499,بساما,بيمه سامان,9,8414,194842998,23629,23157,23157,-472,-2,23627,-2,-0.01,23157,23157,1400-1-21,2021-04-10
500,فولاژ,فولاد آلياژي ايران,9,6422,127027160,20180,19780,19780,-400,-1.98,20180,0,0,19780,19780,1400-1-21,2021-04-10
501,قشكر,شكرشاهرود,9,234029,882289330,3840,3770,3770,-70,-1.82,3840,0,0,3770,3770,1400-1-21,2021-04-10
502,اعتلا,شركت سرمايه گذاري اعتلاء البرز,9,29260,244203960,8516,8346,8346,-170,-2,8515,-1,-0.01,8346,8346,1400-1-21,2021-04-10
503,توريل,توكاريل,9,11327,279640976,25191,24688,24688,-503,-2,25188,-3,-0.01,24688,24688,1400-1-21,2021-04-10
504,ضسپا3000,اختيارخ خساپا-1400-1400/03/26,9,38,32670000,955,850,870,-85,-8.9,860,-95,-9.95,850,880,1400-1-21,2021-04-10
505,اخزا722,اسنادخزانه-م22بودجه97-000428,9,125791,119380577528,947276,950000,948007,731,0.08,949039,1763,0.19,948000,950000,1400-1-21,2021-04-10
506,اخزا905,اسنادخزانه-م5بودجه99-020218,9,21384,14364341900,669211,665005,671000,1789,0.27,671733,2522,0.38,665005,673000,1400-1-21,2021-04-10
507,ضجار2002,اختيارخ وتجارت-2500-1400/02/22,9,139,30592000,301,220,220,-81,-26.91,220,-81,-26.91,220,222,1400-1-21,2021-04-10
508,ضشنا2006,اختيارخ شپنا-20000-1400/02/27,9,47,18008000,551,1010,265,-286,-51.91,383,-168,-30.49,70,1010,1400-1-21,2021-04-10
509,اخزا810,اسنادخزانه-م10بودجه98-001006,9,9640,8392149236,871541,864001,872601,1060,0.12,870555,-986,-0.11,864001,874000,1400-1-21,2021-04-10
510,دكپسول,توليد ژلاتين كپسول ايران,9,10777,356061303,33713,33039,33039,-674,-2,33708,-5,-0.01,33039,33039,1400-1-21,2021-04-10
511,ضشنا2003,اختيارخ شپنا-14000-1400/02/27,9,415,335550000,992,900,700,-292,-29.44,809,-183,-18.45,700,900,1400-1-21,2021-04-10
512,غمارگ,مارگارين‌,9,35592,1100504640,31550,30920,30920,-630,-2,31540,-10,-0.03,30920,30920,1400-1-21,2021-04-10
513,سخواف,سيمان مجد خواف,9,8116,132785876,17042,16361,16361,-681,-4,17037,-5,-0.03,16361,16361,1400-1-21,2021-04-10
514,خموتور,موتورسازان‌تراكتورسازي‌ايران‌,8,55345,813571500,15000,14700,14700,-300,-2,15000,0,0,14700,14700,1400-1-21,2021-04-10
515,پست0008پ09,پسته بادامي30-28مه ولات0008(پ),8,151,263390002,1749999,1740000,1670002,-79997,-4.57,1744305,-5694,-0.33,1670002,1790000,1400-1-21,2021-04-10
516,بتك,كارخانجات كابل سازي‌ تك‌,8,79963,2815897045,33861,35215,35215,1354,4,34228,367,1.08,35215,35215,1400-1-21,2021-04-10
517,كمنگنز,معادن‌منگنزايران‌,8,1351,118158460,89240,87460,87460,-1780,-1.99,89240,0,0,87460,87460,1400-1-21,2021-04-10
518,خكاوه,سايپا ديزل,8,35892,128062656,3640,3568,3568,-72,-1.98,3640,0,0,3568,3568,1400-1-21,2021-04-10
519,شكلر,نيروكلر,8,5012,237268080,48300,47340,47340,-960,-1.99,48300,0,0,47340,47340,1400-1-21,2021-04-10
520,دبالك,مواد اوليه دارويي البرز بالك,8,15260,311807580,20849,20433,20433,-416,-2,20846,-3,-0.01,20433,20433,1400-1-21,2021-04-10
521,ختراك,ريخته‌گري‌ تراكتورسازي‌ ايران‌,8,37820,579024200,15620,15310,15310,-310,-1.98,15620,0,0,15310,15310,1400-1-21,2021-04-10
522,كپرور,فرآوري زغال سنگ پروده طبس,8,2172,79058628,37141,36399,36399,-742,-2,37140,-1,0,36399,36399,1400-1-21,2021-04-10
523,قنقش,قند نقش جهان,8,1172,85334492,74296,72811,72811,-1485,-2,74283,-13,-0.02,72811,72811,1400-1-21,2021-04-10
524,لپيام,گسترش صنايع پيام,8,8000,431960000,55096,53995,53995,-1101,-2,55072,-24,-0.04,53995,53995,1400-1-21,2021-04-10
525,شفا,سرمايه گذاري شفادارو,8,17198,786292560,46650,45720,45720,-930,-1.99,46640,-10,-0.02,45720,45720,1400-1-21,2021-04-10
526,اخزا720,اسنادخزانه-م20بودجه97-000324,8,1113,1074618944,963843,963501,966002,2159,0.22,965516,1673,0.17,963501,970990,1400-1-21,2021-04-10
527,اخزا804,اسنادخزانه-م4بودجه98-000421,8,48321,46038003700,952204,949820,952000,-204,-0.02,952754,550,0.06,949820,952800,1400-1-21,2021-04-10
528,مرقام,ايران‌ارقام‌,8,15470,297024000,19590,19200,19200,-390,-1.99,19590,0,0,19200,19200,1400-1-21,2021-04-10
529,زعف0008پ18,زعفران0008نگين بهرامن(پ),7,2192,272100280,121271,124490,124340,3069,2.53,124133,2862,2.36,123000,124490,1400-1-21,2021-04-10
530,زعف0008پ19,زعفران0008نگين تروند قاينات(پ),7,3943,480962100,120909,121000,122779,1870,1.55,121979,1070,0.88,121000,122779,1400-1-21,2021-04-10
531,دتماد,توليدمواداوليه‌داروپخش‌,7,172778,7916687960,46750,45820,45820,-930,-1.99,46600,-150,-0.32,45820,45820,1400-1-21,2021-04-10
532,سبهان,سيمان‌ بهبهان‌,7,3967,553158480,142280,139440,139440,-2840,-2,142250,-30,-0.02,139440,139440,1400-1-21,2021-04-10
533,آساس2,صندوق س.آسمان آرماني سهام-س,7,700000,700000,162466,1,1,-162465,-100,1,-162465,-100,1,1,1400-1-21,2021-04-10
534,وسكرد,شركت س استان كردستان,7,164000,118080000,730,720,720,-10,-1.37,730,0,0,720,720,1400-1-21,2021-04-10
535,اخزا805,اسنادخزانه-م5بودجه98-000422,7,95876,91436404400,953100,953700,951016,-2084,-0.22,953694,594,0.06,951016,953700,1400-1-21,2021-04-10
536,غدام,خوراك‌  دام‌ پارس‌,7,633,245034300,395000,387100,387100,-7900,-2,394960,-40,-0.01,387100,387100,1400-1-21,2021-04-10
537,كلر,كلر پارس,7,389,51994907,136390,133663,133663,-2727,-2,136387,-3,0,133663,133663,1400-1-21,2021-04-10
538,غمينو,شركت صنايع غذايي مينو شرق,7,20929,234614090,11438,11210,11210,-228,-1.99,11437,-1,-0.01,11210,11210,1400-1-21,2021-04-10
539,كسرا,سراميك‌هاي‌صنعتي‌اردكان‌,7,7443,152507070,20900,20490,20490,-410,-1.96,20900,0,0,20490,20490,1400-1-21,2021-04-10
540,ولملت,واسپاري ملت,7,12700,101854000,8180,8020,8020,-160,-1.96,8180,0,0,8020,8020,1400-1-21,2021-04-10
541,كوثر,بيمه كوثر,7,19034,274356076,14708,14414,14414,-294,-2,14706,-2,-0.01,14414,14414,1400-1-21,2021-04-10
542,كروي,توسعه‌ معادن‌ روي‌ ايران‌,7,1856,53842560,29600,29010,29010,-590,-1.99,29600,0,0,29010,29010,1400-1-21,2021-04-10
543,بنيرو,نيروترانس‌,7,3553,52548870,15090,14790,14790,-300,-1.99,15090,0,0,14790,14790,1400-1-21,2021-04-10
544,ملت,بيمه ملت,7,33690,529943700,16050,15730,15730,-320,-1.99,16050,0,0,15730,15730,1400-1-21,2021-04-10
545,دكپسولح,ح .توليد ژلاتين كپسول ايران,7,16858,399332304,24171,23688,23688,-483,-2,23688,-483,-2,23688,23688,1400-1-21,2021-04-10
546,ولصنم,ليزينگ‌صنعت‌ومعدن‌,7,13678,145807480,11100,10660,10660,-440,-3.96,11100,0,0,10660,10660,1400-1-21,2021-04-10
547,فپنتا,سپنتا,7,303,121606020,409530,401340,401340,-8190,-2,409510,-20,0,401340,401340,1400-1-21,2021-04-10
548,مداران,داده‌پردازي‌ايران‌,7,4017,98938710,25130,24630,24630,-500,-1.99,25130,0,0,24630,24630,1400-1-21,2021-04-10
549,ضمخا7066,اختيارخ اخابر-11700-1400/07/28,7,39,61404000,1400,2480,1280,-120,-8.57,1574,174,12.43,1212,2480,1400-1-21,2021-04-10
550,لخزر,پارس‌ خزر,7,1475,269689000,186570,182840,182840,-3730,-2,186550,-20,-0.01,182840,182840,1400-1-21,2021-04-10
551,تبرك,گروه كارخانجات صنعتي تبرك,7,2650,51818100,19953,19554,19554,-399,-2,19953,0,0,19554,19554,1400-1-21,2021-04-10
552,لازما,كارخانه هاي صنعتي آزمايش,7,24495,809510760,34425,33048,33048,-1377,-4,34367,-58,-0.17,33048,33048,1400-1-21,2021-04-10
553,ضخود2012,اختيارخ خودرو-6000-1400/02/08,7,700,1400000,3,3,2,-1,-33.33,2,-1,-33.33,2,2,1400-1-21,2021-04-10
554,وتوكا,سرمايه‌گذاري‌توكافولاد(هلدينگ,7,5484,64437000,11980,11750,11750,-230,-1.92,11980,0,0,11750,11750,1400-1-21,2021-04-10
555,ضملي3004,اختيارخ فملي-14000-1400/03/02,7,65,21780000,414,399,345,-69,-16.67,335,-79,-19.08,330,399,1400-1-21,2021-04-10
556,لسرما,سرما آفرين‌,7,35376,850439040,24530,24040,24040,-490,-2,24520,-10,-0.04,24040,24040,1400-1-21,2021-04-10
557,خفناور,مهندسي صنعتي روان فن آور,7,58236,2806800492,50205,48197,48197,-2008,-4,49911,-294,-0.59,48197,48197,1400-1-21,2021-04-10
558,آپ,آسان پرداخت پرشين,6,5297,90684640,17460,17120,17120,-340,-1.95,17460,0,0,17120,17120,1400-1-21,2021-04-10
559,كاذر,فرآورده‌هاي‌نسوزآذر,6,996,31981560,32760,32110,32110,-650,-1.98,32760,0,0,32110,32110,1400-1-21,2021-04-10
560,غگلستا,شير پاستوريزه پگاه گلستان,6,205200,5752987200,28608,28036,28036,-572,-2,28541,-67,-0.23,28036,28036,1400-1-21,2021-04-10
561,ضترا3003,اختيارخ شتران-9000-1400/03/09,6,95,133022000,1402,1402,1400,-2,-0.14,1400,-2,-0.14,1400,1402,1400-1-21,2021-04-10
562,بالبر,كابل‌ البرز,6,1900,110523000,59350,58170,58170,-1180,-1.99,59350,0,0,58170,58170,1400-1-21,2021-04-10
563,فنرژي,گسترش صنايع انرژي آذرآب,6,4847,90682523,19090,18709,18709,-381,-2,19086,-4,-0.02,18709,18709,1400-1-21,2021-04-10
564,تملي707,تسهيلات مسكن ب. ملي-مهر97,6,48,35768487,745123,709173,758900,13777,1.85,745177,54,0.01,707867,777000,1400-1-21,2021-04-10
565,ديران,ايران‌دارو,6,1393,36858780,27000,26460,26460,-540,-2,27000,0,0,26460,26460,1400-1-21,2021-04-10
566,اطلس2,صندوق س.توسعه اندوخته آينده-س,6,60000,60000,208693,1,1,-208692,-100,1,-208692,-100,1,1,1400-1-21,2021-04-10
567,اخزا718,اسنادخزانه-م18بودجه97-000525,6,77921,72856134000,934982,934900,935000,18,0,935000,18,0,934900,935000,1400-1-21,2021-04-10
568,غشهد,شهد ايران ‌,6,39823,283937990,7270,7130,7130,-140,-1.93,7270,0,0,7130,7130,1400-1-21,2021-04-10
569,اخزا716,اسنادخزانه-م16بودجه97-000407,6,610,586575519,960974,962490,962199,1225,0.13,961599,625,0.07,960000,962490,1400-1-21,2021-04-10
570,حتوكا,حمل‌ونقل‌توكا,6,3550,106784000,30690,30080,30080,-610,-1.99,30690,0,0,30080,30080,1400-1-21,2021-04-10
571,وگردش,بانك گردشگري,6,2535,43335825,17443,17095,17095,-348,-2,17443,0,0,17095,17095,1400-1-21,2021-04-10
572,قيستو,شركت قند بيستون,6,42460,701736420,16203,16527,16527,324,2,16225,22,0.14,16527,16527,1400-1-21,2021-04-10
573,غديس,پاكديس,6,4483,59139736,13461,13192,13192,-269,-2,13461,0,0,13192,13192,1400-1-21,2021-04-10
574,وسرمد,بيمه  سرمد,6,9872,60495616,6253,6128,6128,-125,-2,6253,0,0,6128,6128,1400-1-21,2021-04-10
575,ضشنا2000,اختيارخ شپنا-9000-1400/02/27,6,13,40635000,3234,3300,3100,-134,-4.14,3126,-108,-3.34,3000,3300,1400-1-21,2021-04-10
576,ضشنا2001,اختيارخ شپنا-10000-1400/02/27,6,22,45370000,2841,2300,2200,-641,-22.56,2062,-779,-27.42,2000,2340,1400-1-21,2021-04-10
577,فاما,صنعتي‌ آما,5,2776,51966720,19100,18720,18720,-380,-1.99,19100,0,0,18720,18720,1400-1-21,2021-04-10
578,وتعاون,بيمه  تعاون,5,14246,88467660,6336,6210,6210,-126,-1.99,6335,-1,-0.02,6210,6210,1400-1-21,2021-04-10
579,وسبحان,سرمايه گذاري سبحان,5,20439,63013437,3145,3083,3083,-62,-1.97,3145,0,0,3083,3083,1400-1-21,2021-04-10
580,اخزا721,اسنادخزانه-م21بودجه97-000728,5,69919,63148772570,902628,903170,903333,705,0.08,903170,542,0.06,903170,903333,1400-1-21,2021-04-10
581,سرو2,صندوق س سروسودمند مدبران-سهام,5,700000,700000,67090,1,1,-67089,-100,1,-67089,-100,1,1,1400-1-21,2021-04-10
582,پست0008پ08,پسته فندقي32-30مه ولات0008(پ),5,44,69391000,1526842,1570500,1579000,52158,3.42,1577068,50226,3.29,1570500,1579000,1400-1-21,2021-04-10
583,اخزا812,اسنادخزانه-م12بودجه98-001111,5,35099,30185488000,859451,860000,860000,549,0.06,860010,559,0.07,860000,861000,1400-1-21,2021-04-10
584,زمگسا,كشاورزي‌ ودامپروي‌ مگسال‌,5,1958,62381880,32510,31860,31860,-650,-2,32510,0,0,31860,31860,1400-1-21,2021-04-10
585,زماهان,مجتمع توليد گوشت مرغ ماهان,5,16400,331230800,20609,20197,20197,-412,-2,20606,-3,-0.01,20197,20197,1400-1-21,2021-04-10
586,ريشمك,توليد و صادرات ريشمك,5,1486,83214514,57141,55999,55999,-1142,-2,57139,-2,0,55999,55999,1400-1-21,2021-04-10
587,وبيمه,سرمايه‌ گذاري‌ صنعت‌ بيمه‌,5,25849,71084750,2800,2750,2750,-50,-1.79,2800,0,0,2750,2750,1400-1-21,2021-04-10
588,فالوم,آلومتك‌,5,1222,43756154,36537,35807,35807,-730,-2,36535,-2,-0.01,35807,35807,1400-1-21,2021-04-10
589,ضسپا3002,اختيارخ خساپا-1800-1400/03/26,5,52,25799000,550,500,500,-50,-9.09,496,-54,-9.82,480,500,1400-1-21,2021-04-10
590,غبهنوش,بهنوش‌ ايران‌,5,3825,268591500,71650,70220,70220,-1430,-2,71640,-10,-0.01,70220,70220,1400-1-21,2021-04-10
591,خشرق,الكتريك‌ خودرو شرق‌,5,5038,73907460,14960,14670,14670,-290,-1.94,14960,0,0,14670,14670,1400-1-21,2021-04-10
592,افران2,صندوق س افرا نماد پايدار-ثابت,5,14240000,14240000,13042,1,1,-13041,-99.99,1,-13041,-99.99,1,1,1400-1-21,2021-04-10
593,فروس,فروسيليس‌ ايران‌,5,10730,55688700,5290,5190,5190,-100,-1.89,5290,0,0,5190,5190,1400-1-21,2021-04-10
594,ثپرديس,سرمايه گذاري مسكن پرديس,5,5371,53479047,10160,9957,9957,-203,-2,10160,0,0,9957,9957,1400-1-21,2021-04-10
595,اخزا713,اسنادخزانه-م13بودجه97-000518,5,34234,32180300290,937608,940010,940000,2392,0.26,940010,2402,0.26,940000,941000,1400-1-21,2021-04-10
596,وجامي,سرمايه گذاري جامي,5,3535,52325070,15104,14802,14802,-302,-2,15103,-1,-0.01,14802,14802,1400-1-21,2021-04-10
597,وسگيلا,شركت س استان گيلان,4,33189,25223640,770,760,760,-10,-1.3,770,0,0,760,760,1400-1-21,2021-04-10
598,وكادو,تكادو,4,1239,21455763,17670,17317,17317,-353,-2,17670,0,0,17317,17317,1400-1-21,2021-04-10
599,كيسون,شركت كيسون,4,7620,87607140,11731,11497,11497,-234,-1.99,11730,-1,-0.01,11497,11497,1400-1-21,2021-04-10
600,تاپكيش,تجارت الكترونيك پارسيان كيش,4,2059,37331729,18501,18131,18131,-370,-2,18501,0,0,18131,18131,1400-1-21,2021-04-10
601,اراد834,مرابحه عام دولت83-ش.خ041220,4,27620000,26425296900000,1000000,1000000,913490,-86510,-8.65,956745,-43255,-4.33,913490,1000000,1400-1-21,2021-04-10
602,سقاين,سيمان‌ قائن‌,4,905,64146400,72320,70880,70880,-1440,-1.99,72320,0,0,70880,70880,1400-1-21,2021-04-10
603,كگاز,شيشه‌ و گاز,4,6056,112883840,19020,18640,18640,-380,-2,19020,0,0,18640,18640,1400-1-21,2021-04-10
604,قشير,قند شيروان قوچان و بجنورد,4,1379,34730115,25698,25185,25185,-513,-2,25698,0,0,25185,25185,1400-1-21,2021-04-10
605,پارتا,مجتمع‌صنعتي‌آرتاويل‌تاير,4,83845,4461811675,54301,53215,53215,-1086,-2,54112,-189,-0.35,53215,53215,1400-1-21,2021-04-10
606,شبصير,توليدات پتروشيمي قائد بصير,4,2257,159411910,72071,70630,70630,-1441,-2,72066,-5,-0.01,70630,70630,1400-1-21,2021-04-10
607,وسيستا,شركت س استان سيستان وبلوچستان,4,46709,35031750,760,750,750,-10,-1.32,760,0,0,750,750,1400-1-21,2021-04-10
608,قهكمت,قندهكمتان‌,4,16611,751149420,46140,45220,45220,-920,-1.99,46130,-10,-0.02,45220,45220,1400-1-21,2021-04-10
609,ضصاد3000,اختيارخ وبصادر-1800-1400/03/12,4,25,16000000,800,640,640,-160,-20,640,-160,-20,640,640,1400-1-21,2021-04-10
610,وآوا,سرمايه گذاري آوا نوين,4,11827,103107786,8895,8718,8718,-177,-1.99,8895,0,0,8718,8718,1400-1-21,2021-04-10
611,خفولا,خدمات فني فولاد يزد,4,8264,365491928,45129,44227,44227,-902,-2,45112,-17,-0.04,44227,44227,1400-1-21,2021-04-10
612,نگين,ص.س. زمين و ساختمان نگين شهرري,4,660,32093800,48780,47770,48780,0,0,48630,-150,-0.31,47770,48780,1400-1-21,2021-04-10
613,كابگن,توليدي و صنعتي آبگينه‌,4,6000,31044000,5123,5174,5174,51,1,5123,0,0,5174,5174,1400-1-21,2021-04-10
614,زير0003پ02,زيره سبز0003 دانش(پ),4,200,105703600,510144,528518,528518,18374,3.6,528518,18374,3.6,528518,528518,1400-1-21,2021-04-10
615,بالاس,مهندسي ساختمان تاسيسات راه آهن,4,1154,65823006,58203,57039,57039,-1164,-2,58201,-2,0,57039,57039,1400-1-21,2021-04-10
616,ومعلم,بيمه معلم,4,108348,530905200,4999,4900,4900,-99,-1.98,4998,-1,-0.02,4900,4900,1400-1-21,2021-04-10
617,فرآور,فرآوري‌موادمعدني‌ايران‌,4,9094,314470520,35280,34580,34580,-700,-1.98,35280,0,0,34580,34580,1400-1-21,2021-04-10
618,ساربيل,سيمان آرتا اردبيل,4,439,24017690,55820,54710,54710,-1110,-1.99,55820,0,0,54710,54710,1400-1-21,2021-04-10
619,حآسا,آسيا سير ارس,4,1770,78168510,45064,44163,44163,-901,-2,45063,-1,0,44163,44163,1400-1-21,2021-04-10
620,تپمپي,پمپ‌ سازي‌ ايران‌,4,5208,99160320,19420,19040,19040,-380,-1.96,19420,0,0,19040,19040,1400-1-21,2021-04-10
621,خاذين,سايپاآذين‌,4,7458,34754280,4750,4660,4660,-90,-1.89,4750,0,0,4660,4660,1400-1-21,2021-04-10
622,قچار,فراوردههاي غذايي وقند چهارمحال,4,785,69260550,90030,88230,88230,-1800,-2,90027,-3,0,88230,88230,1400-1-21,2021-04-10
623,چكاوه,صنايع‌كاغذسازي‌كاوه‌,4,38093,688340510,18430,18070,18070,-360,-1.95,18420,-10,-0.05,18070,18070,1400-1-21,2021-04-10
624,ضسپا3005,اختيارخ خساپا-3000-1400/03/26,4,23,1365000,91,66,60,-31,-34.07,59,-32,-35.16,44,66,1400-1-21,2021-04-10
625,زشگزا,شير و گوشت زاگرس شهركرد,4,11382,93708006,8401,8233,8233,-168,-2,8401,0,0,8233,8233,1400-1-21,2021-04-10
626,قاسم,قاسم ايران,4,2127,28425228,13636,13364,13364,-272,-1.99,13636,0,0,13364,13364,1400-1-21,2021-04-10
627,غشان,شيرپاستوريزه‌پگاه‌خراسان‌,4,7301,55049540,7690,7540,7540,-150,-1.95,7690,0,0,7540,7540,1400-1-21,2021-04-10
628,فجام,جام‌دارو,3,3600,36612000,10370,10170,10170,-200,-1.93,10370,0,0,10170,10170,1400-1-21,2021-04-10
629,غگرجي,بيسكويت‌  گرجي‌,3,26186,484441000,18870,18500,18500,-370,-1.96,18870,0,0,18500,18500,1400-1-21,2021-04-10
630,كسعدي,كاشي‌ سعدي‌,3,1285,26920750,21370,20950,20950,-420,-1.97,21370,0,0,20950,20950,1400-1-21,2021-04-10
631,اعتماد2,صندوق س.اعتماد آفرين پارسيان-د,3,22500000,22500000,35783,1,1,-35782,-100,1,-35782,-100,1,1,1400-1-21,2021-04-10
632,دشيمي,شيمي‌ داروئي‌ داروپخش‌,3,830,25124100,30880,30270,30270,-610,-1.98,30880,0,0,30270,30270,1400-1-21,2021-04-10
633,دجابر,داروسازي‌ جابرابن‌حيان‌,3,836,16611320,20270,19870,19870,-400,-1.97,20270,0,0,19870,19870,1400-1-21,2021-04-10
634,زير0003پ01,زيره سبز0003كيميابذر(پ),3,26,13724950,498710,512000,528518,29808,5.98,527883,29173,5.85,512000,528518,1400-1-21,2021-04-10
635,كساوه,صنايع‌ كاشي‌ و سراميك‌ سينا,3,820,56760400,70630,69220,69220,-1410,-2,70630,0,0,69220,69220,1400-1-21,2021-04-10
636,كفرا,فراورده‌ هاي‌ نسوزايران‌,3,482,22413000,47440,46500,46500,-940,-1.98,47440,0,0,46500,46500,1400-1-21,2021-04-10
637,اراد33,مرابحه عام دولت3-ش.خ 0303,3,75000,66258750000,881689,883450,883450,1761,0.2,883450,1761,0.2,883450,883450,1400-1-21,2021-04-10
638,ثزاگرس,سرمايه گذاري توسعه عمران زاگرس,3,2930,160168450,57542,54665,54665,-2877,-5,57518,-24,-0.04,54665,54665,1400-1-21,2021-04-10
639,كشرق,صنعتي و معدني شمال شرق شاهرود,3,416,37550656,92108,90266,90266,-1842,-2,92107,-1,0,90266,90266,1400-1-21,2021-04-10
640,غاذر,كشت‌وصنعت‌پياذر,3,192,10531200,55960,54850,54850,-1110,-1.98,55960,0,0,54850,54850,1400-1-21,2021-04-10
641,گوهر2,صندوق سكه طلاي كيان,3,30000,30000,52880,1,1,-52879,-100,1,-52879,-100,1,1,1400-1-21,2021-04-10
642,سنوين,سرمايه گذاري اقتصاد نوين,3,2480,22592800,9295,9110,9110,-185,-1.99,9295,0,0,9110,9110,1400-1-21,2021-04-10
643,حريل02,اجاره ريل پردازسير021212,3,502,501965000,982500,982500,1000000,17500,1.78,999930,17430,1.77,982500,1000000,1400-1-21,2021-04-10
644,قشهد,شهد,3,23500,470940000,20440,20040,20040,-400,-1.96,20440,0,0,20040,20040,1400-1-21,2021-04-10
645,سصفها,سيمان‌اصفهان‌,3,168,21052080,127860,125310,125310,-2550,-1.99,127860,0,0,125310,125310,1400-1-21,2021-04-10
646,سنير,سيمان‌ سفيد ني‌ريز,3,152,37393520,251030,246010,246010,-5020,-2,251030,0,0,246010,246010,1400-1-21,2021-04-10
647,قزوين,كارخانجات‌ قند قزوين‌,3,26131,1014666730,39620,38830,38830,-790,-1.99,39600,-20,-0.05,38830,38830,1400-1-21,2021-04-10
648,ضپاس2006,اختيارخ وپارس-5000-1400/02/29,3,11,120000,100,11,10,-90,-90,11,-89,-89,10,11,1400-1-21,2021-04-10
649,سكارون,سيمان كارون,3,185,32265110,177965,174406,174406,-3559,-2,177959,-6,0,174406,174406,1400-1-21,2021-04-10
650,ساروم,سيمان‌اروميه‌,3,482,19357120,40970,40160,40160,-810,-1.98,40970,0,0,40160,40160,1400-1-21,2021-04-10
651,خمهر,مهركام‌پارس‌,3,10298,24818180,2450,2410,2410,-40,-1.63,2450,0,0,2410,2410,1400-1-21,2021-04-10
652,خنصير,مهندسي‌نصيرماشين‌,3,598,63627200,108570,106400,106400,-2170,-2,108570,0,0,106400,106400,1400-1-21,2021-04-10
653,بشهاب,لامپ‌  پارس‌ شهاب‌,3,3000,439230000,149390,146410,146410,-2980,-1.99,149360,-30,-0.02,146410,146410,1400-1-21,2021-04-10
654,اوان,مبين وان كيش,3,671,35962916,54689,53596,53596,-1093,-2,54688,-1,0,53596,53596,1400-1-21,2021-04-10
655,زقيام,كشت و دام قيام اصفهان,3,551,15658869,28998,28419,28419,-579,-2,28998,0,0,28419,28419,1400-1-21,2021-04-10
656,وسفارس,شركت س استان فارس,3,16180,16341800,1030,1010,1010,-20,-1.94,1030,0,0,1010,1010,1400-1-21,2021-04-10
657,سبجنو,سيمان‌ بجنورد,3,16130,921345600,59490,57120,57120,-2370,-3.98,59440,-50,-0.08,57120,57120,1400-1-21,2021-04-10
658,ددام,داروسازي زاگرس فارمد پارس,3,717,15594750,22190,21750,21750,-440,-1.98,22190,0,0,21750,21750,1400-1-21,2021-04-10
659,سخزر,سيمان‌ خزر,3,45006,1357380960,30770,30160,30160,-610,-1.98,30750,-20,-0.06,30160,30160,1400-1-21,2021-04-10
660,وتوس,توسعه‌شهري‌توس‌گستر,3,4192,56759680,13810,13540,13540,-270,-1.96,13810,0,0,13540,13540,1400-1-21,2021-04-10
661,وسكرمان,س.سهام عدالت استان كرمان,3,3000,3030000,1030,1010,1010,-20,-1.94,1030,0,0,1010,1010,1400-1-21,2021-04-10
662,دابور,داروسازي‌ ابوريحان‌,3,472,18247520,39440,38660,38660,-780,-1.98,39440,0,0,38660,38660,1400-1-21,2021-04-10
663,چفيبر,فيبر ايران‌,3,2853,38857860,13890,13620,13620,-270,-1.94,13890,0,0,13620,13620,1400-1-21,2021-04-10
664,اپرداز,آتيه داده پرداز,3,1859,39334581,21590,21159,21159,-431,-2,21590,0,0,21159,21159,1400-1-21,2021-04-10
665,نطرين,عطرين نخ قم,3,4537,54017522,12148,11906,11906,-242,-1.99,12148,0,0,11906,11906,1400-1-21,2021-04-10
666,سكرد,سيمان كردستان,3,16883,162076800,9790,9600,9600,-190,-1.94,9790,0,0,9600,9600,1400-1-21,2021-04-10
667,ضجار2000,اختيارخ وتجارت-1800-1400/02/22,3,23,17250000,880,750,750,-130,-14.77,750,-130,-14.77,750,750,1400-1-21,2021-04-10
668,خاتم2,صندوق س خاتم ايساتيس پويا-ثابت,3,2760407,2760407,10873,1,1,-10872,-99.99,1,-10872,-99.99,1,1,1400-1-21,2021-04-10
669,غشوكو,شوكو پارس,3,1302,50934240,39918,39120,39120,-798,-2,39916,-2,-0.01,39120,39120,1400-1-21,2021-04-10
670,افرا,افرانت,3,2610,87784740,34320,33634,33634,-686,-2,34319,-1,0,33634,33634,1400-1-21,2021-04-10
671,جهرم,پتروشيمي جهرم,3,13000,22698000,1781,1746,1746,-35,-1.97,1781,0,0,1746,1746,1400-1-21,2021-04-10
672,دسانكو,داروسازي سبحان انكولوژي,3,1097,15905403,14794,14499,14499,-295,-1.99,14794,0,0,14499,14499,1400-1-21,2021-04-10
673,كباده,توليد خاك نسوزاستقلال آباده,3,75555,690421590,8703,9138,9138,435,5,8717,14,0.16,9138,9138,1400-1-21,2021-04-10
674,كپشير,پشم‌شيشه‌ايران‌,3,30000,1176000000,39990,39200,39200,-790,-1.98,39970,-20,-0.05,39200,39200,1400-1-21,2021-04-10
675,خكار,ايركا پارت صنعت,3,2739,58833720,21910,21480,21480,-430,-1.96,21910,0,0,21480,21480,1400-1-21,2021-04-10
676,وسكرشا,س.سهام عدالت استان كرمانشاه,3,16200,20088000,1260,1240,1240,-20,-1.59,1260,0,0,1240,1240,1400-1-21,2021-04-10
677,ضفلا3003,اختيارخ فولاد-7133-1400/03/19,2,2,5060000,3077,2530,2530,-547,-17.78,2530,-547,-17.78,2530,2530,1400-1-21,2021-04-10
678,ضصاد3004,اختيارخ وبصادر-3500-1400/03/12,2,12,528000,50,44,44,-6,-12,44,-6,-12,44,44,1400-1-21,2021-04-10
679,وسخراش,شركت س استان خراسان شمالي,2,10000,13500000,1370,1350,1350,-20,-1.46,1370,0,0,1350,1350,1400-1-21,2021-04-10
680,بسويچ,پارس‌سويچ‌,2,830,44861500,55150,54050,54050,-1100,-1.99,55150,0,0,54050,54050,1400-1-21,2021-04-10
681,اخزا8094,اسنادخزانه-م9بودجه98-000923,2,1113042,976586994854,877007,878187,877007,0,0,877404,397,0.05,877007,878187,1400-1-21,2021-04-10
682,كمرجان,بازرگاني و توليدي مرجان كار,2,70,10081540,146961,144022,144022,-2939,-2,146960,-1,0,144022,144022,1400-1-21,2021-04-10
683,تملي805,تسهيلات مسكن ب. ملي-مرداد98,2,30,19865640,697039,662188,662188,-34851,-5,662188,-34851,-5,662188,662188,1400-1-21,2021-04-10
684,سدبير,س. تدبيرگران فارس وخوزستان,2,116,10167748,89441,87653,87653,-1788,-2,89441,0,0,87653,87653,1400-1-21,2021-04-10
685,ثعتما,س. ساختماني اعتماد گستر,2,161,10425877,67455,64757,64757,-2698,-4,67454,-1,0,64757,64757,1400-1-21,2021-04-10
686,اخزا8144,اسنادخزانه-م14بودجه98-010318,2,715525,575906800075,806209,803903,806209,0,0,804873,-1336,-0.17,803903,806209,1400-1-21,2021-04-10
687,طلا2,صندوق س.پشتوانه طلاي لوتوس,2,200000,200000,77411,1,1,-77410,-100,1,-77410,-100,1,1,1400-1-21,2021-04-10
688,ضغدر3000,اختيارخ وغدير-6200-1400/03/26,2,10,45000000,3856,4500,4500,644,16.7,4500,644,16.7,4500,4500,1400-1-21,2021-04-10
689,زنگان,صنعت روي زنگان,2,119,12191074,104536,102446,102446,-2090,-2,104535,-1,0,102446,102446,1400-1-21,2021-04-10
690,ثامان,سامان‌ گستراصفهان‌,2,475,11134000,23910,23440,23440,-470,-1.97,23910,0,0,23440,23440,1400-1-21,2021-04-10
691,تشتاد,صنايع توليدي اشتاد ايران‌,2,6330,97425030,15705,15391,15391,-314,-2,15703,-2,-0.01,15391,15391,1400-1-21,2021-04-10
692,آ س پ,آ.س.پ,2,685,10835330,16140,15818,15818,-322,-2,16140,0,0,15818,15818,1400-1-21,2021-04-10
693,ضخوز2012,اختيارخ فخوز-10000-1400/02/15,2,2,8000000,4444,4000,4000,-444,-9.99,4000,-444,-9.99,4000,4000,1400-1-21,2021-04-10
694,سيلام,سيمان‌ ايلام‌,2,4800,52848000,11230,11010,11010,-220,-1.96,11230,0,0,11010,11010,1400-1-21,2021-04-10
695,وسالت,بانك قرض الحسنه رسالت,2,41149,47856287,1108,1163,1163,55,4.96,1108,0,0,1163,1163,1400-1-21,2021-04-10
696,ضپيك2012,اختيارخ تاپيكو-16000-00/02/19,2,2,143000,88,77,66,-22,-25,71,-17,-19.32,66,77,1400-1-21,2021-04-10
697,وليز,ليزينگ‌ايران‌,2,1135,10612250,9540,9350,9350,-190,-1.99,9540,0,0,9350,9350,1400-1-21,2021-04-10
698,زير0003پ04,زيره سبز0003شركت مينوبذر(پ),2,22,11403104,470028,509827,528518,58490,12.44,518323,48295,10.27,509827,528518,1400-1-21,2021-04-10
699,خكمك,كمك‌فنرايندامين‌,2,940,24994600,27130,26590,26590,-540,-1.99,27130,0,0,26590,26590,1400-1-21,2021-04-10
700,تصميم2,صندوق س با درآمد ثابت تصميم,2,2000000,2000000,16076,1,1,-16075,-99.99,1,-16075,-99.99,1,1,1400-1-21,2021-04-10
701,داسوه,داروسازي‌ اسوه‌,2,707,25904480,37380,36640,36640,-740,-1.98,37380,0,0,36640,36640,1400-1-21,2021-04-10
702,ثاصفا,شركت‌ ساختمان‌ اصفهان‌,2,461,12553491,27786,27231,27231,-555,-2,27786,0,0,27231,27231,1400-1-21,2021-04-10
703,ثشرق,سرمايه گذاري مسكن شمال شرق,2,2261,15284360,6890,6760,6760,-130,-1.89,6890,0,0,6760,6760,1400-1-21,2021-04-10
704,وشمال,س. چشم انداز توسعه شمال,2,118,10038850,88619,85075,85075,-3544,-4,88617,-2,0,85075,85075,1400-1-21,2021-04-10
705,ضصاد3003,اختيارخ وبصادر-3000-1400/03/12,2,13,1026000,112,66,80,-32,-28.57,79,-33,-29.46,66,80,1400-1-21,2021-04-10
706,پست0008پ02,پسته فندقي32-30طلاسبززرند0008,2,5,7747093,1350000,1579504,1429077,79077,5.86,1549419,199419,14.77,1429077,1579504,1400-1-21,2021-04-10
707,سفانو,سيمان فارس نو,2,19126,768673940,41010,40190,40190,-820,-2,41000,-10,-0.02,40190,40190,1400-1-21,2021-04-10
708,رتكو,كنترل‌خوردگي‌تكين‌كو,2,1048,19021200,18520,18150,18150,-370,-2,18520,0,0,18150,18150,1400-1-21,2021-04-10
709,مفاخر,توسعه فناوري اطلاعات خوارزمي,2,750,49073250,66766,65431,65431,-1335,-2,66765,-1,0,65431,65431,1400-1-21,2021-04-10
710,داوه,داروسازي آوه سينا,2,10458,206942904,20191,19788,19788,-403,-2,20189,-2,-0.01,19788,19788,1400-1-21,2021-04-10
711,وحافظ,بيمه حافظ,2,1680,108427200,65857,64540,64540,-1317,-2,65842,-15,-0.02,64540,64540,1400-1-21,2021-04-10
712,اراد50,مرابحه عام دولت5-ش.خ0302,2,11500,11500013000,1000000,1000001,1000002,2,0,1000001,1,0,1000001,1000002,1400-1-21,2021-04-10
713,وسناح,ح. سرمايه گذاري نيروگاهي ايران,2,900,12135000,13530,13650,13350,-180,-1.33,13483,-47,-0.35,13350,13650,1400-1-21,2021-04-10
714,ضغدر3002,اختيارخ وغدير-8200-1400/03/26,2,8,20802000,3977,2600,2601,-1376,-34.6,2600,-1377,-34.62,2600,2601,1400-1-21,2021-04-10
715,آرمان,بيمه آرمان,2,1400,11453400,8521,8181,8181,-340,-3.99,8521,0,0,8181,8181,1400-1-21,2021-04-10
716,اخزا7214,اسنادخزانه-م21بودجه97-000728,2,885256,799266817696,902628,903116,902628,0,0,902865,237,0.03,902628,903116,1400-1-21,2021-04-10
717,كچاد2,معدني‌وصنعتي‌چادرملو,2,7300000,167900000000,23460,23000,23000,-460,-1.96,23000,-460,-1.96,23000,23000,1400-1-21,2021-04-10
718,اوصتا4,صندوق انديشه ورزان صباتامين -د,2,161512556,2962140277040,18321,18340,18340,19,0.1,18340,19,0.1,18340,18340,1400-1-21,2021-04-10
719,طخود2008,اختيارف خودرو-3500-1400/02/08,2,20,21140000,475,1114,1000,525,110.53,1057,582,122.53,1000,1114,1400-1-21,2021-04-10
720,كاسپين,داروسازي كاسپين تامين,2,415,10628980,26134,25612,25612,-522,-2,26134,0,0,25612,25612,1400-1-21,2021-04-10
721,سدور,سيمان‌ دورود,2,8124,154274760,19370,18990,18990,-380,-1.96,19370,0,0,18990,18990,1400-1-21,2021-04-10
722,ركيش,كارت اعتباري ايران كيش,2,2071,49869680,24570,24080,24080,-490,-1.99,24570,0,0,24080,24080,1400-1-21,2021-04-10
723,وسنا,سرمايه گذاري نيروگاهي ايران,2,36551,564128134,15748,15434,15434,-314,-1.99,15740,-8,-0.05,15434,15434,1400-1-21,2021-04-10
724,كهرام,توليدي گرانيت بهسرام,2,8045,896977275,113770,111495,111495,-2275,-2,113666,-104,-0.09,111495,111495,1400-1-21,2021-04-10
725,غپونه,نوش پونه مشهد,2,817,15656171,19554,19163,19163,-391,-2,19554,0,0,19163,19163,1400-1-21,2021-04-10
726,حرهشا,رهشاد سپاهان (سهامي عام,2,198,12611412,64993,63694,63694,-1299,-2,64991,-2,0,63694,63694,1400-1-21,2021-04-10
727,سهرمز,سيمان‌هرمزگان‌,2,7700,188419000,24960,24470,24470,-490,-1.96,24960,0,0,24470,24470,1400-1-21,2021-04-10
728,اراد674,مرابحه عام دولت67-ش.خ0310,2,4000000,3867800000000,1000000,1000000,933900,-66100,-6.61,966950,-33050,-3.31,933900,1000000,1400-1-21,2021-04-10
729,اراد594,مرابحه عام دولتي5-ش.خ 0309,2,16000000,15478400000000,1000000,1000000,934800,-65200,-6.52,967400,-32600,-3.26,934800,1000000,1400-1-21,2021-04-10
730,اخزا9072,اسنادخزانه-م7بودجه99-020704,1,222983,139141392000,625459,624000,624000,-1459,-0.23,624000,-1459,-0.23,624000,624000,1400-1-21,2021-04-10
731,اخزا7184,اسنادخزانه-م18بودجه97-000525,1,365000,341268430000,934982,934982,934982,0,0,934982,0,0,934982,934982,1400-1-21,2021-04-10
732,ضپاس2005,اختيارخ وپارس-4500-1400/02/29,1,10,220000,33,22,22,-11,-33.33,22,-11,-33.33,22,22,1400-1-21,2021-04-10
733,دلقما,دارويي‌ لقمان‌,1,467,12179360,26610,26080,26080,-530,-1.99,26610,0,0,26080,26080,1400-1-21,2021-04-10
734,ثجوان,تامين مسكن جوانان,1,459,5004018,11124,10902,10902,-222,-2,11124,0,0,10902,10902,1400-1-21,2021-04-10
735,ضصاد3001,اختيارخ وبصادر-2000-1400/03/12,1,20,8800000,549,440,440,-109,-19.85,440,-109,-19.85,440,440,1400-1-21,2021-04-10
736,سفاسي,شركت فارسيت اهواز,1,1000,14145000,14433,14145,14145,-288,-2,14433,0,0,14145,14145,1400-1-21,2021-04-10
737,كلوند,كاشي‌ الوند,1,140,6379800,46500,45570,45570,-930,-2,46500,0,0,45570,45570,1400-1-21,2021-04-10
738,كترام,توليدي‌ كاشي‌ تكسرام‌,1,110,5237100,48580,47610,47610,-970,-2,48580,0,0,47610,47610,1400-1-21,2021-04-10
739,پست0008پ04,پسته فندقي32-30سبزدانه0008(پ),1,50,73000000,1493014,1460000,1460000,-33014,-2.21,1460000,-33014,-2.21,1460000,1460000,1400-1-21,2021-04-10
740,چافست,افست‌,1,310,5043700,16600,16270,16270,-330,-1.99,16600,0,0,16270,16270,1400-1-21,2021-04-10
741,خفنر,فنرسازي‌خاور,1,7741,65721090,8660,8490,8490,-170,-1.96,8660,0,0,8490,8490,1400-1-21,2021-04-10
742,ضملي3005,اختيارخ فملي-16000-1400/03/02,1,1,111000,222,111,111,-111,-50,111,-111,-50,111,111,1400-1-21,2021-04-10
743,رطب0002پ01,رطب مضافتي0002افشارتعاون بم(پ),1,32,5168000,170000,161500,161500,-8500,-5,161500,-8500,-5,161500,161500,1400-1-21,2021-04-10
744,ضمخا7075,اختيارخ اخابر-8700-1400/07/28,1,2,5080000,2550,2540,2540,-10,-0.39,2540,-10,-0.39,2540,2540,1400-1-21,2021-04-10
745,كساپا,سايپاشيشه‌,1,150,5740500,39050,38270,38270,-780,-2,39050,0,0,38270,38270,1400-1-21,2021-04-10
746,قجام,فرآوردههاي غذايي وقندتربت‌جام‌,1,10,161460,16475,16146,16146,-329,-2,16475,0,0,16146,16146,1400-1-21,2021-04-10
747,تملي806,تسهيلات مسكن ب. ملي-شهريور98,1,6,5321640,933621,886940,886940,-46681,-5,886940,-46681,-5,886940,886940,1400-1-21,2021-04-10
748,لكما,كارخانجات‌مخابراتي‌ايران‌,1,1000,6035000,6158,6035,6035,-123,-2,6158,0,0,6035,6035,1400-1-21,2021-04-10
749,گكيش,توريستي ورفاهي آبادگران كيش,1,140,6718460,48968,47989,47989,-979,-2,48968,0,0,47989,47989,1400-1-21,2021-04-10
750,ضملي3002,اختيارخ فملي-10000-1400/03/02,1,2,3998000,2318,1999,1999,-319,-13.76,1999,-319,-13.76,1999,1999,1400-1-21,2021-04-10
751,اراد35,مرابحه عام دولت3-ش.خ 0103,1,1000,1000000000,980000,1000000,1000000,20000,2.04,1000000,20000,2.04,1000000,1000000,1400-1-21,2021-04-10
752,اخزا723,اسنادخزانه-م23بودجه97-000824,1,20,17850020,892291,892501,892501,210,0.02,892501,210,0.02,892501,892501,1400-1-21,2021-04-10
753,اخزا8064,اسنادخزانه-م6بودجه98-000519,1,739000,691704000000,936920,936000,936000,-920,-0.1,936000,-920,-0.1,936000,936000,1400-1-21,2021-04-10
754,اخزا7132,اسنادخزانه-م13بودجه97-000518,1,302550,284400025500,937608,940010,940010,2402,0.26,940010,2402,0.26,940010,940010,1400-1-21,2021-04-10
755,قمرو,قند مرودشت‌,1,420,15225000,36980,36250,36250,-730,-1.97,36980,0,0,36250,36250,1400-1-21,2021-04-10
756,صگل411,ص اجاره گل گهر 411- 3 ماهه 17%,1,100,97100100,971001,971001,971001,0,0,971001,0,0,971001,971001,1400-1-21,2021-04-10
757,سفار,سيمان‌فارس‌,1,40,6063600,154680,151590,151590,-3090,-2,154680,0,0,151590,151590,1400-1-21,2021-04-10
758,شدوص,دوده‌ صنعتي‌ پارس‌,1,5000,139600000,28480,27920,27920,-560,-1.97,28480,0,0,27920,27920,1400-1-21,2021-04-10
759,اخزا7134,اسنادخزانه-م13بودجه97-000518,1,336000,315036288000,937608,937608,937608,0,0,937608,0,0,937608,937608,1400-1-21,2021-04-10
760,طفلا3002,اختيارف فولاد-6420-1400/03/19,1,1,85000,1,85,85,84,8400,85,84,8400,85,85,1400-1-21,2021-04-10
761,اراد11,مرابحه عام دولت1-ش.خ لوتوس0206,1,5000,4775000000,935000,955000,955000,20000,2.14,955000,20000,2.14,955000,955000,1400-1-21,2021-04-10
762,شپاس,نفت پاسارگاد,1,367,7960597,22133,21691,21691,-442,-2,22133,0,0,21691,21691,1400-1-21,2021-04-10
763,وساغربي,شركت س استان آذربايجان غربي,1,7000,5320000,770,760,760,-10,-1.3,770,0,0,760,760,1400-1-21,2021-04-10
764,كشم0006پ02,كشمش تيزابي0006تاكستان(پ),1,1463,321860000,220011,220000,220000,-11,0,220000,-11,0,220000,220000,1400-1-21,2021-04-10
765,ومعادن2,توسعه‌معادن‌وفلزات‌,1,7969559,93482927070,11960,11730,11730,-230,-1.92,11730,-230,-1.92,11730,11730,1400-1-21,2021-04-10
766,اخزا819,اسنادخزانه-م19بودجه98-020322,1,15000,10932615000,728841,728841,728841,0,0,728841,0,0,728841,728841,1400-1-21,2021-04-10
767,اخزا807,اسنادخزانه-م7بودجه98-000719,1,23685,21567561000,910000,910600,910600,600,0.07,910600,600,0.07,910600,910600,1400-1-21,2021-04-10
768,اخزا7164,اسنادخزانه-م16بودجه97-000407,1,387000,371896938000,960974,960974,960974,0,0,960974,0,0,960974,960974,1400-1-21,2021-04-10
769,سفارود,كارخانه فارسيت درود,1,589,10461818,18124,17762,17762,-362,-2,18124,0,0,17762,17762,1400-1-21,2021-04-10
770,فخاس,فولاد خراسان,1,185,5104150,28150,27590,27590,-560,-1.99,28150,0,0,27590,27590,1400-1-21,2021-04-10
771,تابان02,اجاره تابان لوتوس14021206,1,500,500000000,985000,1000000,1000000,15000,1.52,1000000,15000,1.52,1000000,1000000,1400-1-21,2021-04-10
772,وايران,ليزينگ ايرانيان,1,700,8631000,12580,12330,12330,-250,-1.99,12580,0,0,12330,12330,1400-1-21,2021-04-10
773,اخزا8124,اسنادخزانه-م12بودجه98-001111,1,599000,514811149000,859451,859451,859451,0,0,859451,0,0,859451,859451,1400-1-21,2021-04-10
774,ثنام,س ساختماني ب نام آوران مهندسي,1,32500,530952500,16670,16337,16337,-333,-2,16661,-9,-0.05,16337,16337,1400-1-21,2021-04-10
775,ضفلا3006,اختيارخ فولاد-11413-1400/03/19,1,1,133000,200,133,133,-67,-33.5,133,-67,-33.5,133,133,1400-1-21,2021-04-10
776,حپارسا,توسعه حمل و نقل ريلي پارسيان,1,145,5006415,35231,34527,34527,-704,-2,35231,0,0,34527,34527,1400-1-21,2021-04-10
777,ضجار2001,اختيارخ وتجارت-2000-1400/02/22,1,55,30800000,840,560,560,-280,-33.33,560,-280,-33.33,560,560,1400-1-21,2021-04-10
778,آبين,كشت و صنعت آبشيرين,1,1600,6609600,4215,4131,4131,-84,-1.99,4215,0,0,4131,4131,1400-1-21,2021-04-10
779,صفارس147,صكوك اجاره فارس147- 3ماهه18%,1,200,209060000,1022613,1045300,1045300,22687,2.22,1045300,22687,2.22,1045300,1045300,1400-1-21,2021-04-10
780,طخود2006,اختيارف خودرو-2500-1400/02/08,1,10,1000000,200,100,100,-100,-50,100,-100,-50,100,100,1400-1-21,2021-04-10
781,وساربيل,شركت س استان اردبيل,1,4000,5040000,1280,1260,1260,-20,-1.56,1280,0,0,1260,1260,1400-1-21,2021-04-10
782,اشاد1,مشاركت دولتي1-شرايط خاص001026,1,1000,999987000,990000,999987,999987,9987,1.01,999987,9987,1.01,999987,999987,1400-1-21,2021-04-10
783,غمهرا,توليدي‌مهرام‌,1,50,5977500,121980,119550,119550,-2430,-1.99,121980,0,0,119550,119550,1400-1-21,2021-04-10
784,ضپاس2000,اختيارخ وپارس-2000-1400/02/29,1,3,2250000,914,750,750,-164,-17.94,750,-164,-17.94,750,750,1400-1-21,2021-04-10
785,لوتوس2,تامين سرمايه لوتوس پارسيان,1,8235366,81118355100,10050,9850,9850,-200,-1.99,9850,-200,-1.99,9850,9850,1400-1-21,2021-04-10
786,ولراز,ليزينگ رازي,1,100,5499900,56121,54999,54999,-1122,-2,56121,0,0,54999,54999,1400-1-21,2021-04-10
787,ضخود2010,اختيارخ خودرو-4500-1400/02/08,1,1,5000,3,5,5,2,66.67,5,2,66.67,5,5,1400-1-21,2021-04-10
788,شپديس2,پتروشيمي پرديس,1,1644589,153834855060,95440,93540,93540,-1900,-1.99,93540,-1900,-1.99,93540,93540,1400-1-21,2021-04-10
789,پسهند,صنايع‌ لاستيكي‌  سهند,1,333,13752900,42140,41300,41300,-840,-1.99,42140,0,0,41300,41300,1400-1-21,2021-04-10
790,وملت,سرمايه گذاري ملت,1,1200,5193600,4416,4328,4328,-88,-1.99,4416,0,0,4328,4328,1400-1-21,2021-04-10
791,وسمازن,س.سهام عدالت استان مازندران,1,6300,6048000,970,960,960,-10,-1.03,970,0,0,960,960,1400-1-21,2021-04-10
792,ضپاس2003,اختيارخ وپارس-3500-1400/02/29,1,1,60000,71,60,60,-11,-15.49,60,-11,-15.49,60,60,1400-1-21,2021-04-10
793,پارسان2,گسترش نفت و گاز پارسيان,1,10000000,199100000000,20310,19910,19910,-400,-1.97,19910,-400,-1.97,19910,19910,1400-1-21,2021-04-10
794,ضفلا3007,اختيارخ فولاد-12840-1400/03/19,1,1,66000,80,66,66,-14,-17.5,66,-14,-17.5,66,66,1400-1-21,2021-04-10
795,دكيمي,كيميدارو,1,170,5004800,30040,29440,29440,-600,-2,30040,0,0,29440,29440,1400-1-21,2021-04-10
796,فمراد,آلومراد,1,100,14104000,143910,141040,141040,-2870,-1.99,143910,0,0,141040,141040,1400-1-21,2021-04-10
797,فسديد,لوله‌وتجهيزات‌ سديد - ورشكسته,1,87,9915477,115122,113971,113971,-1151,-1,115120,-2,0,113971,113971,1400-1-21,2021-04-10
798,ضجار2005,اختيارخ وتجارت-4000-1400/02/22,1,10,150000,24,15,15,-9,-37.5,15,-9,-37.5,15,15,1400-1-21,2021-04-10
799,اخزا8114,اسنادخزانه-م11بودجه98-001013,1,621000,540210384000,869904,869904,869904,0,0,869904,0,0,869904,869904,1400-1-21,2021-04-10
800,ولغدر,ليزينگ‌خودروغدير,1,4132,99622520,24600,24110,24110,-490,-1.99,24600,0,0,24110,24110,1400-1-21,2021-04-10
801,نتوس,پشم‌ بافي‌ توس,1,1,21523,21962,21523,21523,-439,-2,21962,0,0,21523,21523,1400-1-21,2021-04-10
802,وسهمدا,شركت س استان همدان,1,6000,5280000,890,880,880,-10,-1.12,890,0,0,880,880,1400-1-21,2021-04-10
803,اخزا8074,اسنادخزانه-م7بودجه98-000719,1,558000,507780000000,910000,910000,910000,0,0,910000,0,0,910000,910000,1400-1-21,2021-04-10
804,اخزا8044,اسنادخزانه-م4بودجه98-000421,1,287000,273282548000,952204,952204,952204,0,0,952204,0,0,952204,952204,1400-1-21,2021-04-10
805,ضپاس2004,اختيارخ وپارس-4000-1400/02/29,1,8,320000,47,40,40,-7,-14.89,40,-7,-14.89,40,40,1400-1-21,2021-04-10
806,ثعمرا,عمران و توسعه شاهد,1,779,9964189,13052,12791,12791,-261,-2,13052,0,0,12791,12791,1400-1-21,2021-04-10
807,اخزا8084,اسنادخزانه-م8بودجه98-000817,1,617000,551216694000,893382,893382,893382,0,0,893382,0,0,893382,893382,1400-1-21,2021-04-10
808,درهآور,دارويي ره آورد تامين,1,96,5008992,53241,52177,52177,-1064,-2,53241,0,0,52177,52177,1400-1-21,2021-04-10
809,حسير,ريل سير كوثر,1,297,5064741,17401,17053,17053,-348,-2,17401,0,0,17053,17053,1400-1-21,2021-04-10
810,گواهي ظرفيت,گواهي ظرفيت نقدي,1,3000000,36945000000,11729,12315,12315,586,5,12315,586,5,12315,12315,1400-1-21,2021-04-10
811,تهران012,مشاركت ش تهران012-3ماهه18%,1,6,5880000,970300,980000,980000,9700,1,980000,9700,1,980000,980000,1400-1-21,2021-04-10
812,آينده,بازرگاني آينده سازان بهشت پارس,1,320,6238080,19891,19494,19494,-397,-2,19891,0,0,19494,19494,1400-1-21,2021-04-10
813,ثغرب,شركت سرمايه گذاري مسكن شمالغرب,1,100000,780600000,7965,7806,7806,-159,-2,7962,-3,-0.04,7806,7806,1400-1-21,2021-04-10
814,اخزا7224,اسنادخزانه-م22بودجه97-000428,1,194000,183771544000,947276,947276,947276,0,0,947276,0,0,947276,947276,1400-1-21,2021-04-10
815,ثالوند,سرمايه گذاري مسكن الوند,1,274,8665524,32271,31626,31626,-645,-2,32271,0,0,31626,31626,1400-1-21,2021-04-10
816,ضمخا7069,اختيارخ اخابر-17700-1400/07/28,1,3,3000000,1333,1000,1000,-333,-24.98,1000,-333,-24.98,1000,1000,1400-1-21,2021-04-10
817,آوا2,صندوق س.سهام آواي معيار-س,1,8400000,8400000,6316,1,1,-6315,-99.98,1,-6315,-99.98,1,1,1400-1-21,2021-04-10
818,كتوكا,توليدي و خدمات صنايع نسوز توكا,1,154,5888960,39020,38240,38240,-780,-2,39020,0,0,38240,38240,1400-1-21,2021-04-10
819,طخود2005,اختيارف خودرو-2000-1400/02/08,1,100,700000,4,7,7,3,75,7,3,75,7,7,1400-1-21,2021-04-10
820,تملي705,تسهيلات مسكن ب. ملي-مرداد97,1,22,13916716,602456,632578,632578,30122,5,632578,30122,5,632578,632578,1400-1-21,2021-04-10
821,ضملت3000,اختيارخ وبملت-3000-1400/03/19,1,5,4350000,1099,870,870,-229,-20.84,870,-229,-20.84,870,870,1400-1-21,2021-04-10
822,كرمان00,رهني كرمان موتور14001130,1,10,10000000,1024307,1000000,1000000,-24307,-2.37,1000000,-24307,-2.37,1000000,1000000,1400-1-21,2021-04-10
823,غشصفا,شيرپاستوريزه‌پگاه‌اصفهان‌,1,448,12293120,28000,27440,27440,-560,-2,28000,0,0,27440,27440,1400-1-21,2021-04-10
824,مبين014,اجاره اعتماد مبين لوتوس011019,1,10,10000000,990000,1000000,1000000,10000,1.01,1000000,10000,1.01,1000000,1000000,1400-1-21,2021-04-10
825,دقاضي,داروسازي شهيد قاضي,1,450,18946800,43858,42104,42104,-1754,-4,43856,-2,0,42104,42104,1400-1-21,2021-04-10
826,حبندر,دريايي و کشتيراني خط دريابندر,1,1500,48607500,33066,32405,32405,-661,-2,33064,-2,-0.01,32405,32405,1400-1-21,2021-04-10
827,سپر2,صندوق س سپر سرمايه بيدار- ثابت,1,1000000,1000000,11741,1,1,-11740,-99.99,1,-11740,-99.99,1,1,1400-1-21,2021-04-10
828,وسرضوي,س.سهام عدالت استان خراسان رضوي,1,5039,5089390,1030,1010,1010,-20,-1.94,1030,0,0,1010,1010,1400-1-21,2021-04-10
829,ضچاد2004,اختيارخ كچاد-20000-1400/02/05,1,1,2600000,2560,2600,2600,40,1.56,2600,40,1.56,2600,2600,1400-1-21,2021-04-10
830,صخود412,ص مرابحه خودرو412- 3ماهه 18%,1,10,9999990,999999,999999,999999,0,0,999999,0,0,999999,999999,1400-1-21,2021-04-10
831,طملي3001,اختيارف فملي-9000-1400/03/02,1,1,100000,1,100,100,99,9900,100,99,9900,100,100,1400-1-21,2021-04-10
832,ضملت3005,اختيارخ وبملت-6000-1400/03/19,1,10,220000,44,22,22,-22,-50,22,-22,-50,22,22,1400-1-21,2021-04-10
833,وغدير2,سرمايه‌گذاري‌غدير(هلدينگ‌,1,18756000,201627000000,10960,10750,10750,-210,-1.92,10750,-210,-1.92,10750,10750,1400-1-21,2021-04-10
834,ضجار2004,اختيارخ وتجارت-3500-1400/02/22,1,10,220000,35,22,22,-13,-37.14,22,-13,-37.14,22,22,1400-1-21,2021-04-10
835,صگل3092,صكوك اجاره گل گهر309-3ماهه20%,1,118800,125096400000,1075000,1053000,1053000,-22000,-2.05,1053000,-22000,-2.05,1053000,1053000,1400-1-21,2021-04-10
836,صايپا012,صكوك مرابحه سايپا012-3ماهه 16%,1,1508,1508001508,1000001,1000001,1000001,0,0,1000001,0,0,1000001,1000001,1400-1-21,2021-04-10
837,دفارا,داروسازي‌ فارابي‌,1,80,5179200,66060,64740,64740,-1320,-2,66060,0,0,64740,64740,1400-1-21,2021-04-10
838,ضمخا7067,اختيارخ اخابر-13700-1400/07/28,1,1,1001000,1001,1001,1001,0,0,1001,0,0,1001,1001,1400-1-21,2021-04-10
839,ثاباد,توريستي ورفاهي آبادگران ايران,1,278,14953620,54880,53790,53790,-1090,-1.99,54880,0,0,53790,53790,1400-1-21,2021-04-10
840,غشاذر,پگاه‌آذربايجان‌غربي‌,1,511,5007800,10000,9800,9800,-200,-2,10000,0,0,9800,9800,1400-1-21,2021-04-10
841,شسم,توليد سموم‌ علف‌ كش,1,1,93107,89526,93107,93107,3581,4,89526,0,0,93107,93107,1400-1-21,2021-04-10
