,نماد,نام,تعداد,حجم,ارزش,دیروز,اولین,آخرین معامله - مقدار,آخرین معامله - تغییر,آخرین معامله - درصد,قیمت پایانی - مقدار,قیمت پایانی - تغییر,قیمت پایانی - درصد,کمترین,بیشترین,تاریخ,gregorian_date
0,بركت,گروه دارويي بركت,87577,181207478,7537123647860,40810,42850,39690,-1120,-2.74,41590,780,1.91,39520,42850,1400-4-6,2021-06-27
1,ومدير,گ.مديريت ارزش سرمايه ص ب كشوري,59468,152000368,628825522416,3940,4137,4137,197,5,4137,197,5,4137,4137,1400-4-6,2021-06-27
2,خودرو,ايران‌ خودرو,31382,1145837717,2511012854367,2117,2080,2198,81,3.83,2191,74,3.5,2070,2222,1400-4-6,2021-06-27
3,پالايش,صندوق پالايشي يكم-سهام,29112,31010611,2249752132690,73280,72600,72120,-1160,-1.58,72550,-730,-1,72000,73350,1400-4-6,2021-06-27
4,شپنا,پالايش نفت اصفهان,28827,211534578,2807784497850,13530,13260,13040,-490,-3.62,13270,-260,-1.92,12940,13700,1400-4-6,2021-06-27
5,گدنا,تهيه توزيع غذاي دنا آفرين فدك,24686,12562344,279084606174,24308,21500,22575,-1733,-7.13,22216,-2092,-8.61,21010,22575,1400-4-6,2021-06-27
6,خساپا,سايپا,23777,1324978881,2554543709706,1849,1830,1941,92,4.98,1928,79,4.27,1810,1941,1400-4-6,2021-06-27
7,فملي,ملي‌ صنايع‌ مس‌ ايران‌,18830,93937722,1148372777010,12420,12260,12130,-290,-2.33,12220,-200,-1.61,12040,12440,1400-4-6,2021-06-27
8,لطيف,محصولات كاغذي لطيف,17474,1285514,46061252134,34125,35831,35831,1706,5,35831,1706,5,35831,35831,1400-4-6,2021-06-27
9,اپال,فرآوري معدني اپال كاني پارس,16088,13778462,264676629040,19340,19300,19140,-200,-1.03,19210,-130,-0.67,19070,19370,1400-4-6,2021-06-27
10,دارا يكم,صندوق واسطه گري مالي يكم-سهام,16033,11602227,1472968761180,127720,126970,126250,-1470,-1.15,126960,-760,-0.6,126100,128200,1400-4-6,2021-06-27
11,سيتا,سرمايه گذاري سيمان تامين,15332,35551252,602122861690,16180,16580,16980,800,4.94,16940,760,4.7,16180,16980,1400-4-6,2021-06-27
12,غكورش,صنعت غذايي كورش,13936,9095598,365487788670,40400,40820,39720,-680,-1.68,40180,-220,-0.54,39600,41290,1400-4-6,2021-06-27
13,شتران,پالايش نفت تهران,13861,120906547,1147143982870,9580,9560,9300,-280,-2.92,9490,-90,-0.94,9260,9760,1400-4-6,2021-06-27
14,فرابورس,فرابورس ايران,13553,54647149,1772533492322,31091,32645,32440,1349,4.34,32436,1345,4.33,30000,32645,1400-4-6,2021-06-27
15,فولاد,فولاد مباركه اصفهان,12782,75911169,808570658720,10800,10650,10610,-190,-1.76,10650,-150,-1.39,10520,10820,1400-4-6,2021-06-27
16,زكوثر,سرمايه گذاري كشاورزي كوثر,11903,33115081,570593026290,17390,16530,17310,-80,-0.46,17230,-160,-0.92,16530,17980,1400-4-6,2021-06-27
17,خپارس,پارس‌ خودرو,11389,619798047,703224129014,1090,1090,1144,54,4.95,1135,45,4.13,1070,1144,1400-4-6,2021-06-27
18,حكشتي,كشتيراني جمهوري اسلامي ايران,10987,74303633,1226083165600,16030,16380,16180,150,0.94,16500,470,2.93,16070,16830,1400-4-6,2021-06-27
19,سپيدار,سپيدار سيستم آسيا,10936,1255261,67366653129,55322,55080,53024,-2298,-4.15,53667,-1655,-2.99,52800,55081,1400-4-6,2021-06-27
20,كزغال,زغال سنگ پروده طبس,10082,6657350,227259257881,34935,34450,33910,-1025,-2.93,34137,-798,-2.28,33630,35000,1400-4-6,2021-06-27
21,پترول,گ.س.وت.ص.پتروشيمي خليج فارس,9931,49936234,470705007590,9340,9280,9370,30,0.32,9430,90,0.96,9170,9650,1400-4-6,2021-06-27
22,چخزر,صنايع چوب خزر كاسپين,9832,1844134,61472794854,33928,33800,33100,-828,-2.44,33334,-594,-1.75,32600,34400,1400-4-6,2021-06-27
23,وآيند,بانك  آينده,9730,57008267,717825428868,12971,13200,12458,-513,-3.95,12592,-379,-2.92,12453,13250,1400-4-6,2021-06-27
24,رافزا,رايان هم افزا,9666,2544918,191656248888,74403,74417,76700,2297,3.09,75309,906,1.22,73500,76800,1400-4-6,2021-06-27
25,وتجارت,بانك تجارت,8930,287350861,729970985618,2558,2540,2530,-28,-1.09,2540,-18,-0.7,2526,2590,1400-4-6,2021-06-27
26,كرمان,س. توسعه و عمران استان كرمان,8829,297090753,331078051060,1128,1128,1102,-26,-2.3,1114,-14,-1.24,1092,1145,1400-4-6,2021-06-27
27,وبملت,بانك ملت,8254,186479086,776021128267,4182,4080,4185,3,0.07,4161,-21,-0.5,4080,4262,1400-4-6,2021-06-27
28,كمند,صندوق س. با درآمد ثابت كمند,8177,365302215,3697367835941,10116,10121,10121,5,0.05,10121,5,0.05,10121,10123,1400-4-6,2021-06-27
29,سصفها,سيمان‌اصفهان‌,8046,11114082,690881181080,63770,60590,66190,2420,3.79,62160,-1610,-2.52,60590,66800,1400-4-6,2021-06-27
30,تاپيكو,س. نفت و گاز و پتروشيمي تأمين,7990,203418807,2542500424530,11950,12390,12540,590,4.94,12500,550,4.6,12050,12540,1400-4-6,2021-06-27
31,كاما,باما,7841,51136692,460489973080,9240,9140,8860,-380,-4.11,9010,-230,-2.49,8780,9240,1400-4-6,2021-06-27
32,نوري,پتروشيمي نوري,7730,10205676,849400367400,80710,80900,84040,3330,4.13,83230,2520,3.12,79700,84690,1400-4-6,2021-06-27
33,شاروم,پتروشيمي اروميه,7212,5320289,81027868603,15292,14750,15000,-292,-1.91,15230,-62,-0.41,14750,15800,1400-4-6,2021-06-27
34,زملارد,كشاورزي و دامپروري ملارد شير,7153,1435192,43048164942,30039,29890,29539,-500,-1.66,29995,-44,-0.15,29400,30800,1400-4-6,2021-06-27
35,ذوب,سهامي ذوب آهن  اصفهان,7084,112600924,418866050658,3785,3700,3675,-110,-2.91,3720,-65,-1.72,3637,3819,1400-4-6,2021-06-27
36,كالا,بورس كالاي ايران,6321,16820910,571260769150,32900,34540,33100,200,0.61,33960,1060,3.22,33000,34540,1400-4-6,2021-06-27
37,غزر,صنعتي زر ماكارون,6022,2652576,63615132420,24250,23600,23720,-530,-2.19,23980,-270,-1.11,23600,24460,1400-4-6,2021-06-27
38,خبهمن,گروه‌بهمن‌,5602,197713261,274583685572,1363,1369,1389,26,1.91,1389,26,1.91,1335,1421,1400-4-6,2021-06-27
39,چفيبر,فيبر ايران‌,5418,35923473,298542582630,8570,8200,8220,-350,-4.08,8310,-260,-3.03,8150,8890,1400-4-6,2021-06-27
40,شگويا,پتروشيمي تندگويان,5407,23547334,213425150342,9205,9000,8951,-254,-2.76,9064,-141,-1.53,8900,9300,1400-4-6,2021-06-27
41,وبصادر,بانك صادرات ايران,5331,115649384,257101387990,2233,2170,2203,-30,-1.34,2223,-10,-0.45,2170,2280,1400-4-6,2021-06-27
42,وسپهر,سرمايه گذاري مالي سپهرصادرات,5157,11276707,103057547152,9133,9100,9096,-37,-0.41,9139,6,0.07,9094,9295,1400-4-6,2021-06-27
43,ولپارس,ليزينگ پارسيان,5064,10809298,45489911420,4224,4251,4156,-68,-1.61,4208,-16,-0.38,4100,4300,1400-4-6,2021-06-27
44,ثاميد,توسعه و عمران اميد,5041,39065874,64229633376,1685,1651,1635,-50,-2.97,1644,-41,-2.43,1614,1680,1400-4-6,2021-06-27
45,آبادا,توليد نيروي برق آبادان,4970,4480427,53517904260,11460,11450,12030,570,4.97,11940,480,4.19,11450,12030,1400-4-6,2021-06-27
46,آريا,پليمر آريا ساسول,4668,2533946,218033802980,86182,87450,85590,-592,-0.69,86045,-137,-0.16,85000,87450,1400-4-6,2021-06-27
47,هاي وب,داده گسترعصرنوين-هاي وب,4605,25916004,212757775030,8410,8210,8140,-270,-3.21,8210,-200,-2.38,8100,8400,1400-4-6,2021-06-27
48,وپويا,سرمايه گذاري پويا,4565,13927166,66354487406,4782,4864,4700,-82,-1.71,4764,-18,-0.38,4640,4892,1400-4-6,2021-06-27
49,كسرام,پارس‌ سرام‌,4522,45026803,318455450210,7270,6910,7240,-30,-0.41,7070,-200,-2.75,6910,7370,1400-4-6,2021-06-27
50,وكبهمن,مديريت سرمايه گذاري كوثربهمن,4510,3071639,35221317526,11326,11537,11490,164,1.45,11467,141,1.24,11270,11549,1400-4-6,2021-06-27
51,غگل,گلوكوزان‌,4318,53686826,185901592732,3611,3490,3431,-180,-4.98,3463,-148,-4.1,3431,3580,1400-4-6,2021-06-27
52,غگيلا,شيرپاستوريزه پگاه گيلان,4256,4171764,62752096540,15566,15500,14850,-716,-4.6,15042,-524,-3.37,14788,15500,1400-4-6,2021-06-27
53,وغدير,سرمايه‌گذاري‌غدير(هلدينگ‌,4093,27942565,329721388620,11850,11410,11700,-150,-1.27,11800,-50,-0.42,11410,12090,1400-4-6,2021-06-27
54,خزاميا,زامياد,4025,62250524,413782210790,6470,6290,6790,320,4.95,6650,180,2.78,6220,6790,1400-4-6,2021-06-27
55,غشاذر,پگاه‌آذربايجان‌غربي‌,4019,38293149,297205667830,7960,7650,7760,-200,-2.51,7760,-200,-2.51,7570,8200,1400-4-6,2021-06-27
56,ثبهساز,بهساز كاشانه تهران,3974,28652776,56674924993,2023,2000,1954,-69,-3.41,1978,-45,-2.22,1942,2030,1400-4-6,2021-06-27
57,داوه,داروسازي آوه سينا,3950,8402469,153467221433,18764,18765,17956,-808,-4.31,18265,-499,-2.66,17826,19200,1400-4-6,2021-06-27
58,وخارزم,سرمايه گذاري خوارزمي,3917,35441444,168018542777,4738,4798,4704,-34,-0.72,4741,3,0.06,4600,4899,1400-4-6,2021-06-27
59,سيلام,سيمان‌ ايلام‌,3716,24609043,240272633700,10790,9720,9720,-1070,-9.92,9760,-1030,-9.55,9720,9920,1400-4-6,2021-06-27
60,لكما,كارخانجات‌مخابراتي‌ايران‌,3596,40763526,152880455911,3656,3602,3765,109,2.98,3750,94,2.57,3602,3765,1400-4-6,2021-06-27
61,دتوزيع,توزيع دارو پخش,3547,6277884,175276489216,28097,27050,28402,305,1.09,27920,-177,-0.63,26693,29040,1400-4-6,2021-06-27
62,ثشاهد,سرمايه‌ گذاري‌ شاهد,3518,20849258,296570426840,13610,14000,14290,680,5,14220,610,4.48,13620,14290,1400-4-6,2021-06-27
63,خرينگ,رينگ‌سازي‌مشهد,3494,4640427,198878791180,41300,43360,42700,1400,3.39,42860,1560,3.78,39300,43360,1400-4-6,2021-06-27
64,فولاي,صنايع فولاد آلياژي يزد,3461,7507784,285597317923,37709,35824,39593,1884,5,38040,331,0.88,35824,39594,1400-4-6,2021-06-27
65,فاراك,ماشين‌ سازي‌ اراك‌,3426,81216982,167928517751,2112,2060,2035,-77,-3.65,2068,-44,-2.08,2021,2144,1400-4-6,2021-06-27
66,پلاسك,پلاسكوكار,3422,28237734,187651641760,6550,6230,6870,320,4.89,6650,100,1.53,6230,6870,1400-4-6,2021-06-27
67,ومعادنح,ح . توسعه‌معادن‌وفلزات‌,3410,23980407,152786711520,6380,6180,6320,-60,-0.94,6370,-10,-0.16,6120,6520,1400-4-6,2021-06-27
68,تسه0003,امتيازتسهيلات مسكن خرداد1400,3344,85803,47601884019,557834,557000,550000,-7834,-1.4,554781,-3053,-0.55,546002,567999,1400-4-6,2021-06-27
69,بپيوند,برق و انرژي پيوندگستر پارس,3313,1949180,23446670730,12114,11900,11790,-324,-2.67,12029,-85,-0.7,11660,12310,1400-4-6,2021-06-27
70,قشكر,شكرشاهرود,3235,41897450,126137820187,2946,3079,3004,58,1.97,3011,65,2.21,2940,3079,1400-4-6,2021-06-27
71,وپارس,بانك‌پارسيان‌,3218,72062461,201336943195,2844,2818,2758,-86,-3.02,2794,-50,-1.76,2750,2860,1400-4-6,2021-06-27
72,امين يكم,صندوق درآمد ثابت امين يكم فردا,3215,87818789,880400251612,10017,10027,10028,11,0.11,10025,8,0.08,10020,10031,1400-4-6,2021-06-27
73,افرا,افرانت,3163,5778388,154013507159,28821,25939,26570,-2251,-7.81,26653,-2168,-7.52,25939,27800,1400-4-6,2021-06-27
74,فخوز,فولاد  خوزستان,3162,18911118,314189842790,16640,16500,16600,-40,-0.24,16610,-30,-0.18,16360,16980,1400-4-6,2021-06-27
75,فاذر,صنايع‌ آذرآب‌,3131,101711667,122866879450,1225,1211,1226,1,0.08,1208,-17,-1.39,1175,1242,1400-4-6,2021-06-27
76,شبريز,پالايش نفت تبريز,3057,8405327,260089434880,31040,30740,30630,-410,-1.32,30940,-100,-0.32,30010,31930,1400-4-6,2021-06-27
77,لپارس,پارس‌ الكتريك‌,3054,1608254,125649032860,77360,77720,79100,1740,2.25,78130,770,1,76000,80500,1400-4-6,2021-06-27
78,امين,تامين سرمايه امين,3046,1071249,7738774360,7170,7180,7210,40,0.56,7180,10,0.14,7180,7300,1400-4-6,2021-06-27
79,سمگا,گروه سرمايه گذاري ميراث فرهنگي,3030,13020852,262947217143,21031,20640,20040,-991,-4.71,20194,-837,-3.98,19980,21230,1400-4-6,2021-06-27
80,شستا,سرمايه گذاري تامين اجتماعي,3015,42900547,563284182110,12510,13130,13130,620,4.96,13130,620,4.96,13130,13130,1400-4-6,2021-06-27
81,اخابر,مخابرات ايران,2996,27353887,221074822010,8180,8000,7970,-210,-2.57,8080,-100,-1.22,7870,8250,1400-4-6,2021-06-27
82,چكاپا,گروه صنايع كاغذ پارس,2954,34719529,128300669994,3772,3700,3654,-118,-3.13,3695,-77,-2.04,3620,3772,1400-4-6,2021-06-27
83,ديران,ايران‌دارو,2929,8721788,110594537990,13200,13200,12560,-640,-4.85,12680,-520,-3.94,12540,13200,1400-4-6,2021-06-27
84,تاصيكو,سرمايه گذاري صدرتامين,2842,30734706,327576560330,10320,10350,10400,80,0.78,10660,340,3.29,10300,10830,1400-4-6,2021-06-27
85,حريل,ريل پردازسير,2784,33423838,122429068133,3617,3640,3641,24,0.66,3663,46,1.27,3520,3770,1400-4-6,2021-06-27
86,وسلرستا,شركت س استان لرستان,2739,174577878,113281394440,628,658,659,31,4.94,649,21,3.34,620,659,1400-4-6,2021-06-27
87,بگيلان,توسعه مسير برق گيلان,2738,507763,9890054849,19670,19500,19255,-415,-2.11,19613,-57,-0.29,19030,19950,1400-4-6,2021-06-27
88,ثاخت,بين‌المللي‌توسعه‌ساختمان,2727,61734828,133732030446,2149,2119,2207,58,2.7,2166,17,0.79,2064,2225,1400-4-6,2021-06-27
89,خمحركه,نيرو محركه‌,2727,31854520,125878173803,3851,3950,4001,150,3.9,3952,101,2.62,3761,4042,1400-4-6,2021-06-27
90,فارس,صنايع پتروشيمي خليج فارس,2711,25970343,267145288130,10340,10390,10200,-140,-1.35,10290,-50,-0.48,10110,10390,1400-4-6,2021-06-27
91,بترانس,ايران‌ ترانسفو,2696,44385869,104152898309,2380,2355,2312,-68,-2.86,2347,-33,-1.39,2300,2409,1400-4-6,2021-06-27
92,خاهن,آهنگري‌ تراكتورسازي‌ ايران‌,2682,12917425,115215177260,9240,9020,8800,-440,-4.76,8920,-320,-3.46,8780,9330,1400-4-6,2021-06-27
93,پاسا,ايران‌ياساتايرورابر,2638,8501726,164778317500,18910,18410,19480,570,3.01,19380,470,2.49,18410,19850,1400-4-6,2021-06-27
94,فزرين,زرين معدن آسيا,2625,9036427,138325532142,15759,15450,15700,-59,-0.37,15308,-451,-2.86,14972,15757,1400-4-6,2021-06-27
95,پيزد,مجتمع صنايع لاستيك يزد,2622,496405,31422494995,63726,62465,62595,-1131,-1.77,63300,-426,-0.67,61701,66000,1400-4-6,2021-06-27
96,وآوا,سرمايه گذاري آوا نوين,2617,13911515,77239991440,5706,5600,5461,-245,-4.29,5552,-154,-2.7,5421,5780,1400-4-6,2021-06-27
97,ومعادن,توسعه‌معادن‌وفلزات‌,2590,27382862,245517296630,8950,8700,8980,30,0.34,8970,20,0.22,8660,9100,1400-4-6,2021-06-27
98,كلر,كلر پارس,2555,1911086,204763263184,102472,102940,107595,5123,5,107145,4673,4.56,102492,107595,1400-4-6,2021-06-27
99,شفن,پتروشيمي فناوران,2552,1049296,348522289350,317640,321000,333520,15880,5,332150,14510,4.57,319030,333520,1400-4-6,2021-06-27
100,كوير,توليدي فولاد سپيد فراب كوير,2496,9776922,133298683100,14110,13720,13530,-580,-4.11,13630,-480,-3.4,13460,14000,1400-4-6,2021-06-27
101,تاپكيش,تجارت الكترونيك پارسيان كيش,2478,10536806,121117945495,11975,11490,11392,-583,-4.87,11495,-480,-4.01,11377,11999,1400-4-6,2021-06-27
102,فروي,ذوب روي اصفهان,2438,2699316,84027470067,31633,31590,30840,-793,-2.51,31129,-504,-1.59,30710,31969,1400-4-6,2021-06-27
103,تپمپي,پمپ‌ سازي‌ ايران‌,2430,9568182,161119682870,17530,16660,16950,-580,-3.31,16840,-690,-3.94,16660,17260,1400-4-6,2021-06-27
104,تليسه,دامداري تليسه نمونه,2353,23032487,76113256693,3411,3360,3275,-136,-3.99,3305,-106,-3.11,3260,3398,1400-4-6,2021-06-27
105,شصدف,صنعتي دوده فام,2316,386129,11094258428,27364,28732,28732,1368,5,28334,970,3.54,28732,28732,1400-4-6,2021-06-27
106,داسوه,داروسازي‌ اسوه‌,2291,4223508,112897909430,25610,26690,26890,1280,5,26730,1120,4.37,26000,26890,1400-4-6,2021-06-27
107,فاسمين,كالسيمين‌,2286,13717969,219277984250,15330,15560,16050,720,4.7,15980,650,4.24,15100,16090,1400-4-6,2021-06-27
108,ختور,رادياتور ايران‌,2267,9662553,166828736180,16510,17300,17330,820,4.97,17270,760,4.6,16780,17330,1400-4-6,2021-06-27
109,سرو,صندوق س سروسودمند مدبران-سهام,2221,2254374,149663872770,65950,66000,65900,-50,-0.08,66390,440,0.67,64990,67500,1400-4-6,2021-06-27
110,بورس,بورس اوراق بهادار تهران,2216,13690658,418787689360,29160,30610,30610,1450,4.97,30590,1430,4.9,30080,30610,1400-4-6,2021-06-27
111,پتاير,ايران‌ تاير,2215,35412145,100370300685,2851,2854,2806,-45,-1.58,2834,-17,-0.6,2774,2898,1400-4-6,2021-06-27
112,غبهار,كشت وصنعت بهاران گلبهار خراسان,2206,3024232,67314149067,22344,22344,21890,-454,-2.03,22258,-86,-0.38,21680,22880,1400-4-6,2021-06-27
113,كيان,صندوق س. با درآمد ثابت كيان,2200,25617884,745058740041,29066,29085,29083,17,0.06,29084,18,0.06,29082,29089,1400-4-6,2021-06-27
114,سبزوا,سيمان لار سبزوار,2196,24015963,74771324468,3029,3119,3120,91,3,3113,84,2.77,3040,3180,1400-4-6,2021-06-27
115,وساپا,سرمايه‌گذاري‌ سايپا,2114,38209567,195511586450,5030,4860,5100,70,1.39,5120,90,1.79,4840,5250,1400-4-6,2021-06-27
116,مرقام,ايران‌ارقام‌,2096,7223685,112103467820,15520,15250,15410,-110,-0.71,15520,0,0,15130,15880,1400-4-6,2021-06-27
117,ونوين,بانك‌اقتصادنوين‌,2092,26154548,120963030187,4722,4600,4571,-151,-3.2,4625,-97,-2.05,4543,4728,1400-4-6,2021-06-27
118,بكام,كارخانجات توليدي شهيد قندي,2016,22854109,64432437147,2856,2735,2780,-76,-2.66,2819,-37,-1.3,2735,2930,1400-4-6,2021-06-27
119,اعتماد,صندوق س.اعتماد آفرين پارسيان-د,1989,41243230,1534226491700,37181,37199,37201,20,0.05,37199,18,0.05,37199,37202,1400-4-6,2021-06-27
120,غبهنوش,بهنوش‌ ايران‌,1972,1267515,73460384690,59150,59800,56610,-2540,-4.29,57960,-1190,-2.01,56350,60000,1400-4-6,2021-06-27
121,جم,پتروشيمي جم,1935,7441947,314260717990,40550,42560,42000,1450,3.58,42230,1680,4.14,41200,42570,1400-4-6,2021-06-27
122,غپآذر,شير پگاه آذربايجان شرقي,1916,1811114,85580744433,47114,49000,47110,-4,-0.01,47253,139,0.3,46500,49000,1400-4-6,2021-06-27
123,خمهر,مهركام‌پارس‌,1891,58145640,102920210933,1738,1740,1800,62,3.57,1770,32,1.84,1671,1823,1400-4-6,2021-06-27
124,كاوه,فولاد كاوه جنوب كيش,1875,12494795,245617949270,19870,19590,19620,-250,-1.26,19660,-210,-1.06,19290,19940,1400-4-6,2021-06-27
125,آگاس,صندوق س.هستي بخش آگاه-س,1870,1787249,125421933350,69848,69750,69609,-239,-0.34,70176,328,0.47,68700,71372,1400-4-6,2021-06-27
126,كبافق,معادن‌ بافق‌,1845,2503283,104048357030,39680,41550,41660,1980,4.99,41560,1880,4.74,40200,41660,1400-4-6,2021-06-27
127,فجر,فولاد اميركبيركاشان,1828,3968246,117551892250,29490,29500,30000,510,1.73,29620,130,0.44,28500,30420,1400-4-6,2021-06-27
128,ونيرو,سرمايه‌گذاري‌نيرو,1797,30750789,76544811053,2398,2380,2496,98,4.09,2489,91,3.79,2350,2517,1400-4-6,2021-06-27
129,ديرانح,ح . ‌ايران‌دارو,1787,7640625,74875074950,9790,10000,9440,-350,-3.58,9800,10,0.1,8820,10390,1400-4-6,2021-06-27
130,وبانك,سرمايه گذاري گروه توسعه ملي,1765,12870949,103282780430,8130,7800,8060,-70,-0.86,8020,-110,-1.35,7800,8150,1400-4-6,2021-06-27
131,كچاد,معدني‌وصنعتي‌چادرملو,1725,4941980,123998604410,24910,24930,25000,90,0.36,25090,180,0.72,24910,25500,1400-4-6,2021-06-27
132,ضخود7075,اختيارخ خودرو-2000-1400/07/07,1708,66418,21201386000,273,279,348,75,27.47,319,46,16.85,260,359,1400-4-6,2021-06-27
133,دتوليد,داروسازي توليد دارو,1705,6619632,101407172638,14672,14840,15405,733,5,15319,647,4.41,14840,15405,1400-4-6,2021-06-27
134,تبرك,گروه كارخانجات صنعتي تبرك,1702,3813727,57525931713,14940,14667,15180,240,1.61,15084,144,0.96,14570,15400,1400-4-6,2021-06-27
135,ولشرق,ليزينگ ايران و شرق,1682,10272692,68549593615,6512,6610,6659,147,2.26,6673,161,2.47,6450,6790,1400-4-6,2021-06-27
136,گكوثر,هتل پارسيان كوثر اصفهان,1678,37413073,87991122814,2258,2301,2350,92,4.07,2352,94,4.16,2268,2370,1400-4-6,2021-06-27
137,ختوقا,قطعات‌ اتومبيل‌ ايران‌,1676,32056856,68875891971,2119,2100,2148,29,1.37,2149,30,1.42,2060,2200,1400-4-6,2021-06-27
138,خودكفا,اقتصادي و خودكفايي آزادگان,1666,6289719,106700898128,17446,16930,17000,-446,-2.56,16964,-482,-2.76,16923,17440,1400-4-6,2021-06-27
139,گشان,توسعه بين المللي پديده شانديز,1662,4955267,98244905839,19530,19610,19897,367,1.88,19826,296,1.52,19300,19920,1400-4-6,2021-06-27
140,غفارس,شير پاستوريزه پگاه فارس,1651,6405564,94070533373,14162,14745,14870,708,5,14686,524,3.7,14162,14870,1400-4-6,2021-06-27
141,پارند,صندوق س. پارند پايدار سپهر,1646,70246184,790052864008,11242,11247,11247,5,0.04,11247,5,0.04,11246,11253,1400-4-6,2021-06-27
142,سبهان,سيمان‌ بهبهان‌,1633,1360110,76483649140,57590,55700,56370,-1220,-2.12,56230,-1360,-2.36,55420,57490,1400-4-6,2021-06-27
143,ستران,سيمان‌ تهران‌,1623,5106588,118349568890,22240,22680,23000,760,3.42,23180,940,4.23,22200,23350,1400-4-6,2021-06-27
144,زنگان,صنعت روي زنگان,1622,1093517,72527032589,65824,64960,65900,76,0.12,66325,501,0.76,63700,67650,1400-4-6,2021-06-27
145,شاراك,پتروشيمي شازند,1620,4705460,141372312200,29780,29900,30130,350,1.18,30040,260,0.87,29700,30600,1400-4-6,2021-06-27
146,خكاوه,سايپا ديزل,1614,33332441,116943676267,3416,3435,3518,102,2.99,3508,92,2.69,3388,3518,1400-4-6,2021-06-27
147,نوين,بيمه نوين,1565,11850270,58004011050,4913,4960,4918,5,0.1,4895,-18,-0.37,4835,4995,1400-4-6,2021-06-27
148,غصينو,صنعتي مينو,1558,3263892,159200737007,51228,48900,48812,-2416,-4.72,48776,-2452,-4.79,48667,51000,1400-4-6,2021-06-27
149,ماديرا,صنايع ماديران,1551,13479988,113556736147,8300,8390,8330,30,0.36,8424,124,1.49,8201,8600,1400-4-6,2021-06-27
150,غشهداب,كشت و صنعت شهداب ناب خراسان,1532,14008711,46262315504,3357,3290,3248,-109,-3.25,3302,-55,-1.64,3247,3400,1400-4-6,2021-06-27
151,كپارس,كاشي‌ پارس‌,1528,706061,78163562480,114490,115000,108870,-5620,-4.91,110700,-3790,-3.31,108770,116500,1400-4-6,2021-06-27
152,وتوصا,گروه س توسعه صنعتي ايران,1522,8677245,71840886250,8480,8550,8180,-300,-3.54,8280,-200,-2.36,8070,8600,1400-4-6,2021-06-27
153,ساوه,سيمان ساوه,1516,1303554,62415266793,47767,47800,48020,253,0.53,47881,114,0.24,46521,48390,1400-4-6,2021-06-27
154,كسعدي,كاشي‌ سعدي‌,1513,4675748,58583216760,12250,11880,12350,100,0.82,12530,280,2.29,11880,12840,1400-4-6,2021-06-27
155,تملت,تامين سرمايه بانك ملت,1490,9436556,47965366790,5130,5170,5140,10,0.19,5080,-50,-0.97,4960,5170,1400-4-6,2021-06-27
156,دماوند,توليد نيروي برق دماوند,1489,2240571,60372349029,27855,26850,26789,-1066,-3.83,26945,-910,-3.27,26511,27799,1400-4-6,2021-06-27
157,ولساپا,ليزينگ رايان‌ سايپا,1477,27104689,80150048460,2928,2928,2900,-28,-0.96,2957,29,0.99,2860,3050,1400-4-6,2021-06-27
158,سدور,سيمان‌ دورود,1457,8685630,69255090760,7780,7940,7900,120,1.54,7970,190,2.44,7610,8160,1400-4-6,2021-06-27
159,فرآور,فرآوري‌موادمعدني‌ايران‌,1444,2708503,79788470290,28820,30000,29300,480,1.67,29460,640,2.22,28010,30260,1400-4-6,2021-06-27
160,غپينو,پارس‌ مينو,1441,11783573,73543026570,6410,6260,6200,-210,-3.28,6240,-170,-2.65,6100,6440,1400-4-6,2021-06-27
161,چكاوه,صنايع‌كاغذسازي‌كاوه‌,1437,5328405,69978115200,13050,12580,13400,350,2.68,13130,80,0.61,12400,13610,1400-4-6,2021-06-27
162,كرماشا,صنايع پتروشيمي كرمانشاه,1436,2020299,70484599310,34010,34990,34400,390,1.15,34890,880,2.59,33670,35630,1400-4-6,2021-06-27
163,چدن,توليدي چدن سازان,1434,17972302,75067086911,4129,4128,4151,22,0.53,4177,48,1.16,4070,4240,1400-4-6,2021-06-27
164,البرز,بيمه البرز,1434,26148169,114047673598,4340,4288,4330,-10,-0.23,4362,22,0.51,4210,4450,1400-4-6,2021-06-27
165,غسالم,سالمين‌,1408,13793925,48354209581,3515,3550,3464,-51,-1.45,3505,-10,-0.28,3450,3580,1400-4-6,2021-06-27
166,كوثر,بيمه كوثر,1394,6914809,100061912951,14808,14999,14190,-618,-4.17,14471,-337,-2.28,14120,15000,1400-4-6,2021-06-27
167,شغدير,پتروشيمي غدير,1372,1901515,123309723030,63130,62500,63950,820,1.3,64850,1720,2.72,62500,66180,1400-4-6,2021-06-27
168,شپارس,بين‌ المللي‌ محصولات‌  پارس‌,1360,4846042,74436006410,15620,15900,14910,-710,-4.55,15360,-260,-1.66,14840,15900,1400-4-6,2021-06-27
169,سشرق,سيمان‌ شرق‌,1355,20007826,130136848510,6250,6250,6560,310,4.96,6500,250,4,6120,6560,1400-4-6,2021-06-27
170,دشيمي,شيمي‌ داروئي‌ داروپخش‌,1329,1670192,39430870980,23830,24350,23020,-810,-3.4,23610,-220,-0.92,22990,24350,1400-4-6,2021-06-27
171,وپست,پست بانك ايران,1328,6905636,159257574320,23460,23100,23200,-260,-1.11,23060,-400,-1.71,22500,23880,1400-4-6,2021-06-27
172,كگاز,شيشه‌ و گاز,1315,4816188,78402434540,15590,16000,16360,770,4.94,16280,690,4.43,15800,16360,1400-4-6,2021-06-27
173,وسكرمان,س.سهام عدالت استان كرمان,1313,71084301,57955392616,857,815,821,-36,-4.2,815,-42,-4.9,815,840,1400-4-6,2021-06-27
174,كگل,معدني و صنعتي گل گهر,1311,6618910,116578580870,17570,17480,17760,190,1.08,17610,40,0.23,17100,17870,1400-4-6,2021-06-27
175,وآرين,شركت توسعه اقتصادي آرين,1302,12720165,40922964672,3226,3270,3201,-25,-0.77,3217,-9,-0.28,3158,3305,1400-4-6,2021-06-27
176,ونيكي,سرمايه‌گذاري‌ ملي‌ايران‌,1294,9091778,85026138200,9440,9380,9220,-220,-2.33,9350,-90,-0.95,8990,9800,1400-4-6,2021-06-27
177,حفاري,حفاري شمال,1286,9937351,66236949640,6750,6660,6570,-180,-2.67,6670,-80,-1.19,6520,6880,1400-4-6,2021-06-27
178,سكرد,سيمان كردستان,1272,7367528,45941571330,6140,6100,6280,140,2.28,6240,100,1.63,5960,6400,1400-4-6,2021-06-27
179,خكمك,كمك‌فنرايندامين‌,1264,3441538,58220109480,16870,16900,16700,-170,-1.01,16920,50,0.3,16390,17500,1400-4-6,2021-06-27
180,وملي,گروه‌ صنعتي‌ ملي‌ (هلدينگ‌,1262,445050,58960933660,134590,134000,131020,-3570,-2.65,132480,-2110,-1.57,130300,135000,1400-4-6,2021-06-27
181,دانا,بيمه دانا,1256,9803645,47724683641,4806,4819,4998,192,4,4868,62,1.29,4650,4998,1400-4-6,2021-06-27
182,لابسا,آبسال‌,1255,1520472,55054121600,37010,38360,35210,-1800,-4.86,36210,-800,-2.16,35160,38360,1400-4-6,2021-06-27
183,كارين,صندوق س نگين سامان-ثابت,1252,52788791,529677737235,10028,10035,10034,6,0.06,10034,6,0.06,10032,10035,1400-4-6,2021-06-27
184,آسيا,بيمه آسيا,1245,29550814,53051030849,1810,1775,1788,-22,-1.22,1795,-15,-0.83,1775,1830,1400-4-6,2021-06-27
185,زبينا,كشاورزي و دامپروري بينالود,1243,17300453,47806138367,2712,2710,2813,101,3.72,2763,51,1.88,2651,2835,1400-4-6,2021-06-27
186,شلرد,كود شيميايي اوره لردگان,1242,11883703,72233840042,6221,6160,6035,-186,-2.99,6078,-143,-2.3,6035,6220,1400-4-6,2021-06-27
187,كحافظ,كاشي‌ وسراميك‌ حافظ‌,1237,5637593,46657572150,8160,8000,8410,250,3.06,8280,120,1.47,7760,8500,1400-4-6,2021-06-27
188,بزاگرس,نيروگاه زاگرس كوثر,1213,8665262,39067451230,4629,4461,4463,-166,-3.59,4509,-120,-2.59,4398,4677,1400-4-6,2021-06-27
189,كلوند,كاشي‌ الوند,1192,2336313,50139493600,21790,22050,20970,-820,-3.76,21460,-330,-1.51,20890,22250,1400-4-6,2021-06-27
190,وسپه,سرمايه‌گذاري‌ سپه‌,1187,16774666,114536985280,6840,6840,6780,-60,-0.88,6830,-10,-0.15,6620,7140,1400-4-6,2021-06-27
191,ارفع,شركت آهن و فولاد ارفع,1179,4683473,68700768613,14197,14091,14580,383,2.7,14657,460,3.24,13654,14906,1400-4-6,2021-06-27
192,شتوكا,توكا رنگ فولاد سپاهان,1172,3314551,101761738031,29313,30500,30778,1465,5,30702,1389,4.74,29920,30778,1400-4-6,2021-06-27
193,بكهنوج,توليد برق ماهتاب كهنوج,1167,24696675,35514068238,1456,1456,1440,-16,-1.1,1438,-18,-1.24,1420,1470,1400-4-6,2021-06-27
194,خموتور,موتورسازان‌تراكتورسازي‌ايران‌,1165,5904700,54980160860,9130,9000,9180,50,0.55,9310,180,1.97,8940,9530,1400-4-6,2021-06-27
195,كسرا,سراميك‌هاي‌صنعتي‌اردكان‌,1155,7486770,115114012500,15260,15390,15270,10,0.07,15380,120,0.79,14950,15750,1400-4-6,2021-06-27
196,تكمبا,كمباين‌ سازي‌ ايران‌,1153,8031208,54596777970,6960,6800,6700,-260,-3.74,6800,-160,-2.3,6620,7050,1400-4-6,2021-06-27
197,زاگرس,پتروشيمي زاگرس,1138,357768,78724311447,220111,221979,220800,689,0.31,220058,-53,-0.02,218000,221979,1400-4-6,2021-06-27
198,فلوله,لوله‌وماشين‌سازي‌ايران‌,1135,4171155,65248878240,16160,15750,15760,-400,-2.48,15640,-520,-3.22,15360,16100,1400-4-6,2021-06-27
199,آريان,سرمايه گذاري پارس آريان,1130,16306173,205216493246,12814,12600,12650,-164,-1.28,12585,-229,-1.79,12430,12985,1400-4-6,2021-06-27
200,تكشا,گسترش‌صنايع‌وخدمات‌كشاورزي‌,1127,3398017,108749123470,30570,31290,32090,1520,4.97,32000,1430,4.68,30130,32090,1400-4-6,2021-06-27
201,وصندوق,سرمايه‌گذاري‌صندوق‌بازنشستگي‌,1122,11599893,172878485920,14780,14600,14800,20,0.14,14900,120,0.81,14600,15300,1400-4-6,2021-06-27
202,قصفها,قنداصفهان‌,1120,493059,45003352410,91040,91710,90200,-840,-0.92,91270,230,0.25,88500,95000,1400-4-6,2021-06-27
203,ورنا,سرمايه‌گذاري‌ رنا(هلدينگ‌,1120,12052604,57967317603,4702,4550,4830,128,2.72,4810,108,2.3,4542,4923,1400-4-6,2021-06-27
204,وتوكا,سرمايه‌گذاري‌توكافولاد(هلدينگ,1116,8622986,77560362410,9020,8720,8940,-80,-0.89,8990,-30,-0.33,8710,9130,1400-4-6,2021-06-27
205,قمرو,قند مرودشت‌,1110,2239693,59523407030,26960,28200,25620,-1340,-4.97,26580,-380,-1.41,25620,28200,1400-4-6,2021-06-27
206,وصنعت,سرمايه گذاري توسعه صنعت وتجارت,1107,5821620,32328712270,5660,5660,5470,-190,-3.36,5550,-110,-1.94,5450,5700,1400-4-6,2021-06-27
207,وسپهح,ح . سرمايه‌گذاري‌ سپه‌,1097,70021675,385137895520,5810,6390,5500,-310,-5.34,5500,-310,-5.34,5500,6390,1400-4-6,2021-06-27
208,خچرخش,چرخشگر,1096,3886437,45821287490,11770,11270,11670,-100,-0.85,11790,20,0.17,11270,12200,1400-4-6,2021-06-27
209,وساخت,سرمايه‌ گذاري‌ ساختمان‌ايران‌,1089,1380080,68541481390,48120,48010,49200,1080,2.24,49660,1540,3.2,47120,50300,1400-4-6,2021-06-27
210,فولاژ,فولاد آلياژي ايران,1082,9489162,138822422850,13950,14200,14640,690,4.95,14630,680,4.87,14150,14640,1400-4-6,2021-06-27
211,فباهنر,مس‌ شهيدباهنر,1082,2259335,47019326250,21030,21590,20540,-490,-2.33,20810,-220,-1.05,20490,21590,1400-4-6,2021-06-27
212,كنور,توسعه معدني و صنعتي صبانور,1081,1008556,53037025220,51600,53880,52100,500,0.97,52450,850,1.65,51000,53880,1400-4-6,2021-06-27
213,فوكا,فولاد كاويان,1078,8257044,123341276647,14949,14750,14810,-139,-0.93,14938,-11,-0.07,14700,15068,1400-4-6,2021-06-27
214,ضخود7076,اختيارخ خودرو-2500-1400/07/07,1075,51668,6702188000,114,107,133,19,16.67,130,16,14.04,106,145,1400-4-6,2021-06-27
215,درازك,دارويي‌ رازك‌,1073,1635961,50657424100,30040,30300,30580,540,1.8,30960,920,3.06,28540,31540,1400-4-6,2021-06-27
216,شيران,س. صنايع‌شيميايي‌ايران,1073,5915351,128944839460,20920,21040,21960,1040,4.97,21800,880,4.21,20710,21960,1400-4-6,2021-06-27
217,رمپنا,گروه مپنا (سهامي عام),1073,5653071,78119541940,13960,13930,13600,-360,-2.58,13870,-90,-0.64,13500,14280,1400-4-6,2021-06-27
218,غشان,شيرپاستوريزه‌پگاه‌خراسان‌,1058,9007070,41157702422,4754,4550,4580,-174,-3.66,4569,-185,-3.89,4517,4730,1400-4-6,2021-06-27
219,ورازي,بيمه رازي,1055,27786734,35730840788,1251,1300,1260,9,0.72,1286,35,2.8,1230,1313,1400-4-6,2021-06-27
220,شپديس,پتروشيمي پرديس,1051,3773423,419430955600,111280,111280,110790,-490,-0.44,111150,-130,-0.12,109410,113400,1400-4-6,2021-06-27
221,وهور,مديريت انرژي اميد  تابان هور,1048,22722191,38929986275,1732,1740,1680,-52,-3,1716,-16,-0.92,1665,1765,1400-4-6,2021-06-27
222,زدشت,كشت و صنعت دشت خرم دره,1042,3014854,58361735431,18508,18751,19688,1180,6.38,19358,850,4.59,17910,19688,1400-4-6,2021-06-27
223,غمينو,شركت صنايع غذايي مينو شرق,1042,6723332,56112512530,8235,8270,8365,130,1.58,8346,111,1.35,8040,8490,1400-4-6,2021-06-27
224,خاذين,سايپاآذين‌,1041,17052426,49748495107,2877,2870,2907,30,1.04,2917,40,1.39,2820,2998,1400-4-6,2021-06-27
225,قرنح,ح . پديده شيمي قرن,1030,1693806,40650148580,23950,24060,24000,50,0.21,24000,50,0.21,23640,24700,1400-4-6,2021-06-27
226,فمراد,آلومراد,1030,581227,43624817460,74350,75000,75200,850,1.14,75060,710,0.95,70650,77990,1400-4-6,2021-06-27
227,كامياب,صندوق س. كامياب آشنا-د,1030,2519880,25198800000,10000,10000,10000,0,0,10000,0,0,10000,10000,1400-4-6,2021-06-27
228,قزوين,كارخانجات‌ قند قزوين‌,1020,3048297,69655317590,23720,23000,23250,-470,-1.98,22850,-870,-3.67,22540,23930,1400-4-6,2021-06-27
229,قشير,قند شيروان قوچان و بجنورد,1012,2098917,33901976977,16847,16723,16200,-647,-3.84,16152,-695,-4.13,16005,16900,1400-4-6,2021-06-27
230,دزهراوي,داروسازي‌زهراوي‌,1011,6214444,39313697540,6310,6340,6180,-130,-2.06,6330,20,0.32,6110,6480,1400-4-6,2021-06-27
231,وتوشه,سرمايه‌ گذاري‌ پارس‌ توشه‌,1007,6984768,40409103100,5880,5840,5700,-180,-3.06,5790,-90,-1.53,5610,5960,1400-4-6,2021-06-27
232,سصوفي,سيمان‌ صوفيان‌,1006,4244171,63415391650,14670,14870,15380,710,4.84,14940,270,1.84,14050,15400,1400-4-6,2021-06-27
233,رنيك,جنرال مكانيك,1000,2109760,41206107822,19110,19500,19630,520,2.72,19531,421,2.2,18580,19850,1400-4-6,2021-06-27
234,ثفارس,عمران‌وتوسعه‌فارس‌,990,12861167,105311233400,7800,8190,8190,390,5,8190,390,5,8100,8190,1400-4-6,2021-06-27
235,قاسم,قاسم ايران,987,4604609,44297090625,9870,9600,9510,-360,-3.65,9620,-250,-2.53,9430,9990,1400-4-6,2021-06-27
236,غگلستا,شير پاستوريزه پگاه گلستان,982,3292618,55409130253,17658,17100,16776,-882,-4.99,16828,-830,-4.7,16776,17480,1400-4-6,2021-06-27
237,حتايد,تايدواترخاورميانه,973,4238015,118811622250,28180,28000,28000,-180,-0.64,28030,-150,-0.53,27250,28900,1400-4-6,2021-06-27
238,كاذر,فرآورده‌هاي‌نسوزآذر,971,3623392,50610007320,13840,13450,13650,-190,-1.37,13970,130,0.94,13450,14280,1400-4-6,2021-06-27
239,ركيش,كارت اعتباري ايران كيش,961,7676986,119795024090,16390,15580,15580,-810,-4.94,15600,-790,-4.82,15580,15880,1400-4-6,2021-06-27
240,سيمرغ,سيمرغ,959,4348171,69065125280,16010,16060,15700,-310,-1.94,15880,-130,-0.81,15600,16140,1400-4-6,2021-06-27
241,ضخود7077,اختيارخ خودرو-3000-1400/07/07,959,52661,2990939000,52,52,57,5,9.62,57,5,9.62,49,65,1400-4-6,2021-06-27
242,غمارگ,مارگارين‌,957,4467452,102716204420,21920,22790,23000,1080,4.93,22990,1070,4.88,21960,23010,1400-4-6,2021-06-27
243,حسير,ريل سير كوثر,948,3026787,43576381302,14389,14300,14600,211,1.47,14397,8,0.06,13756,15035,1400-4-6,2021-06-27
244,كماسه,تامين‌ ماسه‌ ريخته‌گري‌,944,1277275,41134908400,32250,32000,32560,310,0.96,32210,-40,-0.12,31180,33180,1400-4-6,2021-06-27
245,فسرب,ملي‌ سرب‌وروي‌ ايران‌,942,694882,45858585880,63440,66610,66610,3170,5,65990,2550,4.02,63550,66610,1400-4-6,2021-06-27
246,ودي,بيمه  دي,940,2315995,49721044705,21128,21470,21200,72,0.34,21469,341,1.61,21136,21980,1400-4-6,2021-06-27
247,فنوال,نورد آلومينيوم‌,935,1518251,38930648980,25370,25170,25510,140,0.55,25640,270,1.06,24500,26560,1400-4-6,2021-06-27
248,وسگيلا,شركت س استان گيلان,932,35033250,23446146711,655,660,687,32,4.89,663,8,1.22,632,687,1400-4-6,2021-06-27
249,ساروم,سيمان‌اروميه‌,930,2766650,87664423860,30830,30500,31850,1020,3.31,31690,860,2.79,29500,32370,1400-4-6,2021-06-27
250,وبيمه,سرمايه‌ گذاري‌ صنعت‌ بيمه‌,930,18819771,32531714743,1741,1744,1713,-28,-1.61,1729,-12,-0.69,1705,1760,1400-4-6,2021-06-27
251,چكارن,كارتن‌ ايران‌,927,10933522,29274357369,2666,2679,2663,-3,-0.11,2677,11,0.41,2608,2730,1400-4-6,2021-06-27
252,دفارا,داروسازي‌ فارابي‌,926,966460,37109760820,38530,38900,37770,-760,-1.97,38400,-130,-0.34,37160,39800,1400-4-6,2021-06-27
253,وملل,اعتباري ملل,925,34887033,462605269735,13261,13261,13261,0,0,13260,-1,-0.01,13001,13280,1400-4-6,2021-06-27
254,كفپارس,فرآورده‌هاي‌ نسوز پارس‌,924,10143370,31446306779,3166,3122,3090,-76,-2.4,3100,-66,-2.08,3060,3199,1400-4-6,2021-06-27
255,سرچشمه,سرمايه گذاري مس سرچشمه,920,6401328,45648309200,7148,7250,7140,-8,-0.11,7131,-17,-0.24,7030,7254,1400-4-6,2021-06-27
256,كيميا,معدني كيمياي زنجان گستران,906,3908239,53493048557,13796,13950,13800,4,0.03,13687,-109,-0.79,13215,13950,1400-4-6,2021-06-27
257,ونفت,سرمايه‌گذاري‌ صنعت‌ نفت‌,902,2622361,36872996580,14440,14400,13850,-590,-4.09,14060,-380,-2.63,13720,14500,1400-4-6,2021-06-27
258,حبندر,دريايي و کشتيراني خط دريابندر,893,1955262,50377993553,24781,23961,25530,749,3.02,25765,984,3.97,23961,26020,1400-4-6,2021-06-27
259,زشريف,كشت وصنعت شريف آباد,880,6579684,27242631668,4232,4110,4080,-152,-3.59,4140,-92,-2.17,4041,4270,1400-4-6,2021-06-27
260,وسينا,بانك سينا,861,18996374,49959617807,2689,2605,2580,-109,-4.05,2630,-59,-2.19,2572,2740,1400-4-6,2021-06-27
261,بهپاك,صنعتي بهپاك,860,6121529,43679998857,6913,7258,6945,32,0.46,7135,222,3.21,6900,7258,1400-4-6,2021-06-27
262,ولبهمن,شركت بهمن ليزينگ,854,4382523,30197851743,6778,6954,7000,222,3.28,6891,113,1.67,6552,7035,1400-4-6,2021-06-27
263,خوساز,محورسازان‌ايران‌خودرو,852,9443951,57855140080,5960,5750,6250,290,4.87,6130,170,2.85,5750,6250,1400-4-6,2021-06-27
264,بنو,بيمه تجارت نو,850,3323049,65560623576,19701,19900,19748,47,0.24,19729,28,0.14,19701,19900,1400-4-6,2021-06-27
265,سخوز,سيمان خوزستان,840,3651238,88651965770,23400,24440,24000,600,2.56,24280,880,3.76,23570,24570,1400-4-6,2021-06-27
266,غگلپا,شير پاستوريزه پگاه گلپايگان,831,810049,45418974865,55307,55900,56500,1193,2.16,56069,762,1.38,53750,57432,1400-4-6,2021-06-27
267,پدرخش,درخشان‌ تهران‌,826,1129706,30189848260,27770,26450,26390,-1380,-4.97,26720,-1050,-3.78,26390,27530,1400-4-6,2021-06-27
268,غويتا,ويتانا,820,2130639,20712323802,9818,9970,9650,-168,-1.71,9721,-97,-0.99,9611,9970,1400-4-6,2021-06-27
269,شسپا,نفت سپاهان,816,4045380,65167884400,16140,16190,16010,-130,-0.81,16110,-30,-0.19,15670,16290,1400-4-6,2021-06-27
270,وبوعلي,سرمايه‌گذاري‌بوعلي‌,811,8814518,35269448115,3910,3910,3964,54,1.38,4001,91,2.33,3772,4089,1400-4-6,2021-06-27
271,شبهرن,نفت‌ بهران‌,807,2599149,28235227360,10920,11050,10780,-140,-1.28,10890,-30,-0.27,10750,11050,1400-4-6,2021-06-27
272,تسه0002,امتيازتسهيلاتمسكن ارديبهشت1400,806,12708,7104446114,568337,546666,550000,-18337,-3.23,559053,-9284,-1.63,541000,590000,1400-4-6,2021-06-27
273,وثوق,سرمايه گذاري وثوق امين,802,3434911,47745677085,13503,13900,13908,405,3,13900,397,2.94,13576,13908,1400-4-6,2021-06-27
274,پخش,پخش البرز,801,3219604,60911013004,18344,18200,19261,917,5,18919,575,3.13,17613,19261,1400-4-6,2021-06-27
275,كروي,توسعه‌ معادن‌ روي‌ ايران‌,793,2709512,60873839040,22460,21900,22300,-160,-0.71,22470,10,0.04,21900,23000,1400-4-6,2021-06-27
276,واميد,گروه مديريت سرمايه گذاري اميد,791,3675803,36684868800,9630,9830,9740,110,1.14,9730,100,1.04,9630,10110,1400-4-6,2021-06-27
277,سخاش,سيمان‌خاش‌,789,252827,22324070860,87290,88570,88000,710,0.81,88300,1010,1.16,84540,89890,1400-4-6,2021-06-27
278,كمنگنز,معادن‌منگنزايران‌,783,575535,37342713520,64030,64920,64050,20,0.03,64880,850,1.33,64030,66270,1400-4-6,2021-06-27
279,تشتاد,صنايع توليدي اشتاد ايران‌,783,2846954,21743401822,7699,7801,7480,-219,-2.84,7637,-62,-0.81,7469,7928,1400-4-6,2021-06-27
280,شبصير,توليدات پتروشيمي قائد بصير,770,1291546,94907676322,72836,74000,72500,-336,-0.46,73484,648,0.89,72000,77500,1400-4-6,2021-06-27
281,زشگزا,شير و گوشت زاگرس شهركرد,770,4786597,28540137734,5936,5900,5900,-36,-0.61,5963,27,0.45,5850,6099,1400-4-6,2021-06-27
282,ومهان,گروه توسعه مالي مهر آيندگان,760,2659048,34457038303,13011,12784,12900,-111,-0.85,12976,-35,-0.27,12670,13170,1400-4-6,2021-06-27
283,اپرداز,آتيه داده پرداز,759,1490944,28299630047,19785,18890,19000,-785,-3.97,18981,-804,-4.06,18796,19550,1400-4-6,2021-06-27
284,صبا,سرمايه گذاري صبا تامين,757,11513414,90852349874,7516,7891,7891,375,4.99,7778,262,3.49,7891,7891,1400-4-6,2021-06-27
285,آوا,صندوق س.سهام آواي معيار-س,753,6920886,50586214284,7321,7300,7309,-12,-0.16,7309,-12,-0.16,7249,7425,1400-4-6,2021-06-27
286,اتكاي,بيمه اتكايي ايرانيان,732,2249297,21626135985,9734,9820,9421,-313,-3.22,9615,-119,-1.22,9380,10006,1400-4-6,2021-06-27
287,فباهنرح,ح . مس‌ شهيدباهنر,729,2925207,48324380270,16890,16820,16300,-590,-3.49,16520,-370,-2.19,16200,16940,1400-4-6,2021-06-27
288,ياقوت,صندوق س ياقوت آگاه-ثابت,727,21146552,265487410433,12546,12550,12553,7,0.06,12555,9,0.07,12549,12558,1400-4-6,2021-06-27
289,رانفور,خدمات‌انفورماتيك‌,725,4002175,22184700510,5600,5640,5530,-70,-1.25,5580,-20,-0.36,5480,5640,1400-4-6,2021-06-27
290,مبين,مبين انرژي خليج فارس,721,5007515,85335180280,16680,16930,16900,220,1.32,16920,240,1.44,16510,17330,1400-4-6,2021-06-27
291,ضخود7074,اختيارخ خودرو-1800-1400/07/07,718,23667,11156626000,420,400,489,69,16.43,471,51,12.14,400,494,1400-4-6,2021-06-27
292,دكوثر,داروسازي‌ كوثر,692,9236217,39974914940,4161,4200,4369,208,5,4328,167,4.01,4111,4369,1400-4-6,2021-06-27
293,خريخت,صنايع‌ريخته‌گري‌ايران‌,690,11100528,32891369611,2862,2880,3005,143,5,2963,101,3.53,2807,3005,1400-4-6,2021-06-27
294,مدير,ص.س.مديريت ثروت ص.بازنشستگي-س,677,3579462,30066745777,8413,8366,8370,-43,-0.51,8400,-13,-0.15,8301,8549,1400-4-6,2021-06-27
295,فايرا,آلومينيوم‌ايران‌,672,2145182,34472989580,16410,16380,15830,-580,-3.53,16220,-190,-1.16,15750,16680,1400-4-6,2021-06-27
296,پارسان,گسترش نفت و گاز پارسيان,670,6622136,142751141310,21490,21000,21470,-20,-0.09,21560,70,0.33,21000,21840,1400-4-6,2021-06-27
297,لسرما,سرما آفرين‌,669,1787307,37267675170,20750,21060,20970,220,1.06,20850,100,0.48,20360,21500,1400-4-6,2021-06-27
298,دپارس,پارس‌ دارو,668,674448,22435326970,33560,33880,33880,320,0.95,33260,-300,-0.89,32430,33880,1400-4-6,2021-06-27
299,فسپا,گروه‌صنعتي‌سپاهان‌,665,1135416,46814841330,41310,41300,40980,-330,-0.8,41230,-80,-0.19,40580,41870,1400-4-6,2021-06-27
300,شدوص,دوده‌ صنعتي‌ پارس‌,663,1714186,29721906250,17570,17750,17100,-470,-2.68,17340,-230,-1.31,16990,17810,1400-4-6,2021-06-27
301,قرن,پديده شيمي قرن,661,673549,20365814150,30440,30000,30490,50,0.16,30270,-170,-0.56,29900,30930,1400-4-6,2021-06-27
302,شرانل,نفت ايرانول,660,924356,37950530767,40011,40600,41649,1638,4.09,41056,1045,2.61,40210,42000,1400-4-6,2021-06-27
303,كاردان,صندوق س تجارت شاخصي كاردان,659,272657,41712085070,151940,152100,153490,1550,1.02,152980,1040,0.68,150610,154700,1400-4-6,2021-06-27
304,ميدكو,هلدينگ صنايع  معدني خاورميانه,652,2017949,85655877950,42416,42420,42430,14,0.03,42438,22,0.05,42420,42800,1400-4-6,2021-06-27
305,دسبحا,گروه دارويي سبحان,643,3883345,63808561130,15670,16450,16450,780,4.98,16430,760,4.85,16010,16450,1400-4-6,2021-06-27
306,غبشهر,صنعتي‌ بهشهر,641,3974781,93207528660,22570,22580,23100,530,2.35,23450,880,3.9,22550,23690,1400-4-6,2021-06-27
307,سمازن,سيمان‌مازندران‌,635,2340085,29844617180,12660,12990,12780,120,0.95,12750,90,0.71,12550,13070,1400-4-6,2021-06-27
308,سامان,بانك سامان,628,6826381,61847776322,9113,8900,9060,-53,-0.58,9060,-53,-0.58,8900,9278,1400-4-6,2021-06-27
309,ولانا,شركت ليزينگ آريا دانا,627,894020,24626164784,26882,27500,27688,806,3,27545,663,2.47,26651,27688,1400-4-6,2021-06-27
310,رتاپ,تجارت الكترونيك  پارسيان,623,1701523,9076721160,5390,5260,5330,-60,-1.11,5360,-30,-0.56,5260,5450,1400-4-6,2021-06-27
311,تيپيكو,سرمايه گذاري دارويي تامين,621,1128008,47285582610,41190,42300,41550,360,0.87,41660,470,1.14,40810,42690,1400-4-6,2021-06-27
312,وسبحان,سرمايه گذاري سبحان,617,8688037,22086118130,2480,2536,2515,35,1.41,2542,62,2.5,2483,2578,1400-4-6,2021-06-27
313,افق,فروشگاههاي زنجيره اي افق كوروش,617,645073,42112896110,65390,65390,65470,80,0.12,65330,-60,-0.09,64800,65900,1400-4-6,2021-06-27
314,كشرق,صنعتي و معدني شمال شرق شاهرود,608,376539,22162492823,58301,60500,59500,1199,2.06,58858,557,0.96,57011,60500,1400-4-6,2021-06-27
315,نمرينو,ايران‌ مرينوس‌,604,267578,20310560510,74020,74020,76060,2040,2.76,75910,1890,2.55,71030,77530,1400-4-6,2021-06-27
316,همراه,شركت ارتباطات سيار ايران,602,1795565,36021034420,20400,19990,20150,-250,-1.23,20280,-120,-0.59,19610,20380,1400-4-6,2021-06-27
317,خكرمان,گروه اقتصادي كرمان خودرو,600,7507193,25802056814,3432,3400,3405,-27,-0.79,3437,5,0.15,3365,3488,1400-4-6,2021-06-27
318,پرديس,سرمايه گذاري پرديس,598,5055831,24511473391,4810,4835,4820,10,0.21,4848,38,0.79,4650,4945,1400-4-6,2021-06-27
319,دقاضي,داروسازي شهيد قاضي,585,1115936,30773927314,26891,26205,27697,806,3,27577,686,2.55,26205,27697,1400-4-6,2021-06-27
320,شخارك,پتروشيمي‌ خارك‌,581,950907,41597363800,43480,44000,43590,110,0.25,43590,110,0.25,43400,44000,1400-4-6,2021-06-27
321,دكپسول,توليد ژلاتين كپسول ايران,578,909058,24817837135,27104,27200,27160,56,0.21,27301,197,0.73,26100,27890,1400-4-6,2021-06-27
322,شوينده,مديريت صنعت شوينده ت.ص.بهشهر,578,1088253,24788726000,22920,23700,22850,-70,-0.31,22780,-140,-0.61,22200,23700,1400-4-6,2021-06-27
323,وسهرمز,شركت س استان هرمزگان,576,23814994,18675935398,818,778,800,-18,-2.2,797,-21,-2.57,778,825,1400-4-6,2021-06-27
324,شكلر,نيروكلر,573,1192564,39528049280,31750,32980,33330,1580,4.98,33150,1400,4.41,31890,33330,1400-4-6,2021-06-27
325,باران,بيمه زندگي باران50%تاديه,572,7816554,36693137933,4608,4639,4746,138,2.99,4694,86,1.87,4470,4746,1400-4-6,2021-06-27
326,وبهمن,سرمايه‌گذاري‌بهمن‌,572,3403663,44145240640,12430,12610,13050,620,4.99,12970,540,4.34,12580,13050,1400-4-6,2021-06-27
327,غشصفا,شيرپاستوريزه‌پگاه‌اصفهان‌,570,1042336,23014591260,23000,21890,21850,-1150,-5,22080,-920,-4,21850,22920,1400-4-6,2021-06-27
328,پلوله,گازلوله‌,567,1760556,43363094892,24843,25010,24120,-723,-2.91,24630,-213,-0.86,24098,25588,1400-4-6,2021-06-27
329,تسه0001,امتيازتسهيلات مسكن فروردين1400,564,7916,4429759110,574089,550000,569999,-4090,-0.71,559596,-14493,-2.52,547100,570000,1400-4-6,2021-06-27
330,ارزش,صندوق س ارزش آفرين بيدار-سهام,560,4063390,36285457640,8930,8730,8920,-10,-0.11,8930,0,0,8730,9010,1400-4-6,2021-06-27
331,وشهر,بانك شهر,560,6238224,33277936117,5408,5480,5286,-122,-2.26,5335,-73,-1.35,5281,5480,1400-4-6,2021-06-27
332,جوين,كشت و صنعت جوين,553,6024166,24391764101,4157,4070,4033,-124,-2.98,4049,-108,-2.6,4033,4200,1400-4-6,2021-06-27
333,پارس,پتروشيمي پارس,544,1049699,161157250960,154310,153600,154450,140,0.09,153530,-780,-0.51,152550,155000,1400-4-6,2021-06-27
334,طلا,صندوق س.پشتوانه طلاي لوتوس,544,402676,30470647697,75553,76002,75999,446,0.59,75670,117,0.15,75400,76040,1400-4-6,2021-06-27
335,دامين,داروسازي‌ امين‌,544,4372126,15771517828,3573,3660,3597,24,0.67,3607,34,0.95,3452,3700,1400-4-6,2021-06-27
336,فردا,صندوق س آواي فرداي زاگرس-ثابت,542,23809392,260491589014,10935,10940,10941,6,0.05,10941,6,0.05,10940,10942,1400-4-6,2021-06-27
337,ما,بيمه  ما,542,4351967,36120475420,7940,7950,8330,390,4.91,8300,360,4.53,7930,8330,1400-4-6,2021-06-27
338,خشرق,الكتريك‌ خودرو شرق‌,541,3984621,41117981370,9910,10120,10400,490,4.94,10320,410,4.14,9700,10400,1400-4-6,2021-06-27
339,اميد,تامين سرمايه اميد,537,3767678,25475011070,6790,7000,6610,-180,-2.65,6760,-30,-0.44,6560,7000,1400-4-6,2021-06-27
340,بپاس,بيمه پاسارگاد,531,778753,78767045055,101138,101990,101148,10,0.01,101144,6,0.01,101138,101990,1400-4-6,2021-06-27
341,ثتران,سرمايه گذاري مسكن تهران,527,5953192,17468860439,2993,2980,2900,-93,-3.11,2934,-59,-1.97,2850,3030,1400-4-6,2021-06-27
342,كاريس,صندوق س.سپهر كاريزما-س,526,3190300,38408612395,11842,11945,11960,118,1,12039,197,1.66,11800,12420,1400-4-6,2021-06-27
343,سيدكو,سرمايه گذاري توسعه صنايع سيمان,524,3771429,22700869840,5960,6020,6000,40,0.67,6020,60,1.01,5800,6200,1400-4-6,2021-06-27
344,وخاور,بانك خاورميانه,517,4868620,43816062100,8960,8900,8980,20,0.22,8990,30,0.33,8760,9100,1400-4-6,2021-06-27
345,توريل,توكاريل,512,1162501,16243796692,14183,14390,13800,-383,-2.7,13992,-191,-1.35,13474,14390,1400-4-6,2021-06-27
346,سمايه,بانك سرمايه,508,5644217,22435853802,3878,3950,3994,116,2.99,3975,97,2.5,3801,3994,1400-4-6,2021-06-27
347,درهآور,دارويي ره آورد تامين,507,724224,17402990083,24235,24470,23720,-515,-2.13,24030,-205,-0.85,23600,24570,1400-4-6,2021-06-27
348,بموتو,موتوژن‌,506,779335,42888823970,55470,55500,54720,-750,-1.35,55030,-440,-0.79,53550,55780,1400-4-6,2021-06-27
349,وصنا,گروه‌صنايع‌بهشهرايران‌,505,3707002,19181438120,5250,5160,5180,-70,-1.33,5170,-80,-1.52,5080,5310,1400-4-6,2021-06-27
350,شگل,گلتاش‌,503,2285662,17526708370,7630,7600,7690,60,0.79,7670,40,0.52,7560,7870,1400-4-6,2021-06-27
351,غشهد,شهد ايران ‌,503,2442280,11664676195,4873,4830,4708,-165,-3.39,4795,-78,-1.6,4703,4920,1400-4-6,2021-06-27
352,غشوكو,شوكو پارس,499,859245,20910918603,24942,24201,24621,-321,-1.29,24336,-606,-2.43,24194,24950,1400-4-6,2021-06-27
353,دعبيد,لابراتوارداروسازي‌  دكترعبيدي‌,495,1129224,26786985730,23350,23560,23800,450,1.93,23580,230,0.99,23510,24110,1400-4-6,2021-06-27
354,پكوير,كوير تاير,494,3947608,48596949830,12340,12450,12330,-10,-0.08,12310,-30,-0.24,12030,12600,1400-4-6,2021-06-27
355,وسكاب,س.ص.بازنشستگي كاركنان بانكها,494,7049403,19059357462,2654,2739,2690,36,1.36,2704,50,1.88,2660,2740,1400-4-6,2021-06-27
356,خصدرا,صنعتي‌ دريايي‌ ايران‌,494,11604468,29649415740,2481,2555,2555,74,2.98,2555,74,2.98,2555,2555,1400-4-6,2021-06-27
357,كفرا,فراورده‌ هاي‌ نسوزايران‌,488,1258535,24850084870,18910,19320,19850,940,4.97,19750,840,4.44,18930,19850,1400-4-6,2021-06-27
358,سپ,پرداخت الكترونيك سامان كيش,488,974195,26170717400,27850,27020,26800,-1050,-3.77,27370,-480,-1.72,26480,27500,1400-4-6,2021-06-27
359,وكار,بانك‌ كارآفرين‌,484,12253864,36313745257,2957,2971,2883,-74,-2.5,2962,5,0.17,2850,3002,1400-4-6,2021-06-27
360,كمينا,شيشه سازي مينا,484,2484653,58709955614,23002,23692,23692,690,3,23629,627,2.73,22510,23692,1400-4-6,2021-06-27
361,كهمدا,شيشه‌ همدان‌,477,1885105,17282122260,9120,9260,9270,150,1.64,9170,50,0.55,8860,9270,1400-4-6,2021-06-27
362,سپاها,سيمان‌سپاهان‌,471,4091519,31339664360,7630,7390,7630,0,0,7660,30,0.39,7380,7800,1400-4-6,2021-06-27
363,فخاس,فولاد خراسان,469,1372097,32124295450,22380,23000,23470,1090,4.87,22690,310,1.39,23000,23490,1400-4-6,2021-06-27
364,ثمسكن,سرمايه‌گذاري‌ مسكن‌,467,5814411,25320215657,4331,4382,4300,-31,-0.72,4355,24,0.55,4204,4439,1400-4-6,2021-06-27
365,دابور,داروسازي‌ ابوريحان‌,466,732698,23617807940,31610,32910,32200,590,1.87,32230,620,1.96,31620,32910,1400-4-6,2021-06-27
366,پاكشو,گروه صنعتي پاكشو,464,2653265,14986931970,5690,5850,5600,-90,-1.58,5680,-10,-0.18,5590,5850,1400-4-6,2021-06-27
367,افران,صندوق س افرا نماد پايدار-ثابت,464,6439887,87773056218,13620,13629,13633,13,0.1,13630,10,0.07,13628,13634,1400-4-6,2021-06-27
368,لبوتان,گروه‌صنعتي‌بوتان‌,459,414038,21956661460,50630,50980,52880,2250,4.44,53030,2400,4.74,50980,53160,1400-4-6,2021-06-27
369,شفا,سرمايه گذاري شفادارو,458,382541,14359742770,36890,37270,37570,680,1.84,37420,530,1.44,36000,38670,1400-4-6,2021-06-27
370,كقزوي,شيشه‌ قزوين‌,458,5756201,36908236170,6229,6415,6415,186,2.99,6412,183,2.94,6212,6415,1400-4-6,2021-06-27
371,شاوان,پالايش نفت لاوان,458,405696,33727028893,82522,83595,82950,428,0.52,83065,543,0.66,80810,85700,1400-4-6,2021-06-27
372,تنوين,تامين سرمايه نوين,454,15888603,110905560650,7090,7230,6930,-160,-2.26,6980,-110,-1.55,6900,7230,1400-4-6,2021-06-27
373,وپخش,داروپخش‌ (هلدينگ‌,454,272362,27865567860,97490,102200,102330,4840,4.96,101400,3910,4.01,102000,102360,1400-4-6,2021-06-27
374,وتوسم,سرمايه‌گذاري‌توسعه‌ملي‌,449,3025116,22595143540,7440,7700,7370,-70,-0.94,7470,30,0.4,7340,7700,1400-4-6,2021-06-27
375,خلنت,لنت‌ ترمزايران‌,448,295035,13625387360,46220,47830,45870,-350,-0.76,46190,-30,-0.06,45060,47830,1400-4-6,2021-06-27
376,آپ,آسان پرداخت پرشين,446,6617614,117727353060,16950,17790,17790,840,4.96,17790,840,4.96,17790,17790,1400-4-6,2021-06-27
377,بساما,بيمه سامان,436,1897255,46350790956,23297,24370,24461,1164,5,24430,1133,4.86,23342,24461,1400-4-6,2021-06-27
378,سغرب,سيمان‌غرب‌,434,769270,17810419260,22950,22840,23320,370,1.61,23150,200,0.87,22300,23500,1400-4-6,2021-06-27
379,وتوس,توسعه‌شهري‌توس‌گستر,433,1056650,11641530820,11320,11580,10960,-360,-3.18,11080,-240,-2.12,10890,11580,1400-4-6,2021-06-27
380,وگردش,بانك گردشگري,432,1329410,19295380426,14465,14530,14700,235,1.62,14476,11,0.08,14150,14700,1400-4-6,2021-06-27
381,دسبحان,سبحان دارو,427,994503,15581924400,14970,15710,15700,730,4.88,15650,680,4.54,15220,15710,1400-4-6,2021-06-27
382,سفارس,سيمان فارس و خوزستان,427,6321393,107021183490,16130,16930,16930,800,4.96,16930,800,4.96,16930,16930,1400-4-6,2021-06-27
383,فپنتا,سپنتا,426,45247,17509323210,385270,378000,389640,4370,1.13,386970,1700,0.44,378000,395960,1400-4-6,2021-06-27
384,شيراز,پتروشيمي‌شيراز,421,957039,53089180980,55660,55660,55660,0,0,55560,-100,-0.18,54060,57400,1400-4-6,2021-06-27
385,جم پيلن,پلي پروپيلن جم - جم پيلن,417,458504,33614368770,73700,73700,72990,-710,-0.96,73480,-220,-0.3,72000,74600,1400-4-6,2021-06-27
386,وثنو,سرمايه گذاري ساختماني نوين,411,4630626,19971081050,4223,4300,4349,126,2.98,4313,90,2.13,4180,4349,1400-4-6,2021-06-27
387,وسرضوي,س.سهام عدالت استان خراسان رضوي,411,19851876,18680615316,990,941,941,-49,-4.95,982,-8,-0.81,941,941,1400-4-6,2021-06-27
388,وپترو,سرمايه‌گذاري صنايع پتروشيمي‌,407,1607676,22426547120,14030,14200,13950,-80,-0.57,13950,-80,-0.57,13750,14410,1400-4-6,2021-06-27
389,تماوندح,ح . تامين سرمايه دماوند,406,14271035,46627921407,3319,3236,3220,-99,-2.98,3267,-52,-1.57,3220,3336,1400-4-6,2021-06-27
390,تسه9912,امتياز تسهيلات مسكن اسفند99,404,5329,3019046030,575268,561000,546505,-28763,-5,566531,-8737,-1.52,546505,604031,1400-4-6,2021-06-27
391,وتعاون,بيمه  تعاون,394,2066230,10796295802,5440,5169,5174,-266,-4.89,5225,-215,-3.95,5168,5429,1400-4-6,2021-06-27
392,سهگمت,سيمان‌هگمتان‌,389,962897,22135695430,22140,22200,23210,1070,4.83,22990,850,3.84,22160,23240,1400-4-6,2021-06-27
393,واتي,سرمايه‌ گذاري‌ آتيه‌ دماوند,381,4003446,40154429200,9640,10000,10120,480,4.98,10030,390,4.05,9800,10120,1400-4-6,2021-06-27
394,ختراك,ريخته‌گري‌ تراكتورسازي‌ ايران‌,380,2119462,22632923860,10270,10450,10780,510,4.97,10680,410,3.99,10330,10780,1400-4-6,2021-06-27
395,پارسيان,بيمه پارسيان,379,1121756,9411010790,8390,8600,8410,20,0.24,8390,0,0,8100,8600,1400-4-6,2021-06-27
396,بفجر,فجر انرژي خليج فارس,379,4640428,116210009780,23870,24450,25060,1190,4.99,25040,1170,4.9,23890,25060,1400-4-6,2021-06-27
397,سدشت,صنايع سيمان دشتستان,378,316821,18344712480,55640,53420,58420,2780,5,57160,1520,2.73,53420,58420,1400-4-6,2021-06-27
398,تصميم,صندوق س با درآمد ثابت تصميم,378,2679726,44695437972,16668,16681,16681,13,0.08,16679,11,0.07,16676,16682,1400-4-6,2021-06-27
399,دكيمي,كيميدارو,376,1068187,21697308040,20730,20200,20400,-330,-1.59,20310,-420,-2.03,20010,20990,1400-4-6,2021-06-27
400,كي بي سي,شركت كي بي سي,365,2090300,42697703066,19708,19708,20693,985,5,20427,719,3.65,19100,20693,1400-4-6,2021-06-27
401,شپاكسا,پاكسان‌,361,788266,17194602910,21580,21900,21290,-290,-1.34,21810,230,1.07,21250,22500,1400-4-6,2021-06-27
402,قهكمت,قندهكمتان‌,357,513938,16345572030,31240,30630,32600,1360,4.35,31800,560,1.79,30270,32700,1400-4-6,2021-06-27
403,اعتلا,شركت سرمايه گذاري اعتلاء البرز,353,1477221,9399344876,6400,6261,6305,-95,-1.48,6377,-23,-0.36,6261,6517,1400-4-6,2021-06-27
404,دتماد,توليدمواداوليه‌داروپخش‌,348,459874,18641429400,40250,40500,40500,250,0.62,40540,290,0.72,39500,41760,1400-4-6,2021-06-27
405,دارو,كارخانجات‌داروپخش‌,348,853841,15365893150,18210,17810,18200,-10,-0.05,18000,-210,-1.15,17650,18470,1400-4-6,2021-06-27
406,آكورد,صندوق س. آرمان آتي كوثر-د,347,3204973,105057602377,32763,32779,32779,16,0.05,32780,17,0.05,32779,32784,1400-4-6,2021-06-27
407,فسازان,غلتك سازان سپاهان,344,516405,15556834130,30280,30300,30210,-70,-0.23,30130,-150,-0.5,29500,30750,1400-4-6,2021-06-27
408,كگهر,سنگ آهن گهرزمين,342,335488,13738702647,39823,41000,40200,377,0.95,39948,125,0.31,40001,41500,1400-4-6,2021-06-27
409,تسه9908,امتياز تسهيلات مسكن آبان99,340,6149,3430454414,567722,550000,551000,-16722,-2.95,557888,-9834,-1.73,540120,596000,1400-4-6,2021-06-27
410,سقاين,سيمان‌ قائن‌,340,196924,9719994190,47920,50300,49100,1180,2.46,48800,880,1.84,47830,50300,1400-4-6,2021-06-27
411,تايرا,تراكتورسازي‌ايران‌,339,778668,20020397890,25400,25450,25100,-300,-1.18,25590,190,0.75,24990,25990,1400-4-6,2021-06-27
412,لوتوس,تامين سرمايه لوتوس پارسيان,335,1517084,11795400870,7600,7820,7600,0,0,7670,70,0.92,7550,7900,1400-4-6,2021-06-27
413,اطلس,صندوق س.توسعه اندوخته آينده-س,330,136232,29344505221,215952,213050,215000,-952,-0.44,215401,-551,-0.26,213050,216700,1400-4-6,2021-06-27
414,دالبر,البرزدارو,328,975422,12220446690,12110,12710,12250,140,1.16,12430,320,2.64,12130,12710,1400-4-6,2021-06-27
415,شنفت,نفت‌ پارس‌,327,252555,11427194620,46860,46290,45000,-1860,-3.97,46450,-410,-0.87,44610,46400,1400-4-6,2021-06-27
416,شكربن,كربن‌ ايران‌,319,166531,12418321080,74960,74960,74390,-570,-0.76,74640,-320,-0.43,73200,76990,1400-4-6,2021-06-27
417,شپاس,نفت پاسارگاد,319,462049,7955978684,17256,17720,16840,-416,-2.41,17238,-18,-0.1,16734,17720,1400-4-6,2021-06-27
418,دلر,داروسازي‌ اكسير,317,872467,23695219400,27600,27010,26800,-800,-2.9,27160,-440,-1.59,26610,27990,1400-4-6,2021-06-27
419,سرود,سيمان‌شاهرود,314,1302328,26053527570,19820,20070,20000,180,0.91,20010,190,0.96,19140,20200,1400-4-6,2021-06-27
420,زگلدشت,كشت و دام گلدشت نمونه اصفهان,314,1586342,17422513728,10476,10990,10999,523,4.99,10983,507,4.84,10600,10999,1400-4-6,2021-06-27
421,ولتجار,واسپاري تجارت وسرمايه ايرانيان,312,1954219,12599850501,6573,6699,6451,-122,-1.86,6448,-125,-1.9,6376,6699,1400-4-6,2021-06-27
422,سفانو,سيمان فارس نو,311,474444,11336865800,23420,23630,23900,480,2.05,23770,350,1.49,23630,24440,1400-4-6,2021-06-27
423,كخاك,صنايع‌خاك‌چيني‌ايران‌,309,670950,20017195420,30100,29750,29630,-470,-1.56,29830,-270,-0.9,29630,30660,1400-4-6,2021-06-27
424,فافزا,فولاد افزا سپاهان,297,356988,15016537544,43344,42044,42070,-1274,-2.94,42065,-1279,-2.95,42044,43338,1400-4-6,2021-06-27
425,پخشح,ح. پخش البرز,296,1147517,18436767869,15497,15497,16271,774,4.99,16067,570,3.68,14813,16271,1400-4-6,2021-06-27
426,تسه9911,امتياز تسهيلات مسكن بهمن99,294,3655,2035567926,575534,561100,549450,-26084,-4.53,556927,-18607,-3.23,547700,577959,1400-4-6,2021-06-27
427,غپونه,نوش پونه مشهد,291,634207,9392095439,15222,14800,14766,-456,-3,14833,-389,-2.56,14766,15190,1400-4-6,2021-06-27
428,بخاور,بيمه زندگي خاورميانه,287,1689316,9541514830,5669,5700,5567,-102,-1.8,5656,-13,-0.23,5530,5748,1400-4-6,2021-06-27
429,حسينا,توسعه خدمات دريايي وبندري سينا,286,445148,28610031173,64352,63300,62800,-1552,-2.41,64271,-81,-0.13,62731,66270,1400-4-6,2021-06-27
430,وسرمد,بيمه  سرمد,285,2228722,11211458190,4918,4997,5065,147,2.99,5030,112,2.28,4861,5065,1400-4-6,2021-06-27
431,شجم,صنايع پتروشيمي تخت جمشيد,282,2350411,22242496258,9380,9200,9390,10,0.11,9455,75,0.8,9200,9630,1400-4-6,2021-06-27
432,فالوم,آلومتك‌,280,449815,10528507694,24109,23900,23386,-723,-3,23406,-703,-2.92,23386,24000,1400-4-6,2021-06-27
433,پكرمان,گروه‌ صنعتي‌ بارز,279,1170393,30233839320,26160,25110,26000,-160,-0.61,25830,-330,-1.26,25110,26140,1400-4-6,2021-06-27
434,شاملا,معدني‌ املاح‌  ايران‌,279,410601,14848493720,36140,35900,37000,860,2.38,36160,20,0.06,34410,37400,1400-4-6,2021-06-27
435,ولملت,واسپاري ملت,279,2067632,10682779460,5200,5100,5170,-30,-0.58,5180,-20,-0.38,5100,5270,1400-4-6,2021-06-27
436,سخزر,سيمان‌ خزر,276,486671,8934397490,18600,17740,17990,-610,-3.28,18460,-140,-0.75,17740,19000,1400-4-6,2021-06-27
437,سيستم,همكاران سيستم,275,519676,13521539070,26260,26570,25910,-350,-1.33,26080,-180,-0.69,25820,26570,1400-4-6,2021-06-27
438,ساراب,سيمان‌ داراب‌,268,933382,19579788110,21640,21950,20860,-780,-3.6,20980,-660,-3.05,20860,21950,1400-4-6,2021-06-27
439,حخزر,كشتيراني درياي خزر,265,480219,10476441311,21383,21721,22228,845,3.95,21669,286,1.34,20500,22452,1400-4-6,2021-06-27
440,مداران,داده‌پردازي‌ايران‌,265,681184,11838474820,18090,17380,17200,-890,-4.92,17510,-580,-3.21,17190,18090,1400-4-6,2021-06-27
441,ثعتما,س. ساختماني اعتماد گستر,263,767475,25941788950,32193,33802,33802,1609,5,33801,1608,4.99,33000,33802,1400-4-6,2021-06-27
442,ثباغ,شهر سازي و خانه سازي باغميشه,262,690682,7137823678,10515,10240,10244,-271,-2.58,10428,-87,-0.83,10220,10600,1400-4-6,2021-06-27
443,سشمال,سيمان‌ شمال‌,262,1003674,8768520010,8660,8800,8740,80,0.92,8700,40,0.46,8420,8850,1400-4-6,2021-06-27
444,وارس,سرمايه گذاري ارس صبا,259,1399761,18900171618,13115,13470,13508,393,3,13502,387,2.95,13223,13508,1400-4-6,2021-06-27
445,سباقر,سيمان باقران,253,852874,12927289003,15038,14707,15150,112,0.74,15157,119,0.79,14707,15489,1400-4-6,2021-06-27
446,دسينا,داروسازي‌ سينا,249,623555,11554393630,18570,17960,18200,-370,-1.99,18540,-30,-0.16,17960,18800,1400-4-6,2021-06-27
447,فاما,صنعتي‌ آما,245,486577,7635258580,15990,15810,15880,-110,-0.69,15840,-150,-0.94,15200,16220,1400-4-6,2021-06-27
448,تسه9910,امتياز تسهيلات مسكن دي99,236,3556,1997175986,578258,556100,550000,-28258,-4.89,561636,-16622,-2.87,549346,604999,1400-4-6,2021-06-27
449,ضسپا8041,اختيارخ خساپا-1600-1400/08/26,233,7733,3746604000,417,415,500,83,19.9,484,67,16.07,415,600,1400-4-6,2021-06-27
450,وحكمت,بيمه حكمت صبا,229,2547420,7762512176,3067,3139,3015,-52,-1.7,3052,-15,-0.49,2990,3139,1400-4-6,2021-06-27
451,تسه9909,امتياز تسهيلات مسكن آذر99,229,3396,1896094362,569599,552558,548000,-21599,-3.79,558332,-11267,-1.98,542200,589990,1400-4-6,2021-06-27
452,آساميد,صندوق س.مشترك آسمان اميد -د,228,9266333,113492698043,12242,12246,12250,8,0.07,12248,6,0.05,12246,12251,1400-4-6,2021-06-27
453,سبجنو,سيمان‌ بجنورد,228,440224,14675979770,33270,32550,33650,380,1.14,33340,70,0.21,32550,33740,1400-4-6,2021-06-27
454,ريشمك,توليد و صادرات ريشمك,227,571820,25282449480,42109,44214,44214,2105,5,44214,2105,5,44214,44214,1400-4-6,2021-06-27
455,سپيدما,صندوق س. سپيد دماوند-د,225,9615316,101681805930,10569,10574,10575,6,0.06,10575,6,0.06,10574,10579,1400-4-6,2021-06-27
456,تماوند,تامين سرمايه دماوند,223,2535510,11772713361,4543,4555,4676,133,2.93,4634,91,2,4555,4679,1400-4-6,2021-06-27
457,خراسان,پتروشيمي خراسان,221,180614,11720749810,63350,63350,64550,1200,1.89,63740,390,0.62,63110,66000,1400-4-6,2021-06-27
458,واعتبار,سرمايه گذاري اعتبار ايران,220,1035920,7879506320,7720,7560,7710,-10,-0.13,7660,-60,-0.78,7510,7780,1400-4-6,2021-06-27
459,ساينا,صنايع بهداشتي ساينا,219,55054,7249199008,138172,134400,131264,-6908,-5,134827,-3345,-2.42,131264,134400,1400-4-6,2021-06-27
460,شپلي,پلي اكريل ايران,216,2542905,24259313700,9734,9540,9540,-194,-1.99,9540,-194,-1.99,9540,9540,1400-4-6,2021-06-27
461,بمپنا,توليد برق عسلويه  مپنا,212,263773,16589822259,61075,61800,63255,2180,3.57,62723,1648,2.7,61200,63750,1400-4-6,2021-06-27
462,بميلا,توسعه بازرگاني آهن وفولادميلاد,212,2735545,33931150731,12064,12425,12425,361,2.99,12404,340,2.82,12008,12425,1400-4-6,2021-06-27
463,پرداخت,به پرداخت ملت,212,196570,4360001060,22530,22400,22030,-500,-2.22,22470,-60,-0.27,22000,22910,1400-4-6,2021-06-27
464,خفنر,فنرسازي‌خاور,211,2755272,14061071504,4875,5110,5118,243,4.98,5073,198,4.06,4840,5118,1400-4-6,2021-06-27
465,كدما,معدني‌ دماوند,208,283033,35189492890,118410,124330,124330,5920,5,124330,5920,5,124330,124330,1400-4-6,2021-06-27
466,سكرما,سيمان‌ كرمان‌,207,628348,9318775970,14240,14930,14950,710,4.99,14580,340,2.39,14280,14950,1400-4-6,2021-06-27
467,دفرا,فرآورده‌هاي‌ تزريقي‌ ايران‌,207,571920,13363556010,22270,23380,23380,1110,4.98,23260,990,4.45,22590,23380,1400-4-6,2021-06-27
468,فيروزه,صندوق شاخص30 شركت فيروزه- سهام,205,134786,19204785850,143080,140000,144440,1360,0.95,142480,-600,-0.42,140000,144440,1400-4-6,2021-06-27
469,پسهند,صنايع‌ لاستيكي‌  سهند,203,298794,9098620650,30340,31000,30660,320,1.05,30410,70,0.23,29600,31000,1400-4-6,2021-06-27
470,كپرور,فرآوري زغال سنگ پروده طبس,201,485845,14106796103,27773,28950,29161,1388,5,28868,1095,3.94,28200,29161,1400-4-6,2021-06-27
471,سجام,مجتمع سيمان غرب آسيا,200,1076808,3893299541,3714,3640,3603,-111,-2.99,3674,-40,-1.08,3603,3737,1400-4-6,2021-06-27
472,ضخود7078,اختيارخ خودرو-3500-1400/07/07,200,8568,226476000,25,17,26,1,4,26,1,4,17,32,1400-4-6,2021-06-27
473,ضشنا8004,اختيارخ شپنا-10800-1400/08/16,197,3204,6549648000,2021,1949,2020,-1,-0.05,2044,23,1.14,1911,2200,1400-4-6,2021-06-27
474,سنوين,سرمايه گذاري اقتصاد نوين,193,456373,3979828809,8728,8480,8620,-108,-1.24,8725,-3,-0.03,8480,8989,1400-4-6,2021-06-27
475,شراز,پالايش نفت شيراز,192,74307,7377761758,97833,101900,99570,1737,1.78,98096,263,0.27,98135,101900,1400-4-6,2021-06-27
476,عيار,صندوق سكه طلاي مفيد,190,144320,3859084985,26652,26435,26710,58,0.22,26740,88,0.33,26435,26880,1400-4-6,2021-06-27
477,اتكام,شركت بيمه اتكايي امين,186,1022347,4508253800,4384,4340,4440,56,1.28,4392,8,0.18,4330,4479,1400-4-6,2021-06-27
478,زپارس,ملي كشت و صنعت و دامپروري پارس,183,179546,21052275770,118040,121900,114000,-4040,-3.42,117250,-790,-0.67,114000,121900,1400-4-6,2021-06-27
479,آرمان,بيمه آرمان,181,2164240,15147515760,6796,6999,6999,203,2.99,6999,203,2.99,6999,6999,1400-4-6,2021-06-27
480,دبالك,مواد اوليه دارويي البرز بالك,179,1105155,17158636530,14787,15526,15526,739,5,15526,739,5,15526,15526,1400-4-6,2021-06-27
481,آساس,صندوق س.آسمان آرماني سهام-س,175,54311,8725152896,160160,159150,159808,-352,-0.22,160652,492,0.31,159150,162190,1400-4-6,2021-06-27
482,تسه9810,امتياز تسهيلات مسكن دي98,172,3467,1925097625,559459,545490,555100,-4359,-0.78,555263,-4196,-0.75,540770,575000,1400-4-6,2021-06-27
483,وايرا,سرمايه گذاري صنايع ايران,170,695639,6774070521,10025,9725,9725,-300,-2.99,9819,-206,-2.05,9725,10040,1400-4-6,2021-06-27
484,شساخت,مهندسي و ساختمان صنايع نفت,161,487810,19232209053,39765,38600,39988,223,0.56,39601,-164,-0.41,38600,40000,1400-4-6,2021-06-27
485,اوصتا,صندوق انديشه ورزان صباتامين -د,160,13305574,253467734284,19015,19031,19031,16,0.08,19050,35,0.18,19030,19050,1400-4-6,2021-06-27
486,سكه0012پ01,تمام سكه طرح جديد0012رفاه,158,58700,61850938500,1053966,1050999,1057000,3034,0.29,1053679,-287,-0.03,1049011,1057800,1400-4-6,2021-06-27
487,خاور,ايران خودرو ديزل,152,2666924,16873628148,6143,6327,6327,184,3,6327,184,3,6327,6327,1400-4-6,2021-06-27
488,صايند,صندوق س. گنجينه آينده روشن-د,152,824700,8273239550,10035,10036,10020,-15,-0.15,10032,-3,-0.03,10020,10055,1400-4-6,2021-06-27
489,تسه9907,امتياز تسهيلات مسكن مهر99,150,2592,1448545454,569138,545000,547000,-22138,-3.89,558852,-10286,-1.81,545000,597594,1400-4-6,2021-06-27
490,والبر,سرمايه‌ گذاري‌ البرز(هلدينگ‌,149,2770304,23519880960,8090,8490,8490,400,4.94,8420,330,4.08,8490,8490,1400-4-6,2021-06-27
491,گوهر,صندوق سكه طلاي كيان,148,79660,4178875270,52254,52499,52306,52,0.1,52459,205,0.39,52000,52720,1400-4-6,2021-06-27
492,تسه9902,امتياز تسهيلات مسكن ارديبهشت99,147,1843,1025090542,571887,544444,600000,28113,4.92,556208,-15679,-2.74,543293,600000,1400-4-6,2021-06-27
493,اخزا910,اسنادخزانه-م10بودجه99-020807,147,315543,198016167483,627128,626122,626750,-378,-0.06,627541,413,0.07,626041,628127,1400-4-6,2021-06-27
494,سحرخيز,صندوق س. گروه زعفران سحرخيز,146,328103,2914440093,8892,9195,8870,-22,-0.25,8883,-9,-0.1,8800,9195,1400-4-6,2021-06-27
495,هجرت,پخش هجرت,140,1649981,34641351095,19996,20995,20995,999,5,20995,999,5,20995,20995,1400-4-6,2021-06-27
496,فجام,جام‌دارو,135,430756,3704501600,9550,8600,8600,-950,-9.95,9290,-260,-2.72,8600,8600,1400-4-6,2021-06-27
497,سپاس,صندوق س. پاداش سهامداري-ثابت,132,4679816,47361253860,10116,10121,10121,5,0.05,10120,4,0.04,10120,10124,1400-4-6,2021-06-27
498,شكبير,پتروشيمي اميركبير,130,377274,32549532215,87772,86506,86977,-795,-0.91,87269,-503,-0.57,85312,87500,1400-4-6,2021-06-27
499,غالبر,لبنيات‌ كالبر,129,254720,3920140800,16200,15390,15390,-810,-5,15970,-230,-1.42,15390,15390,1400-4-6,2021-06-27
500,وبازار,صندوق س شاخصي بازارآشنا,128,479635,4880162980,10210,10000,10160,-50,-0.49,10170,-40,-0.39,10000,10250,1400-4-6,2021-06-27
501,وساشرقي,شركت س استان آذربايجان شرقي,128,6113903,5288526095,910,865,865,-45,-4.95,907,-3,-0.33,865,865,1400-4-6,2021-06-27
502,دلقما,دارويي‌ لقمان‌,124,317324,8377353600,25150,26400,26400,1250,4.97,25780,630,2.5,26400,26400,1400-4-6,2021-06-27
503,تسه9904,امتياز تسهيلات مسكن تير99,121,1895,1084884173,583514,555550,607998,24484,4.2,572498,-11016,-1.89,554339,609999,1400-4-6,2021-06-27
504,ارمغان,ص سرمايه گذاري ارمغان ايرانيان,119,1801367,18230991433,10115,10119,10125,10,0.1,10121,6,0.06,10116,10129,1400-4-6,2021-06-27
505,غپاك,لبنيات‌ پاك‌,111,624814,14152037100,23840,22650,22650,-1190,-4.99,22650,-1190,-4.99,22650,22650,1400-4-6,2021-06-27
506,تسه9905,امتياز تسهيلات مسكن مرداد99,111,2065,1188687786,581523,564000,553000,-28523,-4.9,575636,-5887,-1.01,552447,607990,1400-4-6,2021-06-27
507,وبرق,س.کارکنان صنعت برق زنجان وقزوي,102,231114,15785548428,66313,68302,68302,1989,3,68302,1989,3,68302,68302,1400-4-6,2021-06-27
508,مارون,پتروشيمي مارون,100,10023,1456975171,143695,148000,145000,1305,0.91,143719,24,0.02,143700,148000,1400-4-6,2021-06-27
509,اخزا903,اسنادخزانه-م3بودجه99-011110,100,232543,169396705601,727914,720000,729500,1586,0.22,728453,539,0.07,720000,729500,1400-4-6,2021-06-27
510,زر,صندوق س.پشتوانه سكه طلاي زر,98,49756,2302145562,46216,46470,46121,-95,-0.21,46269,53,0.11,45863,46470,1400-4-6,2021-06-27
511,فراز,صندوق س.سهام فراز داريك-س,94,658628,7052655120,10653,10800,10730,77,0.72,10708,55,0.52,10653,10800,1400-4-6,2021-06-27
512,شرنگي,شيميايي رنگين,93,11359,2607758412,236429,229500,229337,-7092,-3,234588,-1841,-0.78,229337,234334,1400-4-6,2021-06-27
513,فردا2,صندوق س آواي فرداي زاگرس-ثابت,90,9000000,9000000,10935,1,1,-10934,-99.99,1,-10934,-99.99,1,1,1400-4-6,2021-06-27
514,خاتم,صندوق س خاتم ايساتيس پويا-ثابت,87,2050499,23198743311,11302,11314,11317,15,0.13,11314,12,0.11,11313,11319,1400-4-6,2021-06-27
515,تسه9903,امتياز تسهيلات مسكن خرداد99,86,1503,883295609,590776,580000,619998,29222,4.95,587688,-3088,-0.52,561238,620314,1400-4-6,2021-06-27
516,تسه9812,امتياز تسهيلات مسكن اسفند98,86,951,528072861,565827,537566,549000,-16827,-2.97,555282,-10545,-1.86,537566,593000,1400-4-6,2021-06-27
517,تسه9901,امتياز تسهيلات مسكن فروردين99,86,855,484554340,579834,575000,607995,28161,4.86,566730,-13104,-2.26,550843,607999,1400-4-6,2021-06-27
518,تسه9906,امتياز تسهيلات مسكن شهريور99,83,778,445357467,592123,621729,580000,-12123,-2.05,572439,-19684,-3.32,562517,621729,1400-4-6,2021-06-27
519,شفارا,پتروشيمي فارابي,83,2392984,8767893376,3558,3664,3664,106,2.98,3646,88,2.47,3664,3664,1400-4-6,2021-06-27
520,كساوه,صنايع‌ كاشي‌ و سراميك‌ سينا,82,187133,11703297820,69480,62540,62540,-6940,-9.99,63460,-6020,-8.66,62540,62540,1400-4-6,2021-06-27
521,دارا,صندوق س. دارا الگوريتم-د,82,1289831,12879773271,9982,9993,9984,2,0.02,9986,4,0.04,9978,9993,1400-4-6,2021-06-27
522,ثشرق,سرمايه گذاري مسكن شمال شرق,80,664278,3886026300,6490,5850,5850,-640,-9.86,6310,-180,-2.77,5850,5850,1400-4-6,2021-06-27
523,نهال,صندوق س. طلاي سرخ نوويرا,79,93386,820545731,8767,8800,8799,32,0.37,8787,20,0.23,8695,8909,1400-4-6,2021-06-27
524,سمتاز,سيمان ممتازان كرمان,75,107675,2804011708,25869,26220,26100,231,0.89,25915,46,0.18,25500,26395,1400-4-6,2021-06-27
525,ثامان,سامان‌ گستراصفهان‌,75,192479,3932345970,22690,20430,20430,-2260,-9.96,22030,-660,-2.91,20430,20430,1400-4-6,2021-06-27
526,تسه9808,امتياز تسهيلات مسكن آبان98,71,778,449746755,571912,560000,560022,-11890,-2.08,578081,6169,1.08,551000,600000,1400-4-6,2021-06-27
527,زعف0008پ05,زعفران0008نگين زرين(پ),71,23189,2932085459,125706,125101,128775,3069,2.44,126443,737,0.59,124540,128775,1400-4-6,2021-06-27
528,ضملي7003,اختيارخ فملي-11720-1400/07/11,70,603,1054445000,1832,1840,1702,-130,-7.1,1749,-83,-4.53,1600,1920,1400-4-6,2021-06-27
529,سيناد,صندوق س.سپهرسودمند سينا-د,70,607509,6075090000,10000,10000,10000,0,0,10000,0,0,10000,10000,1400-4-6,2021-06-27
530,ساروج,بين المللي ساروج بوشهر,69,1120185,18357123010,15913,15970,16390,477,3,16388,475,2.98,15970,16390,1400-4-6,2021-06-27
531,آتيمس,صندوق س.آرمان آتيه درخشان مس-س,67,14378,2468006330,171618,171660,170010,-1608,-0.94,171652,34,0.02,169101,172990,1400-4-6,2021-06-27
532,تسه9806,امتياز تسهيلات مسكن شهريور98,66,1397,824121055,592739,586510,585000,-7739,-1.31,589922,-2817,-0.48,583020,603500,1400-4-6,2021-06-27
533,اخزا902,اسنادخزانه-م2بودجه99-011019,65,192352,141677759308,735625,733565,736651,1026,0.14,736555,930,0.13,733565,737000,1400-4-6,2021-06-27
534,تمحركه,ماشين سازي نيرو محركه,64,189256,3167956184,17256,16739,16739,-517,-3,17087,-169,-0.98,16739,16739,1400-4-6,2021-06-27
535,تسه9811,امتياز تسهيلات مسكن بهمن98,64,455,257704151,569246,541002,596900,27654,4.86,566383,-2863,-0.5,541002,596900,1400-4-6,2021-06-27
536,ثهام,صندوق س ثروت هامرز-سهام,63,142072,1428065777,10139,10150,10050,-89,-0.88,10052,-87,-0.86,10050,10160,1400-4-6,2021-06-27
537,ثنوسا,نوسازي‌وساختمان‌تهران‌,63,121756,1350274040,11670,11090,11090,-580,-4.97,11610,-60,-0.51,11090,11090,1400-4-6,2021-06-27
538,اخزا815,اسنادخزانه-م15بودجه98-010406,63,157091,128834258927,820006,817100,820016,10,0,820125,119,0.01,817100,823000,1400-4-6,2021-06-27
539,دجابر,داروسازي‌ جابرابن‌حيان‌,62,113721,1510214880,13970,13280,13280,-690,-4.94,13900,-70,-0.5,13280,13280,1400-4-6,2021-06-27
540,حفارس,حمل و نقل بين المللي خليج فارس,62,424508,1778264012,4409,4189,4189,-220,-4.99,4381,-28,-0.64,4189,4189,1400-4-6,2021-06-27
541,اخزا908,اسنادخزانه-م8بودجه99-020606,62,159473,103624610290,648559,649400,648040,-519,-0.08,649794,1235,0.19,647532,651449,1400-4-6,2021-06-27
542,فيروزا,صندوق بادرآمد ثابت فيروزه آسيا,61,891866,20959105079,23495,23503,23532,37,0.16,23500,5,0.02,23460,23535,1400-4-6,2021-06-27
543,تسه9804,امتياز تسهيلات مسكن تير98,60,725,404050594,571306,551000,545030,-26276,-4.6,557311,-13995,-2.45,545010,566000,1400-4-6,2021-06-27
544,كيان2,صندوق س. با درآمد ثابت كيان,60,6000000,6000000,29066,1,1,-29065,-100,1,-29065,-100,1,1,1400-4-6,2021-06-27
545,تسه9809,امتياز تسهيلات مسكن آذر98,60,576,323209565,562050,540000,555549,-6501,-1.16,561128,-922,-0.16,540000,590152,1400-4-6,2021-06-27
546,وكادو,تكادو,59,606199,9921052834,15890,16366,16366,476,3,16335,445,2.8,16366,16366,1400-4-6,2021-06-27
547,صنوين,صندوق سرمايه‌گذاري صنوين-مختلط,59,8997,990577620,109650,109950,109000,-650,-0.59,110100,450,0.41,108510,111500,1400-4-6,2021-06-27
548,كترام,توليدي‌ كاشي‌ تكسرام‌,59,50602,2167789680,47600,42840,42840,-4760,-10,46840,-760,-1.6,42840,42840,1400-4-6,2021-06-27
549,اخزا901,اسنادخزانه-م1بودجه99-010621,57,71445,56200518854,785489,782102,786702,1213,0.15,786626,1137,0.14,782102,788000,1400-4-6,2021-06-27
550,اخزا911,اسنادخزانه-م11بودجه99-020906,57,153737,94847384216,617997,618000,615512,-2485,-0.4,616946,-1051,-0.17,614030,618800,1400-4-6,2021-06-27
551,فلامي,لاميران‌,56,339448,11222150880,34800,33060,33060,-1740,-5,33370,-1430,-4.11,33060,33060,1400-4-6,2021-06-27
552,اخزا906,اسنادخزانه-م6بودجه99-020321,56,17358,12104886226,697614,690556,699999,2385,0.34,697366,-248,-0.04,690100,700000,1400-4-6,2021-06-27
553,زعف0008پ15,زعفران0008پوشالمعمول طلاسرخ(پ),55,209841,19904504000,90000,94000,95000,5000,5.56,94855,4855,5.39,94000,95050,1400-4-6,2021-06-27
554,زرين,صندوق س. سهام زرين كوروش-س,53,172416,1692013712,9871,9880,9880,9,0.09,9814,-57,-0.58,9649,10090,1400-4-6,2021-06-27
555,فنورد,نوردوقطعات‌ فولادي‌,51,100775,15542528250,146890,154230,154230,7340,5,154130,7240,4.93,154230,154230,1400-4-6,2021-06-27
556,افق ملت,صندوق س در سهام افق ملت,51,7501,967900590,128210,128010,128360,150,0.12,129040,830,0.65,128010,130000,1400-4-6,2021-06-27
557,شصفها,پتروشيمي‌ اصفهان‌,51,183950,22348085500,119108,121490,121490,2382,2,121490,2382,2,121490,121490,1400-4-6,2021-06-27
558,ضپاس7030,اختيارخ وپارس-3000-1400/07/28,50,1181,313197000,287,309,240,-47,-16.38,265,-22,-7.67,230,309,1400-4-6,2021-06-27
559,ضپاس7029,اختيارخ وپارس-2500-1400/07/28,50,947,470517000,476,364,456,-20,-4.2,497,21,4.41,364,600,1400-4-6,2021-06-27
560,خفولا,خدمات فني فولاد يزد,48,41823,1676684070,41329,40090,40090,-1239,-3,41113,-216,-0.52,40090,40090,1400-4-6,2021-06-27
561,زعف0008پ16,زعفران0008نگين بيرجند(پ),47,55683,6932047194,124308,124500,124500,192,0.15,124491,183,0.15,124000,124900,1400-4-6,2021-06-27
562,تسه9805,امتياز تسهيلات مسكن مرداد98,47,499,285355361,585501,556860,565255,-20246,-3.46,571854,-13647,-2.33,556860,590000,1400-4-6,2021-06-27
563,سپر,صندوق س سپر سرمايه بيدار- ثابت,46,1249748,15140707823,12110,12118,12115,5,0.04,12115,5,0.04,12115,12118,1400-4-6,2021-06-27
564,تسه9807,امتياز تسهيلات مسكن مهر98,46,487,284683301,591747,563030,584100,-7647,-1.29,584565,-7182,-1.21,563030,590000,1400-4-6,2021-06-27
565,هاميد104,اختيارف ت ثاميد-2050-01/04/20,44,786290,786290,1,1,1,0,0,1,0,0,1,1,1400-4-6,2021-06-27
566,زقيام,كشت و دام قيام اصفهان,44,86147,2124385020,25957,24660,24660,-1297,-5,25763,-194,-0.75,24660,24660,1400-4-6,2021-06-27
567,كيسون,شركت كيسون,42,161966,1781626000,11224,11000,11000,-224,-2,11206,-18,-0.16,11000,11000,1400-4-6,2021-06-27
568,غچين,كشت‌ و صنعت‌ چين‌ چين,41,136766,2208770900,16990,16150,16150,-840,-4.94,16860,-130,-0.77,16150,16150,1400-4-6,2021-06-27
569,ضخود7073,اختيارخ خودرو-1600-1400/07/07,41,1486,958266000,566,633,655,89,15.72,645,79,13.96,600,673,1400-4-6,2021-06-27
570,هنوري102,اختيارف ت نوري59561-01/02/15,41,300000,300000,1,1,1,0,0,1,0,0,1,1,1400-4-6,2021-06-27
571,همبين102,اختيارف ت مبين17952-01/02/10,40,767530,767530,759,1,1,-758,-99.87,1,-758,-99.87,1,1,1400-4-6,2021-06-27
572,ضسپا8040,اختيارخ خساپا-1400-1400/08/26,40,1036,624043000,543,520,610,67,12.34,602,59,10.87,520,630,1400-4-6,2021-06-27
573,آكورد2,صندوق س. آرمان آتي كوثر-د,39,3900000,3900000,32763,1,1,-32762,-100,1,-32762,-100,1,1,1400-4-6,2021-06-27
574,خكار,ايركا پارت صنعت,38,35728,680618400,20050,19050,19050,-1000,-4.99,20000,-50,-0.25,19050,19050,1400-4-6,2021-06-27
575,معيار ,سرمايه گذاري معيار صنعت پارس,36,119723,4874761391,42860,40717,40717,-2143,-5,41741,-1119,-2.61,40717,40717,1400-4-6,2021-06-27
576,حتوكا,حمل‌ونقل‌توكا,36,96118,1796445420,19670,18690,18690,-980,-4.98,19550,-120,-0.61,18690,18690,1400-4-6,2021-06-27
577,ضملي7002,اختيارخ فملي-9720-1400/07/11,36,288,861549000,3127,3040,3020,-107,-3.42,2991,-136,-4.35,2901,3300,1400-4-6,2021-06-27
578,زعف0008پ10,زعفران0008نگين طلاي سرخ(پ),35,43337,5637044683,128800,130200,131933,3133,2.43,130075,1275,0.99,129500,131933,1400-4-6,2021-06-27
579,شلعاب,لعابيران‌,35,29359,344381070,12340,11730,11730,-610,-4.94,12330,-10,-0.08,11730,11730,1400-4-6,2021-06-27
580,ضشنا8005,اختيارخ شپنا-12800-1400/08/16,35,543,616175000,1206,1200,1188,-18,-1.49,1135,-71,-5.89,1111,1299,1400-4-6,2021-06-27
581,حپارسا,توسعه حمل و نقل ريلي پارسيان,35,239476,7814341356,34348,32631,32631,-1717,-5,33406,-942,-2.74,32631,32631,1400-4-6,2021-06-27
582,ثرود,سرمايه‌گذاري مسكن زاينده رود,34,181424,3033772128,17602,16722,16722,-880,-5,17414,-188,-1.07,16722,16722,1400-4-6,2021-06-27
583,نطرين,عطرين نخ قم,34,229218,2491599660,11442,10870,10870,-572,-5,11342,-100,-0.87,10870,10870,1400-4-6,2021-06-27
584,اخزا905,اسنادخزانه-م5بودجه99-020218,33,161237,111698196193,690000,690001,698000,8000,1.16,692758,2758,0.4,690000,698980,1400-4-6,2021-06-27
585,اخزا914,اسنادخزانه-م14بودجه99-021025,33,31790,19074551175,600639,600020,600020,-619,-0.1,600017,-622,-0.1,599300,603880,1400-4-6,2021-06-27
586,كاسپين,داروسازي كاسپين تامين,32,48789,944164728,20370,19352,19352,-1018,-5,20302,-68,-0.33,19352,19352,1400-4-6,2021-06-27
587,وزمين,بانك ايران زمين,32,1414976,16272224000,11979,11500,11500,-479,-4,11555,-424,-3.54,11500,11500,1400-4-6,2021-06-27
588,ضجار7040,اختيارخ وتجارت-2497-1400/07/21,32,738,232368000,302,318,290,-12,-3.97,315,13,4.3,290,330,1400-4-6,2021-06-27
589,ضشنا8002,اختيارخ شپنا-7800-1400/08/16,32,214,941138000,4431,4500,4200,-231,-5.21,4398,-33,-0.74,4110,4800,1400-4-6,2021-06-27
590,اخزا814,اسنادخزانه-م14بودجه98-010318,32,132359,109675454891,828068,825100,828611,543,0.07,828621,553,0.07,825100,830000,1400-4-6,2021-06-27
591,سخند,صندوق س.سپهرخبرگان نفت-د,31,1317750,13200855670,10028,10033,10026,-2,-0.02,10018,-10,-0.1,10000,10068,1400-4-6,2021-06-27
592,قنيشا,قند  نيشابور,30,26115,1375999350,55460,52690,52690,-2770,-4.99,55190,-270,-0.49,52690,52690,1400-4-6,2021-06-27
593,ثروتم,صندوق س. ثروت آفرين پارسيان-س,30,81870,6398298150,78061,78434,79500,1439,1.84,78152,91,0.12,77542,79825,1400-4-6,2021-06-27
594,ضخود7072,اختيارخ خودرو-1400-1400/07/07,30,213,179250000,802,940,880,78,9.73,842,40,4.99,800,940,1400-4-6,2021-06-27
595,هكوير109,اختيارف ت كوير-8194-01/09/20,30,400000,48000000,826,120,120,-706,-85.47,120,-706,-85.47,120,120,1400-4-6,2021-06-27
596,ثعمرا,عمران و توسعه شاهد,29,25323,291011916,12096,11492,11492,-604,-4.99,12084,-12,-0.1,11492,11492,1400-4-6,2021-06-27
597,ضملت8042,اختيارخ وبملت-3934-1400/08/19,29,589,435569000,723,700,721,-2,-0.28,740,17,2.35,700,750,1400-4-6,2021-06-27
598,سكه0012پ04,تمام سكه طرح جديد0012صادرات,28,5300,5577593300,1053053,1055000,1054500,1447,0.14,1052376,-677,-0.06,1048200,1055510,1400-4-6,2021-06-27
599,خزر,فنرسازي‌زر,28,317592,11947811040,39590,37620,37620,-1970,-4.98,37940,-1650,-4.17,37620,37620,1400-4-6,2021-06-27
600,ضسپا8042,اختيارخ خساپا-1800-1400/08/26,28,871,314890000,342,350,400,58,16.96,362,20,5.85,340,400,1400-4-6,2021-06-27
601,دمعيار,صندوق س. توازن معيار-د,28,308610,3095534247,10027,10031,10033,6,0.06,10031,4,0.04,10030,10034,1400-4-6,2021-06-27
602,وسديد,گروه ‌صنعتي‌سديد,27,148452,417743928,2871,2814,2814,-57,-1.99,2870,-1,-0.03,2814,2814,1400-4-6,2021-06-27
603,سكه0112پ03,تمام سكه طرح جديد0112سامان,27,5000,5260721300,1051365,1050000,1060000,8635,0.82,1052144,779,0.07,1050000,1060000,1400-4-6,2021-06-27
604,وگستر,گسترش سرمايه گذاري ايرانيان,26,26213,446617094,17934,17038,17038,-896,-5,17906,-28,-0.16,17038,17038,1400-4-6,2021-06-27
605,ضشنا8001,اختيارخ شپنا-6800-1400/08/16,26,356,1780058000,5417,4600,5200,-217,-4.01,5000,-417,-7.7,4600,5200,1400-4-6,2021-06-27
606,سكارون,سيمان كارون,26,13550,2289841600,177886,168992,168992,-8894,-5,176443,-1443,-0.81,168992,168992,1400-4-6,2021-06-27
607,اخزا909,اسنادخزانه-م9بودجه99-020316,26,92376,62791690340,680064,679500,679510,-554,-0.08,679740,-324,-0.05,677500,680404,1400-4-6,2021-06-27
608,وآذر,سرمايه‌گذاري‌توسعه‌آذربايجان‌,26,10325,748149500,76270,72460,72460,-3810,-5,76070,-200,-0.26,72460,72460,1400-4-6,2021-06-27
609,بالاس,مهندسي ساختمان تاسيسات راه آهن,26,18058,662475788,38616,36686,36686,-1930,-5,38526,-90,-0.23,36686,36686,1400-4-6,2021-06-27
610,قيستو,شركت قند بيستون,24,24053,364334307,15437,15167,15129,-308,-2,15415,-22,-0.14,15129,15400,1400-4-6,2021-06-27
611,ضسپا8043,اختيارخ خساپا-2000-1400/08/26,24,722,202227000,198,285,270,72,36.36,280,82,41.41,260,300,1400-4-6,2021-06-27
612,الماس,صندوق س.امين تدبيرگران فردا-س,24,3627,375361299,103125,103800,103887,762,0.74,103491,366,0.35,102117,104000,1400-4-6,2021-06-27
613,سكه0011پ02,تمام سكه طرح جديد0011ملت,24,12900,13606449900,1053546,1057597,1057000,3454,0.33,1054763,1217,0.12,1047000,1057597,1400-4-6,2021-06-27
614,داريك,صندوق س.اعتماد داريك-د,24,624885,6696792390,10714,10600,10720,6,0.06,10717,3,0.03,10600,10732,1400-4-6,2021-06-27
615,واحصا,احياء صنايع خراسان,23,163768,6907570472,44398,42179,42179,-2219,-5,42782,-1616,-3.64,42179,42179,1400-4-6,2021-06-27
616,خپويش,سازه‌ پويش‌,23,77784,4259451840,57640,54760,54760,-2880,-5,56760,-880,-1.53,54760,54760,1400-4-6,2021-06-27
617,غديس,پاكديس,22,43498,532850500,12894,12250,12250,-644,-4.99,12870,-24,-0.19,12250,12250,1400-4-6,2021-06-27
618,وملت,سرمايه گذاري ملت,22,107813,447208324,4320,4148,4148,-172,-3.98,4304,-16,-0.37,4148,4148,1400-4-6,2021-06-27
619,اخزا809,اسنادخزانه-م9بودجه98-000923,22,11475,10460745081,910029,910000,911899,1870,0.21,911612,1583,0.17,910000,912000,1400-4-6,2021-06-27
620,اخزا721,اسنادخزانه-م21بودجه97-000728,22,11749,11030235475,936187,936000,938716,2529,0.27,938823,2636,0.28,936000,941999,1400-4-6,2021-06-27
621,ساربيل,سيمان آرتا اردبيل,21,15809,765155600,50940,48400,48400,-2540,-4.99,50800,-140,-0.27,48400,48400,1400-4-6,2021-06-27
622,شستان,پتروشيمي گلستان,21,420680,1378989040,3414,3278,3278,-136,-3.98,3375,-39,-1.14,3278,3278,1400-4-6,2021-06-27
623,حپترو,حمل و نقل پتروشيمي( سهامي عام,20,5723,277679960,53910,48520,48520,-5390,-10,53800,-110,-0.2,48520,48520,1400-4-6,2021-06-27
624,سفاسي,شركت فارسيت اهواز,20,62208,513589248,8511,8256,8256,-255,-3,8497,-14,-0.16,8256,8256,1400-4-6,2021-06-27
625,هفجر102,اختيارف ت بفجر8626-01/02/11,20,750000,750000,1,1,1,0,0,1,0,0,1,1,1400-4-6,2021-06-27
626,بذر,صندوق س بذر اميد آفرين-سهام,20,4990,462559230,93340,91280,92900,-440,-0.47,92700,-640,-0.69,91280,94850,1400-4-6,2021-06-27
627,اخزا808,اسنادخزانه-م8بودجه98-000817,19,5166,4803486282,928217,927999,931000,2783,0.3,929827,1610,0.17,927999,931000,1400-4-6,2021-06-27
628,ومعلم,بيمه معلم,19,80307,355679703,4662,4429,4429,-233,-5,4656,-6,-0.13,4429,4429,1400-4-6,2021-06-27
629,وپسا,س. پتروشيمي ساختمان  خليج فارس,18,158003,303207757,1958,1919,1919,-39,-1.99,1956,-2,-0.1,1919,1919,1400-4-6,2021-06-27
630,فاهواز,نورد و لوله اهواز,18,24039,234788913,9865,9767,9767,-98,-0.99,9864,-1,-0.01,9767,9767,1400-4-6,2021-06-27
631,آسام,صندوق س.آرمان سپهر آشنا-م,18,15230,1638573020,106837,108365,107416,579,0.54,107589,752,0.7,107415,108373,1400-4-6,2021-06-27
632,گنجين,صندوق س. گنجينه يكم آويد-د,18,115265,1511827140,13107,13124,13115,8,0.06,13116,9,0.07,13111,13124,1400-4-6,2021-06-27
633,اخزا817,اسنادخزانه-م17بودجه98-010512,17,5612,4511267808,803376,803500,803510,134,0.02,803861,485,0.06,803500,806990,1400-4-6,2021-06-27
634,سدبير,س. تدبيرگران فارس وخوزستان,17,65074,5335482334,86306,81991,81991,-4315,-5,84690,-1616,-1.87,81991,81991,1400-4-6,2021-06-27
635,ضپال2007,اختيارخ اپال-32000-1401/02/12,17,327,103472000,323,310,296,-27,-8.36,316,-7,-2.17,296,350,1400-4-6,2021-06-27
636,زفكا,كشت و دامداري فكا,17,29037,312060639,11312,10747,10747,-565,-4.99,11300,-12,-0.11,10747,10747,1400-4-6,2021-06-27
637,لخزر,پارس‌ خزر,16,1901,316364420,175170,166420,166420,-8750,-5,174980,-190,-0.11,166420,166420,1400-4-6,2021-06-27
638,ضجار7038,اختيارخ وتجارت-1797-1400/07/21,15,457,363179000,659,789,820,161,24.43,795,136,20.64,789,820,1400-4-6,2021-06-27
639,اخزا904,اسنادخزانه-م4بودجه99-011215,15,45883,32781113542,714352,714301,714601,249,0.03,714450,98,0.01,714301,714700,1400-4-6,2021-06-27
640,چافست,افست‌,15,17870,262331600,15450,14680,14680,-770,-4.98,15440,-10,-0.06,14680,14680,1400-4-6,2021-06-27
641,ضملت8043,اختيارخ وبملت-4434-1400/08/19,15,285,116880000,410,499,450,40,9.76,410,0,0,400,499,1400-4-6,2021-06-27
642,ضسپا8039,اختيارخ خساپا-1200-1400/08/26,15,185,137469000,631,611,800,169,26.78,743,112,17.75,610,820,1400-4-6,2021-06-27
643,بسويچ,پارس‌سويچ‌,15,11601,296173530,26870,25530,25530,-1340,-4.99,26850,-20,-0.07,25530,25530,1400-4-6,2021-06-27
644,دروز,داروسازي‌ روزدارو,14,7696,233958400,31990,30400,30400,-1590,-4.97,31960,-30,-0.09,30400,30400,1400-4-6,2021-06-27
645,ضپنا8001,اختيارخ رمپنا-11850-1400/08/05,14,67,221350000,3286,2850,3300,14,0.43,3304,18,0.55,2850,3350,1400-4-6,2021-06-27
646,ضپيك7041,اختيارخ تاپيكو-7070-00/07/18,14,58,212000000,3999,3500,4100,101,2.53,3655,-344,-8.6,3500,4100,1400-4-6,2021-06-27
647,لخانه,لوازم‌ خانگي‌ پارس‌,14,7141,169170290,24422,23690,23690,-732,-3,24409,-13,-0.05,23690,23690,1400-4-6,2021-06-27
648,ضملي7004,اختيارخ فملي-13720-1400/07/11,14,87,87533000,1003,1029,951,-52,-5.18,1006,3,0.3,951,1030,1400-4-6,2021-06-27
649,تپكو,توليدتجهيزات‌سنگين‌هپكو,13,66677,352654653,5396,5289,5289,-107,-1.98,5395,-1,-0.02,5289,5289,1400-4-6,2021-06-27
650,ضصاد8033,اختيارخ وبصادر-2489-1400/08/12,13,450,117407000,84,300,220,136,161.9,261,177,210.71,123,300,1400-4-6,2021-06-27
651,اخزا821,اسنادخزانه-م21بودجه98-020906,13,3194,1984178435,618000,618500,618500,500,0.08,621221,3221,0.52,618500,628995,1400-4-6,2021-06-27
652,اخزا807,اسنادخزانه-م7بودجه98-000719,13,8972,8475839439,942882,942000,944999,2117,0.22,944699,1817,0.19,941110,949000,1400-4-6,2021-06-27
653,تملي804,تسهيلات مسكن ب. ملي-تير98,13,410,318059942,761893,723799,799987,38094,5,775756,13863,1.82,723799,799987,1400-4-6,2021-06-27
654,اخزا816,اسنادخزانه-م16بودجه98-010503,13,11704,9456870402,807141,808100,808002,861,0.11,808003,862,0.11,808002,808100,1400-4-6,2021-06-27
655,اراد50,مرابحه عام دولت5-ش.خ0302,12,300000,300000300000,1000001,1000000,1000001,0,0,1000001,0,0,1000001,1000001,1400-4-6,2021-06-27
656,زمگسا,كشاورزي‌ ودامپروي‌ مگسال‌,12,7768,235370400,31890,30300,30300,-1590,-4.99,31860,-30,-0.09,30300,30300,1400-4-6,2021-06-27
657,زعف0008پ09,زعفران0008نگين نوين(پ),12,2733,341449200,124001,125000,124203,202,0.16,124936,935,0.75,124203,126000,1400-4-6,2021-06-27
658,ضشنا8003,اختيارخ شپنا-8800-1400/08/16,12,67,233866000,3614,3970,3330,-284,-7.86,3491,-123,-3.4,3320,3977,1400-4-6,2021-06-27
659,ضپيك7042,اختيارخ تاپيكو-8070-00/07/18,12,407,1258335000,2877,3450,3200,323,11.23,3092,215,7.47,2900,3450,1400-4-6,2021-06-27
660,بالبر,كابل‌ البرز,12,3040,164129600,56830,53990,53990,-2840,-5,56800,-30,-0.05,53990,53990,1400-4-6,2021-06-27
661,ضفلا7004,اختيارخ فولاد-9586-1400/07/25,12,83,174326082,1563,1699,1560,-3,-0.19,1498,-65,-4.16,1403,1699,1400-4-6,2021-06-27
662,اخزا907,اسنادخزانه-م7بودجه99-020704,12,124921,79840531612,639000,639001,639000,0,0,639128,128,0.02,639000,639501,1400-4-6,2021-06-27
663,اخزا806,اسنادخزانه-م6بودجه98-000519,11,54106,52808548108,976228,974500,976000,-228,-0.02,976020,-208,-0.02,974500,977500,1400-4-6,2021-06-27
664,هپارس102,اختيارف ت پارس-157010-01/02/05,11,50613,50613,1,1,1,0,0,1,0,0,1,1,1400-4-6,2021-06-27
665,ولصنم,ليزينگ‌صنعت‌ومعدن‌,11,8582,86420740,10590,10070,10070,-520,-4.91,10590,0,0,10070,10070,1400-4-6,2021-06-27
666,زعف0008پ19,زعفران0008نگين تروند قاينات(پ),11,7045,875463140,124159,124000,126695,2536,2.04,124267,108,0.09,124000,126695,1400-4-6,2021-06-27
667,ضمخا7075,اختيارخ اخابر-8700-1400/07/28,10,124,107442000,973,930,800,-173,-17.78,866,-107,-11,800,1000,1400-4-6,2021-06-27
668,اخزا805,اسنادخزانه-م5بودجه98-000422,10,1051,1041635200,990970,991700,991000,30,0,991090,120,0.01,991000,991700,1400-4-6,2021-06-27
669,اراد61,مرابحه عام دولت61-ش.خ0309,10,240000,240000240000,1000001,1000001,1000001,0,0,1000001,0,0,1000001,1000001,1400-4-6,2021-06-27
670,هكوير110,اختيارف ت كوير-8281-01/10/05,10,1000000,168000000,400,168,168,-232,-58,168,-232,-58,168,168,1400-4-6,2021-06-27
671,ولغدر,ليزينگ‌خودروغدير,10,6050,125295500,21790,20710,20710,-1080,-4.96,21780,-10,-0.05,20710,20710,1400-4-6,2021-06-27
672,ضصاد8030,اختيارخ وبصادر-1589-1400/08/12,10,112,85653000,723,750,768,45,6.22,765,42,5.81,750,769,1400-4-6,2021-06-27
673,غدام,خوراك‌  دام‌ پارس‌,10,908,338411600,392310,372700,372700,-19610,-5,391840,-470,-0.12,372700,372700,1400-4-6,2021-06-27
674,زعف0008پ11,زعفران0008نگين سحرخيز(پ),10,5854,757573900,128449,128100,129500,1051,0.82,129411,962,0.75,128100,130490,1400-4-6,2021-06-27
675,جهرمح,ح.پتروشيمي جهرم,10,154500,78468000,514,544,484,-30,-5.84,508,-6,-1.17,484,544,1400-4-6,2021-06-27
676,اخزا718,اسنادخزانه-م18بودجه97-000525,10,1196,1164757314,972983,969500,976224,3241,0.33,973877,894,0.09,969500,976224,1400-4-6,2021-06-27
677,اخزا813,اسنادخزانه-م13بودجه98-010219,10,4874,4104253652,842514,842000,842005,-509,-0.06,842071,-443,-0.05,842000,842514,1400-4-6,2021-06-27
678,اخزا811,اسنادخزانه-م11بودجه98-001013,10,13007,11732318890,901109,902000,902001,892,0.1,902000,891,0.1,902000,902010,1400-4-6,2021-06-27
679,فيروزه2,صندوق شاخص30 شركت فيروزه- سهام,10,100000,100000,143080,1,1,-143079,-100,1,-143079,-100,1,1,1400-4-6,2021-06-27
680,اخزا713,اسنادخزانه-م13بودجه97-000518,9,25556,24941053924,976101,975760,976000,-101,-0.01,975937,-164,-0.02,974444,977000,1400-4-6,2021-06-27
681,ددام,داروسازي زاگرس فارمد پارس,9,15223,218145590,15080,14330,14330,-750,-4.97,15070,-10,-0.07,14330,14330,1400-4-6,2021-06-27
682,اخزا722,اسنادخزانه-م22بودجه97-000428,9,5204,5147886130,987001,989000,989300,2299,0.23,989217,2216,0.22,985010,989300,1400-4-6,2021-06-27
683,وسالت,بانك قرض الحسنه رسالت,9,67357,78470905,1110,1165,1165,55,4.95,1110,0,0,1165,1165,1400-4-6,2021-06-27
684,ثغرب,شركت سرمايه گذاري مسكن شمالغرب,9,12936,92945160,7563,7185,7185,-378,-5,7561,-2,-0.03,7185,7185,1400-4-6,2021-06-27
685,ضجار7039,اختيارخ وتجارت-1997-1400/07/21,9,185,124852000,657,601,650,-7,-1.07,675,18,2.74,601,710,1400-4-6,2021-06-27
686,اخزا723,اسنادخزانه-م23بودجه97-000824,9,7499,6948800886,925974,924999,925974,0,0,926630,656,0.07,924999,930000,1400-4-6,2021-06-27
687,هبساز103,اختيارف ت ثبهساز-2346-01/03/18,8,73349,73349,1,1,1,0,0,1,0,0,1,1,1400-4-6,2021-06-27
688,اراد53,مرابحه عام دولت5-ش.خ 0207,8,100000,95500000000,1000000,955000,955000,-45000,-4.5,955000,-45000,-4.5,955000,955000,1400-4-6,2021-06-27
689,فسا,پتروشيمي فسا,8,44444,74754808,1733,1682,1682,-51,-2.94,1733,0,0,1682,1682,1400-4-6,2021-06-27
690,ثترانح,ح سرمايه گذاري مسكن تهران,8,1044000,1848080000,1851,1790,1770,-81,-4.38,1770,-81,-4.38,1770,1790,1400-4-6,2021-06-27
691,ثاصفا,شركت‌ ساختمان‌ اصفهان‌,8,2858,73362002,27020,25669,25669,-1351,-5,27010,-10,-0.04,25669,25669,1400-4-6,2021-06-27
692,شزنگ,تجهيزنيروي‌زنگان‌,8,1546,231901546,154640,150001,150001,-4639,-3,154528,-112,-0.07,150001,150001,1400-4-6,2021-06-27
693,وجامي,سرمايه گذاري جامي,8,6490,89523060,14220,13794,13794,-426,-3,14216,-4,-0.03,13794,13794,1400-4-6,2021-06-27
694,حاريا,كشتيراني آريا,7,2926,49586922,17292,16947,16947,-345,-2,17288,-4,-0.02,16947,16947,1400-4-6,2021-06-27
695,وهنر,گروه توسعه هنر ايران,7,8455,62279530,7593,7366,7366,-227,-2.99,7592,-1,-0.01,7366,7366,1400-4-6,2021-06-27
696,زعف0008پ08,زعفران0008نگين روستا(پ),7,4531,573767089,125634,126666,126700,1066,0.85,126631,997,0.79,126499,126700,1400-4-6,2021-06-27
697,تكنار,مجتمع معادن مس تكنار,7,700,79215500,116664,113165,113165,-3499,-3,116635,-29,-0.02,113165,113165,1400-4-6,2021-06-27
698,غمهرا,توليدي‌مهرام‌,7,554,63372060,120410,114390,114390,-6020,-5,120380,-30,-0.02,114390,114390,1400-4-6,2021-06-27
699,اخزا820,اسنادخزانه-م20بودجه98-020806,7,111818,70333079150,628000,628500,629000,1000,0.16,628996,996,0.16,628500,629000,1400-4-6,2021-06-27
700,مفاخر,توسعه فناوري اطلاعات خوارزمي,7,1219,51278454,44280,42066,42066,-2214,-5,44272,-8,-0.02,42066,42066,1400-4-6,2021-06-27
701,تملي706,تسهيلات مسكن ب. ملي-شهريور97,7,56,37242016,633368,665036,665036,31668,5,665036,31668,5,665036,665036,1400-4-6,2021-06-27
702,وليز,ليزينگ‌ايران‌,7,17129,151934230,9330,8870,8870,-460,-4.93,9330,0,0,8870,8870,1400-4-6,2021-06-27
703,زعف0008پ18,زعفران0008نگين بهرامن(پ),7,8995,1166254000,128500,130200,129200,700,0.54,129656,1156,0.9,129200,130200,1400-4-6,2021-06-27
704,ثزاگرس,سرمايه گذاري توسعه عمران زاگرس,7,3597,194140881,56813,53973,53973,-2840,-5,56755,-58,-0.1,53973,53973,1400-4-6,2021-06-27
705,سفار,سيمان‌فارس‌,7,1130,143442200,133620,126940,126940,-6680,-5,133550,-70,-0.05,126940,126940,1400-4-6,2021-06-27
706,حآسا,آسيا سير ارس,6,3807,139142043,38472,36549,36549,-1923,-5,38453,-19,-0.05,36549,36549,1400-4-6,2021-06-27
707,دارا2,صندوق س. دارا الگوريتم-د,6,600000,600000,9982,1,1,-9981,-99.99,1,-9981,-99.99,1,1,1400-4-6,2021-06-27
708,زير0103پ01,زيره سبز0103كيميابذر(پ),6,40,28955640,689839,723891,723891,34052,4.94,723891,34052,4.94,723891,723891,1400-4-6,2021-06-27
709,نتوس,پشم‌ بافي‌ توس,6,2983,56146026,19812,18822,18822,-990,-5,19806,-6,-0.03,18822,18822,1400-4-6,2021-06-27
710,زير0103پ04,زيره سبز0103شركت مينوبذر(پ),6,150,107447830,687635,700000,721000,33365,4.85,716319,28684,4.17,700000,723891,1400-4-6,2021-06-27
711,تكنو,تكنوتار,6,59808,1129773120,19880,18890,18890,-990,-4.98,19800,-80,-0.4,18890,18890,1400-4-6,2021-06-27
712,پست0008پ08,پسته فندقي32-30مه ولات0008(پ),6,39,67538713,1704085,1700000,1788703,84618,4.97,1731762,27677,1.62,1670001,1788703,1400-4-6,2021-06-27
713,نگين,ص.س. زمين و ساختمان نگين شهرري,6,4600,218936000,47650,47580,47580,-70,-0.15,47590,-60,-0.13,47580,47650,1400-4-6,2021-06-27
714,كمرجان,بازرگاني و توليدي مرجان كار,6,656,90456496,145148,137891,137891,-7257,-5,145102,-46,-0.03,137891,137891,1400-4-6,2021-06-27
715,بشهاب,لامپ‌  پارس‌ شهاب‌,6,421,58716870,146810,139470,139470,-7340,-5,146780,-30,-0.02,139470,139470,1400-4-6,2021-06-27
716,اخزا818,اسنادخزانه-م18بودجه98-010614,6,1269,1001880527,788686,789502,789505,819,0.1,789504,818,0.1,789502,789505,1400-4-6,2021-06-27
717,آوا2,صندوق س.سهام آواي معيار-س,6,5200000,5200000,7321,1,1,-7320,-99.99,1,-7320,-99.99,1,1,1400-4-6,2021-06-27
718,بكاب,صنايع‌جوشكاب‌يزد,5,233,77344350,349420,331950,331950,-17470,-5,349330,-90,-0.03,331950,331950,1400-4-6,2021-06-27
719,وسيزد,شركت س استان يزد,5,24769,30119104,1280,1216,1216,-64,-5,1280,0,0,1216,1216,1400-4-6,2021-06-27
720,كتوكا,توليدي و خدمات صنايع نسوز توكا,5,2253,71359269,33339,31673,31673,-1666,-5,33331,-8,-0.02,31673,31673,1400-4-6,2021-06-27
721,زعف0008پ20,زعفران0008نگين وحدت جام(پ),5,4273,534610240,123446,124002,125000,1554,1.26,125114,1668,1.35,124002,125700,1400-4-6,2021-06-27
722,ثپرديس,سرمايه گذاري مسكن پرديس,5,6732,62378712,9753,9266,9266,-487,-4.99,9751,-2,-0.02,9266,9266,1400-4-6,2021-06-27
723,شسم,توليد سموم‌ علف‌ كش,5,1059,104890773,95238,99047,99047,3809,4,95315,77,0.08,99047,99047,1400-4-6,2021-06-27
724,وسصفا,شركت س استان اصفهان,5,53000,53901000,1070,1017,1017,-53,-4.95,1070,0,0,1017,1017,1400-4-6,2021-06-27
725,تملي712,تسهيلات مسكن ب. ملي-اسفند97,5,117,86269833,702238,737349,737349,35111,5,737349,35111,5,737349,737349,1400-4-6,2021-06-27
726,تپولا,مهندسي مرآت پولاد,5,1812,60352284,34337,33307,33307,-1030,-3,34331,-6,-0.02,33307,33307,1400-4-6,2021-06-27
727,وسنا,سرمايه گذاري نيروگاهي ايران,5,4675,70139025,15466,15003,15003,-463,-2.99,15464,-2,-0.01,15003,15003,1400-4-6,2021-06-27
728,گكيش,توريستي ورفاهي آبادگران كيش,5,2062,95866504,47929,46492,46492,-1437,-3,47915,-14,-0.03,46492,46492,1400-4-6,2021-06-27
729,ضصاد8031,اختيارخ وبصادر-1789-1400/08/12,5,82,47035000,569,555,620,51,8.96,574,5,0.88,550,620,1400-4-6,2021-06-27
730,اراد35,مرابحه عام دولت3-ش.خ 0103,4,5000,4999994600,953806,999997,999999,46193,4.84,999999,46193,4.84,999997,999999,1400-4-6,2021-06-27
731,ضمخا7071,اختيارخ اخابر-23700-1400/07/28,4,81,1215000,11,15,15,4,36.36,15,4,36.36,15,15,1400-4-6,2021-06-27
732,تفيرو,مهندسي فيروزا,4,3288,64171896,19135,19517,19517,382,2,19140,5,0.03,19517,19517,1400-4-6,2021-06-27
733,ثتوسا,س.توسعه و عمران استان اردبيل,4,3000,112968000,38820,37656,37656,-1164,-3,38806,-14,-0.04,37656,37656,1400-4-6,2021-06-27
734,ضسپا8044,اختيارخ خساپا-2500-1400/08/26,4,330,54700000,60,197,150,90,150,166,106,176.67,150,189,1400-4-6,2021-06-27
735,زماهان,مجتمع توليد گوشت مرغ ماهان,4,2367,40175091,17866,16973,16973,-893,-5,17863,-3,-0.02,16973,16973,1400-4-6,2021-06-27
736,زنجان,صنايع كشاورزي وكود زنجان,4,16195,145674025,9273,8995,8995,-278,-3,9270,-3,-0.03,8995,8995,1400-4-6,2021-06-27
737,خعمرا,توسعه و عمران شهرستان نائين,4,8457,257075886,29513,30398,30398,885,3,29535,22,0.07,30398,30398,1400-4-6,2021-06-27
738,ضمخا7076,اختيارخ اخابر-9700-1400/07/28,4,50,30000000,500,600,600,100,20,600,100,20,600,600,1400-4-6,2021-06-27
739,جهرم,پتروشيمي جهرم,4,21327,36383862,1758,1706,1706,-52,-2.96,1758,0,0,1706,1706,1400-4-6,2021-06-27
740,دشيري,شيرين دارو,4,103,22076505,220963,214335,214335,-6628,-3,220948,-15,-0.01,214335,214335,1400-4-6,2021-06-27
741,فكمند,گسترش قطعه سازي كمند,4,214486,3113264290,14093,14515,14515,422,2.99,14515,422,2.99,14515,14515,1400-4-6,2021-06-27
742,مهان01,اجاره مهرآيندگان لوتوس0311,4,200000,200000200000,1000001,1000001,1000001,0,0,1000001,0,0,1000001,1000001,1400-4-6,2021-06-27
743,اوان,مبين وان كيش,3,406,20548878,53276,50613,50613,-2663,-5,53272,-4,-0.01,50613,50613,1400-4-6,2021-06-27
744,اخزا810,اسنادخزانه-م10بودجه98-001006,3,3334,3018937000,905000,905500,905500,500,0.06,905500,500,0.06,905500,905500,1400-4-6,2021-06-27
745,ضجار7037,اختيارخ وتجارت-1597-1400/07/21,3,20,24100000,1037,1100,1250,213,20.54,1205,168,16.2,1100,1250,1400-4-6,2021-06-27
746,ضمخا7078,اختيارخ اخابر-7700-1400/07/28,3,35,44950000,1360,1210,1750,390,28.68,1284,-76,-5.59,1200,1750,1400-4-6,2021-06-27
747,صخود412,ص مرابحه خودرو412- 3ماهه 18%,3,30000,29850030000,995000,995001,995001,1,0,995001,1,0,995001,995001,1400-4-6,2021-06-27
748,سخواف,سيمان مجد خواف,3,3496,55743720,16438,15945,15945,-493,-3,16435,-3,-0.02,15945,15945,1400-4-6,2021-06-27
749,كپشير,پشم‌شيشه‌ايران‌,3,453,15687390,36450,34630,34630,-1820,-4.99,36450,0,0,34630,34630,1400-4-6,2021-06-27
750,ضجار7041,اختيارخ وتجارت-2997-1400/07/21,3,120,17490000,142,145,155,13,9.15,146,4,2.82,145,155,1400-4-6,2021-06-27
751,زكشت,كشاورزي مكانيزه اصفهان كشت,3,25734,933192042,38171,36263,36263,-1908,-5,38046,-125,-0.33,36263,36263,1400-4-6,2021-06-27
752,رتكو,كنترل‌خوردگي‌تكين‌كو,3,1453,23683900,17150,16300,16300,-850,-4.96,17150,0,0,16300,16300,1400-4-6,2021-06-27
753,ضمخا7077,اختيارخ اخابر-6700-1400/07/28,3,50,130000000,2490,2600,2600,110,4.42,2600,110,4.42,2600,2600,1400-4-6,2021-06-27
754,آ س پ,آ.س.پ,3,3725,56530600,15974,15176,15176,-798,-5,15971,-3,-0.02,15176,15176,1400-4-6,2021-06-27
755,ضترا8056,اختيارخ شتران-2558-1400/08/09,3,22,87820000,4045,4000,3820,-225,-5.56,3992,-53,-1.31,3820,4000,1400-4-6,2021-06-27
756,شپنا2,پالايش نفت اصفهان,3,299466348,4051779688440,13530,13530,13530,0,0,13530,0,0,13530,13530,1400-4-6,2021-06-27
757,ضملت8044,اختيارخ وبملت-4934-1400/08/19,3,8,2220000,240,300,240,0,0,277,37,15.42,240,300,1400-4-6,2021-06-27
758,غاذر,كشت‌وصنعت‌پياذر,3,1600,81744000,53770,51090,51090,-2680,-4.98,53750,-20,-0.04,51090,51090,1400-4-6,2021-06-27
759,ومشان,س. فني و مهندسي مشانير,3,348,23036208,68243,66196,66196,-2047,-3,68238,-5,-0.01,66196,66196,1400-4-6,2021-06-27
760,ضپاس7027,اختيارخ وپارس-1800-1400/07/28,3,6,5980000,881,990,1000,119,13.51,997,116,13.17,990,1000,1400-4-6,2021-06-27
761,قشهد,شهد,3,870,16860600,20390,19380,19380,-1010,-4.95,20390,0,0,19380,19380,1400-4-6,2021-06-27
762,داراب,پتروشيمي داراب,3,26129,62082504,2449,2376,2376,-73,-2.98,2449,0,0,2376,2376,1400-4-6,2021-06-27
763,سهرمز,سيمان‌هرمزگان‌,3,2168,51078080,24800,23560,23560,-1240,-5,24800,0,0,23560,23560,1400-4-6,2021-06-27
764,ضفلا7003,اختيارخ فولاد-8160-1400/07/25,3,10,40377600,3058,2700,2850,-208,-6.8,2880,-178,-5.82,2700,3000,1400-4-6,2021-06-27
765,ياقوت2,صندوق س ياقوت آگاه-ثابت,2,19564500,19564500,12546,1,1,-12545,-99.99,1,-12545,-99.99,1,1,1400-4-6,2021-06-27
766,اراد33,مرابحه عام دولت3-ش.خ 0303,2,2000,1845000000,905000,920000,925000,20000,2.21,922500,17500,1.93,920000,925000,1400-4-6,2021-06-27
767,كهرام,توليدي گرانيت بهسرام,2,104,11442392,113425,110023,110023,-3402,-3,113421,-4,0,110023,110023,1400-4-6,2021-06-27
768,كصدف,كاشي صدف سرام استقلال آباده,2,420,10282860,25240,24483,24483,-757,-3,25239,-1,0,24483,24483,1400-4-6,2021-06-27
769,پست0008پ04,پسته فندقي32-30سبزدانه0008(پ),2,50,89348000,1650002,1780000,1788700,138698,8.41,1786960,136958,8.3,1780000,1788700,1400-4-6,2021-06-27
770,ثقزوي,شركت عمران و سازندگي قزوين,2,487,14679154,31728,30142,30142,-1586,-5,31726,-2,-0.01,30142,30142,1400-4-6,2021-06-27
771,ثنام,س ساختماني ب نام آوران مهندسي,2,1498,24189704,16647,16148,16148,-499,-3,16646,-1,-0.01,16148,16148,1400-4-6,2021-06-27
772,تملي803,تسهيلات مسكن ب. ملي-خرداد98,2,24,20019578,870419,826899,913900,43481,5,834149,-36270,-4.17,826899,913900,1400-4-6,2021-06-27
773,وسگلستا,شركت س استان گلستان,2,25000,29400000,1237,1176,1176,-61,-4.93,1237,0,0,1176,1176,1400-4-6,2021-06-27
774,وحافظ,بيمه حافظ,2,900,53378100,60519,59309,59309,-1210,-2,60506,-13,-0.02,59309,59309,1400-4-6,2021-06-27
775,سفارود,كارخانه فارسيت درود,2,1154,19911116,17606,17254,17254,-352,-2,17605,-1,-0.01,17254,17254,1400-4-6,2021-06-27
776,اخزا812,اسنادخزانه-م12بودجه98-001111,2,10013,8921047900,887968,888300,890950,2982,0.34,890947,2979,0.34,888300,890950,1400-4-6,2021-06-27
777,آبين,كشت و صنعت آبشيرين,2,3675,15052800,4179,4096,4096,-83,-1.99,4179,0,0,4096,4096,1400-4-6,2021-06-27
778,فبيرا,بسته‌ بندي‌ ايران‌,2,10030,29989700,3082,2990,2990,-92,-2.99,3082,0,0,2990,2990,1400-4-6,2021-06-27
779,كيش0211,خريد دين توسعه كيش14021110,2,1008,1008000000,1000000,1000000,1000000,0,0,1000000,0,0,1000000,1000000,1400-4-6,2021-06-27
780,داريك2,صندوق س.اعتماد داريك-د,2,1430000,1430000,10714,1,1,-10713,-99.99,1,-10713,-99.99,1,1,1400-4-6,2021-06-27
781,پارتا,مجتمع‌صنعتي‌آرتاويل‌تاير,2,612,19487916,32827,31843,31843,-984,-3,32826,-1,0,31843,31843,1400-4-6,2021-06-27
782,اطلس2,صندوق س.توسعه اندوخته آينده-س,2,20000,20000,215952,1,1,-215951,-100,1,-215951,-100,1,1,1400-4-6,2021-06-27
783,ضپاس7026,اختيارخ وپارس-1600-1400/07/28,1,2,2400000,914,1200,1200,286,31.29,1200,286,31.29,1200,1200,1400-4-6,2021-06-27
784,طلا2,صندوق س.پشتوانه طلاي لوتوس,1,100000,100000,75553,1,1,-75552,-100,1,-75552,-100,1,1,1400-4-6,2021-06-27
785,ضپيك7039,اختيارخ تاپيكو-5070-00/07/18,1,64,227520000,4970,3555,3555,-1415,-28.47,3555,-1415,-28.47,3555,3555,1400-4-6,2021-06-27
786,اراد65,مرابحه عام دولتي65-ش.خ0210,1,500,475002500,942232,950005,950005,7773,0.82,950005,7773,0.82,950005,950005,1400-4-6,2021-06-27
787,كمند2,صندوق س. با درآمد ثابت كمند,1,87000000,87000000,10116,1,1,-10115,-99.99,1,-10115,-99.99,1,1,1400-4-6,2021-06-27
788,شتولي,تولي‌پرس‌,1,500,15903500,32456,31807,31807,-649,-2,32454,-2,-0.01,31807,31807,1400-4-6,2021-06-27
789,اراد694,مرابحه عام دولت69-ش.خ0310,1,172500,158700000000,917000,920000,920000,3000,0.33,920000,3000,0.33,920000,920000,1400-4-6,2021-06-27
790,ماهان01,منفعت هواپيمايي ماهان 14011123,1,5,4762150,943000,952430,952430,9430,1,952430,9430,1,952430,952430,1400-4-6,2021-06-27
791,وخاور2,بانك خاورميانه,1,71388288,620364222720,8960,8690,8690,-270,-3.01,8690,-270,-3.01,8690,8690,1400-4-6,2021-06-27
792,ساذري,آذريت‌,1,1800,12362400,6668,6868,6868,200,3,6668,0,0,6868,6868,1400-4-6,2021-06-27
793,ضجار7042,اختيارخ وتجارت-3497-1400/07/21,1,100,8000000,60,80,80,20,33.33,80,20,33.33,80,80,1400-4-6,2021-06-27
794,كفرآور,فرآورده هاي سيمان شرق,1,1000,22666000,23367,22666,22666,-701,-3,23365,-2,-0.01,22666,22666,1400-4-6,2021-06-27
795,دماوند2,توليد نيروي برق دماوند,1,10600000,295263000000,27855,27855,27855,0,0,27855,0,0,27855,27855,1400-4-6,2021-06-27
796,تابا,تابان نيرو سپاهان,1,100,5420800,55884,54208,54208,-1676,-3,55883,-1,0,54208,54208,1400-4-6,2021-06-27
797,اراد49,مرابحه عام دولت4-ش.خ 0206,1,100,97000000,989410,970000,970000,-19410,-1.96,970000,-19410,-1.96,970000,970000,1400-4-6,2021-06-27
798,پلاست,كارخانجات توليدي پلاستيران,1,75,5208750,71597,69450,69450,-2147,-3,71596,-1,0,69450,69450,1400-4-6,2021-06-27
799,مشهد0212,مشاركت ش مشهد0212-3ماهه18%,1,5000,5000000000,1000000,1000000,1000000,0,0,1000000,0,0,1000000,1000000,1400-4-6,2021-06-27
800,پست0008پ09,پسته بادامي30-28مه ولات0008(پ),1,4,6384000,1680000,1596000,1596000,-84000,-5,1596000,-84000,-5,1596000,1596000,1400-4-6,2021-06-27
801,صعبيد312,صكوك اجاره دعبيد-3ماهه18%,1,148,148740000,1005000,1005000,1005000,0,0,1005000,0,0,1005000,1005000,1400-4-6,2021-06-27
802,فايرا2,آلومينيوم‌ايران‌,1,15000000,246150000000,16410,16410,16410,0,0,16410,0,0,16410,16410,1400-4-6,2021-06-27
803,ضپاس7032,اختيارخ وپارس-4000-1400/07/28,1,1,100000,1,100,100,99,9900,100,99,9900,100,100,1400-4-6,2021-06-27
804,ضمخا7067,اختيارخ اخابر-13700-1400/07/28,1,4,1200000,300,300,300,0,0,300,0,0,300,300,1400-4-6,2021-06-27
805,كگل2,معدني و صنعتي گل گهر,1,3100000,54560000000,17570,17600,17600,30,0.17,17600,30,0.17,17600,17600,1400-4-6,2021-06-27
806,فلات,گروه صنايع معادن فلات ايرانيان,1,1000,14748000,15204,14748,14748,-456,-3,15203,-1,-0.01,14748,14748,1400-4-6,2021-06-27
807,شخارك2,پتروشيمي‌ خارك‌,1,1000000,43050000000,43480,43050,43050,-430,-0.99,43050,-430,-0.99,43050,43050,1400-4-6,2021-06-27
808,وصندوق2,سرمايه‌گذاري‌صندوق‌بازنشستگي‌,1,31250000,461875000000,14780,14780,14780,0,0,14780,0,0,14780,14780,1400-4-6,2021-06-27
809,ضملت8041,اختيارخ وبملت-3434-1400/08/19,1,2,2000000,1088,1000,1000,-88,-8.09,1000,-88,-8.09,1000,1000,1400-4-6,2021-06-27
810,وشمال,س. چشم انداز توسعه شمال,1,1209,103278825,88067,85425,85425,-2642,-3,88039,-28,-0.03,85425,85425,1400-4-6,2021-06-27
811,تصميم2,صندوق س با درآمد ثابت تصميم,1,300000,300000,16668,1,1,-16667,-99.99,1,-16667,-99.99,1,1,1400-4-6,2021-06-27
812,ضچاد7035,اختيارخ كچاد-25870-1400/07/04,1,3,4200000,2200,1400,1400,-800,-36.36,1400,-800,-36.36,1400,1400,1400-4-6,2021-06-27
813,دمعيار2,صندوق س. توازن معيار-د,1,700000,700000,10027,1,1,-10026,-99.99,1,-10026,-99.99,1,1,1400-4-6,2021-06-27
814,ضصاد8035,اختيارخ وبصادر-3489-1400/08/12,1,100,5500000,1,55,55,54,5400,55,54,5400,55,55,1400-4-6,2021-06-27
815,شرق1400,مشاركت ليزينگ ايران وشرق140010,1,6,6048000,1008000,1008000,1008000,0,0,1008000,0,0,1008000,1008000,1400-4-6,2021-06-27
816,فاراك2,ماشين‌ سازي‌ اراك‌,1,140000000,295680000000,2112,2112,2112,0,0,2112,0,0,2112,2112,1400-4-6,2021-06-27
817,ومعادن2,توسعه‌معادن‌وفلزات‌,1,10000000,90000000000,8950,9000,9000,50,0.56,9000,50,0.56,9000,9000,1400-4-6,2021-06-27
818,ولراز,ليزينگ رازي,1,100,5432600,56006,54326,54326,-1680,-3,56005,-1,0,54326,54326,1400-4-6,2021-06-27
819,ضصاد8032,اختيارخ وبصادر-1989-1400/08/12,1,5,1505000,250,301,301,51,20.4,301,51,20.4,301,301,1400-4-6,2021-06-27
820,كهمدا2,شيشه‌ همدان‌,1,6000000,54720000000,9120,9120,9120,0,0,9120,0,0,9120,9120,1400-4-6,2021-06-27
821,ضغدر8057,اختيارخ وغدير-9000-1400/08/26,1,1,4350000,4240,4350,4350,110,2.59,4350,110,2.59,4350,4350,1400-4-6,2021-06-27
822,ثالوند,سرمايه گذاري مسكن الوند,1,200,5981400,31481,29907,29907,-1574,-5,31480,-1,0,29907,29907,1400-4-6,2021-06-27
823,كاوه2,فولاد كاوه جنوب كيش,1,62900000,1249823000000,19870,19870,19870,0,0,19870,0,0,19870,19870,1400-4-6,2021-06-27
824,سنفت001,سلف موازي استاندارد سنفت001,1,51000,60168525000,1179775,1179775,1179775,0,0,1179775,0,0,1179775,1179775,1400-4-6,2021-06-27
825,صايپا1122,صكوك مرابحه سايپا112-3ماهه 16%,1,310000,295430000000,970000,953000,953000,-17000,-1.75,953000,-17000,-1.75,953000,953000,1400-4-6,2021-06-27
826,حكمت01,مشاركت حكمت ايرانيان 140107,1,10,9875000,1012500,987500,987500,-25000,-2.47,987500,-25000,-2.47,987500,987500,1400-4-6,2021-06-27
827,دحاوي,الحاوي,1,500,5914000,12193,11828,11828,-365,-2.99,12193,0,0,11828,11828,1400-4-6,2021-06-27
828,تملي802,تسهيلات مسكن ب. ملي-ارديبهشت98,1,6,4988982,875259,831497,831497,-43762,-5,831497,-43762,-5,831497,831497,1400-4-6,2021-06-27
829,عيار2,صندوق سكه طلاي مفيد,1,10000,10000,26652,1,1,-26651,-100,1,-26651,-100,1,1,1400-4-6,2021-06-27
830,پاسار04,اجاره انرژي پاسارگاد14040302,1,1000,1000000000,1000000,1000000,1000000,0,0,1000000,0,0,1000000,1000000,1400-4-6,2021-06-27
831,ثاژن,سخت آژند,1,1000,9307000,9496,9307,9307,-189,-1.99,9496,0,0,9307,9307,1400-4-6,2021-06-27
832,نيرو,نيرو سرمايه,1,100,5218600,53799,52186,52186,-1613,-3,53798,-1,0,52186,52186,1400-4-6,2021-06-27
833,وثخوز,سرمايه گذاري و توسعه خوزستان,1,13777,918140611,70150,66643,66643,-3507,-5,69811,-339,-0.48,66643,66643,1400-4-6,2021-06-27
834,صپا ه 15,بار پايه هفته 15صنعتي,1,9600,7776000,840,810,810,-30,-3.57,810,-30,-3.57,810,810,1400-4-6,2021-06-27
835,صينا205,صكوك منفعت سينا دارو-3ماهه 19%,1,10,9990000,970000,999000,999000,29000,2.99,999000,29000,2.99,999000,999000,1400-4-6,2021-06-27
836,اخزا804,اسنادخزانه-م4بودجه98-000421,1,10,9910000,989950,991000,991000,1050,0.11,991000,1050,0.11,991000,991000,1400-4-6,2021-06-27
837,آساميد4,صندوق س.مشترك آسمان اميد -د,1,8200000,100614000000,12242,12270,12270,28,0.23,12270,28,0.23,12270,12270,1400-4-6,2021-06-27
838,اعتماد2,صندوق س.اعتماد آفرين پارسيان-د,1,9400000,9400000,37181,1,1,-37180,-100,1,-37180,-100,1,1,1400-4-6,2021-06-27
839,ضپيك7043,اختيارخ تاپيكو-10070-00/07/18,1,3,6000000,900,2000,2000,1100,122.22,2000,1100,122.22,2000,2000,1400-4-6,2021-06-27
