,نماد,نام,تعداد,حجم,ارزش,دیروز,اولین,آخرین معامله - مقدار,آخرین معامله - تغییر,آخرین معامله - درصد,قیمت پایانی - مقدار,قیمت پایانی - تغییر,قیمت پایانی - درصد,کمترین,بیشترین,تاریخ,gregorian_date
0,پالايش,صندوق پالايشي يكم-سهام,51365,82435173,7089585963990,85290,86200,86710,1420,1.66,86000,710,0.83,83400,88600,1400-6-10,2021-09-01
1,شبندر,پالايش نفت بندرعباس,40936,586763573,3480835929771,5938,5947,6030,92,1.55,5932,-6,-0.1,5748,6050,1400-6-10,2021-09-01
2,وهامون,سرمايه گذاري هامون صبا,34668,41147098,189976151466,4398,4617,4617,219,4.98,4617,219,4.98,4617,4617,1400-6-10,2021-09-01
3,كدما,معدني‌ دماوند,30862,13150453,3056572943910,236980,248820,225150,-11830,-4.99,232430,-4550,-1.92,225140,248820,1400-6-10,2021-09-01
4,دي,بانك دي,29485,1362703977,1751052045159,1231,1270,1292,61,4.96,1285,54,4.39,1242,1292,1400-6-10,2021-09-01
5,شستا,سرمايه گذاري تامين اجتماعي,25533,113640455,1527058800440,13410,13200,13580,170,1.27,13440,30,0.22,13060,13690,1400-6-10,2021-09-01
6,دارا يكم,صندوق واسطه گري مالي يكم-سهام,23927,21817646,3060419790120,137520,140000,141950,4430,3.22,140270,2750,2,136520,143490,1400-6-10,2021-09-01
7,شپنا,پالايش نفت اصفهان,20920,130168070,1835292782240,14060,13920,14350,290,2.06,14100,40,0.28,13700,14400,1400-6-10,2021-09-01
8,بركت,گروه دارويي بركت,19437,54166782,2190708273820,38950,39890,40890,1940,4.98,40440,1490,3.83,39010,40890,1400-6-10,2021-09-01
9,سپيد,سپيد ماكيان,18885,5558081,314703368040,54430,55500,57150,2720,5,56620,2190,4.02,54170,57150,1400-6-10,2021-09-01
10,فملي,ملي‌ صنايع‌ مس‌ ايران‌,16580,118303857,1640193380810,13720,13720,13970,250,1.82,13860,140,1.02,13550,14120,1400-6-10,2021-09-01
11,خساپا,سايپا,16328,507442793,1037727519115,2039,2020,2080,41,2.01,2045,6,0.29,1979,2093,1400-6-10,2021-09-01
12,خودرو,ايران‌ خودرو,15699,411681514,917769566182,2220,2200,2265,45,2.03,2229,9,0.41,2151,2274,1400-6-10,2021-09-01
13,شتران,پالايش نفت تهران,15493,110692590,1234917422510,11080,11080,11350,270,2.44,11160,80,0.72,10650,11490,1400-6-10,2021-09-01
14,فولاد,فولاد مباركه اصفهان,14077,101181740,1218727217110,11930,12000,12110,180,1.51,12040,110,0.92,11750,12300,1400-6-10,2021-09-01
15,كرمان,س. توسعه و عمران استان كرمان,13004,534320950,763887805390,1377,1381,1445,68,4.94,1430,53,3.85,1375,1445,1400-6-10,2021-09-01
16,گدنا,تهيه توزيع غذاي دنا آفرين فدك,11978,9619380,240167936942,24955,25790,24900,-55,-0.22,24967,12,0.05,24000,25799,1400-6-10,2021-09-01
17,ومدير,گ.مديريت ارزش سرمايه ص ب كشوري,11249,65350871,354066237790,5360,5360,5570,210,3.92,5420,60,1.12,5120,5600,1400-6-10,2021-09-01
18,خگستر,گسترش‌سرمايه‌گذاري‌ايران‌خودرو,11120,273568078,822298938322,2933,2941,3066,133,4.53,3006,73,2.49,2860,3075,1400-6-10,2021-09-01
19,وتجارت,بانك تجارت,11082,248024732,648252512956,2631,2540,2628,-3,-0.11,2614,-17,-0.65,2540,2672,1400-6-10,2021-09-01
20,ولكار,ليزينگ كارآفرين,10674,18867580,100464228510,5130,4980,5380,250,4.87,5320,190,3.7,4980,5380,1400-6-10,2021-09-01
21,وهنر,گروه توسعه هنر ايران,10644,98582378,624991931901,6484,6180,6606,122,1.88,6340,-144,-2.22,6160,6700,1400-6-10,2021-09-01
22,لطيف,محصولات كاغذي لطيف,9287,1792573,100770733492,53793,53700,56482,2689,5,56216,2423,4.5,53700,56482,1400-6-10,2021-09-01
23,خپارس,پارس‌ خودرو,9157,518413053,692035339854,1294,1310,1358,64,4.95,1335,41,3.17,1270,1358,1400-6-10,2021-09-01
24,حگردش,ريل گردش ايرانيان,8913,31738296,110957082816,3395,3496,3496,101,2.97,3496,101,2.97,3496,3496,1400-6-10,2021-09-01
25,قثابت,قند ثابت‌ خراسان‌,8720,112797368,536469601505,4809,4800,4642,-167,-3.47,4756,-53,-1.1,4610,5000,1400-6-10,2021-09-01
26,وكبهمن,مديريت سرمايه گذاري كوثربهمن,8105,8586355,116307649304,12987,12950,13636,649,5,13546,559,4.3,12950,13636,1400-6-10,2021-09-01
27,ذوب,سهامي ذوب آهن  اصفهان,8036,159115446,765418157002,4782,4810,4828,46,0.96,4810,28,0.59,4690,4910,1400-6-10,2021-09-01
28,كاما,باما,7873,62373493,848104383380,13100,13100,13750,650,4.96,13600,500,3.82,13000,13750,1400-6-10,2021-09-01
29,سيتا,سرمايه گذاري سيمان تامين,7791,19895276,317278912890,15340,15130,16100,760,4.95,15950,610,3.98,15130,16100,1400-6-10,2021-09-01
30,خبهمن,گروه‌بهمن‌,7718,285997334,478239480410,1657,1630,1716,59,3.56,1672,15,0.91,1581,1738,1400-6-10,2021-09-01
31,نوري,پتروشيمي نوري,7668,7714999,804915413330,99760,102990,104740,4980,4.99,104330,4570,4.58,102000,104740,1400-6-10,2021-09-01
32,چخزر,صنايع چوب خزر كاسپين,7564,2049980,93854814209,44103,44700,46100,1997,4.53,45783,1680,3.81,44500,46300,1400-6-10,2021-09-01
33,ثبهساز,بهساز كاشانه تهران,7493,52456337,132873717209,2444,2500,2534,90,3.68,2533,89,3.64,2500,2609,1400-6-10,2021-09-01
34,وبملت,بانك ملت,7419,155428638,634867566776,4059,4059,4126,67,1.65,4085,26,0.64,3962,4185,1400-6-10,2021-09-01
35,فگستر,گسترش صنايع روي ايرانيان,7387,6225457,100721764190,16123,16000,16419,296,1.84,16179,56,0.35,15890,16480,1400-6-10,2021-09-01
36,پترول,گ.س.وت.ص.پتروشيمي خليج فارس,7343,82877614,349747247999,4086,4049,4290,204,4.99,4220,134,3.28,4049,4290,1400-6-10,2021-09-01
37,وكار,بانك‌ كارآفرين‌,7289,347564031,1049297464723,3166,3008,3038,-128,-4.04,3019,-147,-4.64,3008,3087,1400-6-10,2021-09-01
38,شصدف,صنعتي دوده فام,7183,9065518,375850177926,40339,40970,42355,2016,5,41459,1120,2.78,39140,42355,1400-6-10,2021-09-01
39,غكورش,صنعت غذايي كورش,7115,4216533,196198671820,45190,44510,47440,2250,4.98,46530,1340,2.97,44510,47440,1400-6-10,2021-09-01
40,زملارد,كشاورزي و دامپروري ملارد شير,6937,2536958,81347359152,30914,31930,32459,1545,5,32065,1151,3.72,30642,32459,1400-6-10,2021-09-01
41,ولپارس,ليزينگ پارسيان,6931,44175042,257100178170,5560,5800,5830,270,4.86,5820,260,4.68,5670,5830,1400-6-10,2021-09-01
42,خزاميا,زامياد,6914,63838208,567295150940,8870,8970,8870,0,0,8890,20,0.23,8630,9220,1400-6-10,2021-09-01
43,فتوسا,توليد و توسعه سرب روي ايرانيان,6879,4756406,71093240708,14715,14330,15051,336,2.28,14947,232,1.58,14303,15235,1400-6-10,2021-09-01
44,ثاميد,توسعه و عمران اميد,6865,64851226,117610633432,1740,1750,1827,87,5,1814,74,4.25,1720,1827,1400-6-10,2021-09-01
45,بوعلي,پتروشيمي بوعلي سينا,6804,6727482,448467817380,63610,66000,66790,3180,5,66660,3050,4.79,64890,66790,1400-6-10,2021-09-01
46,شاروم,پتروشيمي اروميه,6654,4251668,80299872679,18217,18300,19127,910,5,18887,670,3.68,18200,19127,1400-6-10,2021-09-01
47,غزر,صنعتي زر ماكارون,6601,5317442,143580384340,26170,26390,27470,1300,4.97,27000,830,3.17,25650,27470,1400-6-10,2021-09-01
48,وخارزم,سرمايه گذاري خوارزمي,6536,56557278,364353693980,6370,6160,6550,180,2.83,6440,70,1.1,6160,6680,1400-6-10,2021-09-01
49,آريا,پليمر آريا ساسول,6508,4872095,556518087636,109075,110547,114528,5453,5,114226,5151,4.72,110547,114528,1400-6-10,2021-09-01
50,چكارن,كارتن‌ ايران‌,6505,152408813,532518761992,3623,3570,3479,-144,-3.97,3494,-129,-3.56,3442,3760,1400-6-10,2021-09-01
51,ثالوند,سرمايه گذاري مسكن الوند,6465,17387491,415974722527,24858,24050,23905,-953,-3.83,23924,-934,-3.76,23616,25300,1400-6-10,2021-09-01
52,كمند,صندوق س. با درآمد ثابت كمند,6229,260392130,2641209248670,10138,10143,10142,4,0.04,10143,5,0.05,10142,10147,1400-6-10,2021-09-01
53,وبصادر,بانك صادرات ايران,6209,144416604,358608153139,2454,2414,2480,26,1.06,2483,29,1.18,2410,2540,1400-6-10,2021-09-01
54,كزغال,زغال سنگ پروده طبس,6031,3792441,147700694971,37762,37021,39619,1857,4.92,38946,1184,3.14,37021,39640,1400-6-10,2021-09-01
55,آبادا,توليد نيروي برق آبادان,5953,8705199,111104585460,12470,12100,13090,620,4.97,12760,290,2.33,11900,13090,1400-6-10,2021-09-01
56,هاي وب,داده گسترعصرنوين-هاي وب,5898,45646862,435499928090,9420,9400,9610,190,2.02,9540,120,1.27,9300,9770,1400-6-10,2021-09-01
57,حكشتي,كشتيراني جمهوري اسلامي ايران,5891,22720901,409489021860,18040,17650,18240,200,1.11,18020,-20,-0.11,17330,18520,1400-6-10,2021-09-01
58,شگويا,پتروشيمي تندگويان,5771,25321821,312394712394,12122,11990,12590,468,3.86,12337,215,1.77,11802,12650,1400-6-10,2021-09-01
59,وسپهر,سرمايه گذاري مالي سپهرصادرات,5685,10732950,102655414241,9454,9410,9660,206,2.18,9556,102,1.08,9350,9695,1400-6-10,2021-09-01
60,رافزا,رايان هم افزا,5579,1642341,166300077298,96899,100000,101743,4844,5,101258,4359,4.5,97590,101743,1400-6-10,2021-09-01
61,بپيوند,برق و انرژي پيوندگستر پارس,5513,6440920,83189769279,12605,12388,13228,623,4.94,12916,311,2.47,12388,13235,1400-6-10,2021-09-01
62,كتوكا,توليدي و خدمات صنايع نسوز توكا,5284,15094945,377276672132,25928,25400,25570,-358,-1.38,24994,-934,-3.6,24632,26452,1400-6-10,2021-09-01
63,وپارس,بانك‌پارسيان‌,5271,136076283,414591072465,3063,3015,3075,12,0.39,3047,-16,-0.52,2950,3115,1400-6-10,2021-09-01
64,زماهان,مجتمع توليد گوشت مرغ ماهان,5165,19816858,272375926693,14221,13800,13979,-242,-1.7,13745,-476,-3.35,13510,14200,1400-6-10,2021-09-01
65,دتوزيع,توزيع دارو پخش,5100,10826504,423654151450,38610,40490,39000,390,1.01,39131,521,1.35,37330,40540,1400-6-10,2021-09-01
66,صبا,سرمايه گذاري صبا تامين,5037,78929887,772061490360,9317,9782,9782,465,4.99,9782,465,4.99,9601,9782,1400-6-10,2021-09-01
67,ملت,بيمه ملت,4956,186882617,279085291090,1488,1440,1520,32,2.15,1493,5,0.34,1419,1550,1400-6-10,2021-09-01
68,چكاپا,گروه صنايع كاغذ پارس,4874,77706209,354719014904,4421,4350,4642,221,5,4565,144,3.26,4230,4642,1400-6-10,2021-09-01
69,غگيلا,شيرپاستوريزه پگاه گيلان,4866,4322461,119609671220,27583,27990,28000,417,1.51,27672,89,0.32,26700,28500,1400-6-10,2021-09-01
70,امين,تامين سرمايه امين,4856,4535808,42380206890,9320,9340,9390,70,0.75,9340,20,0.21,9150,9530,1400-6-10,2021-09-01
71,وملي,گروه‌ صنعتي‌ ملي‌ (هلدينگ‌,4707,2838063,592063905840,201090,211100,211140,10050,5,208620,7530,3.74,192320,211140,1400-6-10,2021-09-01
72,خمحركه,نيرو محركه‌,4707,54785161,281430622525,5152,5100,5129,-23,-0.45,5137,-15,-0.29,4993,5291,1400-6-10,2021-09-01
73,فارس,صنايع پتروشيمي خليج فارس,4649,47415177,603029495020,12330,12400,12940,610,4.95,12720,390,3.16,12240,12940,1400-6-10,2021-09-01
74,شبريز,پالايش نفت تبريز,4562,11608977,465875207340,40740,40000,40570,-170,-0.42,40130,-610,-1.5,38840,41800,1400-6-10,2021-09-01
75,آريان,سرمايه گذاري پارس آريان,4561,115728997,1831709597651,16573,15745,16130,-443,-2.67,15828,-745,-4.5,15745,16350,1400-6-10,2021-09-01
76,امين يكم,صندوق درآمد ثابت امين يكم فردا,4489,916979384,9214847123226,10030,10036,10047,17,0.17,10049,19,0.19,10035,10070,1400-6-10,2021-09-01
77,بگيلان,توسعه مسير برق گيلان,4412,971588,20155516410,20539,19931,21180,641,3.12,20655,116,0.56,19930,21334,1400-6-10,2021-09-01
78,وپويا,سرمايه گذاري پويا,4370,12097528,68618814865,5464,5400,5737,273,5,5672,208,3.81,5400,5737,1400-6-10,2021-09-01
79,غدام,خوراك‌  دام‌ پارس‌,4295,944900,261983076930,272960,266210,281500,8540,3.13,277260,4300,1.58,265000,285000,1400-6-10,2021-09-01
80,سمتاز,سيمان ممتازان كرمان,4269,29750201,742883116335,25538,25534,24772,-766,-3,24971,-567,-2.22,24772,26150,1400-6-10,2021-09-01
81,كوير,توليدي فولاد سپيد فراب كوير,4227,46140504,713326092890,14970,15390,15710,740,4.94,15460,490,3.27,15000,15710,1400-6-10,2021-09-01
82,كيسون,شركت كيسون,4172,25459153,220245328426,8974,8616,8630,-344,-3.83,8651,-323,-3.6,8616,8900,1400-6-10,2021-09-01
83,حشكوه,دليجان طلايي شكوه پارس,4096,18689737,66217738191,3440,3543,3543,103,2.99,3543,103,2.99,3543,3543,1400-6-10,2021-09-01
84,ثتوسا,س.توسعه و عمران استان اردبيل,4075,7026173,214398075926,30910,29983,31240,330,1.07,30514,-396,-1.28,29983,31700,1400-6-10,2021-09-01
85,فوكا,فولاد كاويان,4038,26988462,423515813714,16372,15710,15970,-402,-2.46,15692,-680,-4.15,15554,16850,1400-6-10,2021-09-01
86,گشان,توسعه بين المللي پديده شانديز,4016,7910427,172852926064,22388,21730,21849,-539,-2.41,21851,-537,-2.4,21501,22388,1400-6-10,2021-09-01
87,غگل,گلوكوزان‌,3939,46116170,175971107290,3736,3701,3922,186,4.98,3816,80,2.14,3610,3922,1400-6-10,2021-09-01
88,تاپيكو,س. نفت و گاز و پتروشيمي تأمين,3865,39256932,565062550510,13860,13860,14550,690,4.98,14390,530,3.82,13770,14550,1400-6-10,2021-09-01
89,كاوه,فولاد كاوه جنوب كيش,3813,15011261,321305930040,21290,21300,21550,260,1.22,21400,110,0.52,20800,21820,1400-6-10,2021-09-01
90,هرمز,فولاد هرمزگان جنوب,3731,22283230,446490650153,19182,19182,20141,959,5,20037,855,4.46,19182,20141,1400-6-10,2021-09-01
91,كفپارس,فرآورده‌هاي‌ نسوز پارس‌,3714,42164072,185161825580,4334,4450,4354,20,0.46,4391,57,1.32,4268,4550,1400-6-10,2021-09-01
92,وايران,ليزينگ ايرانيان,3675,24078458,175485744050,7580,7510,7230,-350,-4.62,7290,-290,-3.83,7210,7690,1400-6-10,2021-09-01
93,وسكرشا,س.سهام عدالت استان كرمانشاه,3617,163535380,117890888449,711,684,727,16,2.25,721,10,1.41,683,746,1400-6-10,2021-09-01
94,فافق,صنايع مس افق كرمان,3613,18000000,83700000000,1000,4650,4650,3650,365,4650,3650,365,4650,4650,1400-6-10,2021-09-01
95,اپال,فرآوري معدني اپال كاني پارس,3556,4016476,91395305490,22750,21750,22820,70,0.31,22750,0,0,21720,23500,1400-6-10,2021-09-01
96,شپلي,پلي اكريل ايران,3545,31117054,356376948113,11774,11520,11498,-276,-2.34,11453,-321,-2.73,11210,12200,1400-6-10,2021-09-01
97,فروي,ذوب روي اصفهان,3543,4987184,173024217921,34290,33937,35170,880,2.57,34694,404,1.18,33610,35600,1400-6-10,2021-09-01
98,فخوز,فولاد  خوزستان,3541,17495291,330503319310,18550,18990,18990,440,2.37,18890,340,1.83,18550,19090,1400-6-10,2021-09-01
99,وغدير,سرمايه‌گذاري‌غدير(هلدينگ‌,3528,28572396,446049136700,15420,14920,15810,390,2.53,15610,190,1.23,14920,16100,1400-6-10,2021-09-01
100,اخابر,مخابرات ايران,3506,45703607,533576065550,11210,11590,11770,560,5,11670,460,4.1,11190,11770,1400-6-10,2021-09-01
101,قتربت,قند تربت حيدريه,3502,1050000,35983500000,1000,34270,34270,33270,3327,34270,33270,3327,34270,34270,1400-6-10,2021-09-01
102,كروي,توسعه‌ معادن‌ روي‌ ايران‌,3472,13376195,426239997760,30660,32130,32160,1500,4.89,31870,1210,3.95,31250,32190,1400-6-10,2021-09-01
103,پيزد,مجتمع صنايع لاستيك يزد,3450,774591,55290450608,68687,68690,72001,3314,4.82,71380,2693,3.92,68316,72121,1400-6-10,2021-09-01
104,بترانس,ايران‌ ترانسفو,3422,80590388,227787779162,2730,2730,2866,136,4.98,2826,96,3.52,2700,2866,1400-6-10,2021-09-01
105,شغدير,پتروشيمي غدير,3357,5043999,474688665860,90090,90500,94590,4500,5,94110,4020,4.46,90100,94590,1400-6-10,2021-09-01
106,غگرجي,بيسكويت‌  گرجي‌,3346,62036186,209247556187,3280,3250,3444,164,5,3373,93,2.84,3163,3444,1400-6-10,2021-09-01
107,رانفور,خدمات‌انفورماتيك‌,3331,26961279,201144233600,7480,7690,7490,10,0.13,7460,-20,-0.27,7270,7700,1400-6-10,2021-09-01
108,فاذر,صنايع‌ آذرآب‌,3298,133900277,176826688960,1308,1290,1347,39,2.98,1321,13,0.99,1271,1350,1400-6-10,2021-09-01
109,غنوش,نوش‌ مازندران‌,3282,9316053,356242452330,37130,36600,38980,1850,4.98,38240,1110,2.99,36130,38980,1400-6-10,2021-09-01
110,چدن,توليدي چدن سازان,3208,44864665,198473612109,4442,4301,4500,58,1.31,4424,-18,-0.41,4251,4591,1400-6-10,2021-09-01
111,دبالك,مواد اوليه دارويي البرز بالك,3202,10681832,210395111335,20224,20830,19213,-1011,-5,19697,-527,-2.61,19213,20850,1400-6-10,2021-09-01
112,شپترو,پتروشيمي آبادان,3199,48660222,249481957333,5280,5101,5205,-75,-1.42,5127,-153,-2.9,5016,5269,1400-6-10,2021-09-01
113,فنورد,نوردوقطعات‌ فولادي‌,3132,1166374,230309116890,196390,186580,206200,9810,5,197460,1070,0.54,186580,206200,1400-6-10,2021-09-01
114,فجر,فولاد اميركبيركاشان,3101,9347246,289211852260,30580,30400,31000,420,1.37,30940,360,1.18,30000,31650,1400-6-10,2021-09-01
115,سفاسي,شركت فارسيت اهواز,3093,14297169,94170426368,6715,6450,6645,-70,-1.04,6587,-128,-1.91,6380,6812,1400-6-10,2021-09-01
116,سرو,صندوق س سروسودمند مدبران-سهام,3084,4596614,390795609160,82830,84000,86350,3520,4.25,85020,2190,2.64,82520,86500,1400-6-10,2021-09-01
117,غبهنوش,بهنوش‌ ايران‌,3070,2755387,236552204540,83320,86980,84000,680,0.82,85850,2530,3.04,83130,87480,1400-6-10,2021-09-01
118,غپاك,لبنيات‌ پاك‌,3056,10747822,207093504170,19970,19900,19420,-550,-2.75,19270,-700,-3.51,18980,19900,1400-6-10,2021-09-01
119,ماديرا,صنايع ماديران,3037,35502650,346338899848,9409,9499,9879,470,5,9755,346,3.68,9190,9879,1400-6-10,2021-09-01
120,فاراك,ماشين‌ سازي‌ اراك‌,2987,69674220,141404358121,2004,1970,2050,46,2.3,2030,26,1.3,1950,2093,1400-6-10,2021-09-01
121,ختور,رادياتور ايران‌,2975,14382572,328519012470,21980,22700,23070,1090,4.96,22840,860,3.91,21600,23070,1400-6-10,2021-09-01
122,ميدكو,توسعه معادن وص.معدني خاورميانه,2960,8070406,360683348900,43520,44650,44990,1470,3.38,44690,1170,2.69,44500,44990,1400-6-10,2021-09-01
123,ونوين,بانك‌اقتصادنوين‌,2945,45833915,221729530420,4840,4720,4900,60,1.24,4840,0,0,4660,4950,1400-6-10,2021-09-01
124,فرابورس,فرابورس ايران,2934,13487843,415516604553,29373,30841,30841,1468,5,30807,1434,4.88,30027,30841,1400-6-10,2021-09-01
125,دلر,داروسازي‌ اكسير,2901,8838272,423565449380,50010,50000,48290,-1720,-3.44,47920,-2090,-4.18,47510,50950,1400-6-10,2021-09-01
126,كيان,صندوق س. با درآمد ثابت كيان,2828,27739152,840856531610,30290,30300,30349,59,0.19,30313,23,0.08,30300,30357,1400-6-10,2021-09-01
127,فزرين,زرين معدن آسيا,2813,9601448,180336145876,18663,18945,18800,137,0.73,18782,119,0.64,18020,19400,1400-6-10,2021-09-01
128,پتاير,ايران‌ تاير,2789,53244471,157008169135,2907,2890,2979,72,2.48,2949,42,1.44,2850,3000,1400-6-10,2021-09-01
129,ومعادن,توسعه‌معادن‌وفلزات‌,2781,21593518,263123505420,12030,12360,12400,370,3.08,12190,160,1.33,12010,12400,1400-6-10,2021-09-01
130,كپشير,پشم‌شيشه‌ايران‌,2711,6036353,140716806900,23520,23870,23310,-210,-0.89,23310,-210,-0.89,22520,24190,1400-6-10,2021-09-01
131,خشرق,الكتريك‌ خودرو شرق‌,2702,14147583,242523830730,17910,17790,17070,-840,-4.69,17140,-770,-4.3,17020,17790,1400-6-10,2021-09-01
132,بجهرم,توسعه مولد نيروگاهي جهرم,2655,49244471,130629115265,2621,2610,2689,68,2.59,2653,32,1.22,2560,2700,1400-6-10,2021-09-01
133,كلر,كلر پارس,2653,1663582,189853770981,113153,107500,116799,3646,3.22,114123,970,0.86,107500,118500,1400-6-10,2021-09-01
134,كچاد,معدني‌وصنعتي‌چادرملو,2649,12557208,382601939210,29700,29670,31000,1300,4.38,30470,770,2.59,29310,31180,1400-6-10,2021-09-01
135,ثشاهد,سرمايه‌ گذاري‌ شاهد,2599,17966013,297854371530,15820,16280,16610,790,4.99,16580,760,4.8,15990,16610,1400-6-10,2021-09-01
136,وهور,مديريت انرژي اميد  تابان هور,2596,156620428,299196858975,1827,1805,1918,91,4.98,1910,83,4.54,1805,1918,1400-6-10,2021-09-01
137,پارس,پتروشيمي پارس,2595,2851920,603941371220,203040,205000,213190,10150,5,211770,8730,4.3,202740,213190,1400-6-10,2021-09-01
138,آگاس,صندوق س.هستي بخش آگاه-س,2588,2992592,262747390716,84947,86650,89000,4053,4.77,87799,2852,3.36,85300,89000,1400-6-10,2021-09-01
139,وسديد,گروه ‌صنعتي‌سديد,2580,43344664,61380491464,1443,1417,1415,-28,-1.94,1416,-27,-1.87,1415,1441,1400-6-10,2021-09-01
140,خكار,ايركا پارت صنعت,2549,9788638,170765894970,17680,17290,17600,-80,-0.45,17450,-230,-1.3,16870,18310,1400-6-10,2021-09-01
141,اعتماد,صندوق س.اعتماد آفرين پارسيان-د,2535,55674880,2142894717050,38443,38474,38491,48,0.12,38489,46,0.12,38474,38494,1400-6-10,2021-09-01
142,خزر,فنرسازي‌زر,2524,6357623,115328857660,18020,17420,18530,510,2.83,18140,120,0.67,17410,18700,1400-6-10,2021-09-01
143,سپيدما,صندوق س. سپيد دماوند-د,2524,124910328,1370708747909,10968,10974,10973,5,0.05,10974,6,0.05,10973,10977,1400-6-10,2021-09-01
144,سكارون,سيمان كارون,2506,1281557,129025565865,102430,102430,100000,-2430,-2.37,100679,-1751,-1.71,99358,104950,1400-6-10,2021-09-01
145,شيران,س. صنايع‌شيميايي‌ايران,2486,6962310,201893621220,28330,28900,29650,1320,4.66,29000,670,2.36,28310,29650,1400-6-10,2021-09-01
146,آپ,آسان پرداخت پرشين,2480,13924484,225633225260,16080,16100,16530,450,2.8,16200,120,0.75,15590,16830,1400-6-10,2021-09-01
147,سبزوا,سيمان لار سبزوار,2474,25067770,95159069911,3658,3635,3840,182,4.98,3796,138,3.77,3635,3840,1400-6-10,2021-09-01
148,اميد,تامين سرمايه اميد,2460,19339046,138528486870,7220,7350,7310,90,1.25,7160,-60,-0.83,6870,7350,1400-6-10,2021-09-01
149,وپاسار,بانك  پاسارگاد,2454,66974144,1006936266590,15030,15010,15040,10,0.07,15030,0,0,14990,15050,1400-6-10,2021-09-01
150,شلرد,كود شيميايي اوره لردگان,2447,19817431,178850033878,9182,8759,9110,-72,-0.78,9025,-157,-1.71,8759,9195,1400-6-10,2021-09-01
151,ثاصفا,شركت‌ ساختمان‌ اصفهان‌,2432,4090046,91255382555,22729,22730,22600,-129,-0.57,22312,-417,-1.83,22048,23240,1400-6-10,2021-09-01
152,وتوصا,گروه س توسعه صنعتي ايران,2407,12472931,129100348930,10160,10020,10590,430,4.23,10350,190,1.87,10020,10640,1400-6-10,2021-09-01
153,كسرام,پارس‌ سرام‌,2396,22130646,145642684870,6770,6670,6650,-120,-1.77,6580,-190,-2.81,6440,6900,1400-6-10,2021-09-01
154,خودكفا,اقتصادي و خودكفايي آزادگان,2388,10969689,157023543402,14535,14220,14300,-235,-1.62,14314,-221,-1.52,14142,14800,1400-6-10,2021-09-01
155,دكپسول,توليد ژلاتين كپسول ايران,2373,3490983,147203783355,41783,42500,41115,-668,-1.6,42167,384,0.92,40820,43555,1400-6-10,2021-09-01
156,ارفع,شركت آهن و فولاد ارفع,2371,8553445,163832500433,19021,19250,19137,116,0.61,19154,133,0.7,18800,19690,1400-6-10,2021-09-01
157,غفارس,شير پاستوريزه پگاه فارس,2359,9247901,137655603945,14331,14101,15047,716,5,14885,554,3.87,14101,15047,1400-6-10,2021-09-01
158,سصفها,سيمان‌اصفهان‌,2323,1973724,128325838380,63510,64180,65800,2290,3.61,65020,1510,2.38,62700,66340,1400-6-10,2021-09-01
159,شفن,پتروشيمي فناوران,2323,791817,308372977630,372390,381530,391000,18610,5,389450,17060,4.58,379000,391000,1400-6-10,2021-09-01
160,بالبر,كابل‌ البرز,2294,3079975,122188388320,41390,42590,39770,-1620,-3.91,39670,-1720,-4.16,39330,42590,1400-6-10,2021-09-01
161,ولانا,شركت ليزينگ آريا دانا,2280,5927442,136395694069,24093,23200,23280,-813,-3.37,23011,-1082,-4.49,22889,24980,1400-6-10,2021-09-01
162,سخواف,سيمان مجد خواف,2234,19786696,256988657595,13220,13000,12824,-396,-3,12988,-232,-1.75,12824,13616,1400-6-10,2021-09-01
163,فاراكح,ح . ماشين‌ سازي‌ اراك‌,2217,49832151,44029481048,861,851,896,35,4.07,884,23,2.67,851,900,1400-6-10,2021-09-01
164,غشهداب,كشت و صنعت شهداب ناب خراسان,2215,41312152,163024454324,3777,3850,3965,188,4.98,3946,169,4.47,3782,3965,1400-6-10,2021-09-01
165,حفاري,حفاري شمال,2202,19879568,140622136880,6950,6890,7150,200,2.88,7070,120,1.73,6790,7230,1400-6-10,2021-09-01
166,غصينو,صنعتي مينو,2199,4930986,116243610614,24019,24500,23750,-269,-1.12,23574,-445,-1.85,23000,24500,1400-6-10,2021-09-01
167,وپترو,سرمايه‌گذاري صنايع پتروشيمي‌,2131,8400673,120964131190,14490,13990,14660,170,1.17,14400,-90,-0.62,13870,14810,1400-6-10,2021-09-01
168,قنيشا,قند  نيشابور,2123,2998256,172457956230,55260,55500,58020,2760,4.99,57520,2260,4.09,55330,58020,1400-6-10,2021-09-01
169,زكوثر,سرمايه گذاري كشاورزي كوثر,2118,6721394,135713280390,19420,19590,20390,970,4.99,20190,770,3.96,19430,20390,1400-6-10,2021-09-01
170,پارسان,گسترش نفت و گاز پارسيان,2107,12474375,395969436450,31550,31530,32050,500,1.58,31740,190,0.6,30900,32200,1400-6-10,2021-09-01
171,فولاي,صنايع فولاد آلياژي يزد,2098,9173237,215548878321,22567,22500,23695,1128,5,23498,931,4.13,22500,23695,1400-6-10,2021-09-01
172,تملت,تامين سرمايه بانك ملت,2083,16071656,89053147800,5370,5240,5630,260,4.84,5540,170,3.17,5230,5630,1400-6-10,2021-09-01
173,ولساپا,ليزينگ رايان‌ سايپا,2076,42917254,133372360942,3074,3074,3184,110,3.58,3108,34,1.11,2999,3197,1400-6-10,2021-09-01
174,شجم,صنايع پتروشيمي تخت جمشيد,2065,26312363,350853828084,13885,13191,13900,15,0.11,13334,-551,-3.97,13191,14100,1400-6-10,2021-09-01
175,حريل,ريل پردازسير,2060,37482035,183645013449,4688,4920,4922,234,4.99,4900,212,4.52,4700,4922,1400-6-10,2021-09-01
176,قجام,فرآوردههاي غذايي وقندتربت‌جام‌,2054,21829437,134897208642,6391,6136,6250,-141,-2.21,6180,-211,-3.3,6136,6391,1400-6-10,2021-09-01
177,وبانك,سرمايه گذاري گروه توسعه ملي,2048,17910490,174988312560,9530,9400,9880,350,3.67,9770,240,2.52,9280,10000,1400-6-10,2021-09-01
178,سمگا,گروه سرمايه گذاري ميراث فرهنگي,2039,18076042,506495761678,26728,28000,28064,1336,5,28020,1292,4.83,27560,28064,1400-6-10,2021-09-01
179,وصنا,گروه‌صنايع‌بهشهرايران‌,2039,32533201,276612089390,8150,8250,8550,400,4.91,8500,350,4.29,8190,8550,1400-6-10,2021-09-01
180,شاوان,پالايش نفت لاوان,2003,2334587,277861821302,118591,121840,119300,709,0.6,119020,429,0.36,115210,122356,1400-6-10,2021-09-01
181,تليسه,دامداري تليسه نمونه,1990,19639364,72006729985,3686,3789,3737,51,1.38,3666,-20,-0.54,3502,3789,1400-6-10,2021-09-01
182,سفارس,سيمان فارس و خوزستان,1977,9623528,227116638110,22900,22210,24040,1140,4.98,23600,700,3.06,22200,24040,1400-6-10,2021-09-01
183,دتوليد,داروسازي توليد دارو,1946,9922227,154899340247,14945,15350,15692,747,5,15611,666,4.46,15100,15692,1400-6-10,2021-09-01
184,وساپا,سرمايه‌گذاري‌ سايپا,1936,23683086,144460745340,5950,5850,6180,230,3.87,6100,150,2.52,5770,6240,1400-6-10,2021-09-01
185,شاراك,پتروشيمي شازند,1924,11414600,491746050270,41380,42000,43440,2060,4.98,43080,1700,4.11,41800,43440,1400-6-10,2021-09-01
186,ساوه,سيمان ساوه,1922,2485018,162289318184,62668,63100,65801,3133,5,65307,2639,4.21,63000,65801,1400-6-10,2021-09-01
187,وگستر,گسترش سرمايه گذاري ايرانيان,1909,7322807,87361700699,11821,11351,12118,297,2.51,11930,109,0.92,11351,12199,1400-6-10,2021-09-01
188,دماوند,توليد نيروي برق دماوند,1909,3656070,104207070661,27748,27051,28970,1222,4.4,28502,754,2.72,27051,29100,1400-6-10,2021-09-01
189,شكربن,كربن‌ ايران‌,1894,1831415,236293823840,125370,120000,131620,6250,4.99,129020,3650,2.91,120000,131630,1400-6-10,2021-09-01
190,بپاس,بيمه پاسارگاد,1887,3055839,210254384083,67362,68800,69740,2378,3.53,68804,1442,2.14,68500,70720,1400-6-10,2021-09-01
191,سلار,شركت سيمان لارستان,1858,2752679,100467120216,38108,36203,36600,-1508,-3.96,36498,-1610,-4.22,36203,38108,1400-6-10,2021-09-01
192,بهپاك,صنعتي بهپاك,1856,15373776,116549168372,7708,7437,7788,80,1.04,7581,-127,-1.65,7333,7835,1400-6-10,2021-09-01
193,وصنعت,سرمايه گذاري توسعه صنعت وتجارت,1843,13232402,93683687910,6800,7000,7140,340,5,7080,280,4.12,6800,7140,1400-6-10,2021-09-01
194,ساربيل,سيمان آرتا اردبيل,1837,2334546,100861344970,41560,42360,43630,2070,4.98,43200,1640,3.95,41800,43630,1400-6-10,2021-09-01
195,غديس,پاكديس,1829,13210781,205877109425,15015,15550,15765,750,5,15584,569,3.79,14800,15765,1400-6-10,2021-09-01
196,تايرا,تراكتورسازي‌ايران‌,1824,20863518,667294682630,30520,32040,32040,1520,4.98,31980,1460,4.78,30520,32040,1400-6-10,2021-09-01
197,كبافق,معادن‌ بافق‌,1821,2222549,100591706990,43550,43000,45720,2170,4.98,45260,1710,3.93,43000,45720,1400-6-10,2021-09-01
198,قرن,پديده شيمي قرن,1816,2738428,98625006160,35550,36900,36280,730,2.05,36020,470,1.32,34140,36900,1400-6-10,2021-09-01
199,ستران,سيمان‌ تهران‌,1810,7969565,261691322290,31390,31180,32950,1560,4.97,32840,1450,4.62,30360,32950,1400-6-10,2021-09-01
200,تسه0005,امتيازتسهيلات مسكن مرداد 1400,1798,37102,22095187131,587727,600021,580000,-7727,-1.31,595525,7798,1.33,579012,606000,1400-6-10,2021-09-01
201,ولراز,ليزينگ رازي,1793,3636751,101987613959,28101,27259,28944,843,3,28044,-57,-0.2,27258,28944,1400-6-10,2021-09-01
202,شپديس,پتروشيمي پرديس,1785,1588549,243989207010,149150,150500,155480,6330,4.24,153590,4440,2.98,149070,156270,1400-6-10,2021-09-01
203,فپنتا,سپنتا,1740,189194,103048627040,564870,550010,536630,-28240,-5,544670,-20200,-3.58,536630,584000,1400-6-10,2021-09-01
204,غسالم,سالمين‌,1731,16007914,60537470582,3706,3590,3869,163,4.4,3782,76,2.05,3590,3887,1400-6-10,2021-09-01
205,والبرح,ح . سرمايه گذاري‌البرز(هلدينگ‌,1710,5218896,43166068278,8119,8050,8270,151,1.86,8271,152,1.87,7860,8600,1400-6-10,2021-09-01
206,كسرا,سراميك‌هاي‌صنعتي‌اردكان‌,1699,8504667,163735337780,19620,19760,19800,180,0.92,19250,-370,-1.89,18640,20200,1400-6-10,2021-09-01
207,كترام,توليدي‌ كاشي‌ تكسرام‌,1693,3619822,113940936980,31190,31400,31500,310,0.99,31480,290,0.93,30070,32100,1400-6-10,2021-09-01
208,افق,فروشگاههاي زنجيره اي افق كوروش,1683,1589510,99913176510,61700,61600,63190,1490,2.41,62860,1160,1.88,60000,64370,1400-6-10,2021-09-01
209,غپينو,پارس‌ مينو,1676,11183232,60428489900,5360,5300,5510,150,2.8,5400,40,0.75,5230,5540,1400-6-10,2021-09-01
210,سخاش,سيمان‌خاش‌,1661,889263,130570437270,140290,142000,147300,7010,5,146830,6540,4.66,141010,147300,1400-6-10,2021-09-01
211,سامان,بانك سامان,1647,14763533,147895921273,9882,9611,10069,187,1.89,10018,136,1.38,9611,10100,1400-6-10,2021-09-01
212,غچين,كشت‌ و صنعت‌ چين‌ چين,1647,5634834,106730357160,19010,18280,19390,380,2,18940,-70,-0.37,18280,19660,1400-6-10,2021-09-01
213,مرقام,ايران‌ارقام‌,1645,5589461,95190547370,16730,16890,17550,820,4.9,17030,300,1.79,16020,17560,1400-6-10,2021-09-01
214,مدير,ص.س.مديريت ثروت ص.بازنشستگي-س,1607,7648320,86058939413,10918,10830,11483,565,5.17,11252,334,3.06,10830,11496,1400-6-10,2021-09-01
215,ونيرو,سرمايه‌گذاري‌نيرو,1591,28120979,90861251521,3109,3080,3264,155,4.99,3231,122,3.92,3080,3264,1400-6-10,2021-09-01
216,تنوين,تامين سرمايه نوين,1589,62394322,491962218640,7550,7750,7920,370,4.9,7880,330,4.37,7320,7920,1400-6-10,2021-09-01
217,قشكر,شكرشاهرود,1589,22069981,80264090655,3614,3689,3600,-14,-0.39,3637,23,0.64,3550,3700,1400-6-10,2021-09-01
218,كارين,صندوق س نگين سامان-ثابت,1584,82055088,825375292497,10051,10057,10056,5,0.05,10059,8,0.08,10056,10159,1400-6-10,2021-09-01
219,كنورح,ح توسعه معدني و صنعتي صبانور,1566,7577328,139540970520,18520,18640,18710,190,1.03,18420,-100,-0.54,17970,18750,1400-6-10,2021-09-01
220,وپست,پست بانك ايران,1558,7617638,159401655400,20970,20610,21110,140,0.67,20930,-40,-0.19,20610,21300,1400-6-10,2021-09-01
221,طلا,صندوق س.پشتوانه طلاي لوتوس,1538,1500329,127717963324,84754,85790,84890,136,0.16,85127,373,0.44,84770,85900,1400-6-10,2021-09-01
222,قصفها,قنداصفهان‌,1534,695832,84555336670,123410,124000,121300,-2110,-1.71,121520,-1890,-1.53,119500,125600,1400-6-10,2021-09-01
223,سدبير,س. تدبيرگران فارس وخوزستان,1517,2162378,88761619530,42498,40450,41611,-887,-2.09,41048,-1450,-3.41,40374,43370,1400-6-10,2021-09-01
224,حتوكا,حمل‌ونقل‌توكا,1510,5369708,108520066650,19540,19500,20490,950,4.86,20210,670,3.43,19220,20510,1400-6-10,2021-09-01
225,پاكشو,گروه صنعتي پاكشو,1505,10555106,63373600000,5890,5890,6030,140,2.38,5950,60,1.02,5890,6090,1400-6-10,2021-09-01
226,وآذر,سرمايه‌گذاري‌توسعه‌آذربايجان‌,1490,977287,75381384620,76540,78000,77000,460,0.6,77130,590,0.77,74590,78500,1400-6-10,2021-09-01
227,پاسا,ايران‌ياساتايرورابر,1489,6047583,132233672600,21900,21900,22430,530,2.42,21870,-30,-0.14,20910,22480,1400-6-10,2021-09-01
228,قرنح,ح . پديده شيمي قرن,1481,1416626,38829096790,27050,27070,27310,260,0.96,27410,360,1.33,26080,28070,1400-6-10,2021-09-01
229,كگل,معدني و صنعتي گل گهر,1478,3563156,84537479450,23390,22550,23790,400,1.71,23640,250,1.07,22550,24140,1400-6-10,2021-09-01
230,حفارس,حمل و نقل بين المللي خليج فارس,1473,25711053,100617292138,3807,3850,3997,190,4.99,3913,106,2.78,3713,3997,1400-6-10,2021-09-01
231,وبيمه,سرمايه‌ گذاري‌ صنعت‌ بيمه‌,1472,32509969,65621686997,1986,2020,2074,88,4.43,2019,33,1.66,1930,2074,1400-6-10,2021-09-01
232,لكما,كارخانجات‌مخابراتي‌ايران‌,1471,30525983,52372180143,1641,1723,1723,82,5,1716,75,4.57,1668,1723,1400-6-10,2021-09-01
233,سشرق,سيمان‌ شرق‌,1459,12515923,112376194790,8880,8600,9060,180,2.03,8980,100,1.13,8600,9200,1400-6-10,2021-09-01
234,ديران,ايران‌دارو,1453,7286471,182452224410,23880,25070,25070,1190,4.98,25040,1160,4.86,24570,25070,1400-6-10,2021-09-01
235,والبر,سرمايه‌ گذاري‌ البرز(هلدينگ‌,1447,12550070,130786186860,10150,10150,10650,500,4.93,10420,270,2.66,9660,10650,1400-6-10,2021-09-01
236,بكهنوج,توليد برق ماهتاب كهنوج,1444,32938068,56309008287,1702,1736,1719,17,1,1710,8,0.47,1650,1740,1400-6-10,2021-09-01
237,ختراك,ريخته‌گري‌ تراكتورسازي‌ ايران‌,1436,6933758,90910005200,13400,13000,13350,-50,-0.37,13110,-290,-2.16,12730,13590,1400-6-10,2021-09-01
238,وسينا,بانك سينا,1410,55854645,178985796185,3145,3150,3259,114,3.62,3204,59,1.88,3085,3302,1400-6-10,2021-09-01
239,ثنوسا,نوسازي‌وساختمان‌تهران‌,1408,14716006,139878264360,9080,9400,9530,450,4.96,9510,430,4.74,9200,9530,1400-6-10,2021-09-01
240,سبهان,سيمان‌ بهبهان‌,1406,1039878,74799634930,69140,68900,72590,3450,4.99,71930,2790,4.04,68900,72590,1400-6-10,2021-09-01
241,فاسمين,كالسيمين‌,1401,5996461,106103986470,17270,17300,18000,730,4.23,17690,420,2.43,17300,18050,1400-6-10,2021-09-01
242,رنيك,جنرال مكانيك,1399,4131957,76095842531,17809,18670,18680,871,4.89,18416,607,3.41,17809,18699,1400-6-10,2021-09-01
243,دسانكو,داروسازي سبحان انكولوژي,1397,6489369,92607048848,13832,14450,14275,443,3.2,14271,439,3.17,13910,14450,1400-6-10,2021-09-01
244,ونيكي,سرمايه‌گذاري‌ ملي‌ايران‌,1376,6588826,76795435590,11410,11510,11850,440,3.86,11640,230,2.02,11490,11850,1400-6-10,2021-09-01
245,بزاگرس,نيروگاه زاگرس كوثر,1371,13026963,76845424734,5840,5950,5930,90,1.54,5899,59,1.01,5562,6095,1400-6-10,2021-09-01
246,رمپنا,گروه مپنا (سهامي عام),1371,11588286,208527247690,17420,17040,18290,870,4.99,17990,570,3.27,17040,18290,1400-6-10,2021-09-01
247,وتوكا,سرمايه‌گذاري‌توكافولاد(هلدينگ,1364,10206009,109775129540,10700,10840,10960,260,2.43,10760,60,0.56,10480,11090,1400-6-10,2021-09-01
248,ثاباد,توريستي ورفاهي آبادگران ايران,1364,3111842,164923989970,50490,52980,53010,2520,4.99,53000,2510,4.97,51950,53010,1400-6-10,2021-09-01
249,وشهر,بانك شهر,1363,16771253,107498249868,6573,6500,6540,-33,-0.5,6410,-163,-2.48,6311,6660,1400-6-10,2021-09-01
250,وساخت,سرمايه‌ گذاري‌ ساختمان‌ايران‌,1352,2016536,108054363940,51880,53100,54450,2570,4.95,53580,1700,3.28,52000,54470,1400-6-10,2021-09-01
251,بكام,كارخانجات توليدي شهيد قندي,1338,16926030,49214207987,2843,2843,2933,90,3.17,2908,65,2.29,2780,2958,1400-6-10,2021-09-01
252,آوا,صندوق س.سهام آواي معيار-س,1335,7760493,69173322772,8656,8930,8960,304,3.51,8914,258,2.98,8671,9079,1400-6-10,2021-09-01
253,آسيا,بيمه آسيا,1332,28926452,62577787910,2153,2120,2198,45,2.09,2163,10,0.46,2070,2229,1400-6-10,2021-09-01
254,تاصيكو,سرمايه گذاري صدرتامين,1329,10378444,120204486450,11500,11500,11600,100,0.87,11580,80,0.7,11150,11750,1400-6-10,2021-09-01
255,خاذين,سايپاآذين‌,1327,16260427,57959242020,3594,3600,3600,6,0.17,3564,-30,-0.83,3420,3679,1400-6-10,2021-09-01
256,ثرود,سرمايه‌گذاري مسكن زاينده رود,1325,5140335,75763609710,14786,14500,15000,214,1.45,14739,-47,-0.32,14047,15199,1400-6-10,2021-09-01
257,لخزر,پارس‌ خزر,1325,521188,96591198980,177190,185000,186040,8850,4.99,185330,8140,4.59,177190,186040,1400-6-10,2021-09-01
258,شپارس,بين‌ المللي‌ محصولات‌  پارس‌,1321,6347990,92633432050,14240,14400,14950,710,4.99,14590,350,2.46,13950,14950,1400-6-10,2021-09-01
259,ونفت,سرمايه‌گذاري‌ صنعت‌ نفت‌,1317,7708726,130597887000,17150,16500,17200,50,0.29,16940,-210,-1.22,16500,17600,1400-6-10,2021-09-01
260,اطلس,صندوق س.توسعه اندوخته آينده-س,1315,871930,236859319566,259461,265746,275420,15959,6.15,271649,12188,4.7,265746,275900,1400-6-10,2021-09-01
261,ورنا,سرمايه‌گذاري‌ رنا(هلدينگ‌,1314,15679904,94955812340,5880,5700,6170,290,4.93,6060,180,3.06,5700,6170,1400-6-10,2021-09-01
262,شسينا,صنايع‌شيميايي‌سينا,1314,1231263,101904573350,79100,81990,83050,3950,4.99,82760,3660,4.63,80850,83050,1400-6-10,2021-09-01
263,غگلستا,شير پاستوريزه پگاه گلستان,1313,3863311,69816148419,17467,16910,18340,873,5,18072,605,3.46,16910,18340,1400-6-10,2021-09-01
264,غالبر,لبنيات‌ كالبر,1309,5283720,67575658480,12420,12570,13040,620,4.99,12790,370,2.98,12210,13040,1400-6-10,2021-09-01
265,دتماد,توليدمواداوليه‌داروپخش‌,1297,2069437,97713524740,48050,46710,47420,-630,-1.31,47220,-830,-1.73,45900,48530,1400-6-10,2021-09-01
266,تيپيكو,سرمايه گذاري دارويي تامين,1292,4962243,110146421690,22150,22900,22250,100,0.45,22200,50,0.23,22000,22900,1400-6-10,2021-09-01
267,كفرآور,فرآورده هاي سيمان شرق,1288,3234605,64515097654,20360,19403,20410,50,0.25,19945,-415,-2.04,19403,21104,1400-6-10,2021-09-01
268,غاذر,كشت‌وصنعت‌پياذر,1286,3375982,87457811530,26440,25220,26080,-360,-1.36,25910,-530,-2,25220,26920,1400-6-10,2021-09-01
269,ميهن,بيمه ميهن,1278,19610350,75552834815,3715,3720,3887,172,4.63,3853,138,3.71,3613,3900,1400-6-10,2021-09-01
270,نوين,بيمه نوين,1275,9692492,54789286060,5630,5550,5719,89,1.58,5653,23,0.41,5450,5800,1400-6-10,2021-09-01
271,ختوقا,قطعات‌ اتومبيل‌ ايران‌,1273,33888801,96391096245,2737,2736,2873,136,4.97,2844,107,3.91,2731,2873,1400-6-10,2021-09-01
272,سصوفي,سيمان‌ صوفيان‌,1273,6288169,137916063900,21080,21080,22130,1050,4.98,21930,850,4.03,20900,22130,1400-6-10,2021-09-01
273,البرز,بيمه البرز,1263,28214836,77926369665,2745,2740,2785,40,1.46,2762,17,0.62,2671,2799,1400-6-10,2021-09-01
274,دانا,بيمه دانا,1255,12983189,78891739890,6020,5870,6130,110,1.83,6080,60,1,5870,6190,1400-6-10,2021-09-01
275,شلعاب,لعابيران‌,1255,5622709,49492514320,8620,8680,8940,320,3.71,8800,180,2.09,8410,9000,1400-6-10,2021-09-01
276,تبرك,گروه كارخانجات صنعتي تبرك,1245,4257425,59794049407,13824,13900,14378,554,4.01,14045,221,1.6,13580,14400,1400-6-10,2021-09-01
277,ثباغ,شهر سازي و خانه سازي باغميشه,1242,11199164,152723475994,13081,13082,13735,654,5,13637,556,4.25,12463,13735,1400-6-10,2021-09-01
278,خكمك,كمك‌فنرايندامين‌,1233,3992604,89969689200,21990,22470,23080,1090,4.96,22530,540,2.46,21000,23080,1400-6-10,2021-09-01
279,وثخوز,سرمايه گذاري و توسعه خوزستان,1231,1219251,65716532536,56383,55800,53564,-2819,-5,53899,-2484,-4.41,53564,56118,1400-6-10,2021-09-01
280,سدور,سيمان‌ دورود,1230,8723463,89002151990,9810,9750,10300,490,4.99,10200,390,3.98,9740,10300,1400-6-10,2021-09-01
281,كلوند,كاشي‌ الوند,1229,4529462,111741579920,23690,23690,24870,1180,4.98,24670,980,4.14,23510,24870,1400-6-10,2021-09-01
282,ضخود7075,اختيارخ خودرو-2000-1400/07/07,1228,45925,16282176000,321,320,368,47,14.64,355,34,10.59,310,379,1400-6-10,2021-09-01
283,حآسا,آسيا سير ارس,1216,2302972,52306735708,22336,23100,23080,744,3.33,22713,377,1.69,22011,23200,1400-6-10,2021-09-01
284,قشير,قند شيروان قوچان و بجنورد,1211,3178892,71394563551,22174,22536,22440,266,1.2,22459,285,1.29,21300,23180,1400-6-10,2021-09-01
285,شزنگ,تجهيزنيروي‌زنگان‌,1209,505187,68646714826,138527,141800,135220,-3307,-2.39,135884,-2643,-1.91,134384,142000,1400-6-10,2021-09-01
286,زدشت,كشت و صنعت دشت خرم دره,1199,2985313,64290516515,21642,20680,21840,198,0.91,21536,-106,-0.49,20610,22490,1400-6-10,2021-09-01
287,زنگان,صنعت روي زنگان,1195,1044364,71443503746,65832,67899,68000,2168,3.29,68409,2577,3.91,64800,69123,1400-6-10,2021-09-01
288,وآوا,سرمايه گذاري آوا نوين,1194,8291676,45713126952,5397,5420,5600,203,3.76,5513,116,2.15,5312,5627,1400-6-10,2021-09-01
289,ساروم,سيمان‌اروميه‌,1191,3742272,170099050010,43580,43140,45750,2170,4.98,45450,1870,4.29,43140,45750,1400-6-10,2021-09-01
290,شفارس,صنايع‌ شيميايي‌ فارس‌,1183,36122552,73643733951,1976,1970,2074,98,4.96,2039,63,3.19,1962,2074,1400-6-10,2021-09-01
291,واعتبار,سرمايه گذاري اعتبار ايران,1181,10103738,87498402850,8510,8170,8760,250,2.94,8660,150,1.76,8170,8930,1400-6-10,2021-09-01
292,اتكاي,بيمه اتكايي ايرانيان,1180,5896237,45360418036,7826,7880,7661,-165,-2.11,7693,-133,-1.7,7600,7897,1400-6-10,2021-09-01
293,گكوثر,هتل پارسيان كوثر اصفهان,1166,25290325,61793232755,2356,2356,2473,117,4.97,2443,87,3.69,2302,2473,1400-6-10,2021-09-01
294,تابا,تابان نيرو سپاهان,1164,1392007,42388767284,31498,30000,30510,-988,-3.14,30452,-1046,-3.32,29924,31788,1400-6-10,2021-09-01
295,وسپه,سرمايه‌گذاري‌ سپه‌,1161,13271308,132205018080,9920,10200,10100,180,1.81,9960,40,0.4,9480,10200,1400-6-10,2021-09-01
296,گنگين,اقتصادي نگين گردشگري ايرانيان,1154,10988752,264228961123,25058,23806,24987,-71,-0.28,24045,-1013,-4.04,23806,25053,1400-6-10,2021-09-01
297,ثنور,سرمايه گذاري كوه نور,1153,11670042,94466370237,7866,8101,8101,235,2.99,8095,229,2.91,7900,8101,1400-6-10,2021-09-01
298,سرچشمه,سرمايه گذاري مس سرچشمه,1150,17976121,145356205429,7742,8125,8129,387,5,8086,344,4.44,7850,8129,1400-6-10,2021-09-01
299,كهمدا,شيشه‌ همدان‌,1148,7911618,89235115940,10850,10550,11390,540,4.98,11280,430,3.96,10550,11390,1400-6-10,2021-09-01
300,زاگرس,پتروشيمي زاگرس,1141,1394857,354930369780,243605,243002,255785,12180,5,254456,10851,4.45,243002,255785,1400-6-10,2021-09-01
301,ارزش,صندوق س ارزش آفرين بيدار-سهام,1139,9391556,108245357640,11350,11500,11600,250,2.2,11530,180,1.59,11180,11700,1400-6-10,2021-09-01
302,داوه,داروسازي آوه سينا,1138,4230073,85840126044,19549,20069,20526,977,5,20293,744,3.81,19720,20526,1400-6-10,2021-09-01
303,پلاسك,پلاسكوكار,1129,8455373,65386107790,7460,7400,7810,350,4.69,7730,270,3.62,7230,7830,1400-6-10,2021-09-01
304,آ س پ,آ.س.پ,1124,4204152,41802858646,10094,10000,9903,-191,-1.89,9943,-151,-1.5,9628,10330,1400-6-10,2021-09-01
305,خفنر,فنرسازي‌خاور,1112,11182994,83169739590,7140,7190,7490,350,4.9,7440,300,4.2,7000,7490,1400-6-10,2021-09-01
306,فباهنر,مس‌ شهيدباهنر,1103,1621618,48619328500,29080,29180,30520,1440,4.95,29980,900,3.09,28800,30530,1400-6-10,2021-09-01
307,سيمرغ,سيمرغ,1100,3769800,74787695990,19660,19300,20250,590,3,19840,180,0.92,18850,20400,1400-6-10,2021-09-01
308,غشان,شيرپاستوريزه‌پگاه‌خراسان‌,1100,9124985,61894081180,6860,7000,6700,-160,-2.33,6780,-80,-1.17,6610,7070,1400-6-10,2021-09-01
309,نطرين,عطرين نخ قم,1089,5629445,48007746389,8196,8300,8605,409,4.99,8528,332,4.05,8106,8605,1400-6-10,2021-09-01
310,ثمسكن,سرمايه‌گذاري‌ مسكن‌,1080,23988413,139886411680,5580,5540,5850,270,4.84,5830,250,4.48,5540,5850,1400-6-10,2021-09-01
311,كوثر,بيمه كوثر,1078,5498357,74641290406,13502,13021,13570,68,0.5,13575,73,0.54,13021,13900,1400-6-10,2021-09-01
312,كرماشا,صنايع پتروشيمي كرمانشاه,1073,2948370,136910788310,44540,44550,46690,2150,4.83,46440,1900,4.27,44550,46760,1400-6-10,2021-09-01
313,پارند,صندوق س. پارند پايدار سپهر,1067,35129006,356604944991,10141,10147,10154,13,0.13,10151,10,0.1,10146,10154,1400-6-10,2021-09-01
314,فرآور,فرآوري‌موادمعدني‌ايران‌,1061,2581801,83517579210,31230,32170,32790,1560,5,32350,1120,3.59,30160,32790,1400-6-10,2021-09-01
315,سپاها,سيمان‌سپاهان‌,1057,15742879,171542508740,10430,10300,10950,520,4.99,10900,470,4.51,10300,10950,1400-6-10,2021-09-01
316,ولصنم,ليزينگ‌صنعت‌ومعدن‌,1056,5557240,44215088350,7950,7700,8000,50,0.63,7960,10,0.13,7670,8100,1400-6-10,2021-09-01
317,ريشمك,توليد و صادرات ريشمك,1050,1326004,60040075043,43554,43850,45730,2176,5,45279,1725,3.96,43554,45731,1400-6-10,2021-09-01
318,همراه,شركت ارتباطات سيار ايران,1047,5620242,60348455940,10380,10350,10890,510,4.91,10550,170,1.64,10190,10890,1400-6-10,2021-09-01
319,واحيا,م .صنايع و معادن احياء سپاهان,1038,1448537,293422592737,200716,195000,202791,2075,1.03,202565,1849,0.92,195000,206700,1400-6-10,2021-09-01
320,ولغدر,ليزينگ‌خودروغدير,1036,8505760,136425201770,15280,16040,16040,760,4.97,16040,760,4.97,15840,16040,1400-6-10,2021-09-01
321,فسرب,ملي‌ سرب‌وروي‌ ايران‌,1035,669997,54322017050,79750,83000,82490,2740,3.44,81080,1330,1.67,75860,83000,1400-6-10,2021-09-01
322,خرينگ,رينگ‌سازي‌مشهد,1033,1722320,77460170600,43260,45000,45420,2160,4.99,44970,1710,3.95,43020,45420,1400-6-10,2021-09-01
323,شصفها,پتروشيمي‌ اصفهان‌,1029,2122017,325979739152,153907,150829,156985,3078,2,153618,-289,-0.19,150829,156985,1400-6-10,2021-09-01
324,وپسا,س. پتروشيمي ساختمان  خليج فارس,1028,25354631,49554765945,2027,1946,1960,-67,-3.31,1954,-73,-3.6,1946,2019,1400-6-10,2021-09-01
325,داسوه,داروسازي‌ اسوه‌,1025,2428182,69401986550,28810,28800,29120,310,1.08,28580,-230,-0.8,27550,29450,1400-6-10,2021-09-01
326,كساوه,صنايع‌ كاشي‌ و سراميك‌ سينا,1021,2426702,135001321790,54860,52500,55600,740,1.35,55630,770,1.4,52500,56630,1400-6-10,2021-09-01
327,زشريف,كشت وصنعت شريف آباد,1020,7291984,38832503269,5341,5160,5375,34,0.64,5325,-16,-0.3,5120,5494,1400-6-10,2021-09-01
328,توريل,توكاريل,1020,4171308,62054857127,14774,14150,15250,476,3.22,14877,103,0.7,14150,15350,1400-6-10,2021-09-01
329,غمينو,شركت صنايع غذايي مينو شرق,1019,5778827,51093024971,8508,8200,8933,425,5,8841,333,3.91,8200,8933,1400-6-10,2021-09-01
330,وسكاب,س.ص.بازنشستگي كاركنان بانكها,1012,17307612,55570908995,3082,3080,3221,139,4.51,3211,129,4.19,3080,3236,1400-6-10,2021-09-01
331,دامين,داروسازي‌ امين‌,1005,10855068,45073376412,4129,4170,4219,90,2.18,4152,23,0.56,4050,4269,1400-6-10,2021-09-01
332,حپترو,حمل و نقل پتروشيمي( سهامي عام,1002,1344417,49627332040,37290,37000,37190,-100,-0.27,36910,-380,-1.02,36120,37440,1400-6-10,2021-09-01
333,خمهر,مهركام‌پارس‌,996,22251703,55297951271,2395,2480,2514,119,4.97,2485,90,3.76,2350,2514,1400-6-10,2021-09-01
334,كاردان,صندوق س تجارت شاخصي كاردان,993,569519,129730345130,221550,222710,229750,8200,3.7,227790,6240,2.82,222710,230000,1400-6-10,2021-09-01
335,ودي,بيمه  دي,991,6623383,55107570180,8258,8200,8390,132,1.6,8320,62,0.75,8170,8398,1400-6-10,2021-09-01
336,افران,صندوق س افرا نماد پايدار-ثابت,984,30891253,437256267634,14147,14156,14155,8,0.06,14155,8,0.06,14152,14157,1400-6-10,2021-09-01
337,ثغرب,شركت سرمايه گذاري مسكن شمالغرب,982,9668975,60848371532,6020,5950,6321,301,5,6293,273,4.53,5950,6321,1400-6-10,2021-09-01
338,هماي,صندوق س هماي آگاه-ثابت,978,5507888,57007480361,10337,10351,10351,14,0.14,10350,13,0.13,10342,10351,1400-6-10,2021-09-01
339,واتي,سرمايه‌ گذاري‌ آتيه‌ دماوند,976,24407423,321303168100,12570,12220,13190,620,4.93,13160,590,4.69,12220,13190,1400-6-10,2021-09-01
340,شبهرن,نفت‌ بهران‌,974,5040763,68067237210,13330,13150,13590,260,1.95,13500,170,1.28,13150,13790,1400-6-10,2021-09-01
341,غمهرا,توليدي‌مهرام‌,969,1494245,99630791250,64120,64110,67320,3200,4.99,66680,2560,3.99,64050,67320,1400-6-10,2021-09-01
342,چفيبر,فيبر ايران‌,966,6840750,59877351030,8440,8550,8860,420,4.98,8750,310,3.67,8250,8860,1400-6-10,2021-09-01
343,خكاوه,سايپا ديزل,965,13823506,62063203352,4401,4450,4533,132,3,4490,89,2.02,4329,4533,1400-6-10,2021-09-01
344,دارو,كارخانجات‌داروپخش‌,961,1654277,55754102110,34260,35120,33900,-360,-1.05,33700,-560,-1.63,32810,35120,1400-6-10,2021-09-01
345,دكيمي,كيميدارو,957,1562395,40593519260,26620,26630,25800,-820,-3.08,25980,-640,-2.4,25400,27070,1400-6-10,2021-09-01
346,كهرام,توليدي گرانيت بهسرام,953,670657,62557121290,92388,89650,95159,2771,3,93277,889,0.96,89650,95159,1400-6-10,2021-09-01
347,فجام,جام‌دارو,952,5693178,42324801050,7310,7210,7540,230,3.15,7430,120,1.64,7100,7570,1400-6-10,2021-09-01
348,ولملت,واسپاري ملت,951,8004564,53389542230,6700,6840,6500,-200,-2.99,6670,-30,-0.45,6500,6950,1400-6-10,2021-09-01
349,پكوير,كوير تاير,939,6498534,105499880290,15500,15650,16270,770,4.97,16230,730,4.71,15650,16270,1400-6-10,2021-09-01
350,وبوعلي,سرمايه‌گذاري‌بوعلي‌,933,9803805,47407148170,4720,4720,4950,230,4.87,4840,120,2.54,4630,4950,1400-6-10,2021-09-01
351,تكمبا,كمباين‌ سازي‌ ايران‌,924,6014757,44241498930,7290,7150,7440,150,2.06,7360,70,0.96,7070,7500,1400-6-10,2021-09-01
352,كسعدي,كاشي‌ سعدي‌,920,3212684,44314270560,13310,13700,13970,660,4.96,13790,480,3.61,13400,13970,1400-6-10,2021-09-01
353,قاسم,قاسم ايران,914,3737587,35065655800,9500,9500,9496,-4,-0.04,9382,-118,-1.24,9111,9601,1400-6-10,2021-09-01
354,ومعلم,بيمه معلم,914,11097848,49585680025,4406,4250,4510,104,2.36,4468,62,1.41,4250,4600,1400-6-10,2021-09-01
355,فايرا,آلومينيوم‌ايران‌,911,6939085,121694483380,16860,16550,17700,840,4.98,17540,680,4.03,16550,17700,1400-6-10,2021-09-01
356,ومهان,گروه توسعه مالي مهر آيندگان,910,3224388,52448764265,16124,16400,16420,296,1.84,16239,115,0.71,15860,16480,1400-6-10,2021-09-01
357,غبهار,كشت وصنعت بهاران گلبهار خراسان,907,2155253,41290258357,18778,19340,19000,222,1.18,19158,380,2.02,18310,19341,1400-6-10,2021-09-01
358,وملل,اعتباري ملل,906,4741603,59968407300,12518,12200,12965,447,3.57,12647,129,1.03,12200,13050,1400-6-10,2021-09-01
359,دفارا,داروسازي‌ فارابي‌,898,1892570,37067625570,19910,19910,20000,90,0.45,19590,-320,-1.61,19220,20500,1400-6-10,2021-09-01
360,غگلپا,شير پاستوريزه پگاه گلپايگان,896,1032640,70880807982,67737,67549,68900,1163,1.72,68640,903,1.33,65611,70544,1400-6-10,2021-09-01
361,خكرمان,گروه اقتصادي كرمان خودرو,893,11230432,45268814235,3981,3962,4074,93,2.34,4031,50,1.26,3900,4100,1400-6-10,2021-09-01
362,كاريس,صندوق س.سپهر كاريزما-س,893,8720953,129855315514,14420,14450,14950,530,3.68,14890,470,3.26,14450,15020,1400-6-10,2021-09-01
363,غمارگ,مارگارين‌,892,1928024,63766284510,32140,33520,33300,1160,3.61,33070,930,2.89,32700,33520,1400-6-10,2021-09-01
364,كيميا,معدني كيمياي زنجان گستران,889,4457150,69895293241,15239,15100,16000,761,4.99,15682,443,2.91,15100,16000,1400-6-10,2021-09-01
365,كپارس,كاشي‌ پارس‌,889,584610,71084152910,117200,119510,123060,5860,5,121590,4390,3.75,116010,123060,1400-6-10,2021-09-01
366,خاهن,آهنگري‌ تراكتورسازي‌ ايران‌,887,6462497,56504955430,8430,8750,8850,420,4.98,8740,310,3.68,8460,8850,1400-6-10,2021-09-01
367,ومشان,س. فني و مهندسي مشانير,884,578456,37386818965,64639,61408,65800,1161,1.8,64632,-7,-0.01,61408,67000,1400-6-10,2021-09-01
368,حتايد,تايدواترخاورميانه,881,2707102,68364807880,25020,24750,25390,370,1.48,25250,230,0.92,24550,25620,1400-6-10,2021-09-01
369,بسويچ,پارس‌سويچ‌,881,1251242,37532207090,29360,30000,30240,880,3,30000,640,2.18,28580,30450,1400-6-10,2021-09-01
370,ركيش,كارت اعتباري ايران كيش,862,7093645,55000349180,7570,7560,7880,310,4.1,7750,180,2.38,7340,7940,1400-6-10,2021-09-01
371,كساپا,سايپاشيشه‌,861,2457919,57639029280,22740,23000,23870,1130,4.97,23450,710,3.12,22790,23870,1400-6-10,2021-09-01
372,ساراب,سيمان‌ داراب‌,861,12700877,248286744060,18650,18990,19580,930,4.99,19550,900,4.83,18650,19580,1400-6-10,2021-09-01
373,چافست,افست‌,859,2931212,47645713350,15640,16250,16420,780,4.99,16250,610,3.9,15120,16420,1400-6-10,2021-09-01
374,حسير,ريل سير كوثر,855,3793622,133317123816,33485,35000,35159,1674,5,35142,1657,4.95,34135,35159,1400-6-10,2021-09-01
375,دسبحان,سبحان دارو,853,2472014,53653950780,21760,20720,21990,230,1.06,21700,-60,-0.28,20700,22500,1400-6-10,2021-09-01
376,سمايه,بانك سرمايه,849,8712823,39682604693,4488,4354,4621,133,2.96,4555,67,1.49,4354,4622,1400-6-10,2021-09-01
377,وثوق,سرمايه گذاري وثوق امين,847,2162096,35014973845,16775,17459,16250,-525,-3.13,16195,-580,-3.46,15937,17459,1400-6-10,2021-09-01
378,كاذر,فرآورده‌هاي‌نسوزآذر,841,5256716,93931971150,17260,17000,18120,860,4.98,17870,610,3.53,17000,18120,1400-6-10,2021-09-01
379,فولاژ,فولاد آلياژي ايران,833,3345534,60279697470,17900,17920,18170,270,1.51,17980,80,0.45,17390,18210,1400-6-10,2021-09-01
380,تسه0004,امتيازتسهيلات مسكن تير1400,827,28526,16789439084,589489,595222,575000,-14489,-2.46,588566,-923,-0.16,560020,609999,1400-6-10,2021-09-01
381,وپخش,داروپخش‌ (هلدينگ‌,825,1165783,42021468410,36220,35530,36780,560,1.55,36080,-140,-0.39,34530,37300,1400-6-10,2021-09-01
382,خموتور,موتورسازان‌تراكتورسازي‌ايران‌,825,5094147,59527636890,11170,11360,11720,550,4.92,11690,520,4.66,11250,11720,1400-6-10,2021-09-01
383,خريخت,صنايع‌ريخته‌گري‌ايران‌,823,13108932,44471227718,3349,3460,3462,113,3.37,3392,43,1.28,3300,3470,1400-6-10,2021-09-01
384,فسازان,غلتك سازان سپاهان,822,2659828,89405434240,32220,33190,33830,1610,5,33610,1390,4.31,32000,33830,1400-6-10,2021-09-01
385,ثزاگرس,سرمايه گذاري توسعه عمران زاگرس,820,605834,30663218286,48731,47010,51164,2433,4.99,50613,1882,3.86,47010,51167,1400-6-10,2021-09-01
386,دكوثر,داروسازي‌ كوثر,817,7828906,39070935280,5050,4810,5110,60,1.19,4990,-60,-1.19,4810,5220,1400-6-10,2021-09-01
387,خلنت,لنت‌ ترمزايران‌,815,738707,57716214360,74550,78270,78270,3720,4.99,78130,3580,4.8,76200,78270,1400-6-10,2021-09-01
388,دزهراوي,داروسازي‌زهراوي‌,815,3732650,26165007750,6880,6810,7150,270,3.92,7010,130,1.89,6760,7200,1400-6-10,2021-09-01
389,ثاخت,بين‌المللي‌توسعه‌ساختمان,814,34506704,94513835466,2609,2739,2739,130,4.98,2739,130,4.98,2730,2739,1400-6-10,2021-09-01
390,غبشهر,صنعتي‌ بهشهر,812,3249193,86832352700,26390,25620,27200,810,3.07,26720,330,1.25,25620,27700,1400-6-10,2021-09-01
391,فلامي,لاميران‌,809,1659698,41328559380,24920,23900,25000,80,0.32,24900,-20,-0.08,23900,25790,1400-6-10,2021-09-01
392,قشرين,قند شيرين خراسان,805,11139086,222016470349,19368,19949,19949,581,3,19931,563,2.91,19470,19949,1400-6-10,2021-09-01
393,ولشرق,ليزينگ ايران و شرق,801,5096991,31704665572,6085,6010,6290,205,3.37,6220,135,2.22,6010,6348,1400-6-10,2021-09-01
394,مفاخر,توسعه فناوري اطلاعات خوارزمي,800,1091436,58557674786,54194,55493,53590,-604,-1.11,53652,-542,-1,52013,56800,1400-6-10,2021-09-01
395,خوساز,محورسازان‌ايران‌خودرو,793,5715818,46563215470,7830,8080,8200,370,4.73,8150,320,4.09,7680,8220,1400-6-10,2021-09-01
396,فروس,فروسيليس‌ ايران‌,780,10072926,64652382770,6140,6060,6440,300,4.89,6420,280,4.56,6060,6440,1400-6-10,2021-09-01
397,سمازن,سيمان‌مازندران‌,775,6971211,114865720000,15940,15860,16730,790,4.96,16480,540,3.39,15790,16730,1400-6-10,2021-09-01
398,تپولا,مهندسي مرآت پولاد,770,1354825,31156795515,23571,23492,22864,-707,-3,22997,-574,-2.44,22864,23820,1400-6-10,2021-09-01
399,فاهواز,نورد و لوله اهواز,769,5110466,36018564368,7191,7048,7048,-143,-1.99,7048,-143,-1.99,7048,7048,1400-6-10,2021-09-01
400,اپرداز,آتيه داده پرداز,761,1458560,31015127159,20895,20700,21769,874,4.18,21264,369,1.77,20131,21870,1400-6-10,2021-09-01
401,شبصير,توليدات پتروشيمي قائد بصير,760,704668,73241816026,102354,101000,104201,1847,1.8,103938,1584,1.55,100786,105999,1400-6-10,2021-09-01
402,غشاذر,پگاه‌آذربايجان‌غربي‌,757,3805346,31103137340,8030,8250,8200,170,2.12,8170,140,1.74,8050,8390,1400-6-10,2021-09-01
403,فخاس,فولاد خراسان,756,1995123,63536069940,31450,32250,31800,350,1.11,31680,230,0.73,30660,32950,1400-6-10,2021-09-01
404,جم,پتروشيمي جم,738,3052105,145457219270,46120,46500,48420,2300,4.99,47660,1540,3.34,45220,48420,1400-6-10,2021-09-01
405,بالاس,مهندسي ساختمان تاسيسات راه آهن,733,1068023,38011390871,35264,35999,36198,934,2.65,35590,326,0.92,34442,36499,1400-6-10,2021-09-01
406,قلرست,قند لرستان‌,733,1450295,40439129850,26920,27980,28260,1340,4.98,27880,960,3.57,26020,28260,1400-6-10,2021-09-01
407,واميد,گروه مديريت سرمايه گذاري اميد,725,6541787,90229981940,13660,13250,13800,140,1.02,13760,100,0.73,13250,13970,1400-6-10,2021-09-01
408,ثشرق,سرمايه گذاري مسكن شمال شرق,725,7048240,39804067980,5470,5440,5740,270,4.94,5650,180,3.29,5360,5740,1400-6-10,2021-09-01
409,وآرين,شركت توسعه اقتصادي آرين,722,10197839,32411440025,3098,3053,3190,92,2.97,3178,80,2.58,3053,3190,1400-6-10,2021-09-01
410,كگاز,شيشه‌ و گاز,717,2744459,58292993840,20660,20230,21690,1030,4.99,21240,580,2.81,19640,21690,1400-6-10,2021-09-01
411,وساشرقي,شركت س استان آذربايجان شرقي,717,26061923,17783187354,710,676,690,-20,-2.82,701,-9,-1.27,675,698,1400-6-10,2021-09-01
412,ساينا,صنايع بهداشتي ساينا,715,445319,51074835289,109889,110000,115383,5494,5,114693,4804,4.37,106108,115383,1400-6-10,2021-09-01
413,ددام,داروسازي زاگرس فارمد پارس,715,2942467,40265847350,13180,12900,13830,650,4.93,13680,500,3.79,12900,13830,1400-6-10,2021-09-01
414,شرانل,نفت ايرانول,713,721277,36511359443,50248,50500,50000,-248,-0.49,50584,336,0.67,49500,51990,1400-6-10,2021-09-01
415,بنيرو,نيروترانس‌,711,8934002,27458493958,3023,3020,3100,77,2.55,3073,50,1.65,2970,3145,1400-6-10,2021-09-01
416,رتاپ,تجارت الكترونيك  پارسيان,708,3600334,23647163440,6530,6500,6620,90,1.38,6570,40,0.61,6430,6690,1400-6-10,2021-09-01
417,قشهد,شهد,707,2763593,48691459380,16950,17300,17790,840,4.96,17620,670,3.95,17000,17790,1400-6-10,2021-09-01
418,شتوكا,توكا رنگ فولاد سپاهان,707,1044307,34876882683,32820,32020,33830,1010,3.08,33397,577,1.76,32020,34130,1400-6-10,2021-09-01
419,درازك,دارويي‌ رازك‌,706,1314673,57228658740,42630,42500,44300,1670,3.92,43530,900,2.11,41010,44760,1400-6-10,2021-09-01
420,شوينده,مديريت صنعت شوينده ت.ص.بهشهر,706,1701084,44065419120,25040,25500,26000,960,3.83,25900,860,3.43,24110,26290,1400-6-10,2021-09-01
421,فنوال,نورد آلومينيوم‌,698,2728045,82627560340,28900,30340,30340,1440,4.98,30290,1390,4.81,29600,30340,1400-6-10,2021-09-01
422,افرا,افرانت,697,1393348,36626444591,26006,25343,26799,793,3.05,26287,281,1.08,25343,26900,1400-6-10,2021-09-01
423,وجامي,سرمايه گذاري جامي,687,4090609,47763557582,12004,11646,11650,-354,-2.95,11676,-328,-2.73,11644,12150,1400-6-10,2021-09-01
424,سفار,سيمان‌فارس‌,687,665324,62384113680,89460,90250,93930,4470,5,93770,4310,4.82,90250,93930,1400-6-10,2021-09-01
425,دلقما,دارويي‌ لقمان‌,681,1365482,52285657750,36870,37390,38710,1840,4.99,38290,1420,3.85,36320,38710,1400-6-10,2021-09-01
426,لازما,كارخانه هاي صنعتي آزمايش,681,1684749,40113324512,23220,23900,23916,696,3,23810,590,2.54,23301,23916,1400-6-10,2021-09-01
427,وكادو,تكادو,679,3191688,67931563964,20786,20532,21409,623,3,21284,498,2.4,20532,21409,1400-6-10,2021-09-01
428,ثامان,سامان‌ گستراصفهان‌,679,2183816,30477531890,13700,13160,14330,630,4.6,13960,260,1.9,13020,14380,1400-6-10,2021-09-01
429,درهآور,دارويي ره آورد تامين,676,1071871,34397247655,30871,32090,32414,1543,5,32091,1220,3.95,31222,32414,1400-6-10,2021-09-01
430,شيراز,پتروشيمي‌شيراز,675,1775134,134577966980,74360,76270,76660,2300,3.09,75810,1450,1.95,75250,76880,1400-6-10,2021-09-01
431,دابور,داروسازي‌ ابوريحان‌,672,2494115,70264731000,27270,26770,28570,1300,4.77,28170,900,3.3,26770,28580,1400-6-10,2021-09-01
432,زمگسا,كشاورزي‌ ودامپروي‌ مگسال‌,668,1149051,34216573990,29410,29300,29770,360,1.22,29780,370,1.26,28800,30440,1400-6-10,2021-09-01
433,وتعاونح,ح . بيمه  تعاون,667,10918042,14854353758,580,1392,1351,771,132.93,1361,781,134.66,1351,1433,1400-6-10,2021-09-01
434,نتوس,پشم‌ بافي‌ توس,667,2068185,31489977886,15428,15071,15120,-308,-2,15226,-202,-1.31,14966,15710,1400-6-10,2021-09-01
435,جم پيلن,پلي پروپيلن جم - جم پيلن,665,718777,78812786540,105520,103070,110340,4820,4.57,109230,3710,3.52,103070,110450,1400-6-10,2021-09-01
436,شخارك,پتروشيمي‌ خارك‌,663,1807623,92020723940,49960,51400,51470,1510,3.02,50860,900,1.8,49510,51500,1400-6-10,2021-09-01
437,لسرما,سرما آفرين‌,656,1379820,33378057600,23360,24290,24520,1160,4.97,24190,830,3.55,23300,24520,1400-6-10,2021-09-01
438,دفاراح,ح . داروسازي‌ فارابي‌,646,1754583,26787040350,15190,15900,15600,410,2.7,15270,80,0.53,15000,15900,1400-6-10,2021-09-01
439,مشهد1412,مشاركت ش مشهد1412-3ماهه18%,641,3200875,3200875000000,1000000,1000000,1000000,0,0,1000000,0,0,1000000,1000000,1400-6-10,2021-09-01
440,زبينا,كشاورزي و دامپروري بينالود,641,8494040,26968608071,3120,3130,3172,52,1.67,3175,55,1.76,3110,3248,1400-6-10,2021-09-01
441,شكلر,نيروكلر,639,924761,37276186990,39920,39850,40800,880,2.2,40310,390,0.98,38330,41180,1400-6-10,2021-09-01
442,ثفارس,عمران‌وتوسعه‌فارس‌,631,7561464,86578762800,10910,11450,11450,540,4.95,11450,540,4.95,11450,11450,1400-6-10,2021-09-01
443,نمرينو,ايران‌ مرينوس‌,630,694046,76544362760,106290,106290,111600,5310,5,110290,4000,3.76,101120,111600,1400-6-10,2021-09-01
444,سكرد,سيمان كردستان,630,4750209,34808859870,7050,6900,7400,350,4.96,7330,280,3.97,6900,7400,1400-6-10,2021-09-01
445,آكورد,صندوق س. آرمان آتي كوثر-د,629,16054140,544069362740,33868,33908,33889,21,0.06,33890,22,0.06,33887,33912,1400-6-10,2021-09-01
446,شراز,پالايش نفت شيراز,626,468597,58851425212,124241,125000,125805,1564,1.26,125591,1350,1.09,120500,127499,1400-6-10,2021-09-01
447,ثعتما,س. ساختماني اعتماد گستر,626,1394502,44715711083,32797,33690,32700,-97,-0.3,32066,-731,-2.23,31814,33690,1400-6-10,2021-09-01
448,زقيام,كشت و دام قيام اصفهان,626,2347947,51932477740,21268,21268,22320,1052,4.95,22118,850,4,21090,22331,1400-6-10,2021-09-01
449,زپارس,ملي كشت و صنعت و دامپروري پارس,625,456008,58290621350,129320,129320,126210,-3110,-2.4,127830,-1490,-1.15,126010,133100,1400-6-10,2021-09-01
450,پسهند,صنايع‌ لاستيكي‌  سهند,625,955353,33520571080,35460,34700,35710,250,0.71,35090,-370,-1.04,33800,36230,1400-6-10,2021-09-01
451,سغرب,سيمان‌غرب‌,621,1417156,33746330110,23230,22580,24250,1020,4.39,23810,580,2.5,22580,24370,1400-6-10,2021-09-01
452,بنو,بيمه تجارت نو,620,2113110,30835575351,14484,14748,14548,64,0.44,14580,96,0.66,14484,14999,1400-6-10,2021-09-01
453,خچرخش,چرخشگر,617,4648936,54828040000,11350,11200,11910,560,4.93,11790,440,3.88,10900,11910,1400-6-10,2021-09-01
454,پدرخش,درخشان‌ تهران‌,616,1297133,32297684260,24100,23620,25300,1200,4.98,24900,800,3.32,23600,25300,1400-6-10,2021-09-01
455,فلات,گروه صنايع معادن فلات ايرانيان,615,2036211,26209424025,13002,12780,12820,-182,-1.4,12872,-130,-1,12612,13335,1400-6-10,2021-09-01
456,شدوص,دوده‌ صنعتي‌ پارس‌,609,2313769,54370448060,22620,22400,23750,1130,5,23500,880,3.89,22000,23750,1400-6-10,2021-09-01
457,تكنو,تكنوتار,609,1548058,25218548940,16000,16700,16060,60,0.38,16290,290,1.81,15760,16700,1400-6-10,2021-09-01
458,فبيرا,بسته‌ بندي‌ ايران‌,606,8588608,19685674655,2290,2340,2296,6,0.26,2292,2,0.09,2250,2350,1400-6-10,2021-09-01
459,وسگيلا,شركت س استان گيلان,603,32184090,20658324137,657,636,652,-5,-0.76,649,-8,-1.22,632,659,1400-6-10,2021-09-01
460,جوين,كشت و صنعت جوين,601,6524144,25263609060,3895,3800,3934,39,1,3872,-23,-0.59,3779,3980,1400-6-10,2021-09-01
461,آبين,كشت و صنعت آبشيرين,597,5939346,15174339415,2580,2533,2580,0,0,2555,-25,-0.97,2529,2608,1400-6-10,2021-09-01
462,پرداخت,به پرداخت ملت,591,1588725,32958142400,20060,19920,21060,1000,4.99,20750,690,3.44,19920,21060,1400-6-10,2021-09-01
463,پخش,پخش البرز,589,2561758,67667706838,26021,26208,26230,209,0.8,26415,394,1.51,25448,27120,1400-6-10,2021-09-01
464,وبهمن,سرمايه‌گذاري‌بهمن‌,584,2537939,44399548440,16670,17400,17500,830,4.98,17490,820,4.92,17370,17500,1400-6-10,2021-09-01
465,زكشت,كشاورزي مكانيزه اصفهان كشت,584,1020396,30321630121,28480,29904,29904,1424,5,29716,1236,4.34,29000,29904,1400-6-10,2021-09-01
466,حپارسا,توسعه حمل و نقل ريلي پارسيان,584,1414906,57363978439,40718,41999,41227,509,1.25,40543,-175,-0.43,39500,41999,1400-6-10,2021-09-01
467,سخوز,سيمان خوزستان,581,1673525,45965100710,26370,25530,27680,1310,4.97,27470,1100,4.17,25530,27680,1400-6-10,2021-09-01
468,كطبس,ذغال‌سنگ‌ نگين‌ ط‌بس‌,578,1439158,94266851760,62830,63700,65970,3140,5,65500,2670,4.25,63000,65970,1400-6-10,2021-09-01
469,تسه0003,امتيازتسهيلات مسكن خرداد1400,577,18316,10748193785,589207,580000,575000,-14207,-2.41,586820,-2387,-0.41,571100,610000,1400-6-10,2021-09-01
470,ورازي,بيمه رازي,574,15988043,31779253269,1897,1931,1991,94,4.96,1988,91,4.8,1931,1991,1400-6-10,2021-09-01
471,سرود,سيمان‌شاهرود,569,3923544,109360582640,26640,26000,27970,1330,4.99,27870,1230,4.62,25550,27970,1400-6-10,2021-09-01
472,وبشهر,توسعه‌ صنايع‌ بهشهر(هلدينگ,567,3936527,52874456090,13210,13210,13860,650,4.92,13430,220,1.67,12770,13870,1400-6-10,2021-09-01
473,شپاس,نفت پاسارگاد,567,3554041,79637557737,21384,21500,22453,1069,5,22408,1024,4.79,21500,22453,1400-6-10,2021-09-01
474,لابسا,آبسال‌,563,1582221,63480978670,38280,40100,40190,1910,4.99,40120,1840,4.81,39220,40190,1400-6-10,2021-09-01
475,فن آوا,گروه فن آوا,561,3837065,94861394767,24027,24700,24747,720,3,24722,695,2.89,24007,24747,1400-6-10,2021-09-01
476,سخزر,سيمان‌ خزر,559,1573250,45215213650,27470,28790,28840,1370,4.99,28740,1270,4.62,27650,28840,1400-6-10,2021-09-01
477,قچار,فراوردههاي غذايي وقند چهارمحال,556,2105428,34577795084,16098,16200,16464,366,2.27,16423,325,2.02,16100,16797,1400-6-10,2021-09-01
478,فاما,صنعتي‌ آما,555,1253549,22097372350,17590,16830,17560,-30,-0.17,17630,40,0.23,16830,18380,1400-6-10,2021-09-01
479,ضخود7077,اختيارخ خودرو-3000-1400/07/07,551,27799,447863000,17,22,17,0,0,16,-1,-5.88,14,22,1400-6-10,2021-09-01
480,سباقر,سيمان باقران,548,3076129,53808403114,17314,17400,17833,519,3,17492,178,1.03,16906,17833,1400-6-10,2021-09-01
481,سيلام,سيمان‌ ايلام‌,547,3096699,26950708270,8310,8590,8720,410,4.93,8700,390,4.69,8450,8720,1400-6-10,2021-09-01
482,بميلا,توسعه بازرگاني آهن وفولادميلاد,546,1936693,25764735710,13357,13540,13385,28,0.21,13303,-54,-0.4,13100,13540,1400-6-10,2021-09-01
483,غپآذر,شير پگاه آذربايجان شرقي,543,830181,43848502759,52467,54300,52950,483,0.92,52818,351,0.67,51560,54300,1400-6-10,2021-09-01
484,بخاور,بيمه زندگي خاورميانه,540,4466667,29444340976,6458,6720,6659,201,3.11,6592,134,2.07,6478,6750,1400-6-10,2021-09-01
485,زشگزا,شير و گوشت زاگرس شهركرد,540,2866715,18308802025,6283,6100,6433,150,2.39,6387,104,1.66,6100,6500,1400-6-10,2021-09-01
486,ثپرديس,سرمايه گذاري مسكن پرديس,539,6266883,42366122126,6493,6670,6817,324,4.99,6760,267,4.11,6361,6817,1400-6-10,2021-09-01
487,اعتلا,شركت سرمايه گذاري اعتلاء البرز,538,3049374,23463516179,7505,7474,7850,345,4.6,7695,190,2.53,7474,7868,1400-6-10,2021-09-01
488,سفانو,سيمان فارس نو,535,1098059,33189080880,29340,29100,30200,860,2.93,30230,890,3.03,29100,30800,1400-6-10,2021-09-01
489,وايرا,سرمايه گذاري صنايع ايران,532,3463025,25545837159,7598,7371,7400,-198,-2.61,7377,-221,-2.91,7371,7590,1400-6-10,2021-09-01
490,وصندوق,سرمايه‌گذاري‌صندوق‌بازنشستگي‌,532,4735470,87592521840,17880,17800,18560,680,3.8,18360,480,2.68,17320,18770,1400-6-10,2021-09-01
491,پكرمان,گروه‌ صنعتي‌ بارز,530,2969535,84539569380,27290,27300,28650,1360,4.98,28470,1180,4.32,26640,28650,1400-6-10,2021-09-01
492,دعبيد,لابراتوارداروسازي‌  دكترعبيدي‌,529,981127,26347042630,26550,26550,26840,290,1.09,26720,170,0.64,26210,27500,1400-6-10,2021-09-01
493,بشهاب,لامپ‌  پارس‌ شهاب‌,528,376459,52237625490,132660,136900,139290,6630,5,138760,6100,4.6,136000,139290,1400-6-10,2021-09-01
494,غپونه,نوش پونه مشهد,527,1051527,17646941873,16431,16900,16880,449,2.73,16782,351,2.14,16240,16923,1400-6-10,2021-09-01
495,لوتوس,تامين سرمايه لوتوس پارسيان,526,2324774,22972761250,9650,9800,9970,320,3.32,9800,150,1.55,9650,10030,1400-6-10,2021-09-01
496,جهرم,پتروشيمي جهرم,523,8219374,12383720098,1516,1490,1527,11,0.73,1507,-9,-0.59,1472,1537,1400-6-10,2021-09-01
497,دشيمي,شيمي‌ داروئي‌ داروپخش‌,521,1022662,28431462510,27650,27350,28000,350,1.27,27800,150,0.54,26910,28550,1400-6-10,2021-09-01
498,ضخود7076,اختيارخ خودرو-2500-1400/07/07,519,26758,2719660000,99,120,110,11,11.11,102,3,3.03,90,120,1400-6-10,2021-09-01
499,فراز,صندوق س.سهام فراز داريك-س,517,4844254,67770956318,13958,13970,13991,33,0.24,13990,32,0.23,13962,14110,1400-6-10,2021-09-01
500,وسصفا,شركت س استان اصفهان,517,20179350,16053549722,831,790,803,-28,-3.37,823,-8,-0.96,790,815,1400-6-10,2021-09-01
501,ولتجارح,ح.واسپا تجارت وسرمايه ايرانيان,516,13671585,26836023413,2014,1954,2060,46,2.28,1963,-51,-2.53,1954,2070,1400-6-10,2021-09-01
502,وسبحان,سرمايه گذاري سبحان,512,5622555,18409536504,3199,3122,3303,104,3.25,3274,75,2.34,3122,3340,1400-6-10,2021-09-01
503,سپ,پرداخت الكترونيك سامان كيش,508,1281327,37585989760,29440,28320,29500,60,0.2,29370,-70,-0.24,28320,30140,1400-6-10,2021-09-01
504,سقاين,سيمان‌ قائن‌,507,721481,49933778760,66010,68950,69310,3300,5,69210,3200,4.85,66800,69310,1400-6-10,2021-09-01
505,تيپيكوح,ح . سرمايه گذاري دارويي تامين,504,1161535,22175270620,19120,19410,19010,-110,-0.58,19090,-30,-0.16,18750,19780,1400-6-10,2021-09-01
506,فيروزه,صندوق شاخص30 شركت فيروزه- سهام,496,345845,61949515550,176230,181290,181500,5270,2.99,179130,2900,1.65,176500,182200,1400-6-10,2021-09-01
507,تكشا,گسترش‌صنايع‌وخدمات‌كشاورزي‌,494,1427204,51387805960,34430,35700,36150,1720,5,36010,1580,4.59,35000,36150,1400-6-10,2021-09-01
508,زفكا,كشت و دامداري فكا,493,1468713,16959080263,11550,11850,11699,149,1.29,11547,-3,-0.03,11211,11950,1400-6-10,2021-09-01
509,هجرت,پخش هجرت,492,727422,24268543549,32429,31580,33930,1501,4.63,33362,933,2.88,31580,34050,1400-6-10,2021-09-01
510,چكاوه,صنايع‌كاغذسازي‌كاوه‌,492,5066698,70086220150,13220,13880,13880,660,4.99,13830,610,4.61,13120,13880,1400-6-10,2021-09-01
511,فسا,پتروشيمي فسا,490,9370423,14545082954,1515,1530,1560,45,2.97,1552,37,2.44,1521,1560,1400-6-10,2021-09-01
512,سكه0012پ01,تمام سكه طرح جديد0012رفاه,485,115000,137892638200,1198059,1209500,1195500,-2559,-0.21,1199066,1007,0.08,1193201,1209500,1400-6-10,2021-09-01
513,كگهر,سنگ آهن گهرزمين,485,1457563,73084964529,49613,51500,50010,397,0.8,49937,324,0.65,49001,51600,1400-6-10,2021-09-01
514,آرمان,بيمه آرمان,484,3617491,26457973240,7131,7487,7200,69,0.97,7314,183,2.57,6862,7487,1400-6-10,2021-09-01
515,غشوكو,شوكو پارس,480,1743604,54323709734,32730,31094,31094,-1636,-5,31156,-1574,-4.81,31094,31720,1400-6-10,2021-09-01
516,وتوسم,سرمايه‌گذاري‌توسعه‌ملي‌,475,2510431,21487811520,8340,8470,8660,320,3.84,8560,220,2.64,8210,8700,1400-6-10,2021-09-01
517,مبين,مبين انرژي خليج فارس,470,2075986,43871466240,20460,21480,21200,740,3.62,20730,270,1.32,20560,21480,1400-6-10,2021-09-01
518,تكنار,مجتمع معادن مس تكنار,467,165991,15340823018,93158,93000,92880,-278,-0.3,92420,-738,-0.79,90364,95930,1400-6-10,2021-09-01
519,لپيام,گسترش صنايع پيام,466,668085,29311329331,45207,43852,43851,-1356,-3,43874,-1333,-2.95,43851,45820,1400-6-10,2021-09-01
520,وحكمت,بيمه حكمت صبا,463,8555546,33507833986,3992,3875,4100,108,2.71,3917,-75,-1.88,3793,4100,1400-6-10,2021-09-01
521,كمنگنز,معادن‌منگنزايران‌,463,425724,35685688390,80700,81070,84730,4030,4.99,83820,3120,3.87,79780,84730,1400-6-10,2021-09-01
522,خراسان,پتروشيمي خراسان,457,286893,24164779340,83290,87150,85730,2440,2.93,83670,380,0.46,81340,87150,1400-6-10,2021-09-01
523,ياقوت,صندوق س ياقوت آگاه-ثابت,457,3887887,50576378588,13003,13022,13000,-3,-0.02,13009,6,0.05,12998,13031,1400-6-10,2021-09-01
524,تسه0002,امتيازتسهيلاتمسكن ارديبهشت1400,456,17268,10123408126,590007,579101,575000,-15007,-2.54,586252,-3755,-0.64,560507,605000,1400-6-10,2021-09-01
525,ميدكوح,ح.توسعه م وص.معدني خاورميانه,455,729160,30654636730,40640,40310,42300,1660,4.08,42040,1400,3.44,40310,42800,1400-6-10,2021-09-01
526,سكرما,سيمان‌ كرمان‌,452,4290803,77151113590,17190,17570,18040,850,4.94,17980,790,4.6,17200,18040,1400-6-10,2021-09-01
527,تپمپي,پمپ‌ سازي‌ ايران‌,449,4512291,91038959230,19230,19870,20190,960,4.99,20180,950,4.94,19630,20190,1400-6-10,2021-09-01
528,سهگمت,سيمان‌هگمتان‌,446,913867,25111774050,27090,27600,27980,890,3.29,27480,390,1.44,26470,28300,1400-6-10,2021-09-01
529,سنير,سيمان‌ سفيد ني‌ريز,445,305066,53218763700,166150,174450,174450,8300,5,174450,8300,5,174450,174450,1400-6-10,2021-09-01
530,كميناح,ح . شيشه سازي مينا,443,4321729,41246482281,9285,9560,9563,278,2.99,9544,259,2.79,9360,9563,1400-6-10,2021-09-01
531,وخاور,بانك خاورميانه,440,3000997,19874598140,6630,6410,6650,20,0.3,6630,0,0,6410,6730,1400-6-10,2021-09-01
532,لپارس,پارس‌ الكتريك‌,439,1442932,165360007200,109150,114600,114600,5450,4.99,114600,5450,4.99,114600,114600,1400-6-10,2021-09-01
533,وسهمدا,شركت س استان همدان,436,18781194,11762330112,628,606,634,6,0.96,627,-1,-0.16,606,643,1400-6-10,2021-09-01
534,بايكا,كارخانجات كابلسازي ‌ايران‌,435,1056492,29847574694,29035,28164,28164,-871,-3,28252,-783,-2.7,28164,29389,1400-6-10,2021-09-01
535,عيار,صندوق سكه طلاي مفيد,434,401392,12219944269,30336,30991,30350,14,0.05,30444,108,0.36,30200,30991,1400-6-10,2021-09-01
536,سيدكو,سرمايه گذاري توسعه صنايع سيمان,433,1770983,13710024770,7570,7510,7660,90,1.19,7700,130,1.72,7510,7900,1400-6-10,2021-09-01
537,سبجنو,سيمان‌ بجنورد,431,328612,16523580300,49120,50850,50260,1140,2.32,50280,1160,2.36,49120,50900,1400-6-10,2021-09-01
538,تسه0001,امتيازتسهيلات مسكن فروردين1400,430,18300,10739276447,589856,580000,575000,-14856,-2.52,586846,-3010,-0.51,560372,614995,1400-6-10,2021-09-01
539,خاور,ايران خودرو ديزل,428,5552938,48793666206,8532,8787,8787,255,2.99,8787,255,2.99,8787,8787,1400-6-10,2021-09-01
540,رتكو,كنترل‌خوردگي‌تكين‌كو,424,1432616,17108438110,11760,11360,12190,430,3.66,11940,180,1.53,11360,12320,1400-6-10,2021-09-01
541,وسرمد,بيمه  سرمد,423,3890065,18963006517,4888,4772,5033,145,2.97,4875,-13,-0.27,4747,5034,1400-6-10,2021-09-01
542,شفا,سرمايه گذاري شفادارو,420,2156246,101242177300,45140,45140,47390,2250,4.98,46950,1810,4.01,43730,47390,1400-6-10,2021-09-01
543,شپاكسا,پاكسان‌,420,1267927,28346086430,22140,22490,22790,650,2.94,22360,220,0.99,21700,22840,1400-6-10,2021-09-01
544,دسبحا,گروه دارويي سبحان,416,1924458,34035785180,17360,17130,17870,510,2.94,17690,330,1.9,16740,18220,1400-6-10,2021-09-01
545,مداران,داده‌پردازي‌ايران‌,415,1571860,33970585860,20770,20490,21800,1030,4.96,21610,840,4.04,20000,21800,1400-6-10,2021-09-01
546,فردا,صندوق س آواي فرداي زاگرس-ثابت,415,18248549,206938298559,11334,11339,11340,6,0.05,11340,6,0.05,11339,11341,1400-6-10,2021-09-01
547,غشهد,شهد ايران ‌,414,3118495,16499091820,5080,5270,5330,250,4.92,5290,210,4.13,5090,5330,1400-6-10,2021-09-01
548,وسين,بيمه سينا,411,6153023,22066450518,3571,3610,3551,-20,-0.56,3586,15,0.42,3520,3670,1400-6-10,2021-09-01
549,سشمال,سيمان‌ شمال‌,410,2839420,30497010720,10250,10730,10760,510,4.98,10740,490,4.78,10460,10760,1400-6-10,2021-09-01
550,وگردش,بانك گردشگري,409,1416851,18772471438,13512,13150,13329,-183,-1.35,13450,-62,-0.46,13107,13598,1400-6-10,2021-09-01
551,تسه9912,امتياز تسهيلات مسكن اسفند99,403,16960,9925960760,589321,583666,575000,-14321,-2.43,585257,-4064,-0.69,559855,605000,1400-6-10,2021-09-01
552,معيار ,سرمايه گذاري معيار صنعت پارس,391,389623,18792004579,47294,46001,48712,1418,3,48231,937,1.98,46001,48712,1400-6-10,2021-09-01
553,كاسپين,داروسازي كاسپين تامين,388,1163443,26955009752,22366,23484,23170,804,3.59,23168,802,3.59,22410,23484,1400-6-10,2021-09-01
554,وزمين,بانك ايران زمين,387,2383218,30791897110,12564,13066,13059,495,3.94,12920,356,2.83,12450,13066,1400-6-10,2021-09-01
555,ما,بيمه  ما,384,2160102,17596727350,7860,8180,8250,390,4.96,8150,290,3.69,7840,8250,1400-6-10,2021-09-01
556,وآتوس,س.آرين توسكا قيمت اسمي 350ريال,382,613129,19751993761,32441,32780,32272,-169,-0.52,32215,-226,-0.7,31468,33391,1400-6-10,2021-09-01
557,پرديس,سرمايه گذاري پرديس,382,1999313,12081815000,5890,6060,6100,210,3.57,6020,130,2.21,5860,6130,1400-6-10,2021-09-01
558,لبوتان,گروه‌صنعتي‌بوتان‌,379,562823,35905514740,61220,61770,64280,3060,5,63800,2580,4.21,61320,64280,1400-6-10,2021-09-01
559,زگلدشت,كشت و دام گلدشت نمونه اصفهان,377,943027,11015175403,11594,11330,11840,246,2.12,11660,66,0.57,11160,11990,1400-6-10,2021-09-01
560,گكيش,توريستي ورفاهي آبادگران كيش,377,578889,25616485741,45489,44128,44125,-1364,-3,44251,-1238,-2.72,44125,45489,1400-6-10,2021-09-01
561,پارتا,مجتمع‌صنعتي‌آرتاويل‌تاير,375,901489,25386445295,28225,28222,28899,674,2.39,28161,-64,-0.23,27379,29000,1400-6-10,2021-09-01
562,دسانكوح,ح . داروسازي سبحان انكولوژي,375,2112137,23249633786,10677,11210,11000,323,3.03,11008,331,3.1,10731,11210,1400-6-10,2021-09-01
563,غشصفا,شيرپاستوريزه‌پگاه‌اصفهان‌,373,762073,25361104170,32350,32270,33500,1150,3.55,33280,930,2.87,32270,33770,1400-6-10,2021-09-01
564,گوهرانح,ح . س. توسعه گوهران اميد,372,1588985,6705544667,4235,4036,4180,-55,-1.3,4220,-15,-0.35,4036,4330,1400-6-10,2021-09-01
565,شساخت,مهندسي و ساختمان صنايع نفت,364,391835,18055560780,47351,47251,46000,-1351,-2.85,46857,-494,-1.04,45931,47251,1400-6-10,2021-09-01
566,كرازي,كارخانجات‌توليدي‌شيشه‌رازي‌,361,25188051,42467053986,1606,1686,1686,80,4.98,1686,80,4.98,1686,1686,1400-6-10,2021-09-01
567,ركيشح,ح. كارت اعتباري ايران كيش,358,2765143,13402015290,4720,4580,4900,180,3.81,4850,130,2.75,4580,5050,1400-6-10,2021-09-01
568,ولتجار,واسپاري تجارت وسرمايه ايرانيان,358,4102699,14104961599,3424,3423,3526,102,2.98,3438,14,0.41,3327,3526,1400-6-10,2021-09-01
569,شفارا,پتروشيمي فارابي,357,4686190,26834977325,5586,5440,5753,167,2.99,5726,140,2.51,5440,5753,1400-6-10,2021-09-01
570,پارسيان,بيمه پارسيان,355,2045658,23832194320,11590,11550,11850,260,2.24,11650,60,0.52,11250,11900,1400-6-10,2021-09-01
571,شكبير,پتروشيمي اميركبير,353,608052,60458664597,96768,99500,99671,2903,3,98453,1685,1.74,95555,99671,1400-6-10,2021-09-01
572,ولبهمن,شركت بهمن ليزينگ,351,3992450,32244354423,7802,7802,8192,390,5,8076,274,3.51,7651,8192,1400-6-10,2021-09-01
573,سهرمز,سيمان‌هرمزگان‌,351,1443632,26541636010,17600,17600,18480,880,5,18390,790,4.49,17600,18480,1400-6-10,2021-09-01
574,اوان,مبين وان كيش,350,436273,15192772329,33829,35500,35000,1171,3.46,34824,995,2.94,33281,35500,1400-6-10,2021-09-01
575,خديزل,بهمن  ديزل,348,272885,14099014268,51730,52000,52940,1210,2.34,51687,-43,-0.08,50600,53000,1400-6-10,2021-09-01
576,پلوله,گازلوله‌,344,628925,16674919503,27077,26988,26900,-177,-0.65,26513,-564,-2.08,26265,27400,1400-6-10,2021-09-01
577,حرهشا,رهشاد سپاهان (سهامي عام,344,181666,14174132076,80207,77801,77801,-2406,-3,78023,-2184,-2.72,77801,80000,1400-6-10,2021-09-01
578,سدشت,صنايع سيمان دشتستان,344,259715,13839114250,54500,55900,53910,-590,-1.08,53830,-670,-1.23,52450,55900,1400-6-10,2021-09-01
579,شگل,گلتاش‌,344,832100,7237464260,8550,8940,8750,200,2.34,8630,80,0.94,8250,8940,1400-6-10,2021-09-01
580,دروز,داروسازي‌ روزدارو,342,695972,22943091370,32550,33990,32340,-210,-0.65,32970,420,1.29,32010,33990,1400-6-10,2021-09-01
581,امين يكم2,صندوق درآمد ثابت امين يكم فردا,342,342000000,342000000,10030,1,1,-10029,-99.99,1,-10029,-99.99,1,1,1400-6-10,2021-09-01
582,كفرا,فراورده‌ هاي‌ نسوزايران‌,340,1043295,28644950750,26420,27450,27740,1320,5,27460,1040,3.94,25600,27740,1400-6-10,2021-09-01
583,گوهران,سرمايه گذاري توسعه گوهران اميد,338,1448028,8238998978,5610,5750,5720,110,1.96,5655,45,0.8,5560,5800,1400-6-10,2021-09-01
584,كقزوي,شيشه‌ قزوين‌,333,1941593,16331157159,8383,8150,8490,107,1.28,8411,28,0.33,8150,8633,1400-6-10,2021-09-01
585,فافزا,فولاد افزا سپاهان,331,336594,15410248670,44861,44982,46000,1139,2.54,45783,922,2.06,44252,46206,1400-6-10,2021-09-01
586,كشرق,صنعتي و معدني شمال شرق شاهرود,330,298880,20608804614,67177,68730,69690,2513,3.74,68953,1776,2.64,67740,69700,1400-6-10,2021-09-01
587,ثجوان,تامين مسكن جوانان,328,1868617,16566669696,9094,8822,8900,-194,-2.13,8866,-228,-2.51,8822,9239,1400-6-10,2021-09-01
588,دسينا,داروسازي‌ سينا,327,1226844,28386721400,22570,22610,23690,1120,4.96,23140,570,2.53,22300,23690,1400-6-10,2021-09-01
589,دشيري,شيرين دارو,325,168811,33658599739,194826,189007,200670,5844,3,199386,4560,2.34,189007,200670,1400-6-10,2021-09-01
590,خنصير,مهندسي‌نصيرماشين‌,321,2633171,41788423770,15120,15870,15870,750,4.96,15870,750,4.96,15870,15870,1400-6-10,2021-09-01
591,بفجر,فجر انرژي خليج فارس,318,1190186,34358715200,28760,27700,29120,360,1.25,28810,50,0.17,27700,29200,1400-6-10,2021-09-01
592,بساما,بيمه سامان,316,471328,11357195267,23834,24999,24000,166,0.7,23984,150,0.63,23834,24999,1400-6-10,2021-09-01
593,وتوشه,سرمايه‌ گذاري‌ پارس‌ توشه‌,312,2165500,16112135150,7270,7500,7540,270,3.71,7440,170,2.34,7080,7630,1400-6-10,2021-09-01
594,وآفري,بيمه كارآفرين,309,6234696,19850782495,3182,3182,3190,8,0.25,3184,2,0.06,3100,3276,1400-6-10,2021-09-01
595,وبازار,صندوق س شاخصي بازارآشنا,306,937624,12404002430,12700,12600,13490,790,6.22,13230,530,4.17,12600,13800,1400-6-10,2021-09-01
596,آساس,صندوق س.آسمان آرماني سهام-س,305,92790,17948268464,189476,192000,195100,5624,2.97,193429,3953,2.09,188300,196550,1400-6-10,2021-09-01
597,حسينا,توسعه خدمات دريايي وبندري سينا,304,263127,15707393866,58768,57843,60087,1319,2.24,59695,927,1.58,57843,60270,1400-6-10,2021-09-01
598,زرين,صندوق س. سهام زرين كوروش-س,299,954860,13075558712,13281,13400,13851,570,4.29,13694,413,3.11,13221,14100,1400-6-10,2021-09-01
599,دالبر,البرزدارو,293,767433,11153803170,14380,13860,14560,180,1.25,14480,100,0.7,13860,14980,1400-6-10,2021-09-01
600,گوهر,صندوق سكه طلاي كيان,291,700868,42026686708,59577,59509,59600,23,0.04,59964,387,0.65,59509,60200,1400-6-10,2021-09-01
601,وارس,سرمايه گذاري ارس صبا,290,689812,9016264935,13137,12850,13098,-39,-0.3,13074,-63,-0.48,12850,13390,1400-6-10,2021-09-01
602,دفرا,فرآورده‌هاي‌ تزريقي‌ ايران‌,289,578621,19473677150,32800,33210,34370,1570,4.79,33660,860,2.62,33200,34390,1400-6-10,2021-09-01
603,كحافظ,كاشي‌ وسراميك‌ حافظ‌,288,18935377,78619685304,3955,4152,4152,197,4.98,4152,197,4.98,4152,4152,1400-6-10,2021-09-01
604,قنقش,قند نقش جهان,286,335168,21639647303,63562,62300,64833,1271,2,64564,1002,1.58,62300,64833,1400-6-10,2021-09-01
605,وملت,سرمايه گذاري ملت,284,3180736,11813550804,3789,3714,3714,-75,-1.98,3714,-75,-1.98,3714,3720,1400-6-10,2021-09-01
606,مارون,پتروشيمي مارون,283,83582,15758085684,188610,184709,189511,901,0.48,188598,-12,-0.01,184709,190000,1400-6-10,2021-09-01
607,زنجان,صنايع كشاورزي وكود زنجان,278,2761318,17161591370,6034,6215,6215,181,3,6215,181,3,6215,6215,1400-6-10,2021-09-01
608,سنوين,سرمايه گذاري اقتصاد نوين,275,996360,7766217691,7998,7759,7880,-118,-1.48,7835,-163,-2.04,7759,8120,1400-6-10,2021-09-01
609,كخاك,صنايع‌خاك‌چيني‌ايران‌,274,399529,14720950270,36520,36500,37960,1440,3.94,36740,220,0.6,35860,38200,1400-6-10,2021-09-01
610,تصميم,صندوق س با درآمد ثابت تصميم,272,3380237,58398709641,17265,17274,17283,18,0.1,17277,12,0.07,17274,17283,1400-6-10,2021-09-01
611,تشتاد,صنايع توليدي اشتاد ايران‌,271,1605478,11245618695,6990,6860,7060,70,1,7005,15,0.21,6850,7188,1400-6-10,2021-09-01
612,تسه9908,امتياز تسهيلات مسكن آبان99,267,4451,2607582476,584588,571009,572000,-12588,-2.15,585842,1254,0.21,567080,600000,1400-6-10,2021-09-01
613,حخزر,كشتيراني درياي خزر,263,663446,15872033443,23775,22822,24000,225,0.95,23924,149,0.63,22822,24390,1400-6-10,2021-09-01
614,ثنام,س ساختماني ب نام آوران مهندسي,262,1915228,29427478220,15840,15365,15365,-475,-3,15365,-475,-3,15365,15365,1400-6-10,2021-09-01
615,سجام,مجتمع سيمان غرب آسيا,260,4206977,21033092323,4855,4999,5000,145,2.99,5000,145,2.99,4894,5000,1400-6-10,2021-09-01
616,سپر,صندوق س سپر سرمايه بيدار- ثابت,259,5843701,73944797590,12646,12653,12656,10,0.08,12654,8,0.06,12648,12656,1400-6-10,2021-09-01
617,لخانه,لوازم‌ خانگي‌ پارس‌,255,952506,21559536735,22205,21543,22871,666,3,22635,430,1.94,21543,22871,1400-6-10,2021-09-01
618,فنرژي,گسترش صنايع انرژي آذرآب,253,818728,12668535069,15683,15996,15370,-313,-2,15473,-210,-1.34,15370,15996,1400-6-10,2021-09-01
619,تاپكيش,تجارت الكترونيك پارسيان كيش,245,2319386,35368317114,14523,15249,15249,726,5,15249,726,5,15249,15249,1400-6-10,2021-09-01
620,واحصا,احياء صنايع خراسان,240,198139,8784023092,44205,42885,44131,-74,-0.17,44314,109,0.25,42885,45530,1400-6-10,2021-09-01
621,فيروزا,صندوق بادرآمد ثابت فيروزه آسيا,239,2238239,55761245430,24703,24733,24803,100,0.4,24913,210,0.85,24704,27173,1400-6-10,2021-09-01
622,آساميد,صندوق س.مشترك آسمان اميد -د,239,6266485,80661324616,12868,12871,12871,3,0.02,12872,4,0.03,12871,12885,1400-6-10,2021-09-01
623,ساروج,بين المللي ساروج بوشهر,237,355853,7032834667,19814,20400,20000,186,0.94,19780,-34,-0.17,19279,20400,1400-6-10,2021-09-01
624,خاتم,صندوق س خاتم ايساتيس پويا-ثابت,234,4079335,48723977495,11935,11945,11948,13,0.11,11944,9,0.08,11941,11948,1400-6-10,2021-09-01
625,كپرور,فرآوري زغال سنگ پروده طبس,232,705927,26795597543,36375,35700,38193,1818,5,37958,1583,4.35,35700,38193,1400-6-10,2021-09-01
626,كي بي سي,شركت كي بي سي,231,833078,22736607449,26677,26678,27340,663,2.49,27292,615,2.31,26001,27980,1400-6-10,2021-09-01
627,شسپا,نفت سپاهان,230,8314234,27428657966,3142,3299,3299,157,5,3200,58,1.85,3299,3299,1400-6-10,2021-09-01
628,افق ملت,صندوق س در سهام افق ملت,229,85097,13626324480,158630,160000,161800,3170,2,160130,1500,0.95,157000,161990,1400-6-10,2021-09-01
629,دپارس,پارس‌ دارو,224,332596,13206249620,38380,39660,40200,1820,4.74,39540,1160,3.02,39000,40270,1400-6-10,2021-09-01
630,قزوين,كارخانجات‌ قند قزوين‌,222,695942,26219955560,36650,35880,37580,930,2.54,37680,1030,2.81,35880,38420,1400-6-10,2021-09-01
631,زر,صندوق س.پشتوانه سكه طلاي زر,213,76934,4001845283,51916,52300,51900,-16,-0.03,52017,101,0.19,51583,52397,1400-6-10,2021-09-01
632,دابورح,ح . داروسازي‌ ابوريحان‌,206,204049,4944009010,23430,23800,24340,910,3.88,24230,800,3.41,23540,24560,1400-6-10,2021-09-01
633,وتوس,توسعه‌شهري‌توس‌گستر,206,1061661,16922876340,15190,15940,15940,750,4.94,15890,700,4.61,15940,15940,1400-6-10,2021-09-01
634,قپيرا,فرآورده‌هاي‌غدايي‌وقندپيرانشهر,204,1169393,9276402800,7790,8140,7980,190,2.44,7880,90,1.16,7630,8140,1400-6-10,2021-09-01
635,تسه9911,امتياز تسهيلات مسكن بهمن99,204,3115,1867701529,591790,609995,562201,-29589,-5,599583,7793,1.32,562201,621000,1400-6-10,2021-09-01
636,اخزا901,اسنادخزانه-م1بودجه99-010621,189,112042,91736198148,817643,816001,818810,1167,0.14,818766,1123,0.14,814256,821500,1400-6-10,2021-09-01
637,وفتخار,سرمايه گذاري افتخار سهام,186,182734,1408330938,7483,7707,7707,224,2.99,7551,68,0.91,7707,7707,1400-6-10,2021-09-01
638,الماس,صندوق س.امين تدبيرگران فردا-س,183,63499,8730996340,131479,131000,138990,7511,5.71,137498,6019,4.58,131000,143990,1400-6-10,2021-09-01
639,ضسپا8044,اختيارخ خساپا-2500-1400/08/26,181,10400,1683966000,154,176,171,17,11.04,162,8,5.19,140,182,1400-6-10,2021-09-01
640,تماوند,تامين سرمايه دماوند,179,5596460,36931039540,6407,6599,6599,192,3,6599,192,3,6599,6599,1400-6-10,2021-09-01
641,اخزا910,اسنادخزانه-م10بودجه99-020807,176,338785,219984041124,647480,645101,649504,2024,0.31,649332,1852,0.29,645100,652900,1400-6-10,2021-09-01
642,فردا2,صندوق س آواي فرداي زاگرس-ثابت,174,17400000,17400000,11334,1,1,-11333,-99.99,1,-11333,-99.99,1,1,1400-6-10,2021-09-01
643,تسه9909,امتياز تسهيلات مسكن آذر99,170,2554,1503060299,583755,583090,560000,-23755,-4.07,588512,4757,0.81,560000,600000,1400-6-10,2021-09-01
644,قمرو,قند مرودشت‌,170,644110,19567097310,28940,30350,30380,1440,4.98,30380,1440,4.98,30350,30380,1400-6-10,2021-09-01
645,شاملا,معدني‌ املاح‌  ايران‌,169,153645,6423978670,41350,41370,42810,1460,3.53,41550,200,0.48,40560,43390,1400-6-10,2021-09-01
646,آتيمس,صندوق س.آرمان آتيه درخشان مس-س,168,55350,12022398762,211307,211000,219400,8093,3.83,217207,5900,2.79,211000,219600,1400-6-10,2021-09-01
647,خفولا,خدمات فني فولاد يزد,166,635722,20628543178,31504,32449,32449,945,3,32449,945,3,32449,32449,1400-6-10,2021-09-01
648,تسه9910,امتياز تسهيلات مسكن دي99,159,1845,1089887396,585664,575099,573999,-11665,-1.99,590725,5061,0.86,556400,614947,1400-6-10,2021-09-01
649,وامين,س. امين توان آفرين ساز,157,468170,6056619319,12915,13044,12915,0,0,12918,3,0.02,12785,13149,1400-6-10,2021-09-01
650,ثتران,سرمايه گذاري مسكن تهران,156,3077252,13976878584,4326,4542,4542,216,4.99,4499,173,4,4542,4542,1400-6-10,2021-09-01
651,شستان,پتروشيمي گلستان,154,1879840,6478964590,3380,3447,3447,67,1.98,3447,67,1.98,3396,3447,1400-6-10,2021-09-01
652,تسه9810,امتياز تسهيلات مسكن دي98,147,2851,1688438698,582833,582055,583000,167,0.03,592227,9394,1.61,580000,611974,1400-6-10,2021-09-01
653,سپاس,صندوق س. پاداش سهامداري-ثابت,140,4137396,41975384253,10138,10144,10146,8,0.08,10145,7,0.07,10143,10146,1400-6-10,2021-09-01
654,اخزا902,اسنادخزانه-م2بودجه99-011019,138,411342,316301854870,767245,765100,772000,4755,0.62,768951,1706,0.22,764020,772000,1400-6-10,2021-09-01
655,وپخشح,ح . داروپخش‌ (هلدينگ‌,133,157566,5043207800,31560,33500,32260,700,2.22,32010,450,1.43,30060,33500,1400-6-10,2021-09-01
656,وثنو,سرمايه گذاري ساختماني نوين,132,1895843,9821996481,5060,5100,5211,151,2.98,5171,111,2.19,5100,5211,1400-6-10,2021-09-01
657,تسه9907,امتياز تسهيلات مسكن مهر99,132,1506,888662242,593480,572590,563830,-29650,-5,590081,-3399,-0.57,563830,600000,1400-6-10,2021-09-01
658,فكمند,گسترش قطعه سازي كمند,125,1454130,47167613016,31493,32437,32437,944,3,32437,944,3,32436,32437,1400-6-10,2021-09-01
659,ضسپا8043,اختيارخ خساپا-2000-1400/08/26,125,5276,1819941000,327,327,380,53,16.21,345,18,5.5,320,380,1400-6-10,2021-09-01
660,اخزا903,اسنادخزانه-م3بودجه99-011110,122,241356,183534921639,759625,758336,763490,3865,0.51,760432,807,0.11,757002,763490,1400-6-10,2021-09-01
661,گپارس,امور رفاهي كارگزاران پارس,117,32421,4217480158,134038,130017,130017,-4021,-3,132363,-1675,-1.25,130017,133420,1400-6-10,2021-09-01
662,قيستو,شركت قند بيستون,117,510012,8644349806,16620,16952,16952,332,2,16949,329,1.98,16640,16952,1400-6-10,2021-09-01
663,تسه9902,امتياز تسهيلات مسكن ارديبهشت99,117,1313,779531444,582823,567777,570200,-12623,-2.17,593703,10880,1.87,567777,600000,1400-6-10,2021-09-01
664,اخزا908,اسنادخزانه-م8بودجه99-020606,115,371316,249711696950,671694,673900,674900,3206,0.48,672505,811,0.12,670000,675000,1400-6-10,2021-09-01
665,تسه9808,امتياز تسهيلات مسكن آبان98,115,2188,1304014253,586966,602000,594000,7034,1.2,595985,9019,1.54,565000,604998,1400-6-10,2021-09-01
666,اخزا914,اسنادخزانه-م14بودجه99-021025,114,216523,134812593645,620606,620160,623000,2394,0.39,622625,2019,0.33,619513,625000,1400-6-10,2021-09-01
667,سكه0012پ04,تمام سكه طرح جديد0012صادرات,113,30100,36010367500,1196208,1206000,1193821,-2387,-0.2,1196358,150,0.01,1192106,1206000,1400-6-10,2021-09-01
668,دجابر,داروسازي‌ جابرابن‌حيان‌,111,562875,9997784980,17540,17960,17960,420,2.39,17670,130,0.74,17600,17960,1400-6-10,2021-09-01
669,سكه0112پ03,تمام سكه طرح جديد0112سامان,109,27200,32540844800,1197377,1200021,1195554,-1823,-0.15,1196355,-1022,-0.09,1190000,1207000,1400-6-10,2021-09-01
670,سحرخيز,صندوق س. گروه زعفران سحرخيز,107,177940,1778704528,9957,10088,10010,53,0.53,9996,39,0.39,9770,10170,1400-6-10,2021-09-01
671,كمينا,شيشه سازي مينا,105,752351,9021440841,11642,11991,11991,349,3,11918,276,2.37,11991,11991,1400-6-10,2021-09-01
672,اخزا909,اسنادخزانه-م9بودجه99-020316,102,225278,158995198345,704256,701002,707500,3244,0.46,705773,1517,0.22,701002,707500,1400-6-10,2021-09-01
673,تسه9904,امتياز تسهيلات مسكن تير99,101,946,557554272,589639,561055,595000,5361,0.91,589381,-258,-0.04,561055,600000,1400-6-10,2021-09-01
674,آسام,صندوق س.آرمان سپهر آشنا-م,98,292230,38033739950,130205,130220,130220,15,0.01,130150,-55,-0.04,126010,130300,1400-6-10,2021-09-01
675,كامياب,صندوق س. كامياب آشنا-د,96,758175,7822156618,10313,10317,10317,4,0.04,10317,4,0.04,10310,10320,1400-6-10,2021-09-01
676,خمحور,توليدمحورخودرو,96,4361533,13782444280,3010,3160,3160,150,4.98,3141,131,4.35,3160,3160,1400-6-10,2021-09-01
677,ضشنا8005,اختيارخ شپنا-12800-1400/08/16,92,1114,3139522000,2858,3000,2859,1,0.03,2818,-40,-1.4,2250,3000,1400-6-10,2021-09-01
678,اوصتا,صندوق انديشه ورزان صباتامين -د,91,5212155,102771224222,19699,19713,19718,19,0.1,19718,19,0.1,19710,19721,1400-6-10,2021-09-01
679,صايند,صندوق س. گنجينه آينده روشن-د,89,541500,5495328570,10139,10154,10162,23,0.23,10148,9,0.09,10125,10165,1400-6-10,2021-09-01
680,كگلح,ح . معدني و صنعتي گل گهر,88,3000000,67730000000,11160,22480,22580,11420,102.33,22580,11420,102.33,22480,22580,1400-6-10,2021-09-01
681,ثروتم,صندوق س. ثروت آفرين پارسيان-س,88,142710,13420985930,93023,92375,95239,2216,2.38,94044,1021,1.1,92223,95239,1400-6-10,2021-09-01
682,ضملت8042,اختيارخ وبملت-3934-1400/08/19,88,2256,1502654000,635,670,650,15,2.36,666,31,4.88,620,737,1400-6-10,2021-09-01
683,سكه0111پ05,تمام سكه طرح جديد0111آينده,85,67200,80508246900,1196187,1210000,1192500,-3687,-0.31,1198039,1852,0.15,1191500,1210000,1400-6-10,2021-09-01
684,تسه9906,امتياز تسهيلات مسكن شهريور99,85,686,404733673,591387,570079,577000,-14387,-2.43,589991,-1396,-0.24,570079,604995,1400-6-10,2021-09-01
685,ارمغان,ص سرمايه گذاري ارمغان ايرانيان,85,859559,8721861366,10133,10150,10149,16,0.16,10147,14,0.14,10136,10150,1400-6-10,2021-09-01
686,تسه9806,امتياز تسهيلات مسكن شهريور98,84,1823,1064812052,579358,590000,580000,642,0.11,584099,4741,0.82,573010,600000,1400-6-10,2021-09-01
687,كهربا,صندوق س.پشتوانه سكه طلا كهربا,80,4083948,42677919059,10393,10400,10479,86,0.83,10450,57,0.55,10400,10504,1400-6-10,2021-09-01
688,آكورد2,صندوق س. آرمان آتي كوثر-د,80,12400000,12400000,33868,1,1,-33867,-100,1,-33867,-100,1,1,1400-6-10,2021-09-01
689,تسه9809,امتياز تسهيلات مسكن آذر98,80,1208,716821501,584037,584037,592000,7963,1.36,593395,9358,1.6,582000,601899,1400-6-10,2021-09-01
690,صنوين,صندوق سرمايه‌گذاري صنوين-مختلط,78,28855,3098714400,106090,104110,108990,2900,2.73,107390,1300,1.23,104110,109870,1400-6-10,2021-09-01
691,سكه0011پ02,تمام سكه طرح جديد0011ملت,77,16500,19763977400,1198053,1199004,1191111,-6942,-0.58,1197817,-236,-0.02,1191111,1210000,1400-6-10,2021-09-01
692,ضملت8041,اختيارخ وبملت-3434-1400/08/19,77,1266,1182308000,934,900,1040,106,11.35,934,0,0,890,1050,1400-6-10,2021-09-01
693,خپويش,سازه‌ پويش‌,77,193987,12756585120,62630,65760,65760,3130,5,64790,2160,3.45,65760,65760,1400-6-10,2021-09-01
694,كمرجان,بازرگاني و توليدي مرجان كار,76,14233,1659340072,122719,116584,116584,-6135,-5,121917,-802,-0.65,116584,116584,1400-6-10,2021-09-01
695,تسه9905,امتياز تسهيلات مسكن مرداد99,75,692,409301736,591379,581200,580000,-11379,-1.92,591476,97,0.02,562180,604995,1400-6-10,2021-09-01
696,تسه9903,امتياز تسهيلات مسكن خرداد99,74,591,347932112,582676,558544,584000,1324,0.23,588718,6042,1.04,558544,598888,1400-6-10,2021-09-01
697,تسه9807,امتياز تسهيلات مسكن مهر98,71,897,533683210,585854,583114,592000,6146,1.05,594965,9111,1.56,583114,604142,1400-6-10,2021-09-01
698,دحاوي,الحاوي,71,377615,3114568520,8503,8248,8248,-255,-3,8387,-116,-1.36,8248,8248,1400-6-10,2021-09-01
699,وتعاون,بيمه  تعاون,71,4602444,10337089224,2181,2246,2246,65,2.98,2246,65,2.98,2246,2246,1400-6-10,2021-09-01
700,دارا,صندوق س. دارا الگوريتم-د,69,768080,7670235005,9971,9982,10000,29,0.29,9986,15,0.15,9969,10000,1400-6-10,2021-09-01
701,نهال,صندوق س. طلاي سرخ نوويرا,68,79828,795563541,9707,9725,10058,351,3.62,9966,259,2.67,9724,10069,1400-6-10,2021-09-01
702,تسه9811,امتياز تسهيلات مسكن بهمن98,67,740,434704311,586198,570000,569762,-16436,-2.8,587438,1240,0.21,561139,615507,1400-6-10,2021-09-01
703,كنور,توسعه معدني و صنعتي صبانور,66,685802,11871232620,16490,17310,17310,820,4.97,16600,110,0.67,17310,17310,1400-6-10,2021-09-01
704,ضصاد8033,اختيارخ وبصادر-2489-1400/08/12,65,2545,896625000,341,350,347,6,1.76,352,11,3.23,334,369,1400-6-10,2021-09-01
705,اخزا911,اسنادخزانه-م11بودجه99-020906,63,164884,105511729507,638403,636101,641987,3584,0.56,639915,1512,0.24,636101,645100,1400-6-10,2021-09-01
706,ضملي7003,اختيارخ فملي-11720-1400/07/11,62,641,1763614000,2516,2899,2770,254,10.1,2751,235,9.34,2600,2899,1400-6-10,2021-09-01
707,اطلس2,صندوق س.توسعه اندوخته آينده-س,61,610000,610000,259461,1,1,-259460,-100,1,-259460,-100,1,1,1400-6-10,2021-09-01
708,پلاست,كارخانجات توليدي پلاستيران,60,51715,2811847980,52789,54372,54372,1583,3,53180,391,0.74,54372,54372,1400-6-10,2021-09-01
709,ضسپا8042,اختيارخ خساپا-1800-1400/08/26,57,1077,499544000,448,450,490,42,9.38,464,16,3.57,411,495,1400-6-10,2021-09-01
710,ضخود7078,اختيارخ خودرو-3500-1400/07/07,54,2294,14919000,6,6,6,0,0,7,1,16.67,5,8,1400-6-10,2021-09-01
711,كيان2,صندوق س. با درآمد ثابت كيان,53,5300000,5300000,30290,1,1,-30289,-100,1,-30289,-100,1,1,1400-6-10,2021-09-01
712,تسه9901,امتياز تسهيلات مسكن فروردين99,53,552,327659929,603318,627000,586012,-17306,-2.87,593587,-9731,-1.61,573153,627000,1400-6-10,2021-09-01
713,ضسپا8041,اختيارخ خساپا-1600-1400/08/26,52,1388,863487000,629,666,669,40,6.36,622,-7,-1.11,450,669,1400-6-10,2021-09-01
714,تسه9812,امتياز تسهيلات مسكن اسفند98,51,386,225456941,591565,581669,562000,-29565,-5,584085,-7480,-1.26,562000,599900,1400-6-10,2021-09-01
715,هفارس104,اختيارف ت فارس-11832-01/04/12,49,1141500,1141500,1,1,1,0,0,1,0,0,1,1,1400-6-10,2021-09-01
716,اخزا004,اسنادخزانه-م4بودجه00-030522,49,149105,83068576312,553010,553009,558000,4990,0.9,557115,4105,0.74,553001,558000,1400-6-10,2021-09-01
717,ثهام,صندوق س ثروت هامرز-سهام,48,194032,2327817830,11875,11650,12200,325,2.74,11997,122,1.03,11650,12200,1400-6-10,2021-09-01
718,ضپال2007,اختيارخ اپال-32000-1401/02/12,48,924,1240939000,1370,1439,1380,10,0.73,1343,-27,-1.97,1295,1439,1400-6-10,2021-09-01
719,ضملت8043,اختيارخ وبملت-4434-1400/08/19,47,1195,509978000,401,350,440,39,9.73,427,26,6.48,350,460,1400-6-10,2021-09-01
720,كصدف,كاشي صدف سرام استقلال آباده,47,103224,2253276696,21194,21829,21829,635,3,21328,134,0.63,21829,21829,1400-6-10,2021-09-01
721,ضملي7004,اختيارخ فملي-13720-1400/07/11,47,555,726589000,1237,1200,1314,77,6.22,1309,72,5.82,1200,1370,1400-6-10,2021-09-01
722,وحافظح,ح . بيمه حافظ,45,274489,1772924451,6590,6459,6459,-131,-1.99,6459,-131,-1.99,6459,6459,1400-6-10,2021-09-01
723,پادا,صندوق س.پاداش سرمايه پارس-س,44,21838,2656282206,120997,121450,124470,3473,2.87,121636,639,0.53,120300,124470,1400-6-10,2021-09-01
724,ضخود7072,اختيارخ خودرو-1400-1400/07/07,44,127,122779000,905,777,988,83,9.17,967,62,6.85,900,988,1400-6-10,2021-09-01
725,ضخود7074,اختيارخ خودرو-1800-1400/07/07,42,744,374790000,469,450,518,49,10.45,504,35,7.46,450,539,1400-6-10,2021-09-01
726,داريك,صندوق س.اعتماد داريك-د,40,671976,7651501112,11378,11385,11387,9,0.08,11387,9,0.08,11385,11387,1400-6-10,2021-09-01
727,گوهر2,صندوق سكه طلاي كيان,40,400000,400000,59577,1,1,-59576,-100,1,-59576,-100,1,1,1400-6-10,2021-09-01
728,اخزا907,اسنادخزانه-م7بودجه99-020704,38,157368,104124225340,661252,666000,667000,5748,0.87,661661,409,0.06,659361,667000,1400-6-10,2021-09-01
729,اخزا821,اسنادخزانه-م21بودجه98-020906,37,37271,23975012530,634110,641999,651500,17390,2.74,643262,9152,1.44,638000,652540,1400-6-10,2021-09-01
730,ثقزوي,شركت عمران و سازندگي قزوين,36,46353,1355454426,30146,29242,29242,-904,-3,30016,-130,-0.43,29242,29242,1400-6-10,2021-09-01
731,خبازرس,بازرسي مهندسي و صنعتي ايران,36,223551,6227236656,27045,27856,27856,811,3,27508,463,1.71,27856,27856,1400-6-10,2021-09-01
732,ضملت8044,اختيارخ وبملت-4934-1400/08/19,35,1340,431950000,268,300,316,48,17.91,322,54,20.15,259,370,1400-6-10,2021-09-01
733,ضجار7042,اختيارخ وتجارت-3497-1400/07/21,35,3035,92489000,50,40,30,-20,-40,30,-20,-40,30,40,1400-6-10,2021-09-01
734,بذر,صندوق س بذر اميد آفرين-سهام,34,21180,2385032930,111390,109500,113970,2580,2.32,112610,1220,1.1,109500,114050,1400-6-10,2021-09-01
735,ضمخا7076,اختيارخ اخابر-9700-1400/07/28,31,252,584477000,2118,2110,2420,302,14.26,2319,201,9.49,1501,2450,1400-6-10,2021-09-01
736,گنجين,صندوق س. گنجينه يكم آويد-د,30,430385,5852459956,13585,13599,13599,14,0.1,13598,13,0.1,13592,13600,1400-6-10,2021-09-01
737,ضفلا7005,اختيارخ فولاد-11013-1400/07/25,27,168,462629156,1872,1935,1900,28,1.5,1964,92,4.91,1900,2000,1400-6-10,2021-09-01
738,پاسار04,اجاره انرژي پاسارگاد14040302,25,625000,624999375000,1000000,999999,999999,-1,0,999999,-1,0,999999,999999,1400-6-10,2021-09-01
739,دمعيار,صندوق س. توازن معيار-د,25,815495,8197279950,10046,10050,10055,9,0.09,10052,6,0.06,10050,10055,1400-6-10,2021-09-01
740,ضشنا8006,اختيارخ شپنا-14800-1400/08/16,24,384,699530000,1782,1600,1965,183,10.27,1822,40,2.24,1581,1980,1400-6-10,2021-09-01
741,ضشنا8004,اختيارخ شپنا-10800-1400/08/16,24,198,801986000,4065,3707,4400,335,8.24,4050,-15,-0.37,3707,4450,1400-6-10,2021-09-01
742,ضذوب905,اختيارخ ذوب-5000-14000917,22,456,339998000,751,790,696,-55,-7.32,746,-5,-0.67,695,798,1400-6-10,2021-09-01
743,ضسپا8039,اختيارخ خساپا-1200-1400/08/26,22,123,125328000,1035,999,1000,-35,-3.38,1019,-16,-1.55,822,1098,1400-6-10,2021-09-01
744,ضجار7040,اختيارخ وتجارت-2497-1400/07/21,22,1014,358419000,354,350,400,46,12.99,353,-1,-0.28,335,400,1400-6-10,2021-09-01
745,ضفلا7004,اختيارخ فولاد-9586-1400/07/25,21,194,866671536,3031,3030,3200,169,5.58,3186,155,5.11,3000,3300,1400-6-10,2021-09-01
746,ضمخا7075,اختيارخ اخابر-8700-1400/07/28,21,146,477638000,3115,3251,3210,95,3.05,3271,156,5.01,2152,3569,1400-6-10,2021-09-01
747,ددامح,ح . داروسازي زاگرس فارمد پارس,21,23915,373074000,15600,15600,15600,0,0,15600,0,0,15600,15600,1400-6-10,2021-09-01
748,وحافظ,بيمه حافظ,21,74739,863310189,11786,11551,11551,-235,-1.99,11743,-43,-0.36,11551,11551,1400-6-10,2021-09-01
749,ضبدر8078,اختيارخ شبندر-5157-1400/08/30,20,122,905370360,1700,1200,1590,-110,-6.47,1584,-116,-6.82,1200,1700,1400-6-10,2021-09-01
750,ضصاد8034,اختيارخ وبصادر-2989-1400/08/12,19,620,119780000,364,199,175,-189,-51.92,193,-171,-46.98,175,200,1400-6-10,2021-09-01
751,اخزا006,اسنادخزانه-م6بودجه00-030723,19,43393,23433509780,540003,540100,540000,-3,0,540030,27,0,540000,547998,1400-6-10,2021-09-01
752,اخزا817,اسنادخزانه-م17بودجه98-010512,19,46543,38870529061,834726,831216,842000,7274,0.87,835153,427,0.05,831216,842000,1400-6-10,2021-09-01
753,عيار2,صندوق سكه طلاي مفيد,18,180000,180000,30336,1,1,-30335,-100,1,-30335,-100,1,1,1400-6-10,2021-09-01
754,ضملت8038,اختيارخ وبملت-1934-1400/08/19,18,167,367741000,2424,2106,2300,-124,-5.12,2202,-222,-9.16,2105,2400,1400-6-10,2021-09-01
755,اراد50,مرابحه عام دولت5-ش.خ0302,18,445000,445000795000,1000000,1000001,1000002,2,0,1000002,2,0,1000001,1000002,1400-6-10,2021-09-01
756,سرو2,صندوق س سروسودمند مدبران-سهام,17,2000000,2000000,82830,1,1,-82829,-100,1,-82829,-100,1,1,1400-6-10,2021-09-01
757,زعف0008پ18,زعفران0008نگين بهرامن(پ),17,2435,368628250,150713,143550,150000,-713,-0.47,151387,674,0.45,143550,154000,1400-6-10,2021-09-01
758,زعف0008پ19,زعفران0008نگين تروند قاينات(پ),17,3155,476387620,150552,154500,150000,-552,-0.37,150994,442,0.29,148010,154500,1400-6-10,2021-09-01
759,اخزا905,اسنادخزانه-م5بودجه99-020218,16,35347,25537158971,719093,721498,725000,5907,0.82,722470,3377,0.47,718107,725000,1400-6-10,2021-09-01
760,اخزا812,اسنادخزانه-م12بودجه98-001111,16,29940,27631016367,920045,920521,927999,7954,0.86,922880,2835,0.31,920521,927999,1400-6-10,2021-09-01
761,زعف0008پ11,زعفران0008نگين سحرخيز(پ),16,22486,3389532910,147890,147500,144000,-3890,-2.63,150740,2850,1.93,144000,151500,1400-6-10,2021-09-01
762,شتولي,تولي‌پرس‌,16,43529,1146858563,26884,26347,26347,-537,-2,26755,-129,-0.48,26347,26347,1400-6-10,2021-09-01
763,ضجار7037,اختيارخ وتجارت-1597-1400/07/21,15,71,69035000,1200,971,971,-229,-19.08,972,-228,-19,971,990,1400-6-10,2021-09-01
764,تپكو,توليدتجهيزات‌سنگين‌هپكو,15,42931,223971027,5323,5217,5217,-106,-1.99,5322,-1,-0.02,5217,5217,1400-6-10,2021-09-01
765,اخزا904,اسنادخزانه-م4بودجه99-011215,15,145275,108115898831,744779,742121,744779,0,0,744215,-564,-0.08,742121,744779,1400-6-10,2021-09-01
766,داراب,پتروشيمي داراب,15,121239,275212530,2340,2270,2270,-70,-2.99,2338,-2,-0.09,2270,2270,1400-6-10,2021-09-01
767,نيرو,نيرو سرمايه,15,21149,1002483749,48867,47401,47401,-1466,-3,48715,-152,-0.31,47401,47401,1400-6-10,2021-09-01
768,ضپاس7029,اختيارخ وپارس-2500-1400/07/28,14,507,362874000,722,720,700,-22,-3.05,716,-6,-0.83,700,737,1400-6-10,2021-09-01
769,اخزا721,اسنادخزانه-م21بودجه97-000728,14,54828,53406367606,973952,974000,974000,48,0,974071,119,0.01,974000,974300,1400-6-10,2021-09-01
770,ضسپا8040,اختيارخ خساپا-1400-1400/08/26,14,91,73917000,748,751,840,92,12.3,812,64,8.56,751,845,1400-6-10,2021-09-01
771,ضپاس7030,اختيارخ وپارس-3000-1400/07/28,13,547,213635000,399,410,389,-10,-2.51,391,-8,-2.01,389,410,1400-6-10,2021-09-01
772,اگ001254,گام بانك پارسيان0012,12,61182,54706739000,888988,896000,889600,612,0.07,894164,5176,0.58,889600,896000,1400-6-10,2021-09-01
773,ضبدر8079,اختيارخ شبندر-6011-1400/08/30,12,68,374331228,1199,1000,1229,30,2.5,1175,-24,-2,1000,1230,1400-6-10,2021-09-01
774,ضمخا7070,اختيارخ اخابر-19700-1400/07/28,12,177,38170000,131,230,200,69,52.67,216,85,64.89,50,250,1400-6-10,2021-09-01
775,ضملي7005,اختيارخ فملي-15720-1400/07/11,11,166,101189000,578,600,600,22,3.81,610,32,5.54,600,638,1400-6-10,2021-09-01
776,سفارود,كارخانه فارسيت درود,11,5581,92890164,16983,16644,16644,-339,-2,16977,-6,-0.04,16644,16644,1400-6-10,2021-09-01
777,اخزا906,اسنادخزانه-م6بودجه99-020321,10,7167,5085618181,704013,705500,710000,5987,0.85,709588,5575,0.79,705000,711000,1400-6-10,2021-09-01
778,اخزا811,اسنادخزانه-م11بودجه98-001013,10,19344,18029998991,934168,926502,932000,-2168,-0.23,932072,-2096,-0.22,926502,943799,1400-6-10,2021-09-01
779,اخزا808,اسنادخزانه-م8بودجه98-000817,10,11789,11384877574,963149,957003,964001,852,0.09,965720,2571,0.27,957003,965800,1400-6-10,2021-09-01
780,آگاس2,صندوق س.هستي بخش آگاه-س,10,1200000,1200000,84947,1,1,-84946,-100,1,-84946,-100,1,1,1400-6-10,2021-09-01
781,شسم,توليد سموم‌ علف‌ كش,10,1440,147676320,98609,102553,102553,3944,4,98723,114,0.12,102553,102553,1400-6-10,2021-09-01
782,سخند,صندوق س.سپهرخبرگان نفت-د,10,15700,157377340,10028,10035,10020,-8,-0.08,10024,-4,-0.04,10015,10035,1400-6-10,2021-09-01
783,افران2,صندوق س افرا نماد پايدار-ثابت,10,27100000,27100000,14147,1,1,-14146,-99.99,1,-14146,-99.99,1,1,1400-6-10,2021-09-01
784,اخزا813,اسنادخزانه-م13بودجه98-010219,10,9437,8290298198,872923,872194,878999,6076,0.7,878489,5566,0.64,872194,878999,1400-6-10,2021-09-01
785,ضمخا7066,اختيارخ اخابر-11700-1400/07/28,10,152,167190000,1272,910,1011,-261,-20.52,1100,-172,-13.52,910,1300,1400-6-10,2021-09-01
786,اروند06,منفعت صبا اروند ملت 14001113,9,220000,220000000000,1020000,1000000,1000000,-20000,-1.96,1000000,-20000,-1.96,1000000,1000000,1400-6-10,2021-09-01
787,ساذري,آذريت‌,9,181380,1382115600,7399,7620,7620,221,2.99,7434,35,0.47,7620,7620,1400-6-10,2021-09-01
788,تملي705,تسهيلات مسكن ب. ملي-مرداد97,9,87,63371553,705304,740569,740569,35265,5,728409,23105,3.28,670039,740569,1400-6-10,2021-09-01
789,وسقم,شركت س استان قم,9,121076,158730636,1380,1311,1311,-69,-5,1380,0,0,1311,1311,1400-6-10,2021-09-01
790,ضخود7073,اختيارخ خودرو-1600-1400/07/07,9,21,15434000,654,700,750,96,14.68,735,81,12.39,700,752,1400-6-10,2021-09-01
791,ضمخا7078,اختيارخ اخابر-7700-1400/07/28,9,52,212200000,4295,4100,4000,-295,-6.87,4081,-214,-4.98,4000,4100,1400-6-10,2021-09-01
792,كابگن,توليدي و صنعتي آبگينه‌,9,195000,1098630000,5524,5634,5634,110,1.99,5570,46,0.83,5634,5634,1400-6-10,2021-09-01
793,اخزا820,اسنادخزانه-م20بودجه98-020806,9,2622,1726445803,654751,657036,658498,3747,0.57,658446,3695,0.56,657036,658498,1400-6-10,2021-09-01
794,فراز2,صندوق س.سهام فراز داريك-س,9,7000000,7000000,13958,1,1,-13957,-99.99,1,-13957,-99.99,1,1,1400-6-10,2021-09-01
795,اخزا815,اسنادخزانه-م15بودجه98-010406,8,2211,1890507503,851969,850719,852003,34,0,855046,3077,0.36,850719,856669,1400-6-10,2021-09-01
796,اشاد10,مشاركت دولتي10-شرايط خاص001226,8,3900,3796760000,973500,970000,979000,5500,0.56,973528,28,0,970000,979000,1400-6-10,2021-09-01
797,ضبدر8076,اختيارخ شبندر-3448-1400/08/30,8,11,149424284,2841,2810,2999,158,5.56,2900,59,2.08,2801,2999,1400-6-10,2021-09-01
798,تملي706,تسهيلات مسكن ب. ملي-شهريور97,8,98,85175178,860569,903589,849999,-10570,-1.23,869134,8565,1,817541,903589,1400-6-10,2021-09-01
799,ضخود7080,اختيارخ خودرو-4500-1400/07/07,8,400,1900000,9,4,5,-4,-44.44,5,-4,-44.44,4,5,1400-6-10,2021-09-01
800,اخزا807,اسنادخزانه-م7بودجه98-000719,7,17258,16894232930,978164,978000,979500,1336,0.14,978922,758,0.08,978000,979500,1400-6-10,2021-09-01
801,ضملي7002,اختيارخ فملي-9720-1400/07/11,7,45,212048000,4500,4699,4700,200,4.44,4712,212,4.71,4699,4750,1400-6-10,2021-09-01
802,زعف0008پ10,زعفران0008نگين طلاي سرخ(پ),7,817,126018530,153953,154500,154990,1037,0.67,154245,292,0.19,146000,154990,1400-6-10,2021-09-01
803,هپارس102,اختيارف ت پارس-157010-01/02/05,7,30000,30000,1,1,1,0,0,1,0,0,1,1,1400-6-10,2021-09-01
804,اخزا816,اسنادخزانه-م16بودجه98-010503,6,9336,7839085617,838880,838880,840328,1448,0.17,839662,782,0.09,838880,840920,1400-6-10,2021-09-01
805,ضپنا8000,اختيارخ رمپنا-9850-1400/08/05,6,14,108049000,889,7000,8888,7999,899.78,7718,6829,768.17,7000,8888,1400-6-10,2021-09-01
806,دارا2,صندوق س. دارا الگوريتم-د,6,600000,600000,9971,1,1,-9970,-99.99,1,-9970,-99.99,1,1,1400-6-10,2021-09-01
807,اراد61,مرابحه عام دولت61-ش.خ0309,6,36000,36000000000,1000000,1000000,1000000,0,0,1000000,0,0,1000000,1000000,1400-6-10,2021-09-01
808,نگين,ص.س. زمين و ساختمان نگين شهرري,6,2392,124358160,51070,51990,51980,910,1.78,51990,920,1.8,51980,51990,1400-6-10,2021-09-01
809,وشمال,س. چشم انداز توسعه شمال,5,1200,95943600,82425,79953,79953,-2472,-3,82400,-25,-0.03,79953,79953,1400-6-10,2021-09-01
810,ضجار7041,اختيارخ وتجارت-2997-1400/07/21,5,159,29408000,195,185,184,-11,-5.64,185,-10,-5.13,184,185,1400-6-10,2021-09-01
811,اخزا809,اسنادخزانه-م9بودجه98-000923,5,1802,1707797448,944409,947900,946000,1591,0.17,947723,3314,0.35,946000,947999,1400-6-10,2021-09-01
812,ثنظام,س. ساختماني نظام مهندسي ايران,5,596,26759804,46287,44899,44899,-1388,-3,46283,-4,-0.01,44899,44899,1400-6-10,2021-09-01
813,وآذر2,سرمايه‌گذاري‌توسعه‌آذربايجان‌,5,9500000,727130000000,76540,76540,76540,0,0,76540,0,0,76540,76540,1400-6-10,2021-09-01
814,هماي2,صندوق س هماي آگاه-ثابت,5,50858000,50858000,10337,1,1,-10336,-99.99,1,-10336,-99.99,1,1,1400-6-10,2021-09-01
815,اخزا814,اسنادخزانه-م14بودجه98-010318,4,8309,7185293307,861002,860000,865174,4172,0.48,864760,3758,0.44,858001,865174,1400-6-10,2021-09-01
816,اخزا818,اسنادخزانه-م18بودجه98-010614,4,2447,2006320329,818998,819727,820203,1205,0.15,819910,912,0.11,819727,820203,1400-6-10,2021-09-01
817,ضبدر8073,اختيارخ شبندر-2167-1400/08/30,4,5,98364000,4580,4200,4200,-380,-8.3,4200,-380,-8.3,4200,4200,1400-6-10,2021-09-01
818,ضشنا8000,اختيارخ شپنا-5800-1400/08/16,4,17,117083000,5843,6011,9000,3157,54.03,6887,1044,17.87,6000,9000,1400-6-10,2021-09-01
819,ضجار7039,اختيارخ وتجارت-1997-1400/07/21,4,141,101621000,729,721,721,-8,-1.1,721,-8,-1.1,720,721,1400-6-10,2021-09-01
820,پست0008پ08,پسته فندقي32-30مه ولات0008(پ),4,23,41870000,1850000,1850000,1810000,-40000,-2.16,1820435,-29565,-1.6,1810000,1850000,1400-6-10,2021-09-01
821,اراد36,مرابحه عام دولت3-ش.خ 0104,4,31000,29331000000,987930,948000,940000,-47930,-4.85,946161,-41769,-4.23,940000,975000,1400-6-10,2021-09-01
822,ثاژن,سخت آژند,4,2915,26080505,9129,8947,8947,-182,-1.99,9128,-1,-0.01,8947,8947,1400-6-10,2021-09-01
823,ضبدر8077,اختيارخ شبندر-4302-1400/08/30,4,51,555054000,2422,2300,2330,-92,-3.8,2324,-98,-4.05,2300,2330,1400-6-10,2021-09-01
824,وسالت,بانك قرض الحسنه رسالت,4,25773,29510085,1112,1145,1145,33,2.97,1112,0,0,1145,1145,1400-6-10,2021-09-01
825,اراد33,مرابحه عام دولت3-ش.خ 0303,3,61000,54106390000,883499,886990,886990,3491,0.4,886990,3491,0.4,886990,886990,1400-6-10,2021-09-01
826,ضفلا7002,اختيارخ فولاد-6733-1400/07/25,3,20,167676396,5500,5980,5979,479,8.71,5980,480,8.73,5979,5980,1400-6-10,2021-09-01
827,ضبدر8074,اختيارخ شبندر-2595-1400/08/30,3,6,104921600,4300,3700,3740,-560,-13.02,3733,-567,-13.19,3700,3740,1400-6-10,2021-09-01
828,اراد334,مرابحه عام دولت3-ش.خ 0303,3,1945000,1715556800000,883499,886400,862000,-21499,-2.43,882034,-1465,-0.17,862000,886400,1400-6-10,2021-09-01
829,طخود7077,اختيارف خودرو-3000-1400/07/07,3,5,2000000,570,400,400,-170,-29.82,400,-170,-29.82,400,400,1400-6-10,2021-09-01
830,كشم0006پ02,كشمش تيزابي0006تاكستان(پ),3,222,51282000,220937,231000,231000,10063,4.55,231000,10063,4.55,231000,231000,1400-6-10,2021-09-01
831,تصميم2,صندوق س با درآمد ثابت تصميم,3,2800000,2800000,17265,1,1,-17264,-99.99,1,-17264,-99.99,1,1,1400-6-10,2021-09-01
832,سنفت007,سلف موازي استاندارد سنفت007,3,250000,403600000000,1648250,1614400,1614400,-33850,-2.05,1614400,-33850,-2.05,1614400,1614400,1400-6-10,2021-09-01
833,زعف0008پ12,زعفران0008پوشالمعمول سحرخيز(پ),3,1431,171734000,118444,120050,120000,1556,1.31,120010,1566,1.32,120000,120050,1400-6-10,2021-09-01
834,ضترا8058,اختيارخ شتران-3442-1400/08/09,3,52,208180000,3855,4080,4000,145,3.76,4003,148,3.84,4000,4100,1400-6-10,2021-09-01
835,فسديد,لوله‌وتجهيزات‌ سديد - ورشكسته,3,250,27070000,109373,108280,108280,-1093,-1,109366,-7,-0.01,108280,108280,1400-6-10,2021-09-01
836,افاد4,منفعت دولتي4-شرايط خاص14010729,3,62000,60140000000,969879,970000,970000,121,0.01,970000,121,0.01,970000,970000,1400-6-10,2021-09-01
837,سپيدما2,صندوق س. سپيد دماوند-د,3,30000000,30000000,10968,1,1,-10967,-99.99,1,-10967,-99.99,1,1,1400-6-10,2021-09-01
838,كباده,توليد خاك نسوزاستقلال آباده,3,35673,322412574,8775,9038,9038,263,3,8784,9,0.1,9038,9038,1400-6-10,2021-09-01
839,تملي702,تسهيلات مسكن ب. ملي-ارديبهشت97,3,32,18090240,538400,565320,565320,26920,5,565320,26920,5,565320,565320,1400-6-10,2021-09-01
840,شكف,كف,3,612,59431932,99092,97111,97111,-1981,-2,99080,-12,-0.01,97111,97111,1400-6-10,2021-09-01
841,ضچاد7032,اختيارخ كچاد-15870-1400/07/04,3,25,350000000,13500,14000,14000,500,3.7,14000,500,3.7,14000,14000,1400-6-10,2021-09-01
842,زرين2,صندوق س. سهام زرين كوروش-س,3,400000,400000,13281,1,1,-13280,-99.99,1,-13280,-99.99,1,1,1400-6-10,2021-09-01
843,طمخا7068,اختيارف اخابر-15700-1400/07/28,3,4,20000000,6402,5000,5000,-1402,-21.9,5000,-1402,-21.9,5000,5000,1400-6-10,2021-09-01
844,ضپنا8006,اختيارخ رمپنا-23850-1400/08/05,3,3,6000000,550,2000,2000,1450,263.64,2000,1450,263.64,2000,2000,1400-6-10,2021-09-01
845,ضشنا8002,اختيارخ شپنا-7800-1400/08/16,2,3,23400000,3705,7850,7700,3995,107.83,7800,4095,110.53,7700,7850,1400-6-10,2021-09-01
846,تملي805,تسهيلات مسكن ب. ملي-مرداد98,2,38,31541406,873723,830037,830037,-43686,-5,830037,-43686,-5,830037,830037,1400-6-10,2021-09-01
847,آريان2,سرمايه گذاري پارس آريان,2,11200000,180051200000,16573,16076,16076,-497,-3,16076,-497,-3,16076,16076,1400-6-10,2021-09-01
848,اراد834,مرابحه عام دولت83-ش.خ041220,2,17980000,16492554040000,1000000,917298,917240,-82760,-8.28,917272,-82728,-8.27,917240,917298,1400-6-10,2021-09-01
849,ضمخا7071,اختيارخ اخابر-23700-1400/07/28,2,31,195000,45,5,45,0,0,6,-39,-86.67,5,45,1400-6-10,2021-09-01
850,اخزا810,اسنادخزانه-م10بودجه98-001006,2,1562,1467718000,937555,939000,940000,2445,0.26,939640,2085,0.22,939000,940000,1400-6-10,2021-09-01
851,فولاد2,فولاد مباركه اصفهان,2,90000000,1087100000000,11930,12030,12140,210,1.76,12079,149,1.25,12030,12140,1400-6-10,2021-09-01
852,سايرا,ايرانيت‌,2,416,15524704,38080,37319,37319,-761,-2,38078,-2,-0.01,37319,37319,1400-6-10,2021-09-01
853,اراد214,مرابحه عام دولت2ش.خ صادرات0212,2,28050000,26693939550000,1000000,951677,951608,-48392,-4.84,951656,-48344,-4.83,951608,951677,1400-6-10,2021-09-01
854,صخود0012,ص مرابحه خودرو0012- 3ماهه 18%,2,100,102000000,1010000,1020000,1020000,10000,0.99,1020000,10000,0.99,1020000,1020000,1400-6-10,2021-09-01
855,ضپنا8002,اختيارخ رمپنا-13850-1400/08/05,2,51,268000000,2512,3000,5300,2788,110.99,5255,2743,109.2,3000,5300,1400-6-10,2021-09-01
856,كمند2,صندوق س. با درآمد ثابت كمند,2,155000000,155000000,10138,1,1,-10137,-99.99,1,-10137,-99.99,1,1,1400-6-10,2021-09-01
857,تملي711,تسهيلات مسكن ب. ملي-بهمن97,2,30,19200020,610101,640000,640001,29900,4.9,640001,29900,4.9,640000,640001,1400-6-10,2021-09-01
858,ضبدر8075,اختيارخ شبندر-3021-1400/08/30,2,25,409850000,3810,3500,3500,-310,-8.14,3500,-310,-8.14,3500,3500,1400-6-10,2021-09-01
859,عسيرجان,سلف موازي كلوخه سنگ آهن سيرجان,2,2005,2528800645,1230417,1261232,1267329,36912,3,1261247,30830,2.51,1261232,1267329,1400-6-10,2021-09-01
860,افاد1,منفعت دولت-با شرايط خاص140006,2,200,200260000,1000000,1001300,1001300,1300,0.13,1001300,1300,0.13,1001300,1001300,1400-6-10,2021-09-01
861,افاد61,منفعت دولت6-ش.خاص140109,2,50000,49000000000,1000000,980000,980000,-20000,-2,980000,-20000,-2,980000,980000,1400-6-10,2021-09-01
862,اراد704,مرابحه عام دولت70-ش.خ0112,2,34228000,32378199082000,943750,946013,945900,2150,0.23,945956,2206,0.23,945900,946013,1400-6-10,2021-09-01
863,ضپال2001,اختيارخ اپال-14000-1401/02/12,2,21,294000000,16000,14000,14000,-2000,-12.5,14000,-2000,-12.5,14000,14000,1400-6-10,2021-09-01
864,تملي803,تسهيلات مسكن ب. ملي-خرداد98,2,10,6437885,644817,612577,675000,30183,4.68,643788,-1029,-0.16,612577,675000,1400-6-10,2021-09-01
865,ضمخا7077,اختيارخ اخابر-6700-1400/07/28,2,2,10290000,4400,5190,5100,700,15.91,5145,745,16.93,5100,5190,1400-6-10,2021-09-01
866,ضپاس7028,اختيارخ وپارس-2000-1400/07/28,2,121,131000000,1400,1000,1100,-300,-21.43,1083,-317,-22.64,1000,1100,1400-6-10,2021-09-01
867,كيا,كيا الكترود شرق,2,100000,740000000,7400,7400,7400,0,0,7400,0,0,7400,7400,1400-6-10,2021-09-01
868,ضترا8060,اختيارخ شتران-4323-1400/08/09,2,18,49500000,1575,2750,2750,1175,74.6,2750,1175,74.6,2750,2750,1400-6-10,2021-09-01
869,ضصاد8030,اختيارخ وبصادر-1589-1400/08/12,2,27,30220000,1183,1120,1100,-83,-7.02,1119,-64,-5.41,1100,1120,1400-6-10,2021-09-01
870,ضپنا8001,اختيارخ رمپنا-11850-1400/08/05,2,12,62500000,8000,5000,5500,-2500,-31.25,5208,-2792,-34.9,5000,5500,1400-6-10,2021-09-01
871,اوصتا4,صندوق انديشه ورزان صباتامين -د,2,152145000,2999995110000,19699,19718,19718,19,0.1,19718,19,0.1,19718,19718,1400-6-10,2021-09-01
872,اراد644,مرابحه عام دولتي64-ش.خ0111,2,31820000,30165535010000,944500,948061,947950,3450,0.37,948005,3505,0.37,947950,948061,1400-6-10,2021-09-01
873,ضشنا8001,اختيارخ شپنا-6800-1400/08/16,2,2,15000000,6750,7000,8000,1250,18.52,7500,750,11.11,7000,8000,1400-6-10,2021-09-01
874,ياقوت2,صندوق س ياقوت آگاه-ثابت,2,19801000,19801000,13003,1,1,-13002,-99.99,1,-13002,-99.99,1,1,1400-6-10,2021-09-01
875,ميدكو2,توسعه معادن وص.معدني خاورميانه,1,15900000,710730000000,43520,44700,44700,1180,2.71,44700,1180,2.71,44700,44700,1400-6-10,2021-09-01
876,زير0103پ01,زيره سبز0103كيميابذر(پ),1,10,8200000,820000,820000,820000,0,0,820000,0,0,820000,820000,1400-6-10,2021-09-01
877,مبين0132,اجاره اعتماد مبين نوين010710,1,100000,92260000000,909000,922600,922600,13600,1.5,922600,13600,1.5,922600,922600,1400-6-10,2021-09-01
878,ضچاد7034,اختيارخ كچاد-21870-1400/07/04,1,1,9990000,9001,9990,9990,989,10.99,9990,989,10.99,9990,9990,1400-6-10,2021-09-01
879,كگهر2,سنگ آهن گهرزمين,1,3000000,150330000000,49613,50110,50110,497,1,50110,497,1,50110,50110,1400-6-10,2021-09-01
880,سپرمي,پرميت‌,1,957,8878089,9186,9277,9277,91,0.99,9186,0,0,9277,9277,1400-6-10,2021-09-01
881,ثاميد4,توسعه و عمران اميد,1,765201666,1785980688444,1740,2334,2334,594,34.14,2334,594,34.14,2334,2334,1400-6-10,2021-09-01
882,اگ0012542,گام بانك پارسيان0012,1,336000,299208000000,888988,890500,890500,1512,0.17,890500,1512,0.17,890500,890500,1400-6-10,2021-09-01
883,گنگين2,اقتصادي نگين گردشگري ايرانيان,1,12000000,300696000000,25058,25058,25058,0,0,25058,0,0,25058,25058,1400-6-10,2021-09-01
884,پست0008پ04,پسته فندقي32-30سبزدانه0008(پ),1,3,5362560,1792846,1787520,1787520,-5326,-0.3,1787520,-5326,-0.3,1787520,1787520,1400-6-10,2021-09-01
885,ضذوب900,اختيارخ ذوب-2500-14000917,1,4,10000000,1726,2500,2500,774,44.84,2500,774,44.84,2500,2500,1400-6-10,2021-09-01
886,خبهمن2,گروه‌بهمن‌,1,180000000,295200000000,1657,1640,1640,-17,-1.03,1640,-17,-1.03,1640,1640,1400-6-10,2021-09-01
887,اخزا723,اسنادخزانه-م23بودجه97-000824,1,45,43200000,959441,960000,960000,559,0.06,960000,559,0.06,960000,960000,1400-6-10,2021-09-01
888,كچاد2,معدني‌وصنعتي‌چادرملو,1,4800000,144000000000,29700,30000,30000,300,1.01,30000,300,1.01,30000,30000,1400-6-10,2021-09-01
889,فارس2,صنايع پتروشيمي خليج فارس,1,80000000,1004000000000,12330,12550,12550,220,1.78,12550,220,1.78,12550,12550,1400-6-10,2021-09-01
890,اراد584,مرابحه عام دولت5-ش.خ 0110,1,3100000,2963600000000,990000,956000,956000,-34000,-3.43,956000,-34000,-3.43,956000,956000,1400-6-10,2021-09-01
891,ضپاس7034,اختيارخ وپارس-5000-1400/07/28,1,1,50000,44,50,50,6,13.64,50,6,13.64,50,50,1400-6-10,2021-09-01
892,افاد44,منفعت دولتي4-شرايط خاص14010729,1,2000000,1940000000000,969879,970000,970000,121,0.01,970000,121,0.01,970000,970000,1400-6-10,2021-09-01
893,حرهشا4,رهشاد سپاهان (سهامي عام,1,1020342,65301888000,80207,64000,64000,-16207,-20.21,64000,-16207,-20.21,64000,64000,1400-6-10,2021-09-01
894,بساما2,بيمه سامان,1,19000000,430217000000,23834,22643,22643,-1191,-5,22643,-1191,-5,22643,22643,1400-6-10,2021-09-01
895,ضصاد8031,اختيارخ وبصادر-1789-1400/08/12,1,1,888000,797,888,888,91,11.42,888,91,11.42,888,888,1400-6-10,2021-09-01
896,مبين013,اجاره اعتماد مبين نوين010710,1,10000,9226000000,909000,922600,922600,13600,1.5,922600,13600,1.5,922600,922600,1400-6-10,2021-09-01
897,طخود7076,اختيارف خودرو-2500-1400/07/07,1,10,2600000,479,260,260,-219,-45.72,260,-219,-45.72,260,260,1400-6-10,2021-09-01
898,زعف0008پ15,زعفران0008پوشالمعمول طلاسرخ(پ),1,500,62298000,121000,124596,124596,3596,2.97,124596,3596,2.97,124596,124596,1400-6-10,2021-09-01
899,ارمغان2,ص سرمايه گذاري ارمغان ايرانيان,1,3945162,3945162,10133,1,1,-10132,-99.99,1,-10132,-99.99,1,1,1400-6-10,2021-09-01
900,ضشنا8003,اختيارخ شپنا-8800-1400/08/16,1,3,18600000,5686,6200,6200,514,9.04,6200,514,9.04,6200,6200,1400-6-10,2021-09-01
901,دمعيار2,صندوق س. توازن معيار-د,1,1000000,1000000,10046,1,1,-10045,-99.99,1,-10045,-99.99,1,1,1400-6-10,2021-09-01
902,فخوز2,فولاد  خوزستان,1,25000000,471000000000,18550,18840,18840,290,1.56,18840,290,1.56,18840,18840,1400-6-10,2021-09-01
903,شپديس2,پتروشيمي پرديس,1,3000000,457260000000,149150,152420,152420,3270,2.19,152420,3270,2.19,152420,152420,1400-6-10,2021-09-01
904,اراد494,مرابحه عام دولت4-ش.خ 0206,1,3020000,2848512320000,939499,943216,943216,3717,0.4,943216,3717,0.4,943216,943216,1400-6-10,2021-09-01
905,زير0103پ04,زيره سبز0103شركت مينوبذر(پ),1,20,15800000,795000,790000,790000,-5000,-0.63,790000,-5000,-0.63,790000,790000,1400-6-10,2021-09-01
906,هنوري102,اختيارف ت نوري59561-01/02/15,1,4257,4257,1,1,1,0,0,1,0,0,1,1,1400-6-10,2021-09-01
907,ضخود7079,اختيارخ خودرو-4000-1400/07/07,1,4,76000,11,19,19,8,72.73,19,8,72.73,19,19,1400-6-10,2021-09-01
908,اراد404,مرابحه عام دولت4-ش.خ 0207,1,600000,547200000000,1000000,912000,912000,-88000,-8.8,912000,-88000,-8.8,912000,912000,1400-6-10,2021-09-01
909,آسام4,صندوق س.آرمان سپهر آشنا-م,1,232560,30000240000,130205,129000,129000,-1205,-0.93,129000,-1205,-0.93,129000,129000,1400-6-10,2021-09-01
910,اراد364,مرابحه عام دولت3-ش.خ 0104,1,2498000,2350618000000,987930,941000,941000,-46930,-4.75,941000,-46930,-4.75,941000,941000,1400-6-10,2021-09-01
911,افاد84,منفعت دولت8-ش.خاص ساير0205,1,25000,23750000000,950000,950000,950000,0,0,950000,0,0,950000,950000,1400-6-10,2021-09-01
912,آوا2,صندوق س.سهام آواي معيار-س,1,1900000,1900000,8656,1,1,-8655,-99.99,1,-8655,-99.99,1,1,1400-6-10,2021-09-01
913,فراز4,صندوق س.سهام فراز داريك-س,1,4000000,54400000000,13958,13600,13600,-358,-2.56,13600,-358,-2.56,13600,13600,1400-6-10,2021-09-01
914,ضمخا7069,اختيارخ اخابر-17700-1400/07/28,1,10,5500000,400,550,550,150,37.5,550,150,37.5,550,550,1400-6-10,2021-09-01
915,طلا2,صندوق س.پشتوانه طلاي لوتوس,1,100000,100000,84754,1,1,-84753,-100,1,-84753,-100,1,1,1400-6-10,2021-09-01
916,ضپال2006,اختيارخ اپال-28000-1401/02/12,1,1,2320000,2994,2320,2320,-674,-22.51,2320,-674,-22.51,2320,2320,1400-6-10,2021-09-01
917,ضملي7001,اختيارخ فملي-8720-1400/07/11,1,24,136800000,5500,5700,5700,200,3.64,5700,200,3.64,5700,5700,1400-6-10,2021-09-01
918,وخارزم2,سرمايه گذاري خوارزمي,1,39200000,249704000000,6370,6370,6370,0,0,6370,0,0,6370,6370,1400-6-10,2021-09-01
919,صايپا012,صكوك مرابحه سايپا012-3ماهه 16%,1,5000,5000010000,1000002,1000002,1000002,0,0,1000002,0,0,1000002,1000002,1400-6-10,2021-09-01
920,ضغدر8058,اختيارخ وغدير-10000-1400/08/26,1,3,18330000,6000,6110,6110,110,1.83,6110,110,1.83,6110,6110,1400-6-10,2021-09-01
921,نوآور,ص.اعتبارسرمايه نوآفرين70%تاديه,1,1000,761750000,692500,761750,761750,69250,10,761750,69250,10,761750,761750,1400-6-10,2021-09-01
922,ضذوب901,اختيارخ ذوب-3000-14000917,1,3,6600000,2120,2200,2200,80,3.77,2200,80,3.77,2200,2200,1400-6-10,2021-09-01
923,تملي709,تسهيلات مسكن ب. ملي-آذر97,1,20,16999980,847015,849999,849999,2984,0.35,849999,2984,0.35,849999,849999,1400-6-10,2021-09-01
924,كايتا,ايتالران‌,1,1557,14989239,9347,9627,9627,280,3,9347,0,0,9627,9627,1400-6-10,2021-09-01
925,ضگل8071,اختيارخ كگل-7700-1400/08/23,1,3,53400000,14500,17800,17800,3300,22.76,17800,3300,22.76,17800,17800,1400-6-10,2021-09-01
926,مشهد0212,مشاركت ش مشهد0212-3ماهه18%,1,10000,9900010000,999519,990001,990001,-9518,-0.95,990001,-9518,-0.95,990001,990001,1400-6-10,2021-09-01
927,زعف0008پ20,زعفران0008نگين وحدت جام(پ),1,1500,215145000,141930,143430,143430,1500,1.06,143430,1500,1.06,143430,143430,1400-6-10,2021-09-01
928,پاسار042,اجاره انرژي پاسارگاد14040302,1,2350000,2350000000000,1000000,1000000,1000000,0,0,1000000,0,0,1000000,1000000,1400-6-10,2021-09-01
