,نماد,نام,تعداد,حجم,ارزش,دیروز,اولین,آخرین معامله - مقدار,آخرین معامله - تغییر,آخرین معامله - درصد,قیمت پایانی - مقدار,قیمت پایانی - تغییر,قیمت پایانی - درصد,کمترین,بیشترین,تاریخ,gregorian_date
0,پالايش,صندوق پالايشي يكم-سهام,29810,30167151,2168274177770,74590,73400,71100,-3490,-4.68,71880,-2710,-3.63,70940,73730,1400-8-24,2021-11-15
1,شستا,سرمايه گذاري تامين اجتماعي,22869,116202381,1288788817830,11550,11420,10980,-570,-4.94,11090,-460,-3.98,10980,11490,1400-8-24,2021-11-15
2,بورس,بورس اوراق بهادار تهران,22685,268593926,4169243214190,10300,15700,14920,4620,44.85,15520,5220,50.68,14920,16480,1400-8-24,2021-11-15
3,دارا يكم,صندوق واسطه گري مالي يكم-سهام,19358,12351930,1414600156540,119080,118000,113230,-5850,-4.91,114520,-4560,-3.83,113000,118290,1400-8-24,2021-11-15
4,شپنا,پالايش نفت اصفهان,18976,131677849,1451497735330,11560,11490,10990,-570,-4.93,11020,-540,-4.67,10990,11490,1400-8-24,2021-11-15
5,بركت,گروه دارويي بركت,14135,45970422,1112845284030,23190,23760,24340,1150,4.96,24210,1020,4.4,23750,24340,1400-8-24,2021-11-15
6,فولاد,فولاد مباركه اصفهان,10567,71773060,809287914550,11740,11650,11250,-490,-4.17,11280,-460,-3.92,11160,11660,1400-8-24,2021-11-15
7,وبملت,بانك ملت,9545,295970383,941371568537,3334,3286,3168,-166,-4.98,3181,-153,-4.59,3168,3340,1400-8-24,2021-11-15
8,خگستر,گسترش‌سرمايه‌گذاري‌ايران‌خودرو,9115,263135981,641804030703,2460,2511,2412,-48,-1.95,2439,-21,-0.85,2368,2545,1400-8-24,2021-11-15
9,شبندر,پالايش نفت بندرعباس,9009,122725868,814051130490,6870,6780,6550,-320,-4.66,6630,-240,-3.49,6530,6800,1400-8-24,2021-11-15
10,فجهان,مجتمع جهان فولاد سيرجان,8877,41838465,244747360605,5858,5949,5859,1,0.02,5850,-8,-0.14,5781,5949,1400-8-24,2021-11-15
11,فسبزوار,پارس فولاد سبزوار,8369,6676138,234826306630,35450,35630,35360,-90,-0.25,35170,-280,-0.79,35080,35630,1400-8-24,2021-11-15
12,خبهمن,گروه‌بهمن‌,8080,339584916,647826558460,1914,1944,1910,-4,-0.21,1908,-6,-0.31,1850,1979,1400-8-24,2021-11-15
13,تپكو,توليدتجهيزات‌سنگين‌هپكو,8069,191440060,685784518693,3561,3600,3620,59,1.66,3582,21,0.59,3458,3661,1400-8-24,2021-11-15
14,كدما,معدني‌ دماوند,7016,4572317,374991837530,85910,85000,81700,-4210,-4.9,82010,-3900,-4.54,81620,85100,1400-8-24,2021-11-15
15,بركتح,ح . گروه دارويي بركت,6853,18445091,384294606790,19960,20370,20970,1010,5.06,20830,870,4.36,20230,21560,1400-8-24,2021-11-15
16,فملي,ملي‌ صنايع‌ مس‌ ايران‌,6820,33957940,453143335480,13750,13700,13240,-510,-3.71,13340,-410,-2.98,13070,13800,1400-8-24,2021-11-15
17,فرابورس,فرابورس ايران,6808,23764875,533118731601,23200,23200,22040,-1160,-5,22433,-767,-3.31,22040,23430,1400-8-24,2021-11-15
18,حكشتي,كشتيراني جمهوري اسلامي ايران,6398,43906206,669537955880,14720,14710,14800,80,0.54,15250,530,3.6,14590,15450,1400-8-24,2021-11-15
19,وسديد,گروه ‌صنعتي‌سديد,6267,124604953,137293364887,1071,1103,1103,32,2.99,1102,31,2.89,1085,1103,1400-8-24,2021-11-15
20,كيمياتك,آريان كيميا تك,6079,2768819,72367939230,25880,26010,26040,160,0.62,26140,260,1,25920,26660,1400-8-24,2021-11-15
21,شتران,پالايش نفت تهران,6031,58738011,262883730719,4663,4640,4430,-233,-5,4476,-187,-4.01,4430,4690,1400-8-24,2021-11-15
22,نوري,پتروشيمي نوري,5854,2761005,336531013730,124600,125700,120930,-3670,-2.95,121890,-2710,-2.17,120050,125800,1400-8-24,2021-11-15
23,مديريت,س. و خدمات مديريت صند. ب كشوري,5800,12601440,116627554473,9671,9740,9230,-441,-4.56,9255,-416,-4.3,9188,9740,1400-8-24,2021-11-15
24,كرمان,س. توسعه و عمران استان كرمان,5784,184029434,188469033278,1064,1049,1014,-50,-4.7,1024,-40,-3.76,1012,1059,1400-8-24,2021-11-15
25,وبرق,س.کارکنان صنعت برق زنجان وقزوي,5766,7262735,1046874658756,144354,148684,140024,-4330,-3,144143,-211,-0.15,140024,148684,1400-8-24,2021-11-15
26,كالا,بورس كالاي ايران,5253,19355754,646114641170,34870,33990,33130,-1740,-4.99,33380,-1490,-4.27,33130,34590,1400-8-24,2021-11-15
27,وتجارت,بانك تجارت,5006,180383247,351143415793,2037,2020,1936,-101,-4.96,1947,-90,-4.42,1936,2029,1400-8-24,2021-11-15
28,چكاوه,صنايع‌كاغذسازي‌كاوه‌,4637,35533067,361772049990,10430,9910,10270,-160,-1.53,10180,-250,-2.4,9910,10650,1400-8-24,2021-11-15
29,كمند,صندوق س. با درآمد ثابت كمند,4547,173524564,1743830978357,10044,10049,10050,6,0.06,10049,5,0.05,10049,10051,1400-8-24,2021-11-15
30,آريا,پليمر آريا ساسول,4422,1024168,119707844872,120311,119000,116161,-4150,-3.45,116883,-3428,-2.85,115471,119799,1400-8-24,2021-11-15
31,سپيد,سپيد ماكيان,3929,2693731,152693557950,58530,57890,57170,-1360,-2.32,56680,-1850,-3.16,55620,58490,1400-8-24,2021-11-15
32,سمگا,گروه سرمايه گذاري ميراث فرهنگي,3833,68186370,813545666722,11777,12000,11511,-266,-2.26,11931,154,1.31,11473,12200,1400-8-24,2021-11-15
33,وخارزم,سرمايه گذاري خوارزمي,3793,50167033,241845734060,5040,5000,4790,-250,-4.96,4820,-220,-4.37,4790,5010,1400-8-24,2021-11-15
34,كيان,صندوق س. با درآمد ثابت كيان,3732,58564253,1849009585744,31555,31573,31573,18,0.06,31572,17,0.05,31571,31575,1400-8-24,2021-11-15
35,غزر,صنعتي زر ماكارون,3718,9735278,99298662370,10700,10450,10170,-530,-4.95,10200,-500,-4.67,10170,10500,1400-8-24,2021-11-15
36,خنصير,مهندسي‌نصيرماشين‌,3636,12484701,296988278740,23810,24500,23450,-360,-1.51,23790,-20,-0.08,23010,24780,1400-8-24,2021-11-15
37,لطيف,محصولات كاغذي لطيف,3492,1968795,81479946506,39808,40000,40640,832,2.09,41386,1578,3.96,39001,41798,1400-8-24,2021-11-15
38,فخوز,فولاد  خوزستان,3489,34101080,230278508260,7050,7070,6720,-330,-4.68,6750,-300,-4.26,6700,7070,1400-8-24,2021-11-15
39,امين,تامين سرمايه امين,3459,3553664,42827375800,12070,12100,12070,0,0,12060,-10,-0.08,11550,12110,1400-8-24,2021-11-15
40,زاگرس,پتروشيمي زاگرس,3453,773799,205656710958,277060,278220,263207,-13853,-5,265775,-11285,-4.07,263207,278220,1400-8-24,2021-11-15
41,شلرد,كود شيميايي اوره لردگان,3438,26389275,304778535980,11801,11561,11447,-354,-3,11549,-252,-2.14,11447,11840,1400-8-24,2021-11-15
42,غكورش,صنعت غذايي كورش,3347,2836501,131647112370,48070,46640,46450,-1620,-3.37,46410,-1660,-3.45,45690,47640,1400-8-24,2021-11-15
43,وبصادر,بانك صادرات ايران,3338,86525798,160967040534,1931,1900,1850,-81,-4.19,1860,-71,-3.68,1835,1950,1400-8-24,2021-11-15
44,صبا,سرمايه گذاري صبا تامين,3263,20410715,124740190205,6219,6320,6067,-152,-2.44,6112,-107,-1.72,6031,6320,1400-8-24,2021-11-15
45,بوعلي,پتروشيمي بوعلي سينا,3135,1147377,88318042180,79500,78820,76180,-3320,-4.18,77180,-2320,-2.92,76000,78820,1400-8-24,2021-11-15
46,وتوصا,گروه س توسعه صنعتي ايران,3135,19552073,212832487280,10530,11050,10460,-70,-0.66,10890,360,3.42,10330,11050,1400-8-24,2021-11-15
47,وهامون,سرمايه گذاري هامون صبا,3120,17398847,49747878406,2958,2950,2903,-55,-1.86,2859,-99,-3.35,2812,2950,1400-8-24,2021-11-15
48,كاما,باما,3088,20795459,175419037020,8850,8710,8410,-440,-4.97,8440,-410,-4.63,8410,8710,1400-8-24,2021-11-15
49,گدنا,تهيه توزيع غذاي دنا آفرين فدك,2982,1308085,18669905172,14638,14700,14250,-388,-2.65,14273,-365,-2.49,14155,14700,1400-8-24,2021-11-15
50,ذوب,سهامي ذوب آهن  اصفهان,2959,33357879,123752116058,3837,3837,3670,-167,-4.35,3710,-127,-3.31,3655,3852,1400-8-24,2021-11-15
51,بكاب,صنايع‌جوشكاب‌يزد,2931,1348775,151599704860,113400,117000,109900,-3500,-3.09,112400,-1000,-0.88,107730,118800,1400-8-24,2021-11-15
52,چخزر,صنايع چوب خزر كاسپين,2899,893435,25855728534,28438,27740,29450,1012,3.56,28940,502,1.77,27740,29585,1400-8-24,2021-11-15
53,سپيدار,سپيدار سيستم آسيا,2896,1523232,27900887310,19072,19072,18399,-673,-3.53,18317,-755,-3.96,18119,19072,1400-8-24,2021-11-15
54,وصنعت,سرمايه گذاري توسعه صنعت وتجارت,2846,29534559,217484872860,7430,7470,7310,-120,-1.62,7360,-70,-0.94,7220,7580,1400-8-24,2021-11-15
55,نهال,صندوق س. طلاي سرخ نوويرا,2759,8346725,152437257609,18367,18750,18058,-309,-1.68,18263,-104,-0.57,17800,19179,1400-8-24,2021-11-15
56,ثبهساز,بهساز كاشانه تهران,2736,24096013,39390849215,1704,1688,1622,-82,-4.81,1635,-69,-4.05,1619,1703,1400-8-24,2021-11-15
57,ولقمان,سرمايه گذاري لقمان,2725,12162360,42100241091,3558,3555,3452,-106,-2.98,3462,-96,-2.7,3452,3628,1400-8-24,2021-11-15
58,فسرب,ملي‌ سرب‌وروي‌ ايران‌,2654,3284773,207937152730,60870,60010,63910,3040,4.99,63300,2430,3.99,59400,63910,1400-8-24,2021-11-15
59,غگيلا,شيرپاستوريزه پگاه گيلان,2635,3778222,62866717023,17374,17300,16506,-868,-5,16639,-735,-4.23,16506,17370,1400-8-24,2021-11-15
60,ومدير,گ.مديريت ارزش سرمايه ص ب كشوري,2625,11477451,50239054509,4473,4435,4383,-90,-2.01,4377,-96,-2.15,4337,4480,1400-8-24,2021-11-15
61,شگويا,پتروشيمي تندگويان,2589,10522796,113859065420,11250,11100,10752,-498,-4.43,10820,-430,-3.82,10702,11200,1400-8-24,2021-11-15
62,غويتا,ويتانا,2583,24740201,173723314741,6890,7098,6725,-165,-2.39,7022,132,1.92,6682,7234,1400-8-24,2021-11-15
63,خمهرح,ح . مهركام‌پارس‌,2504,46722961,41127166045,904,920,867,-37,-4.09,880,-24,-2.65,850,934,1400-8-24,2021-11-15
64,بپيوند,برق و انرژي پيوندگستر پارس,2487,2296787,24202909415,10475,10370,10380,-95,-0.91,10538,63,0.6,10201,10820,1400-8-24,2021-11-15
65,انرژي3,سايراشخاص بورس انرژي,2449,2313169,222341804280,101170,96120,96120,-5050,-4.99,96120,-5050,-4.99,96120,96120,1400-8-24,2021-11-15
66,فارس,صنايع پتروشيمي خليج فارس,2413,13031761,149986191910,11910,12000,11320,-590,-4.95,11510,-400,-3.36,11320,12010,1400-8-24,2021-11-15
67,خاذين,سايپاآذين‌,2376,61537004,189899438388,2955,3102,3050,95,3.21,3086,131,4.43,3011,3102,1400-8-24,2021-11-15
68,ثاميد,توسعه و عمران اميد,2363,15314503,21868765732,1432,1422,1411,-21,-1.47,1428,-4,-0.28,1390,1460,1400-8-24,2021-11-15
69,سحرخيز,صندوق س. گروه زعفران سحرخيز,2353,4535209,81929400369,18420,18600,17820,-600,-3.26,18065,-355,-1.93,17400,18840,1400-8-24,2021-11-15
70,هاي وب,داده گسترعصرنوين-هاي وب,2338,19488659,171930076840,9020,8910,8640,-380,-4.21,8820,-200,-2.22,8600,9120,1400-8-24,2021-11-15
71,وسپهر,سرمايه گذاري مالي سپهرصادرات,2330,6806488,48056570407,7062,7061,7060,-2,-0.03,7061,-1,-0.01,7060,7090,1400-8-24,2021-11-15
72,پترول,گ.س.وت.ص.پتروشيمي خليج فارس,2315,27037160,84036793893,3229,3184,3068,-161,-4.99,3112,-117,-3.62,3068,3220,1400-8-24,2021-11-15
73,ولكار,ليزينگ كارآفرين,2308,2679486,10750131772,4073,4024,4030,-43,-1.06,4027,-46,-1.13,3950,4083,1400-8-24,2021-11-15
74,لپارس,پارس‌ الكتريك‌,2288,1207844,120439085040,104420,102190,99200,-5220,-5,99710,-4710,-4.51,99200,103500,1400-8-24,2021-11-15
75,شاروم,پتروشيمي اروميه,2251,1581257,21981571873,14370,14150,13710,-660,-4.59,13901,-469,-3.26,13700,14370,1400-8-24,2021-11-15
76,وگستر,گسترش سرمايه گذاري ايرانيان,2228,16185253,118620703559,7050,6899,7402,352,4.99,7329,279,3.96,6800,7402,1400-8-24,2021-11-15
77,ولپارس,ليزينگ پارسيان,2141,4073147,16331110602,4027,4010,4003,-24,-0.6,4009,-18,-0.45,3951,4097,1400-8-24,2021-11-15
78,زملارد,كشاورزي و دامپروري ملارد شير,2090,1121310,23907525632,22409,21665,21289,-1120,-5,21321,-1088,-4.86,21289,21930,1400-8-24,2021-11-15
79,حتايد,تايدواترخاورميانه,2080,17947412,106131844030,5890,5920,5830,-60,-1.02,5910,20,0.34,5700,6070,1400-8-24,2021-11-15
80,وكبهمن,مديريت سرمايه گذاري كوثربهمن,2074,497267,5032859374,10375,10240,10086,-289,-2.79,10286,-89,-0.86,10060,10360,1400-8-24,2021-11-15
81,وساخت,سرمايه‌ گذاري‌ ساختمان‌ايران‌,2053,3768378,170878252420,43520,45090,45190,1670,3.84,45350,1830,4.2,44010,45690,1400-8-24,2021-11-15
82,سيتا,سرمايه گذاري سيمان تامين,1971,2710072,26196768760,9980,9770,9580,-400,-4.01,9790,-190,-1.9,9510,9950,1400-8-24,2021-11-15
83,وسكرمان,س.سهام عدالت استان كرمان,1971,201401450,100124756871,522,503,496,-26,-4.98,497,-25,-4.79,496,515,1400-8-24,2021-11-15
84,كزغال,زغال سنگ پروده طبس,1950,935369,28615188422,31820,31250,30319,-1501,-4.72,30592,-1228,-3.86,30300,31600,1400-8-24,2021-11-15
85,شصدف,صنعتي دوده فام,1859,2136209,63172879307,30338,30611,29729,-609,-2.01,29572,-766,-2.52,28901,30800,1400-8-24,2021-11-15
86,رافزا,رايان هم افزا,1856,349872,23266614892,69081,68214,65627,-3454,-5,66500,-2581,-3.74,65627,70000,1400-8-24,2021-11-15
87,غگل,گلوكوزان‌,1839,28063884,96153006986,3546,3540,3369,-177,-4.99,3426,-120,-3.38,3369,3600,1400-8-24,2021-11-15
88,امين يكم,صندوق درآمد ثابت امين يكم فردا,1832,42035000,425503076775,10115,10122,10125,10,0.1,10123,8,0.08,10120,10126,1400-8-24,2021-11-15
89,آبادا,توليد نيروي برق آبادان,1825,917114,11778871610,13320,13350,12660,-660,-4.95,12920,-400,-3,12660,13440,1400-8-24,2021-11-15
90,شپديس,پتروشيمي پرديس,1821,1529322,292204809020,197710,197720,190940,-6770,-3.42,191070,-6640,-3.36,188010,197720,1400-8-24,2021-11-15
91,طلا,صندوق س.پشتوانه طلاي لوتوس,1816,2067716,181278786650,89391,88000,88074,-1317,-1.47,87671,-1720,-1.92,86910,88440,1400-8-24,2021-11-15
92,سرو,صندوق س سروسودمند مدبران-سهام,1807,1826660,133421269290,75390,74650,72680,-2710,-3.59,73040,-2350,-3.12,72500,74650,1400-8-24,2021-11-15
93,اعتماد,صندوق س.اعتماد آفرين پارسيان-د,1805,27659080,1106221785970,39971,39993,39996,25,0.06,39995,24,0.06,39993,39997,1400-8-24,2021-11-15
94,پارند,صندوق س. پارند پايدار سپهر,1798,72932273,733103211831,10046,10051,10052,6,0.06,10052,6,0.06,10051,10053,1400-8-24,2021-11-15
95,بگيلان,توسعه مسير برق گيلان,1797,397394,5977016008,15528,15210,15017,-511,-3.29,15415,-113,-0.73,14890,15400,1400-8-24,2021-11-15
96,غبهار,كشت وصنعت بهاران گلبهار خراسان,1776,7935897,130478631966,16056,16858,16858,802,5,16442,386,2.4,15255,16858,1400-8-24,2021-11-15
97,خصدرا,صنعتي‌ دريايي‌ ايران‌,1773,38960122,97487044918,2564,2535,2488,-76,-2.96,2502,-62,-2.42,2488,2623,1400-8-24,2021-11-15
98,خزاميا,زامياد,1753,15897529,108694093510,7040,7060,6770,-270,-3.84,6840,-200,-2.84,6690,7130,1400-8-24,2021-11-15
99,ختوقا,قطعات‌ اتومبيل‌ ايران‌,1751,38700523,87934235395,2276,2325,2242,-34,-1.49,2272,-4,-0.18,2175,2369,1400-8-24,2021-11-15
100,قثابت,قند ثابت‌ خراسان‌,1741,37465706,78751759214,2202,2130,2092,-110,-5,2102,-100,-4.54,2092,2200,1400-8-24,2021-11-15
101,فگستر,گسترش صنايع روي ايرانيان,1711,4405754,39140337531,9284,9500,8820,-464,-5,8884,-400,-4.31,8820,9500,1400-8-24,2021-11-15
102,غسالم,سالمين‌,1711,23486290,75857557841,3161,3162,3171,10,0.32,3230,69,2.18,3124,3300,1400-8-24,2021-11-15
103,زنگان,صنعت روي زنگان,1684,1533798,122821728731,77056,76200,80908,3852,5,80077,3021,3.92,74101,80908,1400-8-24,2021-11-15
104,ثشاهد,سرمايه‌ گذاري‌ شاهد,1663,9383462,114867548680,12730,12700,12100,-630,-4.95,12240,-490,-3.85,12100,12700,1400-8-24,2021-11-15
105,وملي,گروه‌ صنعتي‌ ملي‌ (هلدينگ‌,1658,608755,98085141040,168100,165310,159700,-8400,-5,161120,-6980,-4.15,159700,168600,1400-8-24,2021-11-15
106,وپارس,بانك‌پارسيان‌,1654,68242612,152251931733,2255,2260,2190,-65,-2.88,2231,-24,-1.06,2165,2299,1400-8-24,2021-11-15
107,فتوسا,توليد و توسعه سرب روي ايرانيان,1633,1126378,12080023156,11158,11000,10621,-537,-4.81,10795,-363,-3.25,10606,11100,1400-8-24,2021-11-15
108,بترانس,ايران‌ ترانسفو,1622,35134169,76499159793,2270,2230,2158,-112,-4.93,2177,-93,-4.1,2157,2264,1400-8-24,2021-11-15
109,چكاپا,گروه صنايع كاغذ پارس,1563,20321910,59573101452,3026,3040,2882,-144,-4.76,2931,-95,-3.14,2880,3040,1400-8-24,2021-11-15
110,وغدير,سرمايه‌گذاري‌غدير(هلدينگ‌,1556,7083093,107872329720,15620,15610,15150,-470,-3.01,15250,-370,-2.37,15070,15610,1400-8-24,2021-11-15
111,ملت,بيمه ملت,1553,57292221,64057719968,1151,1133,1105,-46,-4,1118,-33,-2.87,1094,1148,1400-8-24,2021-11-15
112,آگاس,صندوق س.هستي بخش آگاه-س,1538,1032721,83583338479,82724,82950,80399,-2325,-2.81,80935,-1789,-2.16,80200,82950,1400-8-24,2021-11-15
113,چفيبر,فيبر ايران‌,1530,14883515,96923031520,6280,6590,6330,50,0.8,6510,230,3.66,6280,6590,1400-8-24,2021-11-15
114,وپويا,سرمايه گذاري پويا,1521,4945674,20004880232,4225,4133,4036,-189,-4.47,4045,-180,-4.26,4014,4200,1400-8-24,2021-11-15
115,تسه0006,امتيازتسهيلات مسكن شهريور1400,1520,47624,37858755609,805250,816111,798997,-6253,-0.78,794951,-10299,-1.28,775300,829973,1400-8-24,2021-11-15
116,كفپارس,فرآورده‌هاي‌ نسوز پارس‌,1496,12224959,46756082364,3742,3840,3726,-16,-0.43,3825,83,2.22,3699,3920,1400-8-24,2021-11-15
117,كتوكا,توليدي و خدمات صنايع نسوز توكا,1490,8312266,110687418584,12752,13100,13389,637,5,13316,564,4.42,12810,13389,1400-8-24,2021-11-15
118,تسه0007,امتيازتسهيلات مسكن مهر1400,1481,33887,27174415347,807348,821111,784200,-23148,-2.87,801913,-5435,-0.67,772000,830000,1400-8-24,2021-11-15
119,شاوان,پالايش نفت لاوان,1472,843139,117040273813,142884,142300,137279,-5605,-3.92,138815,-4069,-2.85,137020,142300,1400-8-24,2021-11-15
120,ماديرا,صنايع ماديران,1471,12688739,82027474853,6766,6790,6550,-216,-3.19,6465,-301,-4.45,6428,6830,1400-8-24,2021-11-15
121,شاراك,پتروشيمي شازند,1465,2094484,98889249330,48080,48480,47150,-930,-1.93,47210,-870,-1.81,46900,48700,1400-8-24,2021-11-15
122,وهنر,گروه توسعه هنر ايران,1453,22886073,78653668428,3341,3441,3441,100,2.99,3437,96,2.87,3251,3441,1400-8-24,2021-11-15
123,رتاپ,تجارت الكترونيك  پارسيان,1448,7187332,46184821190,6380,6680,6540,160,2.51,6430,50,0.78,6150,6680,1400-8-24,2021-11-15
124,كچاد,معدني‌وصنعتي‌چادرملو,1447,4513561,134630892000,30740,30740,29290,-1450,-4.72,29830,-910,-2.96,29270,30740,1400-8-24,2021-11-15
125,شبريز,پالايش نفت تبريز,1441,3334538,110313922130,34180,34180,32800,-1380,-4.04,33080,-1100,-3.22,32610,34180,1400-8-24,2021-11-15
126,سيمرغ,سيمرغ,1439,4357662,102397784930,23830,23800,23450,-380,-1.59,23500,-330,-1.38,23180,24190,1400-8-24,2021-11-15
127,فروي,ذوب روي اصفهان,1414,2280755,50286502350,22892,22892,21960,-932,-4.07,22048,-844,-3.69,21880,22892,1400-8-24,2021-11-15
128,شپلي,پلي اكريل ايران,1409,12279979,89973850211,7442,7600,7219,-223,-3,7327,-115,-1.55,7219,7600,1400-8-24,2021-11-15
129,خكمك,كمك‌فنرايندامين‌,1409,4773454,122130223130,24910,25010,26150,1240,4.98,25590,680,2.73,24100,26150,1400-8-24,2021-11-15
130,شسپا,نفت سپاهان,1408,22044692,80236920515,3759,3715,3635,-124,-3.3,3642,-117,-3.11,3612,3740,1400-8-24,2021-11-15
131,شبصير,توليدات پتروشيمي قائد بصير,1394,437322,52085483897,123394,123520,118281,-5113,-4.14,119101,-4293,-3.48,117610,123530,1400-8-24,2021-11-15
132,حفاري,حفاري شمال,1388,12714028,56341284686,4603,4558,4373,-230,-5,4431,-172,-3.74,4373,4558,1400-8-24,2021-11-15
133,حريل,ريل پردازسير,1386,18017722,56098081329,3078,3032,3082,4,0.13,3113,35,1.14,2976,3195,1400-8-24,2021-11-15
134,خزر,فنرسازي‌زر,1382,8112156,94892289210,12270,11890,11660,-610,-4.97,11700,-570,-4.65,11660,12260,1400-8-24,2021-11-15
135,كماسه,تامين‌ ماسه‌ ريخته‌گري‌,1373,14804330,84448759230,5950,5900,5660,-290,-4.87,5700,-250,-4.2,5660,5960,1400-8-24,2021-11-15
136,ثفارس,عمران‌وتوسعه‌فارس‌,1366,10416282,85892609240,8480,8430,8220,-260,-3.07,8250,-230,-2.71,8060,8550,1400-8-24,2021-11-15
137,كاوه,فولاد كاوه جنوب كيش,1334,2801388,44652690600,16230,16390,16100,-130,-0.8,16090,-140,-0.86,15580,16390,1400-8-24,2021-11-15
138,وهور,مديريت انرژي اميد  تابان هور,1327,40515011,62187703188,1476,1433,1530,54,3.66,1535,59,4,1433,1549,1400-8-24,2021-11-15
139,پيزد,مجتمع صنايع لاستيك يزد,1324,148160,8046261267,56016,55060,54300,-1716,-3.06,55063,-953,-1.7,54010,55510,1400-8-24,2021-11-15
140,وصنا,گروه‌صنايع‌بهشهرايران‌,1239,13466127,88909680170,6310,6250,6620,310,4.91,6600,290,4.6,6250,6620,1400-8-24,2021-11-15
141,فلامي,لاميران‌,1216,2491691,53555289690,21340,22050,20290,-1050,-4.92,21490,150,0.7,20280,22400,1400-8-24,2021-11-15
142,ثاخت,بين‌المللي‌توسعه‌ساختمان,1203,25820959,51369477217,2070,2080,1968,-102,-4.93,1989,-81,-3.91,1967,2085,1400-8-24,2021-11-15
143,اطلس,صندوق س.توسعه اندوخته آينده-س,1201,484063,123131714403,254090,254999,249997,-4093,-1.61,254371,281,0.11,248452,257000,1400-8-24,2021-11-15
144,سپر,صندوق س سپر سرمايه بيدار- ثابت,1200,52689664,692569862369,13143,13150,13151,8,0.06,13144,1,0.01,13143,13153,1400-8-24,2021-11-15
145,شغدير,پتروشيمي غدير,1200,1182951,113981748550,97700,98000,95120,-2580,-2.64,96350,-1350,-1.38,95000,98000,1400-8-24,2021-11-15
146,ومعادن,توسعه‌معادن‌وفلزات‌,1189,7533615,77639545020,10600,10600,10200,-400,-3.77,10400,-200,-1.89,10190,10700,1400-8-24,2021-11-15
147,رانفور,خدمات‌انفورماتيك‌,1182,20777693,87997714561,4429,4340,4234,-195,-4.4,4235,-194,-4.38,4208,4450,1400-8-24,2021-11-15
148,اخابر,مخابرات ايران,1175,15524789,118694916270,7990,7760,7600,-390,-4.88,7650,-340,-4.26,7600,7930,1400-8-24,2021-11-15
149,كبافق,معادن‌ بافق‌,1174,1889638,62656561760,31790,31500,33370,1580,4.97,33160,1370,4.31,31000,33370,1400-8-24,2021-11-15
150,پاكشو,گروه صنعتي پاكشو,1172,27827935,159062867150,5470,5570,5740,270,4.94,5720,250,4.57,5570,5740,1400-8-24,2021-11-15
151,بپاس,بيمه پاسارگاد,1170,11341164,515346438876,45464,45945,44550,-914,-2.01,45440,-24,-0.05,44103,45945,1400-8-24,2021-11-15
152,حشكوه,دليجان طلايي شكوه پارس,1159,44685819,158833211999,3464,3567,3555,91,2.63,3554,90,2.6,3395,3567,1400-8-24,2021-11-15
153,رمپنا,گروه مپنا (سهامي عام),1158,13259227,219515331920,17370,17500,16510,-860,-4.95,16560,-810,-4.66,16510,17690,1400-8-24,2021-11-15
154,اپال,فرآوري معدني اپال كاني پارس,1139,1959365,42280804800,21740,21740,21550,-190,-0.87,21680,-60,-0.28,21500,21780,1400-8-24,2021-11-15
155,ثنام,س ساختماني ب نام آوران مهندسي,1138,8273184,94691113551,11116,11448,11449,333,3,11446,330,2.97,11270,11449,1400-8-24,2021-11-15
156,كرماشا,صنايع پتروشيمي كرمانشاه,1138,1015998,54857390680,54950,54950,53180,-1770,-3.22,54260,-690,-1.26,53030,54970,1400-8-24,2021-11-15
157,ثنوسا,نوسازي‌وساختمان‌تهران‌,1137,15836014,88573288790,5860,5870,5570,-290,-4.95,5590,-270,-4.61,5570,5930,1400-8-24,2021-11-15
158,حفارس,حمل و نقل بين المللي خليج فارس,1121,16224369,67029211919,4127,3962,4020,-107,-2.59,4131,4,0.1,3962,4290,1400-8-24,2021-11-15
159,فاسمين,كالسيمين‌,1120,4420380,72602143200,17020,16830,16240,-780,-4.58,16420,-600,-3.53,16180,17180,1400-8-24,2021-11-15
160,ثعتما,س. ساختماني اعتماد گستر,1112,4211786,141129971696,33439,34442,32436,-1003,-3,33508,69,0.21,32436,34442,1400-8-24,2021-11-15
161,ونوين,بانك‌اقتصادنوين‌,1110,18206368,59763539045,3400,3331,3231,-169,-4.97,3283,-117,-3.44,3230,3447,1400-8-24,2021-11-15
162,سپيدما,صندوق س. سپيد دماوند-د,1110,56209428,639335443471,11368,11374,11374,6,0.05,11374,6,0.05,11374,11379,1400-8-24,2021-11-15
163,فاراك,ماشين‌ سازي‌ اراك‌,1106,30213334,50485681721,1742,1750,1655,-87,-4.99,1671,-71,-4.08,1655,1750,1400-8-24,2021-11-15
164,خراسان,پتروشيمي خراسان,1102,872350,110852684080,132610,131950,125980,-6630,-5,127070,-5540,-4.18,125980,131950,1400-8-24,2021-11-15
165,زكشت,كشاورزي مكانيزه اصفهان كشت,1101,3713569,89310677072,23028,23082,24177,1149,4.99,24050,1022,4.44,23082,24179,1400-8-24,2021-11-15
166,خمحركه,نيرو محركه‌,1097,16289014,57805395287,3699,3700,3515,-184,-4.97,3549,-150,-4.06,3515,3760,1400-8-24,2021-11-15
167,شجم,صنايع پتروشيمي تخت جمشيد,1096,11946328,165830736184,14469,14460,13950,-519,-3.59,13881,-588,-4.06,13746,14869,1400-8-24,2021-11-15
168,ضجار1023,اختيارخ وتجارت-2500-1400/10/15,1084,42614,3189056000,102,96,74,-28,-27.45,75,-27,-26.47,68,99,1400-8-24,2021-11-15
169,غدام,خوراك‌  دام‌ پارس‌,1083,724649,99306088370,132480,135010,139100,6620,5,137040,4560,3.44,126870,139100,1400-8-24,2021-11-15
170,كرازي,كارخانجات‌توليدي‌شيشه‌رازي‌,1070,31938658,40630520300,1310,1315,1259,-51,-3.89,1272,-38,-2.9,1245,1339,1400-8-24,2021-11-15
171,قشرين,قند شيرين خراسان,1054,15537850,127228778729,8111,7871,8354,243,3,8188,77,0.95,7868,8354,1400-8-24,2021-11-15
172,غاذر,كشت‌وصنعت‌پياذر,1047,3358662,108849892140,30980,32000,32520,1540,4.97,32410,1430,4.62,31400,32520,1400-8-24,2021-11-15
173,خكار,ايركا پارت صنعت,1042,9957286,44285916563,4638,4520,4407,-231,-4.98,4448,-190,-4.1,4407,4690,1400-8-24,2021-11-15
174,بساما,بيمه سامان,1039,3102060,69640721170,21585,22664,22070,485,2.25,22450,865,4.01,21250,22664,1400-8-24,2021-11-15
175,فجر,فولاد اميركبيركاشان,1036,2105053,51587632100,25370,25050,24290,-1080,-4.26,24510,-860,-3.39,24170,25500,1400-8-24,2021-11-15
176,توريل,توكاريل,1016,7250627,81159474736,10733,10732,11269,536,4.99,11193,460,4.29,10530,11269,1400-8-24,2021-11-15
177,اتكاي,بيمه اتكايي ايرانيان,1008,13004631,153789092622,12044,12050,11870,-174,-1.44,11826,-218,-1.81,11715,12050,1400-8-24,2021-11-15
178,وساپا,سرمايه‌گذاري‌ سايپا,1004,11250127,53629216529,4924,4960,4690,-234,-4.75,4767,-157,-3.19,4678,4989,1400-8-24,2021-11-15
179,تاپيكو,س. نفت و گاز و پتروشيمي تأمين,992,7869448,112929513640,14760,14760,14260,-500,-3.39,14360,-400,-2.71,14100,14760,1400-8-24,2021-11-15
180,شپترو,پتروشيمي آبادان,990,13902427,49576782858,3657,3630,3548,-109,-2.98,3566,-91,-2.49,3548,3690,1400-8-24,2021-11-15
181,خمهر,مهركام‌پارس‌,985,33596664,62222670647,1931,1930,1835,-96,-4.97,1852,-79,-4.09,1835,1970,1400-8-24,2021-11-15
182,ارفع,شركت آهن و فولاد ارفع,982,3357164,52684784173,15455,15760,15800,345,2.23,15622,167,1.08,15310,16150,1400-8-24,2021-11-15
183,شيران,س. صنايع‌شيميايي‌ايران,977,2141151,48470229730,23620,23070,22500,-1120,-4.74,23070,-550,-2.33,22440,23500,1400-8-24,2021-11-15
184,هرمز,فولاد هرمزگان جنوب,974,2889800,49220862452,17517,17460,16899,-618,-3.53,17310,-207,-1.18,16802,17460,1400-8-24,2021-11-15
185,دتوزيع,توزيع دارو پخش,973,3239450,91912799657,29671,28998,28190,-1481,-4.99,28373,-1298,-4.37,28188,29670,1400-8-24,2021-11-15
186,تكشا,گسترش‌صنايع‌وخدمات‌كشاورزي‌,973,1567841,59217486170,37150,38890,36490,-660,-1.78,37770,620,1.67,35800,38890,1400-8-24,2021-11-15
187,تبرك,گروه كارخانجات صنعتي تبرك,963,5118234,47004998505,9025,8950,9309,284,3.15,9184,159,1.76,8950,9409,1400-8-24,2021-11-15
188,ونيرو,سرمايه‌گذاري‌نيرو,958,12919642,29722677241,2314,2335,2245,-69,-2.98,2301,-13,-0.56,2240,2358,1400-8-24,2021-11-15
189,دماوند,توليد نيروي برق دماوند,952,1748946,36991692073,21852,21860,20760,-1092,-5,21297,-555,-2.54,20760,21990,1400-8-24,2021-11-15
190,كلر,كلر پارس,937,571739,59461987113,108847,107998,103405,-5442,-5,104002,-4845,-4.45,103405,109900,1400-8-24,2021-11-15
191,خفنر,فنرسازي‌خاور,934,4535390,38690207380,8810,8700,8480,-330,-3.75,8530,-280,-3.18,8370,9000,1400-8-24,2021-11-15
192,زيتون,صندوق س زيتون نماد پايا- مختلط,927,3435918,34391586850,10055,10050,10000,-55,-0.55,10009,-46,-0.46,10000,10050,1400-8-24,2021-11-15
193,اميد,تامين سرمايه اميد,916,18607055,138852201560,7540,7670,7180,-360,-4.77,7460,-80,-1.06,7170,7750,1400-8-24,2021-11-15
194,سبزوا,سيمان لار سبزوار,906,14287237,31523924373,2302,2301,2187,-115,-5,2206,-96,-4.17,2187,2335,1400-8-24,2021-11-15
195,دلر,داروسازي‌ اكسير,903,2561033,110247430580,45140,43500,42900,-2240,-4.96,43050,-2090,-4.63,42890,43980,1400-8-24,2021-11-15
196,بجهرم,توسعه مولد نيروگاهي جهرم,899,15695526,33383148846,2173,2140,2100,-73,-3.36,2127,-46,-2.12,2080,2170,1400-8-24,2021-11-15
197,سبهان,سيمان‌ بهبهان‌,896,1582682,86600416870,52400,54660,55020,2620,5,54720,2320,4.43,52700,55020,1400-8-24,2021-11-15
198,كگل,معدني و صنعتي گل گهر,896,8685648,208756897240,24180,24000,24000,-180,-0.74,24030,-150,-0.62,23750,24230,1400-8-24,2021-11-15
199,فسپا,گروه‌صنعتي‌سپاهان‌,890,3321102,56738487670,17520,17340,16940,-580,-3.31,17080,-440,-2.51,16750,17770,1400-8-24,2021-11-15
200,وكار,بانك‌ كارآفرين‌,890,16979772,52952670818,3084,3120,3095,11,0.36,3119,35,1.13,3085,3149,1400-8-24,2021-11-15
201,افران,صندوق س افرا نماد پايدار-ثابت,885,15183107,223838655699,14733,14743,14743,10,0.07,14743,10,0.07,14741,14744,1400-8-24,2021-11-15
202,غپينو,پارس‌ مينو,880,10054365,34061224543,3540,3490,3363,-177,-5,3388,-152,-4.29,3363,3490,1400-8-24,2021-11-15
203,غشهداب,كشت و صنعت شهداب ناب خراسان,879,17374981,47795098751,2874,2760,2731,-143,-4.98,2751,-123,-4.28,2731,2848,1400-8-24,2021-11-15
204,كفرآور,فرآورده هاي سيمان شرق,872,4277695,81012310395,19267,18800,18690,-577,-2.99,18938,-329,-1.71,18689,19844,1400-8-24,2021-11-15
205,پتاير,ايران‌ تاير,869,17254943,35963564039,2185,2150,2076,-109,-4.99,2084,-101,-4.62,2076,2151,1400-8-24,2021-11-15
206,اوان,مبين وان كيش,869,3033253,70023734773,22732,22589,23868,1136,5,23085,353,1.55,21596,23868,1400-8-24,2021-11-15
207,زكوثر,سرمايه گذاري كشاورزي كوثر,862,2107129,36147188610,17850,17270,17100,-750,-4.2,17150,-700,-3.92,16960,17850,1400-8-24,2021-11-15
208,وسكرشا,س.سهام عدالت استان كرمانشاه,861,71000162,35612950718,527,510,501,-26,-4.93,502,-25,-4.74,501,518,1400-8-24,2021-11-15
209,چدن,توليدي چدن سازان,861,10527568,29451942117,2895,2850,2751,-144,-4.97,2798,-97,-3.35,2751,2900,1400-8-24,2021-11-15
210,شفارس,صنايع‌ شيميايي‌ فارس‌,852,21879133,26284319765,1259,1238,1197,-62,-4.92,1201,-58,-4.61,1197,1270,1400-8-24,2021-11-15
211,وايران,ليزينگ ايرانيان,850,10666804,43386667258,4262,4130,4049,-213,-5,4067,-195,-4.58,4049,4300,1400-8-24,2021-11-15
212,غصينو,صنعتي مينو,843,3554072,83080745668,22511,23010,23620,1109,4.93,23280,769,3.42,22962,23636,1400-8-24,2021-11-15
213,خموتور,موتورسازان‌تراكتورسازي‌ايران‌,834,5339087,34439066080,6710,6800,6380,-330,-4.92,6450,-260,-3.87,6380,6800,1400-8-24,2021-11-15
214,ثتران,سرمايه گذاري مسكن تهران,826,10887889,43255281259,4146,4100,3939,-207,-4.99,3973,-173,-4.17,3939,4180,1400-8-24,2021-11-15
215,تسه0004,امتيازتسهيلات مسكن تير1400,821,40769,32882182743,802788,805000,766001,-36787,-4.58,806549,3761,0.47,766000,813755,1400-8-24,2021-11-15
216,بشهاب,لامپ‌  پارس‌ شهاب‌,801,374357,50121833400,134030,138500,134000,-30,-0.02,133890,-140,-0.1,130000,138500,1400-8-24,2021-11-15
217,خلنت,لنت‌ ترمزايران‌,789,469139,37048546560,81770,81760,77690,-4080,-4.99,78970,-2800,-3.42,77690,81760,1400-8-24,2021-11-15
218,كگاز,شيشه‌ و گاز,782,4826013,81413881890,16100,16680,16900,800,4.97,16870,770,4.78,16250,16900,1400-8-24,2021-11-15
219,هماي,صندوق س هماي آگاه-ثابت,780,10956228,111053662275,10135,10141,10136,1,0.01,10136,1,0.01,10130,10141,1400-8-24,2021-11-15
220,غشصفا,شيرپاستوريزه‌پگاه‌اصفهان‌,779,2695854,96041907990,34240,33210,35950,1710,4.99,35630,1390,4.06,33210,35950,1400-8-24,2021-11-15
221,حسير,ريل سير كوثر,778,2367644,86506457667,38014,38000,36880,-1134,-2.98,36537,-1477,-3.89,36114,38899,1400-8-24,2021-11-15
222,تاصيكو,سرمايه گذاري صدرتامين,776,8004548,73293610340,9280,9110,9090,-190,-2.05,9200,-80,-0.86,8920,9400,1400-8-24,2021-11-15
223,ودي,بيمه  دي,767,5367773,28933167736,5508,5536,5428,-80,-1.45,5390,-118,-2.14,5294,5590,1400-8-24,2021-11-15
224,شلعاب,لعابيران‌,760,4604849,27046348700,5910,5900,5830,-80,-1.35,5870,-40,-0.68,5760,6060,1400-8-24,2021-11-15
225,خپويش,سازه‌ پويش‌,752,499182,42258053230,81880,82530,84000,2120,2.59,84650,2770,3.38,82530,85970,1400-8-24,2021-11-15
226,بسويچ,پارس‌سويچ‌,749,2373009,43198879330,17350,18100,18210,860,4.96,18200,850,4.9,18100,18210,1400-8-24,2021-11-15
227,كگهر,سنگ آهن گهرزمين,742,1700718,82017829952,48435,47950,48495,60,0.12,48291,-144,-0.3,46428,49999,1400-8-24,2021-11-15
228,مفاخر,توسعه فناوري اطلاعات خوارزمي,741,644220,18014090977,26938,28279,28284,1346,5,27963,1025,3.81,27200,28284,1400-8-24,2021-11-15
229,تملت,تامين سرمايه بانك ملت,741,4728795,17059168659,3742,3810,3600,-142,-3.79,3608,-134,-3.58,3555,3810,1400-8-24,2021-11-15
230,تسه0005,امتيازتسهيلات مسكن مرداد 1400,739,14783,11789706161,804970,815000,800000,-4970,-0.62,797518,-7452,-0.93,773000,819999,1400-8-24,2021-11-15
231,دلقما,دارويي‌ لقمان‌,736,1746297,44432913860,25250,25000,25930,680,2.69,25440,190,0.75,24400,26350,1400-8-24,2021-11-15
232,غبشهر,صنعتي‌ بهشهر,730,2842467,69581452390,25640,25600,24360,-1280,-4.99,24480,-1160,-4.52,24360,25600,1400-8-24,2021-11-15
233,ورنا,سرمايه‌گذاري‌ رنا(هلدينگ‌,728,8682062,28633610963,3348,3399,3225,-123,-3.67,3298,-50,-1.49,3200,3423,1400-8-24,2021-11-15
234,آريان,سرمايه گذاري پارس آريان,724,13692513,248943140509,18198,18100,18220,22,0.12,18181,-17,-0.09,17840,18570,1400-8-24,2021-11-15
235,سرچشمه,سرمايه گذاري مس سرچشمه,719,6409986,38584289814,5973,6220,5976,3,0.05,6019,46,0.77,5850,6220,1400-8-24,2021-11-15
236,وبانك,سرمايه گذاري گروه توسعه ملي,717,6210346,52762783760,8700,8560,8450,-250,-2.87,8580,-120,-1.38,8430,8830,1400-8-24,2021-11-15
237,آپ,آسان پرداخت پرشين,709,10144756,106503516960,10010,10160,10510,500,5,10500,490,4.9,10100,10510,1400-8-24,2021-11-15
238,حتوكا,حمل‌ونقل‌توكا,707,3824967,51970796010,13040,13070,13690,650,4.98,13590,550,4.22,13000,13690,1400-8-24,2021-11-15
239,وساغربي,شركت س استان آذربايجان غربي,706,56312951,27275996897,505,510,480,-25,-4.95,487,-18,-3.56,480,511,1400-8-24,2021-11-15
240,ثرود,سرمايه‌گذاري مسكن زاينده رود,705,2783039,21251090461,7667,7500,7414,-253,-3.3,7636,-31,-0.4,7400,7998,1400-8-24,2021-11-15
241,فروس,فروسيليس‌ ايران‌,703,6739590,46256232120,6990,6910,6800,-190,-2.72,6860,-130,-1.86,6710,7030,1400-8-24,2021-11-15
242,ديران,ايران‌دارو,702,1716173,36757332920,22370,21690,21260,-1110,-4.96,21420,-950,-4.25,21260,22360,1400-8-24,2021-11-15
243,خموتورح,ح . موتورسازان‌تراكتورسازي‌,700,4993281,23652619210,5010,5010,4630,-380,-7.58,4740,-270,-5.39,4600,5160,1400-8-24,2021-11-15
244,شفارا,پتروشيمي فارابي,694,5941577,55037014299,9342,9554,9068,-274,-2.93,9263,-79,-0.85,9062,9590,1400-8-24,2021-11-15
245,ولساپا,ليزينگ رايان‌ سايپا,693,11318306,30363898591,2753,2700,2640,-113,-4.1,2683,-70,-2.54,2638,2800,1400-8-24,2021-11-15
246,وساشرقي,شركت س استان آذربايجان شرقي,692,44224529,21635037913,477,500,482,5,1.05,484,7,1.47,470,500,1400-8-24,2021-11-15
247,غمينو,شركت صنايع غذايي مينو شرق,691,5085914,24279222327,4945,5000,4698,-247,-4.99,4774,-171,-3.46,4698,5000,1400-8-24,2021-11-15
248,ثغرب,شركت سرمايه گذاري مسكن شمالغرب,690,7430363,32814354926,4238,4440,4436,198,4.67,4416,178,4.2,4230,4449,1400-8-24,2021-11-15
249,فنورد,نوردوقطعات‌ فولادي‌,690,249682,53507144640,214740,225400,208100,-6640,-3.09,214300,-440,-0.2,207010,225400,1400-8-24,2021-11-15
250,وپست,پست بانك ايران,688,3068714,61753805680,20920,21250,19880,-1040,-4.97,20120,-800,-3.82,19880,21250,1400-8-24,2021-11-15
251,وسكرد,شركت س استان كردستان,687,51191383,25295220185,516,502,491,-25,-4.84,494,-22,-4.26,491,510,1400-8-24,2021-11-15
252,سفارس,سيمان فارس و خوزستان,685,3315271,57591538630,17920,17710,17700,-220,-1.23,17370,-550,-3.07,17080,17800,1400-8-24,2021-11-15
253,ثاباد,توريستي ورفاهي آبادگران ايران,685,1255966,57113724700,43540,45710,45710,2170,4.98,45470,1930,4.43,44400,45710,1400-8-24,2021-11-15
254,حآفرين,ريل پرداز نو آفرين,684,9400824,56537765312,6228,6254,5917,-311,-4.99,6014,-214,-3.44,5917,6399,1400-8-24,2021-11-15
255,دشيمي,شيمي‌ داروئي‌ داروپخش‌,684,2095940,52259666670,25960,25220,24670,-1290,-4.97,24930,-1030,-3.97,24670,25940,1400-8-24,2021-11-15
256,تليسه,دامداري تليسه نمونه,681,8224531,19222441444,2435,2360,2334,-101,-4.15,2337,-98,-4.02,2314,2460,1400-8-24,2021-11-15
257,ساوه,سيمان ساوه,679,353963,16297776496,47686,46710,46580,-1106,-2.32,46044,-1642,-3.44,45302,47600,1400-8-24,2021-11-15
258,دانا,بيمه دانا,675,7668429,32962589717,4464,4483,4247,-217,-4.86,4298,-166,-3.72,4241,4483,1400-8-24,2021-11-15
259,بموتو,موتوژن‌,670,1976193,138149501540,69900,72000,72140,2240,3.2,69910,10,0.01,67580,72140,1400-8-24,2021-11-15
260,فولاي,صنايع فولاد آلياژي يزد,666,1857811,31935545234,17767,17500,17299,-468,-2.63,17190,-577,-3.25,16879,18258,1400-8-24,2021-11-15
261,خرينگ,رينگ‌سازي‌مشهد,665,2473699,68011653320,28850,28350,28190,-660,-2.29,27490,-1360,-4.71,27410,28410,1400-8-24,2021-11-15
262,قصفها,قنداصفهان‌,658,657383,54437500110,86910,85240,82570,-4340,-4.99,82810,-4100,-4.72,82570,86890,1400-8-24,2021-11-15
263,فلوله,لوله‌وماشين‌سازي‌ايران‌,656,19814178,21415326972,1087,1100,1078,-9,-0.83,1081,-6,-0.55,1055,1114,1400-8-24,2021-11-15
264,شيراز,پتروشيمي‌شيراز,653,1083406,94985423660,91630,93190,87050,-4580,-5,87970,-3660,-3.99,87050,93190,1400-8-24,2021-11-15
265,كپشير,پشم‌شيشه‌ايران‌,649,2539595,31401718520,12930,12790,12290,-640,-4.95,12360,-570,-4.41,12290,12860,1400-8-24,2021-11-15
266,وسين,بيمه سينا,644,7909109,27925525852,3554,3490,3600,46,1.29,3531,-23,-0.65,3448,3610,1400-8-24,2021-11-15
267,دسانكو,داروسازي سبحان انكولوژي,643,3691397,44345657433,12599,12260,11970,-629,-4.99,12013,-586,-4.65,11970,12400,1400-8-24,2021-11-15
268,خمحور,توليدمحورخودرو,639,16753635,45686438084,2616,2746,2746,130,4.97,2727,111,4.24,2610,2746,1400-8-24,2021-11-15
269,ستران,سيمان‌ تهران‌,637,2288817,46310666000,21250,21200,20190,-1060,-4.99,20230,-1020,-4.8,20190,21240,1400-8-24,2021-11-15
270,وسگيلا,شركت س استان گيلان,635,63624980,31172035166,514,500,489,-25,-4.86,490,-24,-4.67,489,510,1400-8-24,2021-11-15
271,اتكام,بيمه اتكايي امين,633,12517410,49922653169,3802,3992,3992,190,5,3988,186,4.89,3922,3992,1400-8-24,2021-11-15
272,فزرين,زرين معدن آسيا,631,2325597,31786778147,13954,14280,13600,-354,-2.54,13668,-286,-2.05,13460,14280,1400-8-24,2021-11-15
273,ونيكي,سرمايه‌گذاري‌ ملي‌ايران‌,627,2366505,24059554850,10470,10470,10160,-310,-2.96,10370,-100,-0.96,10020,10470,1400-8-24,2021-11-15
274,خبازرس,بازرسي مهندسي و صنعتي ايران,625,1196042,30155975374,24299,25513,24720,421,1.73,25213,914,3.76,24601,25513,1400-8-24,2021-11-15
275,افق,فروشگاههاي زنجيره اي افق كوروش,625,2771071,127203829830,46060,46100,45130,-930,-2.02,45900,-160,-0.35,45000,46460,1400-8-24,2021-11-15
276,ارزش,صندوق س ارزش آفرين بيدار-سهام,614,4596163,44339078220,10020,9950,9530,-490,-4.89,9650,-370,-3.69,9500,9950,1400-8-24,2021-11-15
277,غالبر,لبنيات‌ كالبر,613,2490013,29200630110,11680,11340,12050,370,3.17,11730,50,0.43,11200,12100,1400-8-24,2021-11-15
278,فپنتا,سپنتا,612,102745,46343785630,467690,455140,458420,-9270,-1.98,451060,-16630,-3.56,444310,466850,1400-8-24,2021-11-15
279,همراه,شركت ارتباطات سيار ايران,609,5050534,41530481790,8520,8370,8170,-350,-4.11,8410,-110,-1.29,8120,8440,1400-8-24,2021-11-15
280,غپآذر,شير پگاه آذربايجان شرقي,608,1427314,46715418334,32112,31225,33450,1338,4.17,32730,618,1.92,31225,33450,1400-8-24,2021-11-15
281,كيميا,معدني كيمياي زنجان گستران,597,2554278,35584437673,13988,14200,13949,-39,-0.28,13931,-57,-0.41,13700,14300,1400-8-24,2021-11-15
282,چكارن,كارتن‌ ايران‌,596,8028586,22100150601,2803,2820,2725,-78,-2.78,2753,-50,-1.78,2690,2850,1400-8-24,2021-11-15
283,خاهن,آهنگري‌ تراكتورسازي‌ ايران‌,592,4390983,22763898010,5230,5260,5170,-60,-1.15,5200,-30,-0.57,5050,5280,1400-8-24,2021-11-15
284,مدير,ص.س.مديريت ثروت ص.بازنشستگي-س,590,3098834,31148103613,10258,10160,9978,-280,-2.73,10052,-206,-2.01,9911,10191,1400-8-24,2021-11-15
285,سفاسي,شركت فارسيت اهواز,587,5611418,21022327996,3857,3897,3742,-115,-2.98,3746,-111,-2.88,3742,3897,1400-8-24,2021-11-15
286,وثخوز,سرمايه گذاري و توسعه خوزستان,583,1080041,33937354137,30144,29510,31651,1507,5,31422,1278,4.24,29510,31651,1400-8-24,2021-11-15
287,وشهر,بانك شهر,581,10158827,48400867850,4929,4921,4732,-197,-4,4764,-165,-3.35,4732,4921,1400-8-24,2021-11-15
288,زماهان,مجتمع توليد گوشت مرغ ماهان,579,3566469,24857936793,7277,6976,6914,-363,-4.99,6970,-307,-4.22,6914,7180,1400-8-24,2021-11-15
289,تسه0003,امتيازتسهيلات مسكن خرداد1400,574,15075,12091599495,806283,820000,801000,-5283,-0.66,802096,-4187,-0.52,766000,820000,1400-8-24,2021-11-15
290,شكربن,كربن‌ ايران‌,572,586464,59287944640,99980,99990,100010,30,0.03,101090,1110,1.11,99460,103000,1400-8-24,2021-11-15
291,زقيام,كشت و دام قيام اصفهان,571,8803299,14312180510,1692,1681,1608,-84,-4.96,1626,-66,-3.9,1608,1682,1400-8-24,2021-11-15
292,كلوند,كاشي‌ الوند,569,1123011,26437118570,23660,23850,23080,-580,-2.45,23540,-120,-0.51,22900,24200,1400-8-24,2021-11-15
293,ساروم,سيمان‌اروميه‌,569,1403446,54548685300,38500,38500,39600,1100,2.86,38870,370,0.96,37660,39900,1400-8-24,2021-11-15
294,قرن,پديده شيمي قرن,568,441451,10673248570,25080,24150,23990,-1090,-4.35,24580,-500,-1.99,23850,25000,1400-8-24,2021-11-15
295,آساميد,صندوق س.مشترك آسمان اميد -د,565,21518511,288709058398,13409,13415,13412,3,0.02,13417,8,0.06,13411,13419,1400-8-24,2021-11-15
296,فرآور,فرآوري‌موادمعدني‌ايران‌,565,823245,23431451590,28610,29390,28100,-510,-1.78,28460,-150,-0.52,27900,29390,1400-8-24,2021-11-15
297,آسيا,بيمه آسيا,563,10959306,19023756722,1776,1795,1720,-56,-3.15,1736,-40,-2.25,1707,1796,1400-8-24,2021-11-15
298,بكام,كارخانجات توليدي شهيد قندي,560,8757355,16313459607,1914,1883,1835,-79,-4.13,1863,-51,-2.66,1830,1920,1400-8-24,2021-11-15
299,تسه0001,امتيازتسهيلات مسكن فروردين1400,558,13329,10659740597,806146,820000,780500,-25646,-3.18,799740,-6406,-0.79,770000,820000,1400-8-24,2021-11-15
300,دتوليد,داروسازي توليد دارو,558,2035940,19544109122,9987,9813,9488,-499,-5,9600,-387,-3.88,9488,10099,1400-8-24,2021-11-15
301,شنفت,نفت‌ پارس‌,557,3699857,33194100630,9030,9090,9100,70,0.78,9000,-30,-0.33,8820,9180,1400-8-24,2021-11-15
302,تسه0002,امتيازتسهيلاتمسكن ارديبهشت1400,555,15855,12682256213,805912,815000,778000,-27912,-3.46,799890,-6022,-0.75,770009,820000,1400-8-24,2021-11-15
303,فباهنر,مس‌ شهيدباهنر,555,719641,18037501180,25780,25950,24890,-890,-3.45,25290,-490,-1.9,24780,25950,1400-8-24,2021-11-15
304,سفانو,سيمان فارس نو,554,1433494,39494352860,27000,27300,26610,-390,-1.44,27550,550,2.04,26300,28350,1400-8-24,2021-11-15
305,كهمدا,شيشه‌ همدان‌,550,3655089,32091445310,9110,8900,8670,-440,-4.83,8780,-330,-3.62,8660,9180,1400-8-24,2021-11-15
306,وآوا,سرمايه گذاري آوا نوين,545,3837833,12322000104,3310,3291,3190,-120,-3.63,3230,-80,-2.42,3154,3309,1400-8-24,2021-11-15
307,فجام,جام‌دارو,544,6568060,31902035950,4930,4950,4890,-40,-0.81,4860,-70,-1.42,4700,4950,1400-8-24,2021-11-15
308,فافق,صنايع مس افق كرمان,541,6269557,25224050942,4127,4127,4004,-123,-2.98,4023,-104,-2.52,4004,4168,1400-8-24,2021-11-15
309,وپاسار,بانك  پاسارگاد,541,11091619,148427390220,13470,13470,13280,-190,-1.41,13380,-90,-0.67,12960,13490,1400-8-24,2021-11-15
310,پارسان,گسترش نفت و گاز پارسيان,536,2178817,72643091500,34150,34150,33200,-950,-2.78,33640,-510,-1.49,33000,34900,1400-8-24,2021-11-15
311,قاسم,قاسم ايران,536,5947935,21375017986,3758,3700,3571,-187,-4.98,3594,-164,-4.36,3571,3718,1400-8-24,2021-11-15
312,گكوثر,هتل پارسيان كوثر اصفهان,533,11989753,25926260560,2235,2249,2124,-111,-4.97,2162,-73,-3.27,2124,2258,1400-8-24,2021-11-15
313,تسه9908,امتياز تسهيلات مسكن آبان99,526,12372,9792741104,804103,815050,790000,-14103,-1.75,791524,-12579,-1.56,765100,815050,1400-8-24,2021-11-15
314,آ س پ,آ.س.پ,525,3991197,27206894058,7077,6802,6724,-353,-4.99,6817,-260,-3.67,6724,7090,1400-8-24,2021-11-15
315,غگرجي,بيسكويت‌  گرجي‌,522,7663957,17828494814,2431,2399,2310,-121,-4.98,2326,-105,-4.32,2310,2410,1400-8-24,2021-11-15
316,مرقام,ايران‌ارقام‌,521,3346918,40021739580,12460,12390,11840,-620,-4.98,11960,-500,-4.01,11840,12650,1400-8-24,2021-11-15
317,خكرمان,گروه اقتصادي كرمان خودرو,518,10007537,27128527762,2767,2810,2685,-82,-2.96,2711,-56,-2.02,2684,2810,1400-8-24,2021-11-15
318,خكاوه,سايپا ديزل,515,7144990,27194970127,3902,3816,3785,-117,-3,3806,-96,-2.46,3785,3928,1400-8-24,2021-11-15
319,كساوه,صنايع‌ كاشي‌ و سراميك‌ سينا,511,1771597,77610032260,41820,42790,43910,2090,5,43810,1990,4.76,42100,43910,1400-8-24,2021-11-15
320,وسبحان,سرمايه گذاري سبحان,509,16988699,47088624612,2901,2930,2815,-86,-2.96,2772,-129,-4.45,2756,2930,1400-8-24,2021-11-15
321,وسكاب,س.ص.بازنشستگي كاركنان بانكها,508,6382786,20118659552,3250,3214,3189,-61,-1.88,3152,-98,-3.02,3120,3288,1400-8-24,2021-11-15
322,وپسا,س. پتروشيمي ساختمان  خليج فارس,506,8183766,15045990869,1884,1916,1828,-56,-2.97,1839,-45,-2.39,1828,1919,1400-8-24,2021-11-15
323,ياقوت,صندوق س ياقوت آگاه-ثابت,506,3040145,41300262673,13568,13585,13589,21,0.15,13585,17,0.13,13570,13595,1400-8-24,2021-11-15
324,شكام,صنايع شيميايي كيمياگران امروز,505,3584393,111020900008,29559,28800,31036,1477,5,30973,1414,4.78,28800,31036,1400-8-24,2021-11-15
325,كاذر,فرآورده‌هاي‌نسوزآذر,504,2394703,35241923380,15170,15180,14430,-740,-4.88,14720,-450,-2.97,14420,15200,1400-8-24,2021-11-15
326,البرز,بيمه البرز,501,10676470,22448687742,2149,2128,2098,-51,-2.37,2106,-43,-2,2080,2174,1400-8-24,2021-11-15
327,فايرا,آلومينيوم‌ايران‌,500,1481386,24958182700,17190,17020,16810,-380,-2.21,17060,-130,-0.76,16780,17390,1400-8-24,2021-11-15
328,نوين,بيمه نوين,497,6680431,27101641724,4199,4298,4060,-139,-3.31,4057,-142,-3.38,3990,4298,1400-8-24,2021-11-15
329,تپمپي,پمپ‌ سازي‌ ايران‌,496,2440020,38462686380,16200,16240,15800,-400,-2.47,15760,-440,-2.72,15470,16350,1400-8-24,2021-11-15
330,ساربيل,سيمان آرتا اردبيل,493,732757,19707633690,26280,25560,27590,1310,4.98,26900,620,2.36,25540,27590,1400-8-24,2021-11-15
331,فنفت,صنايع تجهيزات نفت,492,1474768,19552860297,13596,13189,13189,-407,-2.99,13258,-338,-2.49,13189,13757,1400-8-24,2021-11-15
332,بكهنوج,توليد برق ماهتاب كهنوج,490,12044528,14198857523,1215,1234,1158,-57,-4.69,1179,-36,-2.96,1155,1234,1400-8-24,2021-11-15
333,فسازان,غلتك سازان سپاهان,489,1651082,39259943150,24870,24190,23630,-1240,-4.99,23780,-1090,-4.38,23630,24900,1400-8-24,2021-11-15
334,پارس,پتروشيمي پارس,488,158743,30070807230,191980,193000,190600,-1380,-0.72,191210,-770,-0.4,187810,193990,1400-8-24,2021-11-15
335,سقاين,سيمان‌ قائن‌,487,276840,13420940440,47910,45950,49390,1480,3.09,48420,510,1.06,45950,49630,1400-8-24,2021-11-15
336,شكلر,نيروكلر,482,1123172,34182992500,31820,31800,30230,-1590,-5,30430,-1390,-4.37,30230,31800,1400-8-24,2021-11-15
337,سكارون,سيمان كارون,482,353338,19306435889,56003,55200,54323,-1680,-3,54640,-1363,-2.43,54323,57000,1400-8-24,2021-11-15
338,شبهرن,نفت‌ بهران‌,482,2537946,30499636990,12280,12280,11990,-290,-2.36,12140,-140,-1.14,11960,12280,1400-8-24,2021-11-15
339,زفكا,كشت و دامداري فكا,478,3259385,24980976348,7926,7920,7900,-26,-0.33,7664,-262,-3.31,7530,7920,1400-8-24,2021-11-15
340,سخاش,سيمان‌خاش‌,476,259793,24354943210,90390,90500,94900,4510,4.99,93750,3360,3.72,90500,94900,1400-8-24,2021-11-15
341,لازما,كارخانه هاي صنعتي آزمايش,476,1091168,32287360174,29041,29000,29900,859,2.96,29590,549,1.89,28202,29911,1400-8-24,2021-11-15
342,بالاس,مهندسي ساختمان تاسيسات راه آهن,471,751932,22422301215,31347,31000,29780,-1567,-5,29820,-1527,-4.87,29780,31000,1400-8-24,2021-11-15
343,حپارسا,توسعه حمل و نقل ريلي پارسيان,467,818602,31825063365,38556,38170,39000,444,1.15,38877,321,0.83,37650,40099,1400-8-24,2021-11-15
344,رنيك,جنرال مكانيك,464,1447628,17712638411,12720,12500,12190,-530,-4.17,12236,-484,-3.81,12085,12750,1400-8-24,2021-11-15
345,سباقر,سيمان باقران,463,4443005,65891278700,15253,15253,15090,-163,-1.07,14830,-423,-2.77,14796,15254,1400-8-24,2021-11-15
346,بزاگرس,نيروگاه زاگرس كوثر,456,5731229,22056234019,4021,4094,3820,-201,-5,3848,-173,-4.3,3820,4136,1400-8-24,2021-11-15
347,شوينده,مديريت صنعت شوينده ت.ص.بهشهر,451,1037410,21364389730,20470,20500,20700,230,1.12,20590,120,0.59,20070,21250,1400-8-24,2021-11-15
348,خريخت,صنايع‌ريخته‌گري‌ايران‌,449,7800820,28290888392,3758,3660,3571,-187,-4.98,3627,-131,-3.49,3571,3748,1400-8-24,2021-11-15
349,آكورد,صندوق س. آرمان آتي كوثر-د,448,12334939,434316717521,35193,35216,35211,18,0.05,35210,17,0.05,35210,35217,1400-8-24,2021-11-15
350,ثپرديس,سرمايه گذاري مسكن پرديس,448,4759769,21679501894,4763,4600,4525,-238,-5,4555,-208,-4.37,4525,4862,1400-8-24,2021-11-15
351,كمرجان,بازرگاني و توليدي مرجان كار,446,309863,17072475669,57603,56299,54723,-2880,-5,55097,-2506,-4.35,54723,58500,1400-8-24,2021-11-15
352,اعتلا,شركت سرمايه گذاري اعتلاء البرز,446,4303307,17169997914,4166,4218,3979,-187,-4.49,3990,-176,-4.22,3958,4229,1400-8-24,2021-11-15
353,سشرق,سيمان‌ شرق‌,444,2581926,19556106870,7700,7750,7520,-180,-2.34,7570,-130,-1.69,7430,7930,1400-8-24,2021-11-15
354,تكنو,تكنوتار,444,1872041,19039270310,10010,10450,10170,160,1.6,10170,160,1.6,9770,10450,1400-8-24,2021-11-15
355,وسينا,بانك سينا,437,15660855,34268639398,2264,2186,2199,-65,-2.87,2188,-76,-3.36,2154,2243,1400-8-24,2021-11-15
356,تسه9911,امتياز تسهيلات مسكن بهمن99,432,6963,5505957025,804570,800077,771001,-33569,-4.17,790745,-13825,-1.72,765000,828888,1400-8-24,2021-11-15
357,تسه9912,امتياز تسهيلات مسكن اسفند99,430,7296,5805177200,805064,810000,800000,-5064,-0.63,795666,-9398,-1.17,765000,820000,1400-8-24,2021-11-15
358,ولغدر,ليزينگ‌خودروغدير,427,1397012,18157179600,12980,12850,12650,-330,-2.54,13000,20,0.15,12500,13400,1400-8-24,2021-11-15
359,شدوص,دوده‌ صنعتي‌ پارس‌,426,819229,17413327650,21820,21300,21270,-550,-2.52,21260,-560,-2.57,20900,21950,1400-8-24,2021-11-15
360,تكمبا,كمباين‌ سازي‌ ايران‌,425,3119288,14899370843,4724,4800,4769,45,0.95,4777,53,1.12,4560,4870,1400-8-24,2021-11-15
361,وسپه,سرمايه‌گذاري‌ سپه‌,424,3311385,27507214160,8540,8540,8260,-280,-3.28,8380,-160,-1.87,8250,8540,1400-8-24,2021-11-15
362,لابسا,آبسال‌,424,853689,26463250690,32190,32980,30800,-1390,-4.32,31000,-1190,-3.7,30590,32980,1400-8-24,2021-11-15
363,وبوعلي,سرمايه‌گذاري‌بوعلي‌,423,3306723,12665888921,3895,3802,3820,-75,-1.93,3838,-57,-1.46,3770,3910,1400-8-24,2021-11-15
364,والبر,سرمايه‌ گذاري‌ البرز(هلدينگ‌,422,2061661,17819961690,8950,8780,8700,-250,-2.79,8760,-190,-2.12,8510,8900,1400-8-24,2021-11-15
365,دارو,كارخانجات‌داروپخش‌,421,1301580,36629698400,29480,28120,28120,-1360,-4.61,28140,-1340,-4.55,28010,29370,1400-8-24,2021-11-15
366,كساپا,سايپاشيشه‌,419,2118033,40555601100,18240,19150,19150,910,4.99,19150,910,4.99,18690,19150,1400-8-24,2021-11-15
367,دزهراوي,داروسازي‌زهراوي‌,416,3319696,17703434660,5550,5550,5280,-270,-4.86,5330,-220,-3.96,5280,5590,1400-8-24,2021-11-15
368,افرا,افرانت,414,1201808,19429655531,15728,15800,16514,786,5,16167,439,2.79,15798,16514,1400-8-24,2021-11-15
369,دروز,داروسازي‌ روزدارو,411,814919,26485482480,33470,34440,32830,-640,-1.91,32500,-970,-2.9,31900,34440,1400-8-24,2021-11-15
370,وتوسم,سرمايه‌گذاري‌توسعه‌ملي‌,410,8928659,75126452360,8560,8440,8370,-190,-2.22,8410,-150,-1.75,8200,8600,1400-8-24,2021-11-15
371,ختور,رادياتور ايران‌,409,2263911,42674722350,17960,18850,18850,890,4.96,18850,890,4.96,18850,18850,1400-8-24,2021-11-15
372,وحكمت,بيمه حكمت صبا,408,4533714,19704952848,4337,4369,4400,63,1.45,4346,9,0.21,4251,4466,1400-8-24,2021-11-15
373,سكه0012پ01,تمام سكه طرح جديد0012رفاه,408,83300,103587005400,1262486,1245555,1244489,-17997,-1.43,1243541,-18945,-1.5,1235597,1247500,1400-8-24,2021-11-15
374,غديس,پاكديس,408,1284367,15761442902,12792,12350,12153,-639,-5,12272,-520,-4.07,12153,12700,1400-8-24,2021-11-15
375,فمراد,آلومراد,407,1415343,23097780610,17020,16350,16280,-740,-4.35,16320,-700,-4.11,16170,17150,1400-8-24,2021-11-15
376,قچار,فراوردههاي غذايي وقند چهارمحال,406,2783404,28336576373,10326,9910,9810,-516,-5,10181,-145,-1.4,9810,10490,1400-8-24,2021-11-15
377,وپترو,سرمايه‌گذاري صنايع پتروشيمي‌,405,1319865,16856059120,12560,13000,12530,-30,-0.24,12770,210,1.67,12500,13000,1400-8-24,2021-11-15
378,سپاها,سيمان‌سپاهان‌,403,2629492,22809201930,9080,8810,8660,-420,-4.63,8670,-410,-4.52,8630,9020,1400-8-24,2021-11-15
379,سيلام,سيمان‌ ايلام‌,403,8367828,59290303110,6760,7090,7090,330,4.88,7090,330,4.88,6890,7090,1400-8-24,2021-11-15
380,اپرداز,آتيه داده پرداز,401,1193178,29807339207,24939,24766,24830,-109,-0.44,24981,42,0.17,24450,25297,1400-8-24,2021-11-15
381,فردا,صندوق س آواي فرداي زاگرس-ثابت,400,17410217,205616255914,11804,11810,11811,7,0.06,11810,6,0.05,11810,11811,1400-8-24,2021-11-15
382,لخزر,پارس‌ خزر,397,100931,13633996110,137600,141990,133000,-4600,-3.34,135280,-2320,-1.69,130800,141990,1400-8-24,2021-11-15
383,خوساز,محورسازان‌ايران‌خودرو,394,3113780,23235388880,7740,7520,7360,-380,-4.91,7460,-280,-3.62,7360,7930,1400-8-24,2021-11-15
384,دبالك,مواد اوليه دارويي البرز بالك,392,2026134,17335645125,8952,8572,8505,-447,-4.99,8556,-396,-4.42,8505,8792,1400-8-24,2021-11-15
385,قنيشا,قند  نيشابور,392,441680,16963866190,40050,40500,38050,-2000,-4.99,38410,-1640,-4.09,38050,40500,1400-8-24,2021-11-15
386,پلاسك,پلاسكوكار,389,2737722,13395765373,5037,5052,4925,-112,-2.22,4908,-129,-2.56,4786,5149,1400-8-24,2021-11-15
387,دتماد,توليدمواداوليه‌داروپخش‌,388,769218,34578353570,46450,46010,44750,-1700,-3.66,44950,-1500,-3.23,44140,46020,1400-8-24,2021-11-15
388,وملل,اعتباري ملل,386,2388619,24885386994,10628,11000,10130,-498,-4.69,10503,-125,-1.18,10110,11000,1400-8-24,2021-11-15
389,وتوس,توسعه‌شهري‌توس‌گستر,386,1065438,11237126920,10970,11070,10460,-510,-4.65,10640,-330,-3.01,10430,11080,1400-8-24,2021-11-15
390,ريشمك,توليد و صادرات ريشمك,376,555715,16476775847,30751,29606,29341,-1410,-4.59,29650,-1101,-3.58,29330,30300,1400-8-24,2021-11-15
391,بالبر,كابل‌ البرز,374,620757,15066664430,25360,25360,24100,-1260,-4.97,24270,-1090,-4.3,24100,25360,1400-8-24,2021-11-15
392,پاسا,ايران‌ياساتايرورابر,373,1284686,18398632470,14780,14900,14300,-480,-3.25,14320,-460,-3.11,14070,14960,1400-8-24,2021-11-15
393,ثمسكن,سرمايه‌گذاري‌ مسكن‌,373,4722352,19098880058,4185,4260,3976,-209,-4.99,4044,-141,-3.37,3976,4260,1400-8-24,2021-11-15
394,سدور,سيمان‌ دورود,372,3534316,22793899810,6720,6550,6410,-310,-4.61,6450,-270,-4.02,6390,6720,1400-8-24,2021-11-15
395,تسه9810,امتياز تسهيلات مسكن دي98,371,13351,10415029303,802064,773340,772990,-29074,-3.62,780094,-21970,-2.74,761970,824999,1400-8-24,2021-11-15
396,شپاكسا,پاكسان‌,368,1271305,22059081480,17510,17500,17740,230,1.31,17350,-160,-0.91,17000,17900,1400-8-24,2021-11-15
397,ثنظام,س. ساختماني نظام مهندسي ايران,367,1248425,29040013760,24470,23247,23247,-1223,-5,23261,-1209,-4.94,23247,23720,1400-8-24,2021-11-15
398,ضجار1022,اختيارخ وتجارت-2000-1400/10/15,366,15172,3447522000,305,262,214,-91,-29.84,227,-78,-25.57,214,266,1400-8-24,2021-11-15
399,شرنگي,شيميايي رنگين,365,134348,21044975586,158834,159990,154069,-4765,-3,156645,-2189,-1.38,154069,160350,1400-8-24,2021-11-15
400,ثعمرا,عمران و توسعه شاهد,358,1725229,12807409913,7398,7350,7274,-124,-1.68,7421,23,0.31,7103,7640,1400-8-24,2021-11-15
401,چافست,افست‌,357,1223828,11439713720,9410,9460,9100,-310,-3.29,9360,-50,-0.53,9010,9800,1400-8-24,2021-11-15
402,ميدكو,توسعه معادن وص.معدني خاورميانه,356,3680893,171768834830,46670,46670,46600,-70,-0.15,46660,-10,-0.02,46600,46680,1400-8-24,2021-11-15
403,سشمال,سيمان‌ شمال‌,355,1638461,14332378630,9060,9150,8620,-440,-4.86,8760,-300,-3.31,8610,9150,1400-8-24,2021-11-15
404,تسه9910,امتياز تسهيلات مسكن دي99,353,6024,4763577891,806291,800000,770000,-36291,-4.5,790767,-15524,-1.93,770000,824790,1400-8-24,2021-11-15
405,قجام,فرآوردههاي غذايي وقندتربت‌جام‌,348,3316205,23716677631,7292,7147,7147,-145,-1.99,7152,-140,-1.92,7147,7306,1400-8-24,2021-11-15
406,ولصنم,ليزينگ‌صنعت‌ومعدن‌,347,2407629,10994782555,4571,4721,4560,-11,-0.24,4568,-3,-0.07,4450,4721,1400-8-24,2021-11-15
407,شپارس,بين‌ المللي‌ محصولات‌  پارس‌,347,2157401,16762758630,7780,7750,7760,-20,-0.26,7770,-10,-0.13,7560,7930,1400-8-24,2021-11-15
408,سدشت,صنايع سيمان دشتستان,346,262968,8609998120,33690,32310,32030,-1660,-4.93,33160,-530,-1.57,32010,33990,1400-8-24,2021-11-15
409,خچرخش,چرخشگر,345,1750267,14238233290,8410,8100,8110,-300,-3.57,8130,-280,-3.33,8000,8390,1400-8-24,2021-11-15
410,ونفت,سرمايه‌گذاري‌ صنعت‌ نفت‌,345,3723896,55717685520,14960,14750,14850,-110,-0.74,14960,0,0,14540,15060,1400-8-24,2021-11-15
411,خشرق,الكتريك‌ خودرو شرق‌,344,1516125,21819085550,15020,15200,14270,-750,-4.99,14390,-630,-4.19,14270,15200,1400-8-24,2021-11-15
412,كمينا,شيشه سازي مينا,344,1479479,15645265338,10342,10042,10652,310,3,10575,233,2.25,10040,10652,1400-8-24,2021-11-15
413,غگلستا,شير پاستوريزه پگاه گلستان,344,1147534,14671147879,13381,13090,12712,-669,-5,12785,-596,-4.45,12712,13090,1400-8-24,2021-11-15
414,بهپاك,صنعتي بهپاك,343,3414236,19785922325,6061,6000,5758,-303,-5,5795,-266,-4.39,5758,6000,1400-8-24,2021-11-15
415,كطبس,ذغال‌سنگ‌ نگين‌ ط‌بس‌,339,500313,24426029490,48930,50300,48000,-930,-1.9,48820,-110,-0.22,47330,50300,1400-8-24,2021-11-15
416,كسرام,پارس‌ سرام‌,338,4839812,20211293078,3979,4175,4177,198,4.98,4176,197,4.95,4050,4177,1400-8-24,2021-11-15
417,پكوير,كوير تاير,337,2530320,17766770860,7110,7100,6950,-160,-2.25,7020,-90,-1.27,6930,7120,1400-8-24,2021-11-15
418,ضصاد1114,اختيارخ وبصادر-2500-1400/11/06,337,16890,1515554000,112,101,90,-22,-19.64,90,-22,-19.64,83,120,1400-8-24,2021-11-15
419,شخارك,پتروشيمي‌ خارك‌,336,384781,21067188380,55510,55510,54640,-870,-1.57,55350,-160,-0.29,54550,55600,1400-8-24,2021-11-15
420,تسه9909,امتياز تسهيلات مسكن آذر99,336,4992,3954772627,806698,806050,790000,-16698,-2.07,792222,-14476,-1.79,767000,818800,1400-8-24,2021-11-15
421,غفارس,شير پاستوريزه پگاه فارس,335,2052491,14501019399,7397,7400,7028,-369,-4.99,7068,-329,-4.45,7028,7400,1400-8-24,2021-11-15
422,داوه,داروسازي آوه سينا,335,1130825,12716619931,11766,11829,11178,-588,-5,11300,-466,-3.96,11178,11829,1400-8-24,2021-11-15
423,عيار,صندوق سكه طلاي مفيد,335,648094,20395861798,32086,31760,31350,-736,-2.29,31471,-615,-1.92,31194,31760,1400-8-24,2021-11-15
424,زعف0008پ10,زعفران0008نگين طلاي سرخ(پ),334,255080,58527921897,230540,227000,232000,1460,0.63,229449,-1091,-0.47,223000,240000,1400-8-24,2021-11-15
425,پدرخش,درخشان‌ تهران‌,334,787996,15713139010,20260,20740,19680,-580,-2.86,19940,-320,-1.58,19410,20740,1400-8-24,2021-11-15
426,ضشنا1050,اختيارخ شپنا-7629-1400/10/19,334,6946,3030324000,501,430,445,-56,-11.18,436,-65,-12.97,422,505,1400-8-24,2021-11-15
427,زدشت,كشت و صنعت دشت خرم دره,333,938287,13858280083,15449,15426,14677,-772,-5,14810,-639,-4.14,14677,15426,1400-8-24,2021-11-15
428,قشكر,شكرشاهرود,332,3957507,11602485016,3039,3000,2900,-139,-4.57,2951,-88,-2.9,2889,3106,1400-8-24,2021-11-15
429,كي بي سي,شركت كي بي سي,329,952228,18070123449,19242,19000,18700,-542,-2.82,18977,-265,-1.38,18280,19500,1400-8-24,2021-11-15
430,كروي,توسعه‌ معادن‌ روي‌ ايران‌,328,590026,13846093230,24130,23140,23380,-750,-3.11,23720,-410,-1.7,23140,24150,1400-8-24,2021-11-15
431,جم پيلن,پلي پروپيلن جم - جم پيلن,328,220217,24893225650,115520,116350,112990,-2530,-2.19,114840,-680,-0.59,112010,116350,1400-8-24,2021-11-15
432,گوهر,صندوق سكه طلاي كيان,327,1010668,62976229463,63352,62500,62000,-1352,-2.13,62311,-1041,-1.64,61983,63000,1400-8-24,2021-11-15
433,كسعدي,كاشي‌ سعدي‌,326,944385,8433204230,9160,9020,8940,-220,-2.4,9030,-130,-1.42,8850,9150,1400-8-24,2021-11-15
434,دكپسول,توليد ژلاتين كپسول ايران,326,334051,10523419431,32224,31840,31101,-1123,-3.48,31699,-525,-1.63,31101,32223,1400-8-24,2021-11-15
435,غشان,شيرپاستوريزه‌پگاه‌خراسان‌,324,3478507,17268782220,5210,4970,4950,-260,-4.99,4960,-250,-4.8,4950,5100,1400-8-24,2021-11-15
436,زمگسا,كشاورزي‌ ودامپروي‌ مگسال‌,324,994296,18766375520,19790,19800,18810,-980,-4.95,18870,-920,-4.65,18810,19800,1400-8-24,2021-11-15
437,حرهشا,رهشاد سپاهان (سهامي عام,323,218532,22795693953,108926,103710,103480,-5446,-5,104313,-4613,-4.23,103480,108919,1400-8-24,2021-11-15
438,فبيرا,بسته‌ بندي‌ ايران‌,322,4118802,7070955768,1675,1675,1725,50,2.99,1704,29,1.73,1675,1725,1400-8-24,2021-11-15
439,سخند,صندوق س.سپهرخبرگان نفت-د,322,29578210,297437171080,10037,10044,10045,8,0.08,10056,19,0.19,10044,10070,1400-8-24,2021-11-15
440,سغرب,سيمان‌غرب‌,320,905088,13778677030,15890,15200,15100,-790,-4.97,15240,-650,-4.09,15100,15800,1400-8-24,2021-11-15
441,فاهواز,نورد و لوله اهواز,320,3996126,23570700255,5906,5793,5920,14,0.24,5898,-8,-0.14,5788,5990,1400-8-24,2021-11-15
442,دجابر,داروسازي‌ جابرابن‌حيان‌,317,1967360,26739827790,14270,13560,13560,-710,-4.98,13590,-680,-4.77,13560,13840,1400-8-24,2021-11-15
443,كنور,توسعه معدني و صنعتي صبانور,317,998865,19130357730,18980,19250,18910,-70,-0.37,19010,30,0.16,18780,19530,1400-8-24,2021-11-15
444,وايرا,سرمايه گذاري صنايع ايران,316,3423011,16050048688,4635,4689,4774,139,3,4689,54,1.17,4500,4774,1400-8-24,2021-11-15
445,ددام,داروسازي زاگرس فارمد پارس,313,2284428,24536905640,11190,10860,10640,-550,-4.92,10740,-450,-4.02,10640,11090,1400-8-24,2021-11-15
446,سصوفي,سيمان‌ صوفيان‌,312,747143,11729789790,16390,16180,15620,-770,-4.7,15810,-580,-3.54,15580,16180,1400-8-24,2021-11-15
447,دكوثر,داروسازي‌ كوثر,312,2966126,9558137825,3352,3389,3258,-94,-2.8,3263,-89,-2.66,3185,3389,1400-8-24,2021-11-15
448,پكرمان,گروه‌ صنعتي‌ بارز,312,900619,21465952620,24100,24100,23880,-220,-0.91,23860,-240,-1,23050,24490,1400-8-24,2021-11-15
449,ركيش,كارت اعتباري ايران كيش,307,2051934,12115102150,5970,5970,5860,-110,-1.84,5920,-50,-0.84,5680,6100,1400-8-24,2021-11-15
450,سپ,پرداخت الكترونيك سامان كيش,305,595683,18195361280,29980,29020,31470,1490,4.97,30150,170,0.57,29020,31470,1400-8-24,2021-11-15
451,وصندوق,سرمايه‌گذاري‌صندوق‌بازنشستگي‌,303,1658364,31652384710,19240,19300,19330,90,0.47,19200,-40,-0.21,19010,19330,1400-8-24,2021-11-15
452,زعف0110پ11,زعفران0110نگين سحرخيز(پ),301,91739,27726264963,305147,309088,297999,-7148,-2.34,302230,-2917,-0.96,290000,309088,1400-8-24,2021-11-15
453,وبيمه,سرمايه‌ گذاري‌ صنعت‌ بيمه‌,299,4599426,7161229068,1590,1596,1572,-18,-1.13,1574,-16,-1.01,1531,1596,1400-8-24,2021-11-15
454,كاسپين,داروسازي كاسپين تامين,298,761337,19329782040,26403,25600,25210,-1193,-4.52,25389,-1014,-3.84,25110,25980,1400-8-24,2021-11-15
455,بنو,بيمه تجارت نو,296,1897098,15889456235,8734,8510,8298,-436,-4.99,8451,-283,-3.24,8298,8570,1400-8-24,2021-11-15
456,خاهنح,ح . آهنگري تراكتورسازي‌ ايران‌,295,3625930,13607633496,3894,3722,3780,-114,-2.93,3753,-141,-3.62,3650,3870,1400-8-24,2021-11-15
457,زشريف,كشت وصنعت شريف آباد,295,2785736,9151946159,3378,3322,3270,-108,-3.2,3319,-59,-1.75,3226,3388,1400-8-24,2021-11-15
458,زبينا,كشاورزي و دامپروري بينالود,292,3483032,7758826790,2331,2303,2215,-116,-4.98,2274,-57,-2.45,2215,2338,1400-8-24,2021-11-15
459,كمنگنز,معادن‌منگنزايران‌,292,152935,10224310110,67210,67000,66100,-1110,-1.65,66960,-250,-0.37,65100,68030,1400-8-24,2021-11-15
460,تسه9907,امتياز تسهيلات مسكن مهر99,290,6179,4888546198,803524,843700,780000,-23524,-2.93,791155,-12369,-1.54,764111,843700,1400-8-24,2021-11-15
461,رتكو,كنترل‌خوردگي‌تكين‌كو,290,1128412,9348628080,8620,8510,8290,-330,-3.83,8400,-220,-2.55,8190,8740,1400-8-24,2021-11-15
462,درهآور,دارويي ره آورد تامين,289,386594,7841339404,21034,20531,20020,-1014,-4.82,20626,-408,-1.94,20020,21397,1400-8-24,2021-11-15
463,كيان2,صندوق س. با درآمد ثابت كيان,287,28700000,28700000,31555,1,1,-31554,-100,1,-31554,-100,1,1,1400-8-24,2021-11-15
464,شگل,گلتاش‌,286,1189215,8018400910,6630,6540,6840,210,3.17,6690,60,0.9,6530,6880,1400-8-24,2021-11-15
465,دعبيد,لابراتوارداروسازي‌  دكترعبيدي‌,284,410931,8368262910,21130,20410,20350,-780,-3.69,20960,-170,-0.8,20090,20800,1400-8-24,2021-11-15
466,پخش,پخش البرز,284,504760,14011340534,29099,28441,27645,-1454,-5,27891,-1208,-4.15,27645,29168,1400-8-24,2021-11-15
467,شراز,پالايش نفت شيراز,282,195694,23105895966,119666,122670,116999,-2667,-2.23,118907,-759,-0.63,116560,122670,1400-8-24,2021-11-15
468,سكرد,سيمان كردستان,280,1325429,6774882780,5310,5180,5080,-230,-4.33,5210,-100,-1.88,5050,5290,1400-8-24,2021-11-15
469,بنيرو,نيروترانس‌,279,4527336,9073591599,2102,2025,1997,-105,-5,2040,-62,-2.95,1997,2088,1400-8-24,2021-11-15
470,كفرا,فراورده‌ هاي‌ نسوزايران‌,278,482656,9293938600,19580,19770,19100,-480,-2.45,19380,-200,-1.02,18610,20400,1400-8-24,2021-11-15
471,فنوال,نورد آلومينيوم‌,277,406535,9460950400,23710,23930,23120,-590,-2.49,23420,-290,-1.22,22880,23930,1400-8-24,2021-11-15
472,دكيمي,كيميدارو,275,517983,10643004430,20900,21350,20130,-770,-3.68,20650,-250,-1.2,19900,21590,1400-8-24,2021-11-15
473,غگلپا,شير پاستوريزه پگاه گلپايگان,275,600518,30372533483,53091,50510,50438,-2653,-5,50577,-2514,-4.74,50437,52870,1400-8-24,2021-11-15
474,ثتوسا,س.توسعه و عمران استان اردبيل,274,513982,9234653715,18263,17740,17716,-547,-3,17967,-296,-1.62,17716,18690,1400-8-24,2021-11-15
475,ساينا,صنايع بهداشتي ساينا,274,145336,14019075038,92530,89904,97156,4626,5,96090,3560,3.85,89904,97156,1400-8-24,2021-11-15
476,سخوز,سيمان خوزستان,273,672635,15979563150,23760,23000,23150,-610,-2.57,23760,0,0,22750,24200,1400-8-24,2021-11-15
477,پارسيان,بيمه پارسيان,271,1600524,15049222820,9490,9550,9130,-360,-3.79,9420,-70,-0.74,9120,9590,1400-8-24,2021-11-15
478,جم,پتروشيمي جم,271,639681,30981252900,48730,48750,48150,-580,-1.19,48640,-90,-0.18,48010,49000,1400-8-24,2021-11-15
479,سامان,بانك سامان,271,2642234,19218751565,7492,7280,7268,-224,-2.99,7367,-125,-1.67,7268,7380,1400-8-24,2021-11-15
480,سهرمز,سيمان‌هرمزگان‌,269,432431,6440112810,15170,14900,14890,-280,-1.85,15050,-120,-0.79,14500,15650,1400-8-24,2021-11-15
481,قلرست,قند لرستان‌,266,421082,8158230360,19800,19520,19500,-300,-1.52,19570,-230,-1.16,18850,19800,1400-8-24,2021-11-15
482,آبين,كشت و صنعت آبشيرين,259,1859205,3337945756,1843,1792,1788,-55,-2.98,1827,-16,-0.87,1788,1842,1400-8-24,2021-11-15
483,ساراب,سيمان‌ داراب‌,258,545898,8754141240,16710,16390,15880,-830,-4.97,16300,-410,-2.45,15880,16590,1400-8-24,2021-11-15
484,وثوق,سرمايه گذاري وثوق امين,258,1058084,11165150845,10870,10845,10544,-326,-3,10552,-318,-2.93,10544,10845,1400-8-24,2021-11-15
485,واميد,گروه مديريت سرمايه گذاري اميد,258,3016019,39450402230,13050,13110,13060,10,0.08,13060,10,0.08,13040,13140,1400-8-24,2021-11-15
486,ثباغ,شهر سازي و خانه سازي باغميشه,258,994709,7928550587,8194,8225,7790,-404,-4.93,8066,-128,-1.56,7790,8236,1400-8-24,2021-11-15
487,وتوكا,سرمايه‌گذاري‌توكافولاد(هلدينگ,256,1582120,13353972920,8630,8640,8350,-280,-3.24,8450,-180,-2.09,8320,8640,1400-8-24,2021-11-15
488,تاپكيش,تجارت الكترونيك پارسيان كيش,256,1427939,24916692415,18338,17422,17422,-916,-5,17449,-889,-4.85,17422,17840,1400-8-24,2021-11-15
489,ولراز,ليزينگ رازي,256,505776,11674158474,22417,22461,23089,672,3,23082,665,2.97,22461,23089,1400-8-24,2021-11-15
490,وآذر,سرمايه‌گذاري‌توسعه‌آذربايجان‌,255,485099,20700840860,40650,42680,42680,2030,4.99,42670,2020,4.97,42300,42680,1400-8-24,2021-11-15
491,شپاس,نفت پاسارگاد,255,533163,9860728516,18618,18798,18600,-18,-0.1,18550,-68,-0.37,18280,18798,1400-8-24,2021-11-15
492,فسا,پتروشيمي فسا,253,4791817,5729938531,1216,1247,1180,-36,-2.96,1204,-12,-0.99,1180,1247,1400-8-24,2021-11-15
493,تايرا,تراكتورسازي‌ايران‌,251,1037822,22720884620,22590,22340,21680,-910,-4.03,22020,-570,-2.52,21680,22670,1400-8-24,2021-11-15
494,دابور,داروسازي‌ ابوريحان‌,251,477946,11821962380,25310,25130,24550,-760,-3,24830,-480,-1.9,24050,25510,1400-8-24,2021-11-15
495,واحيا,م .صنايع و معادن احياء سپاهان,250,154246,22954409765,150080,150080,147990,-2090,-1.39,149593,-487,-0.32,147100,150490,1400-8-24,2021-11-15
496,ومعلم,بيمه معلم,250,2554055,6379450209,2542,2462,2486,-56,-2.2,2523,-19,-0.75,2460,2556,1400-8-24,2021-11-15
497,نمرينو,ايران‌ مرينوس‌,250,107259,7918096860,74470,77200,73770,-700,-0.94,74100,-370,-0.5,72000,77200,1400-8-24,2021-11-15
498,تنوين,تامين سرمايه نوين,250,2054908,11238361840,5420,5430,5450,30,0.55,5440,20,0.37,5420,5550,1400-8-24,2021-11-15
499,خديزل,بهمن  ديزل,248,323698,15953773286,50284,49999,49500,-784,-1.56,49476,-808,-1.61,47771,51200,1400-8-24,2021-11-15
500,تسه9902,امتياز تسهيلات مسكن ارديبهشت99,248,6536,5135231093,804766,800011,780000,-24766,-3.08,785684,-19082,-2.37,764528,820000,1400-8-24,2021-11-15
501,غپاك,لبنيات‌ پاك‌,244,622358,8089747830,13050,12730,13060,10,0.08,13020,-30,-0.23,12730,13300,1400-8-24,2021-11-15
502,كامياب,صندوق س. كامياب آشنا-د,241,1968740,21417608666,10873,10885,10879,6,0.06,10879,6,0.06,10876,10885,1400-8-24,2021-11-15
503,ومشان,س. فني و مهندسي مشانير,240,198575,10510776876,53969,54899,52350,-1619,-3,52931,-1038,-1.92,52350,54900,1400-8-24,2021-11-15
504,كحافظ,كاشي‌ وسراميك‌ حافظ‌,239,1833009,6450351161,3621,3690,3525,-96,-2.65,3576,-45,-1.24,3450,3690,1400-8-24,2021-11-15
505,فاما,صنعتي‌ آما,237,1162874,20812989340,17460,17170,18330,870,4.98,17900,440,2.52,17000,18330,1400-8-24,2021-11-15
506,تابا,تابان نيرو سپاهان,237,305060,8824325365,29716,29700,28825,-891,-3,28939,-777,-2.61,28825,29780,1400-8-24,2021-11-15
507,كقزوي,شيشه‌ قزوين‌,236,1894424,15296169706,8235,8141,8095,-140,-1.7,8074,-161,-1.96,7988,8235,1400-8-24,2021-11-15
508,شصفها,پتروشيمي‌ اصفهان‌,236,298385,37777976275,124582,126960,126995,2413,1.94,126608,2026,1.63,125000,127073,1400-8-24,2021-11-15
509,زشگزا,شير و گوشت زاگرس شهركرد,231,1006123,5145278180,5268,5299,5045,-223,-4.23,5213,-55,-1.04,5031,5368,1400-8-24,2021-11-15
510,زر,صندوق س.پشتوانه سكه طلاي زر,229,180384,9726448060,55281,54696,53999,-1282,-2.32,53921,-1360,-2.46,53629,54696,1400-8-24,2021-11-15
511,وآرين,شركت توسعه اقتصادي آرين,228,2586417,5318595740,2112,2061,2055,-57,-2.7,2081,-31,-1.47,2049,2080,1400-8-24,2021-11-15
512,بفجر,فجر انرژي خليج فارس,228,725490,8473600220,12230,12250,11620,-610,-4.99,12180,-50,-0.41,11620,12250,1400-8-24,2021-11-15
513,ويسا,سرمايه گذاري ايساتيس پويا,226,1600987,11708847353,7518,7350,7293,-225,-2.99,7314,-204,-2.71,7293,7579,1400-8-24,2021-11-15
514,ميهن,بيمه ميهن,226,7974978,19961369934,2384,2503,2503,119,4.99,2503,119,4.99,2503,2503,1400-8-24,2021-11-15
515,حپترو,حمل و نقل پتروشيمي( سهامي عام,225,380398,10200998110,27990,27090,26600,-1390,-4.97,27190,-800,-2.86,26600,27750,1400-8-24,2021-11-15
516,ثشرق,سرمايه گذاري مسكن شمال شرق,221,1771266,7416462093,4349,4200,4160,-189,-4.35,4268,-81,-1.86,4150,4380,1400-8-24,2021-11-15
517,وارس,سرمايه گذاري ارس صبا,221,1645361,19682794564,12317,12090,11948,-369,-3,11963,-354,-2.87,11948,12475,1400-8-24,2021-11-15
518,غچين,كشت‌ و صنعت‌ چين‌ چين,218,543176,7390941840,13940,14050,13650,-290,-2.08,13770,-170,-1.22,13470,14050,1400-8-24,2021-11-15
519,كاردان,صندوق س تجارت شاخصي كاردان,218,57487,11246863690,201820,200570,194000,-7820,-3.87,195640,-6180,-3.06,194000,200570,1400-8-24,2021-11-15
520,قهكمت,قندهكمتان‌,218,1321617,6778209540,5370,5470,5110,-260,-4.84,5250,-120,-2.23,5110,5480,1400-8-24,2021-11-15
521,غشاذر,پگاه‌آذربايجان‌غربي‌,216,1447080,8298007560,5990,5710,5700,-290,-4.84,5840,-150,-2.5,5700,5950,1400-8-24,2021-11-15
522,فلات,گروه صنايع معادن فلات ايرانيان,215,1068269,13721874827,12977,12919,12845,-132,-1.02,12845,-132,-1.02,12589,13098,1400-8-24,2021-11-15
523,آوا,صندوق س.سهام آواي معيار-س,214,1071249,8701237793,8211,8151,8053,-158,-1.92,8123,-88,-1.07,8000,8250,1400-8-24,2021-11-15
524,وبشهر,توسعه‌ صنايع‌ بهشهر(هلدينگ,213,792175,10913905920,14210,13990,13910,-300,-2.11,14110,-100,-0.7,13600,14070,1400-8-24,2021-11-15
525,كترام,توليدي‌ كاشي‌ تكسرام‌,213,883318,20855137980,22490,23610,23610,1120,4.98,23610,1120,4.98,23610,23610,1400-8-24,2021-11-15
526,فولاژ,فولاد آلياژي ايران,212,514973,8368431470,16540,16700,16090,-450,-2.72,16510,-30,-0.18,16050,16700,1400-8-24,2021-11-15
527,واعتبار,سرمايه گذاري اعتبار ايران,212,1847806,12039368000,6820,6610,6490,-330,-4.84,6570,-250,-3.67,6480,6750,1400-8-24,2021-11-15
528,لپيام,گسترش صنايع پيام,210,459691,16148387543,36172,35150,35087,-1085,-3,35129,-1043,-2.88,35087,36477,1400-8-24,2021-11-15
529,شرانل,نفت ايرانول,207,256943,12180474874,48154,47001,47320,-834,-1.73,47914,-240,-0.5,47001,47780,1400-8-24,2021-11-15
530,پارتا,مجتمع‌صنعتي‌آرتاويل‌تاير,206,787538,19158837952,25067,24315,24315,-752,-3,24406,-661,-2.64,24315,25000,1400-8-24,2021-11-15
531,بايكا,كارخانجات كابلسازي ‌ايران‌,201,1322711,25200289972,18498,19052,19052,554,2.99,19052,554,2.99,19052,19052,1400-8-24,2021-11-15
532,تسه9904,امتياز تسهيلات مسكن تير99,200,3632,2902670563,806475,800011,810000,3525,0.44,799193,-7282,-0.9,767000,819960,1400-8-24,2021-11-15
533,فخاس,فولاد خراسان,200,448841,10527230730,24610,23540,23700,-910,-3.7,24480,-130,-0.53,23380,23990,1400-8-24,2021-11-15
534,وخاور,بانك خاورميانه,200,2638529,13860897210,5450,5350,5290,-160,-2.94,5400,-50,-0.92,5180,5480,1400-8-24,2021-11-15
535,دامين,داروسازي‌ امين‌,200,1711894,4776058940,2874,2820,2770,-104,-3.62,2846,-28,-0.97,2760,2887,1400-8-24,2021-11-15
536,زگلدشت,كشت و دام گلدشت نمونه اصفهان,197,579216,5199521672,9273,9052,8901,-372,-4.01,9169,-104,-1.12,8827,9193,1400-8-24,2021-11-15
537,سفار,سيمان‌فارس‌,195,116007,7136359490,58640,61570,61570,2930,5,59910,1270,2.17,60000,61570,1400-8-24,2021-11-15
538,گشان,توسعه بين المللي پديده شانديز,195,735221,14493411573,19139,19713,19713,574,3,19713,574,3,19713,19713,1400-8-24,2021-11-15
539,دحاوي,الحاوي,193,871403,4134436985,4874,4771,4730,-144,-2.95,4819,-55,-1.13,4728,4890,1400-8-24,2021-11-15
540,كصدف,كاشي صدف سرام استقلال آباده,190,416886,9306320431,21827,22450,22481,654,3,22254,427,1.96,21850,22481,1400-8-24,2021-11-15
541,معيار ,سرمايه گذاري معيار صنعت پارس,190,212474,10733905367,51868,53300,50312,-1556,-3,50519,-1349,-2.6,50312,53300,1400-8-24,2021-11-15
542,سمازن,سيمان‌مازندران‌,190,731664,10194425670,13900,13940,14000,100,0.72,13920,20,0.14,13800,14110,1400-8-24,2021-11-15
543,دبالكح,ح.مواد اوليه دارويي البرز بالك,188,601034,3776271832,6598,6466,6269,-329,-4.99,6283,-315,-4.77,6269,6466,1400-8-24,2021-11-15
544,تيپيكو,سرمايه گذاري دارويي تامين,181,257770,5616833370,22360,21610,21670,-690,-3.09,22330,-30,-0.13,21610,22120,1400-8-24,2021-11-15
545,ختراك,ريخته‌گري‌ تراكتورسازي‌ ايران‌,179,1457701,10037728410,7200,6900,6840,-360,-5,6980,-220,-3.06,6840,7090,1400-8-24,2021-11-15
546,فافزا,فولاد افزا سپاهان,179,324485,13599299679,43021,42596,41731,-1290,-3,41910,-1111,-2.58,41731,44000,1400-8-24,2021-11-15
547,ثامان,سامان‌ گستراصفهان‌,177,523743,5180225750,10210,10100,9890,-320,-3.13,10100,-110,-1.08,9710,10390,1400-8-24,2021-11-15
548,لبوتان,گروه‌صنعتي‌بوتان‌,177,153790,6642444980,43550,42530,42570,-980,-2.25,43390,-160,-0.37,41380,44500,1400-8-24,2021-11-15
549,غشهد,شهد ايران ‌,177,657040,2976425714,4692,4700,4473,-219,-4.67,4659,-33,-0.7,4461,4700,1400-8-24,2021-11-15
550,سصفها,سيمان‌اصفهان‌,176,514528,18769981440,34750,36480,36480,1730,4.98,36480,1730,4.98,36480,36480,1400-8-24,2021-11-15
551,كاريس,صندوق س.سپهر كاريزما-س,176,754584,10051080412,13644,13520,13230,-414,-3.03,13320,-324,-2.37,13211,13615,1400-8-24,2021-11-15
552,شستان,پتروشيمي گلستان,175,1842419,6720276199,3681,3616,3615,-66,-1.79,3648,-33,-0.9,3608,3754,1400-8-24,2021-11-15
553,ثاصفا,شركت‌ ساختمان‌ اصفهان‌,170,791529,9681952023,11876,12232,12232,356,3,12228,352,2.96,12220,12232,1400-8-24,2021-11-15
554,وبهمن,سرمايه‌گذاري‌بهمن‌,169,1223400,17334856270,14590,14350,14000,-590,-4.04,14170,-420,-2.88,13870,14900,1400-8-24,2021-11-15
555,دپارس,پارس‌ دارو,167,262922,8635322150,34340,33310,32630,-1710,-4.98,33460,-880,-2.56,32630,33800,1400-8-24,2021-11-15
556,تسه9906,امتياز تسهيلات مسكن شهريور99,166,2569,2076524269,805825,791520,780101,-25724,-3.19,808301,2476,0.31,766000,844999,1400-8-24,2021-11-15
557,ولتجار,واسپاري تجارت وسرمايه ايرانيان,166,1770550,5594779799,3242,3160,3149,-93,-2.87,3195,-47,-1.45,3145,3290,1400-8-24,2021-11-15
558,وتعاون,بيمه  تعاون,165,4350932,7531161955,1778,1750,1758,-20,-1.12,1740,-38,-2.14,1725,1786,1400-8-24,2021-11-15
559,تماوند,تامين سرمايه دماوند,165,1394376,8189326409,5922,5981,5848,-74,-1.25,5898,-24,-0.41,5745,6099,1400-8-24,2021-11-15
560,سلار,شركت سيمان لارستان,165,361638,10658195136,28614,29472,29472,858,3,29451,837,2.93,29472,29472,1400-8-24,2021-11-15
561,كارين,صندوق س نگين سامان-ثابت,164,3554528,36001849721,10122,10129,10128,6,0.06,10128,6,0.06,10128,10130,1400-8-24,2021-11-15
562,تپولا,مهندسي مرآت پولاد,163,633824,10538644912,16144,16628,16628,484,3,16627,483,2.99,16300,16628,1400-8-24,2021-11-15
563,وزمين,بانك ايران زمين,161,1079637,11576361082,10990,10600,10551,-439,-3.99,10809,-181,-1.65,10551,11000,1400-8-24,2021-11-15
564,سكرما,سيمان‌ كرمان‌,159,583794,8138616850,14520,14300,13850,-670,-4.61,14180,-340,-2.34,13830,14450,1400-8-24,2021-11-15
565,سخزر,سيمان‌ خزر,157,222992,4077663840,18800,18800,18260,-540,-2.87,18650,-150,-0.8,18000,18990,1400-8-24,2021-11-15
566,غنوش,نوش‌ مازندران‌,156,914003,9807252190,10220,10730,10730,510,4.99,10730,510,4.99,10730,10730,1400-8-24,2021-11-15
567,درازك,دارويي‌ رازك‌,155,244151,8808288800,37130,36010,36090,-1040,-2.8,36500,-630,-1.7,35900,36780,1400-8-24,2021-11-15
568,تكنار,مجتمع معادن مس تكنار,154,63152,3224167529,52333,52350,50800,-1533,-2.93,51899,-434,-0.83,50764,52350,1400-8-24,2021-11-15
569,بميلا,توسعه بازرگاني آهن وفولادميلاد,153,902561,7728346578,8804,8611,8540,-264,-3,8613,-191,-2.17,8540,8790,1400-8-24,2021-11-15
570,غشوكوح,ح . شوكو پارس,153,786852,4241171456,5550,5401,5400,-150,-2.7,5390,-160,-2.88,5384,5549,1400-8-24,2021-11-15
571,سيستم,همكاران سيستم,151,1106831,5435590421,5015,5100,4883,-132,-2.63,4986,-29,-0.58,4850,5100,1400-8-24,2021-11-15
572,صايند,صندوق س. گنجينه آينده روشن-د,151,1432010,14358809610,10002,10001,10020,18,0.18,10027,25,0.25,9990,10049,1400-8-24,2021-11-15
573,تصميم,صندوق س با درآمد ثابت تصميم,150,567657,10195165157,17949,17959,17959,10,0.06,17960,11,0.06,17959,17962,1400-8-24,2021-11-15
574,شكبير,پتروشيمي اميركبير,150,67787,6654824183,98266,101021,97944,-322,-0.33,98260,-6,-0.01,96704,101021,1400-8-24,2021-11-15
575,بخاور,بيمه زندگي خاورميانه,150,1438507,5697800614,4065,4152,3930,-135,-3.32,4023,-42,-1.03,3906,4152,1400-8-24,2021-11-15
576,حآسا,آسيا سير ارس,149,902195,13038522140,13764,14452,14452,688,5,14300,536,3.89,14452,14452,1400-8-24,2021-11-15
577,دقاضي,داروسازي شهيد قاضي,146,169024,5026524587,29592,30269,29666,74,0.25,29663,71,0.24,28801,30269,1400-8-24,2021-11-15
578,مبين,مبين انرژي خليج فارس,145,319756,7780827930,24730,25300,23880,-850,-3.44,24700,-30,-0.12,23800,25300,1400-8-24,2021-11-15
579,سجام,مجتمع سيمان غرب آسيا,144,2456828,6809188889,2801,2752,2743,-58,-2.07,2780,-21,-0.75,2743,2815,1400-8-24,2021-11-15
580,فردا2,صندوق س آواي فرداي زاگرس-ثابت,143,14300000,14300000,11804,1,1,-11803,-99.99,1,-11803,-99.99,1,1,1400-8-24,2021-11-15
581,دارا,صندوق س. دارا الگوريتم-د,142,4566093,45845139829,10044,10050,10040,-4,-0.04,10040,-4,-0.04,10031,10050,1400-8-24,2021-11-15
582,پسهند,صنايع‌ لاستيكي‌  سهند,141,338343,7929692100,23840,24000,23290,-550,-2.31,23630,-210,-0.88,22650,24110,1400-8-24,2021-11-15
583,سرود,سيمان‌شاهرود,140,152241,3664668320,24940,24700,23890,-1050,-4.21,24730,-210,-0.84,23710,25200,1400-8-24,2021-11-15
584,تسه9811,امتياز تسهيلات مسكن بهمن98,139,1954,1545867930,811716,800020,777130,-34586,-4.26,791130,-20586,-2.54,772000,815000,1400-8-24,2021-11-15
585,ما,بيمه  ما,139,709671,4173821760,6040,5900,5890,-150,-2.48,5990,-50,-0.83,5850,5980,1400-8-24,2021-11-15
586,بمپنا,توليد برق عسلويه  مپنا,138,1361051,7128862845,5480,5535,5270,-210,-3.83,5373,-107,-1.95,5206,5535,1400-8-24,2021-11-15
587,تسه9905,امتياز تسهيلات مسكن مرداد99,138,3183,2600131191,808298,809001,847998,39700,4.91,816881,8583,1.06,768000,847999,1400-8-24,2021-11-15
588,غپونه,نوش پونه مشهد,134,1050815,13722644665,13421,13659,13100,-321,-2.39,13059,-362,-2.7,13019,13659,1400-8-24,2021-11-15
589,هجرت,پخش هجرت,133,164431,4730055844,29788,29240,28586,-1202,-4.04,29443,-345,-1.16,28302,29240,1400-8-24,2021-11-15
590,اخزا002,اسنادخزانه-م2بودجه00-031024,133,179013,89950257977,501586,502789,502000,414,0.08,502479,893,0.18,500555,503990,1400-8-24,2021-11-15
591,واتي,سرمايه‌ گذاري‌ آتيه‌ دماوند,132,632663,6592254850,10840,10570,10540,-300,-2.77,10690,-150,-1.38,10340,10580,1400-8-24,2021-11-15
592,وكادو,تكادو,131,939123,15370616415,16847,16410,16342,-505,-3,16367,-480,-2.85,16342,16455,1400-8-24,2021-11-15
593,تسه9903,امتياز تسهيلات مسكن خرداد99,130,2252,1818235916,810016,790000,770001,-40015,-4.94,807387,-2629,-0.32,770001,850000,1400-8-24,2021-11-15
594,ماني,صندوق س. با درآمد ثابت ماني,129,3211111,33631132996,10468,10474,10475,7,0.07,10473,5,0.05,10473,10475,1400-8-24,2021-11-15
595,لوتوس,تامين سرمايه لوتوس پارسيان,129,655418,3735104080,5760,5660,5700,-60,-1.04,5750,-10,-0.17,5650,5750,1400-8-24,2021-11-15
596,زرين,صندوق س. سهام زرين كوروش-س,128,474783,6251337732,13650,13468,13246,-404,-2.96,13167,-483,-3.54,12940,13498,1400-8-24,2021-11-15
597,كخاك,صنايع‌خاك‌چيني‌ايران‌,128,160782,4431801840,28070,27410,27520,-550,-1.96,27930,-140,-0.5,27380,28550,1400-8-24,2021-11-15
598,كشرق,صنعتي و معدني شمال شرق شاهرود,126,76772,5415183564,73078,71070,70000,-3078,-4.21,72113,-965,-1.32,70000,73290,1400-8-24,2021-11-15
599,ضفلا1163,اختيارخ فولاد-10000-1400/11/24,125,1076,2569349000,2788,2600,2250,-538,-19.3,2388,-400,-14.35,2250,2600,1400-8-24,2021-11-15
600,دفارا,داروسازي‌ فارابي‌,124,249876,3658882100,14990,14630,14590,-400,-2.67,14900,-90,-0.6,14440,14860,1400-8-24,2021-11-15
601,مارون,پتروشيمي مارون,122,49599,9017004168,182448,184498,180500,-1948,-1.07,182389,-59,-0.03,179012,184498,1400-8-24,2021-11-15
602,خاتم,صندوق س خاتم ايساتيس پويا-ثابت,122,3760705,46278487513,12299,12307,12307,8,0.07,12306,7,0.06,12305,12308,1400-8-24,2021-11-15
603,لوتوسح,ح . تامين سرمايه لوتوس پارسيان,121,1085163,4749367922,4387,4387,4400,13,0.3,4377,-10,-0.23,4300,4430,1400-8-24,2021-11-15
604,فيروزه,صندوق شاخص30 شركت فيروزه- سهام,121,41781,7372712480,178570,179000,175010,-3560,-1.99,176460,-2110,-1.18,175000,179700,1400-8-24,2021-11-15
605,داريوش,صندوق س. ثروت داريوش -س,120,411334,4026109690,9900,9880,9840,-60,-0.61,9788,-112,-1.13,9200,9900,1400-8-24,2021-11-15
606,وپخش,داروپخش‌ (هلدينگ‌,119,214094,6850840060,31320,32480,32000,680,2.17,31420,100,0.32,30510,32480,1400-8-24,2021-11-15
607,فوكا,فولاد كاويان,118,363283,5167324090,14659,14220,14220,-439,-2.99,14593,-66,-0.45,14220,14450,1400-8-24,2021-11-15
608,دسبحان,سبحان دارو,117,196463,3032443930,15630,15030,15170,-460,-2.94,15590,-40,-0.26,15000,15700,1400-8-24,2021-11-15
609,تسه9901,امتياز تسهيلات مسكن فروردين99,116,1201,960567647,809979,770009,800000,-9979,-1.23,799807,-10172,-1.26,770009,812000,1400-8-24,2021-11-15
610,دسبحا,گروه دارويي سبحان,116,325866,6014024140,18880,18550,19250,370,1.96,18770,-110,-0.58,18000,19250,1400-8-24,2021-11-15
611,شاملا,معدني‌ املاح‌  ايران‌,115,206826,6198525210,31120,30500,30000,-1120,-3.6,30620,-500,-1.61,29820,30550,1400-8-24,2021-11-15
612,تسه9812,امتياز تسهيلات مسكن اسفند98,114,1463,1164408351,811952,775020,777460,-34492,-4.25,795905,-16047,-1.98,773000,825000,1400-8-24,2021-11-15
613,حخزر,كشتيراني درياي خزر,111,248605,4066091051,16898,17100,16315,-583,-3.45,16743,-155,-0.92,16315,17100,1400-8-24,2021-11-15
614,وبازار,صندوق س شاخصي بازارآشنا,110,344971,4375685700,13010,12790,12700,-310,-2.38,12680,-330,-2.54,12590,12950,1400-8-24,2021-11-15
615,ثالوند,سرمايه گذاري مسكن الوند,110,1551664,13528958416,8304,8719,8719,415,5,8653,349,4.2,8719,8719,1400-8-24,2021-11-15
616,حسينا,توسعه خدمات دريايي وبندري سينا,110,84213,3753045736,45249,46648,44360,-889,-1.96,45075,-174,-0.38,44310,46648,1400-8-24,2021-11-15
617,شزنگ,تجهيزنيروي‌زنگان‌,109,75307,11104770220,143166,147460,147460,4294,3,147460,4294,3,147460,147460,1400-8-24,2021-11-15
618,تسه9809,امتياز تسهيلات مسكن آذر98,108,2332,1834287301,804257,801000,796000,-8257,-1.03,786573,-17684,-2.2,764045,819998,1400-8-24,2021-11-15
619,گوهران,سرمايه گذاري توسعه گوهران اميد,107,669199,3420786815,5093,5000,5095,2,0.04,5097,4,0.08,5000,5200,1400-8-24,2021-11-15
620,پرداخت,به پرداخت ملت,106,141267,1903677470,13650,13790,13460,-190,-1.39,13630,-20,-0.15,13210,13870,1400-8-24,2021-11-15
621,سنير,سيمان‌ سفيد ني‌ريز,105,103372,4045980080,37280,39140,39140,1860,4.99,38360,1080,2.9,39140,39140,1400-8-24,2021-11-15
622,داسوه,داروسازي‌ اسوه‌,103,186311,4470361480,24580,23700,23650,-930,-3.78,24400,-180,-0.73,23540,24510,1400-8-24,2021-11-15
623,شساخت,مهندسي و ساختمان صنايع نفت,101,584014,25251294266,43221,44000,43400,179,0.41,43231,10,0.02,41925,44400,1400-8-24,2021-11-15
624,دسينا,داروسازي‌ سينا,99,294505,6306910370,21690,21800,21000,-690,-3.18,21570,-120,-0.55,20720,21950,1400-8-24,2021-11-15
625,سيدكو,سرمايه گذاري توسعه صنايع سيمان,98,1149985,7131138130,6290,6190,6060,-230,-3.66,6250,-40,-0.64,6050,6290,1400-8-24,2021-11-15
626,سهگمت,سيمان‌هگمتان‌,96,89467,2023326230,23330,23900,22510,-820,-3.51,23230,-100,-0.43,22450,23900,1400-8-24,2021-11-15
627,پرديس,سرمايه گذاري پرديس,96,2996205,10432785810,3317,3482,3482,165,4.97,3421,104,3.14,3482,3482,1400-8-24,2021-11-15
628,پلوله,گازلوله‌,95,325986,9518644666,28351,28881,29201,850,3,29084,733,2.59,28881,29201,1400-8-24,2021-11-15
629,ولانا,شركت ليزينگ آريا دانا,95,367572,5549234484,14658,15097,15097,439,2.99,14981,323,2.2,15097,15097,1400-8-24,2021-11-15
630,زعف0008پ08,زعفران0008نگين روستا(پ),94,46320,10667300024,231946,230023,234000,2054,0.89,230296,-1650,-0.71,225556,235522,1400-8-24,2021-11-15
631,اخزا910,اسنادخزانه-م10بودجه99-020807,93,193217,126368305579,654243,650011,654495,252,0.04,654023,-220,-0.03,650011,654495,1400-8-24,2021-11-15
632,كپرور,فرآوري زغال سنگ پروده طبس,92,173862,5396958629,31574,30824,30800,-774,-2.45,31377,-197,-0.62,30800,31900,1400-8-24,2021-11-15
633,وتوشه,سرمايه‌ گذاري‌ پارس‌ توشه‌,92,899996,5410540000,6080,6020,5950,-130,-2.14,6050,-30,-0.49,5950,6100,1400-8-24,2021-11-15
634,شفا,سرمايه گذاري شفادارو,91,302414,12550181000,43680,41500,41500,-2180,-4.99,42280,-1400,-3.21,41500,41500,1400-8-24,2021-11-15
635,آتيمس,صندوق س.آرمان آتيه درخشان مس-س,89,11641,2190477183,191861,189000,186000,-5861,-3.05,188169,-3692,-1.92,186000,190499,1400-8-24,2021-11-15
636,كهربا,صندوق س.پشتوانه سكه طلا كهربا,89,417497,4479527970,10983,10820,10710,-273,-2.49,10729,-254,-2.31,10646,10820,1400-8-24,2021-11-15
637,شفن,پتروشيمي فناوران,88,1922108,26332879600,13050,13700,13700,650,4.98,13190,140,1.07,13700,13700,1400-8-24,2021-11-15
638,اراد50,مرابحه عام دولت5-ش.خ0302,87,1042000,1042000035000,1000000,1000000,1000001,1,0,1000000,0,0,1000000,1000001,1400-8-24,2021-11-15
639,ارمغان,ص سرمايه گذاري ارمغان ايرانيان,87,1085781,10906077307,10040,10041,10040,0,0,10044,4,0.04,10040,10055,1400-8-24,2021-11-15
640,لسرما,سرما آفرين‌,86,704513,13265979790,17940,18830,18830,890,4.96,18680,740,4.12,18830,18830,1400-8-24,2021-11-15
641,وامين,س. امين توان آفرين ساز,85,297792,3766421581,12767,12767,12790,23,0.18,12758,-9,-0.07,12600,12790,1400-8-24,2021-11-15
642,سكه0012پ04,تمام سكه طرح جديد0012صادرات,84,13000,16118731200,1261179,1240000,1244998,-16181,-1.28,1239902,-21277,-1.69,1235000,1245000,1400-8-24,2021-11-15
643,دالبر,البرزدارو,84,253155,3298268310,13130,13130,12960,-170,-1.29,13110,-20,-0.15,12600,13350,1400-8-24,2021-11-15
644,ثزاگرس,سرمايه گذاري توسعه عمران زاگرس,82,95545,3284075644,35322,33582,33758,-1564,-4.43,34989,-333,-0.94,33582,35500,1400-8-24,2021-11-15
645,آساس,صندوق س.آسمان آرماني سهام-س,81,34520,5954455700,174290,175790,170313,-3977,-2.28,172493,-1797,-1.03,170311,175790,1400-8-24,2021-11-15
646,سپاس,صندوق س. پاداش سهامداري-ثابت,79,1023972,10290823144,10044,10050,10052,8,0.08,10050,6,0.06,10049,10053,1400-8-24,2021-11-15
647,وآفري,بيمه كارآفرين,78,1303872,4396250285,3291,3222,3389,98,2.98,3319,28,0.85,3222,3389,1400-8-24,2021-11-15
648,تشتاد,صنايع توليدي اشتاد ايران‌,77,486645,2586449760,5475,5321,5311,-164,-3,5431,-44,-0.8,5311,5340,1400-8-24,2021-11-15
649,اخزا006,اسنادخزانه-م6بودجه00-030723,77,597002,316917385150,529317,531990,531960,2643,0.5,530848,1531,0.29,530000,532000,1400-8-24,2021-11-15
650,ضشنا1049,اختيارخ شپنا-6540-1400/10/19,76,3092,3117735000,1390,1300,1000,-390,-28.06,1008,-382,-27.48,992,1300,1400-8-24,2021-11-15
651,وآتوس,س.آرين توسكا قيمت اسمي 350ريال,75,68264,1788478871,25534,26289,26300,766,3,25685,151,0.59,25140,26300,1400-8-24,2021-11-15
652,ضشنا1048,اختيارخ شپنا-5450-1400/10/19,74,903,1902925000,2407,2201,1989,-418,-17.37,2107,-300,-12.46,1989,2215,1400-8-24,2021-11-15
653,قزوين,كارخانجات‌ قند قزوين‌,72,50584,1469751690,30300,28960,28810,-1490,-4.92,30170,-130,-0.43,28810,30470,1400-8-24,2021-11-15
654,سبجنو,سيمان‌ بجنورد,72,72346,2622329910,36700,37370,36660,-40,-0.11,36620,-80,-0.22,35500,37370,1400-8-24,2021-11-15
655,فن آوا,گروه فن آوا,71,341215,7700225376,21931,22335,22588,657,3,22395,464,2.12,21701,22588,1400-8-24,2021-11-15
656,ضملت1133,اختيارخ وبملت-3000-1400/11/13,71,2605,1510997000,695,688,550,-145,-20.86,580,-115,-16.55,504,688,1400-8-24,2021-11-15
657,ضفلا1164,اختيارخ فولاد-12000-1400/11/24,68,872,1057063000,1552,1500,1200,-352,-22.68,1212,-340,-21.91,1146,1500,1400-8-24,2021-11-15
658,سكه0011پ02,تمام سكه طرح جديد0011ملت,68,9900,12281307600,1269981,1250000,1240100,-29881,-2.35,1240536,-29445,-2.32,1230002,1250000,1400-8-24,2021-11-15
659,سمتاز,سيمان ممتازان كرمان,65,160475,2427261855,15570,15313,15104,-466,-2.99,15457,-113,-0.73,15103,15388,1400-8-24,2021-11-15
660,فالوم,آلومتك‌,63,353792,8265996288,22684,23364,23364,680,3,23246,562,2.48,23364,23364,1400-8-24,2021-11-15
661,اخزا901,اسنادخزانه-م1بودجه99-010621,62,188994,158216319587,836615,835000,837000,385,0.05,837150,535,0.06,835000,837600,1400-8-24,2021-11-15
662,آكورد2,صندوق س. آرمان آتي كوثر-د,62,6200000,6200000,35193,1,1,-35192,-100,1,-35192,-100,1,1,1400-8-24,2021-11-15
663,قشهد,شهد,61,124650,1841769220,15210,14650,14740,-470,-3.09,15160,-50,-0.33,14650,15150,1400-8-24,2021-11-15
664,اخزا004,اسنادخزانه-م4بودجه00-030522,61,347593,191589094991,549599,550000,549521,-78,-0.01,551188,1589,0.29,548504,552100,1400-8-24,2021-11-15
665,زعف0110پ05,زعفران0110نگين زرين(پ),60,11627,3488258300,302564,300105,300000,-2564,-0.85,300014,-2550,-0.84,300000,300105,1400-8-24,2021-11-15
666,واحصا,احياء صنايع خراسان,60,34084,1707145149,51628,50080,50080,-1548,-3,51348,-280,-0.54,50080,50707,1400-8-24,2021-11-15
667,زعف0008پ05,زعفران0008نگين زرين(پ),57,32331,7923941747,236405,236482,245000,8595,3.64,245088,8683,3.67,236482,245408,1400-8-24,2021-11-15
668,زعف0008پ15,زعفران0008پوشالمعمول طلاسرخ(پ),55,44881,10009578810,212410,223030,223030,10620,5,223025,10615,5,215000,223030,1400-8-24,2021-11-15
669,اخزا917,اسنادخزانه-م17بودجه99-010226,55,177097,158948660774,897229,896341,897450,221,0.02,897523,294,0.03,896341,899890,1400-8-24,2021-11-15
670,ضملت1134,اختيارخ وبملت-3500-1400/11/13,55,2253,671034000,424,310,300,-124,-29.25,298,-126,-29.72,290,310,1400-8-24,2021-11-15
671,ضپال2007,اختيارخ اپال-32000-1401/02/12,54,1100,429524000,409,391,380,-29,-7.09,390,-19,-4.65,378,409,1400-8-24,2021-11-15
672,ضملت1135,اختيارخ وبملت-4000-1400/11/13,53,2179,424031000,262,201,199,-63,-24.05,195,-67,-25.57,170,202,1400-8-24,2021-11-15
673,اخزا902,اسنادخزانه-م2بودجه99-011019,52,143102,111595725906,779959,779959,780000,41,0.01,779833,-126,-0.02,778200,780500,1400-8-24,2021-11-15
674,اخزا903,اسنادخزانه-م3بودجه99-011110,52,185618,142944062643,770013,768801,770000,-13,0,770098,85,0.01,768801,771000,1400-8-24,2021-11-15
675,صنوين,صندوق سرمايه‌گذاري صنوين-مختلط,49,36555,3634307910,99000,97170,98060,-940,-0.95,99420,420,0.42,97170,100810,1400-8-24,2021-11-15
676,زعف0110پ18,زعفران0110نگين بهرامن(پ),47,16090,4860842521,301058,306997,292999,-8059,-2.68,302103,1045,0.35,290501,307000,1400-8-24,2021-11-15
677,اخزا007,اسنادخزانه-م7بودجه00-030912,44,190702,98137206886,514043,511555,514610,567,0.11,514610,567,0.11,511021,517000,1400-8-24,2021-11-15
678,زعف0008پ20,زعفران0008نگين وحدت جام(پ),43,12867,2902047586,229124,223501,229000,-124,-0.05,225542,-3582,-1.56,222036,234000,1400-8-24,2021-11-15
679,اخزا003,اسنادخزانه-م3بودجه00-030418,43,101439,56994353184,560113,559609,561100,987,0.18,561858,1745,0.31,559609,562999,1400-8-24,2021-11-15
680,برن0104پ01,برنج طارم0104تجارت مازندران(پ),43,4024,1791557030,450643,451000,443000,-7643,-1.7,445218,-5425,-1.2,443000,451000,1400-8-24,2021-11-15
681,اخزا914,اسنادخزانه-م14بودجه99-021025,42,140902,88068193027,625136,624556,625101,-35,-0.01,625032,-104,-0.02,624556,626899,1400-8-24,2021-11-15
682,ضشنا1047,اختيارخ شپنا-4905-1400/10/19,42,328,934862000,3257,3001,2800,-457,-14.03,2850,-407,-12.5,2800,3001,1400-8-24,2021-11-15
683,اخزا008,اسنادخزانه-م8بودجه00-030919,41,169284,86957649885,511857,513986,514000,2143,0.42,513679,1822,0.36,511500,514689,1400-8-24,2021-11-15
684,زعف0008پ12,زعفران0008پوشالمعمول سحرخيز(پ),41,17580,3896518727,212410,223030,221000,8590,4.04,221645,9235,4.35,215500,223030,1400-8-24,2021-11-15
685,سكه0112پ03,تمام سكه طرح جديد0112سامان,41,5200,6462526000,1264780,1238001,1245900,-18880,-1.49,1242793,-21987,-1.74,1238000,1249297,1400-8-24,2021-11-15
686,فكمند,گسترش قطعه سازي كمند,40,210847,7046085046,31827,33418,33418,1591,5,32874,1047,3.29,33418,33418,1400-8-24,2021-11-15
687,وجامي,سرمايه گذاري جامي,39,143543,1180067003,8475,8221,8221,-254,-3,8442,-33,-0.39,8221,8221,1400-8-24,2021-11-15
688,غشوكو,شوكو پارس,38,48941,428037986,9016,8746,8746,-270,-2.99,9003,-13,-0.14,8746,8746,1400-8-24,2021-11-15
689,اخزا911,اسنادخزانه-م11بودجه99-020906,37,323840,208259259544,642247,641509,643000,753,0.12,643093,846,0.13,641509,644980,1400-8-24,2021-11-15
690,اخزا904,اسنادخزانه-م4بودجه99-011215,37,202000,152433248492,754499,754631,754500,1,0,754620,121,0.02,754500,758000,1400-8-24,2021-11-15
691,ثاژن,سخت آژند,37,721261,4014538726,5797,5566,5566,-231,-3.98,5597,-200,-3.45,5566,5566,1400-8-24,2021-11-15
692,اخزا815,اسنادخزانه-م15بودجه98-010406,36,149229,130612059702,874628,870998,874846,218,0.02,875246,618,0.07,870997,876999,1400-8-24,2021-11-15
693,اخزا809,اسنادخزانه-م9بودجه98-000923,36,44107,43338718478,981464,982000,982997,1533,0.16,982581,1117,0.11,980900,983000,1400-8-24,2021-11-15
694,گوهر2,صندوق سكه طلاي كيان,35,350000,350000,63352,1,1,-63351,-100,1,-63351,-100,1,1,1400-8-24,2021-11-15
695,ضصاد1113,اختيارخ وبصادر-2000-1400/11/06,34,1952,463962000,315,280,230,-85,-26.98,238,-77,-24.44,226,289,1400-8-24,2021-11-15
696,ضبدر1164,اختيارخ شبندر-7000-1400/11/13,33,1376,1032000000,1000,750,750,-250,-25,750,-250,-25,750,750,1400-8-24,2021-11-15
697,خفناور,مهندسي صنعتي روان فن آور,33,69444,2693177208,40823,38782,38782,-2041,-5,40231,-592,-1.45,38782,38782,1400-8-24,2021-11-15
698,اگ010155,گام بانك اقتصاد نوين0101,32,275500,249449030500,905000,907700,905001,1,0,905441,441,0.05,905000,907700,1400-8-24,2021-11-15
699,ضغدر1130,اختيارخ وغدير-10000-1400/11/20,31,276,1762020000,7500,6660,6200,-1300,-17.33,6384,-1116,-14.88,6200,6670,1400-8-24,2021-11-15
700,اخزا001,اسنادخزانه-م1بودجه00-030821,30,80688,42125825556,520412,526459,522083,1671,0.32,522083,1671,0.32,519002,523490,1400-8-24,2021-11-15
701,اخزا812,اسنادخزانه-م12بودجه98-001111,30,120858,115418320885,954800,955000,955000,200,0.02,954991,191,0.02,954002,955500,1400-8-24,2021-11-15
702,سكه0111پ05,تمام سكه طرح جديد0111آينده,30,5800,7202619800,1252014,1241850,1239000,-13014,-1.04,1241831,-10183,-0.81,1239000,1244000,1400-8-24,2021-11-15
703,افق ملت,صندوق س در سهام افق ملت,30,30368,4428686100,147180,146500,145000,-2180,-1.48,145830,-1350,-0.92,145000,146500,1400-8-24,2021-11-15
704,وسنا,سرمايه گذاري نيروگاهي ايران,30,233413,2851704208,12593,12216,12216,-377,-2.99,12530,-63,-0.5,12216,12404,1400-8-24,2021-11-15
705,پلاست,كارخانجات توليدي پلاستيران,30,64501,526650665,7928,8165,8165,237,2.99,7940,12,0.15,8165,8165,1400-8-24,2021-11-15
706,الماس,صندوق س.امين تدبيرگران فردا-س,29,3838,409926036,108128,108000,106360,-1768,-1.64,106807,-1321,-1.22,106360,108900,1400-8-24,2021-11-15
707,اخزا908,اسنادخزانه-م8بودجه99-020606,29,206566,140497021720,679998,675709,680000,2,0,680156,158,0.02,675709,681000,1400-8-24,2021-11-15
708,اوصتا,صندوق انديشه ورزان صباتامين -د,28,267039,5477649441,20501,20511,20513,12,0.06,20513,12,0.06,20511,20513,1400-8-24,2021-11-15
709,ضشنا1051,اختيارخ شپنا-8719-1400/10/19,27,903,118091000,160,198,121,-39,-24.38,131,-29,-18.13,121,198,1400-8-24,2021-11-15
710,زعف0110پ10,زعفران0110نگين طلاي سرخ(پ),27,14270,4261795756,299561,302307,293900,-5661,-1.89,298654,-907,-0.3,283137,304001,1400-8-24,2021-11-15
711,فيروزا,صندوق بادرآمد ثابت فيروزه آسيا,27,118869,3052348515,25677,25700,25697,20,0.08,25678,1,0,25663,25700,1400-8-24,2021-11-15
712,زعف0008پ11,زعفران0008نگين سحرخيز(پ),26,38904,9466514064,237476,245408,238500,1024,0.43,243330,5854,2.47,230000,245408,1400-8-24,2021-11-15
713,ثبات,صندوق س. ثبات ويستا -د,26,345958,3594738082,10386,10390,10390,4,0.04,10391,5,0.05,10390,10391,1400-8-24,2021-11-15
714,ضترا1135,اختيارخ شتران-6176-1400/11/10,25,186,36729934,112,60,89,-23,-20.54,87,-25,-22.32,60,90,1400-8-24,2021-11-15
715,ضجار1020,اختيارخ وتجارت-1600-1400/10/15,25,969,451210000,535,560,450,-85,-15.89,466,-69,-12.9,428,560,1400-8-24,2021-11-15
716,ضصاد1111,اختيارخ وبصادر-1600-1400/11/06,24,920,404586000,563,451,423,-140,-24.87,440,-123,-21.85,420,460,1400-8-24,2021-11-15
717,اخزا918,اسنادخزانه-م18بودجه99-010323,24,67050,59241206000,882719,883000,885000,2281,0.26,883538,819,0.09,883000,885000,1400-8-24,2021-11-15
718,آرمان,بيمه آرمان,23,307937,1787054731,5982,5803,5803,-179,-2.99,5949,-33,-0.55,5803,5915,1400-8-24,2021-11-15
719,ضشنا1046,اختيارخ شپنا-4360-1400/10/19,23,203,718784000,4130,3500,3530,-600,-14.53,3541,-589,-14.26,3500,3550,1400-8-24,2021-11-15
720,اخزا816,اسنادخزانه-م16بودجه98-010503,23,204684,176307082750,861024,860000,861000,-24,0,861362,338,0.04,860000,861505,1400-8-24,2021-11-15
721,اخزا811,اسنادخزانه-م11بودجه98-001013,23,114248,110924226094,970796,971000,972399,1603,0.17,970907,111,0.01,970604,972399,1400-8-24,2021-11-15
722,داريك,صندوق س.اعتماد داريك-د,23,422634,5011249711,11851,11857,11859,8,0.07,11857,6,0.05,11857,11859,1400-8-24,2021-11-15
723,اخزا817,اسنادخزانه-م17بودجه98-010512,22,235940,202156045568,856500,850026,856900,400,0.05,856811,311,0.04,850026,857001,1400-8-24,2021-11-15
724,دشيري,شيرين دارو,21,3694,493052956,137602,133474,133474,-4128,-3,137383,-219,-0.16,133474,133474,1400-8-24,2021-11-15
725,وحافظ,بيمه حافظ,21,61925,570143475,9691,9207,9207,-484,-4.99,9662,-29,-0.3,9207,9207,1400-8-24,2021-11-15
726,وملت,سرمايه گذاري ملت,21,243279,687263175,2882,2825,2825,-57,-1.98,2874,-8,-0.28,2825,2825,1400-8-24,2021-11-15
727,فراز,صندوق س.سهام فراز داريك-س,21,90746,1286961435,14181,14199,14182,1,0.01,14182,1,0.01,14182,14199,1400-8-24,2021-11-15
728,ضپاس1013,اختيارخ وپارس-3000-1400/10/22,21,1563,83623000,65,54,55,-10,-15.38,54,-11,-16.92,41,55,1400-8-24,2021-11-15
729,زعف0008پ16,زعفران0008نگين بيرجند(پ),21,8070,1844151819,228967,222036,229899,932,0.41,228519,-448,-0.2,222036,233500,1400-8-24,2021-11-15
730,ضبدر1165,اختيارخ شبندر-8000-1400/11/13,21,522,186300000,364,430,365,1,0.27,357,-7,-1.92,200,430,1400-8-24,2021-11-15
731,اخزا005,اسنادخزانه-م5بودجه00-030626,20,116411,62520399167,538118,533012,537104,-1014,-0.19,537066,-1052,-0.2,533012,539000,1400-8-24,2021-11-15
732,امين يكم2,صندوق درآمد ثابت امين يكم فردا,20,20000000,20000000,10115,1,1,-10114,-99.99,1,-10114,-99.99,1,1,1400-8-24,2021-11-15
733,اعتلاح,ح سرمايه گذاري اعتلاء البرز,20,256427,610296260,6341,2380,2380,-3961,-62.47,2380,-3961,-62.47,2380,2380,1400-8-24,2021-11-15
734,ثجوان,تامين مسكن جوانان,19,135675,742006575,5638,5469,5469,-169,-3,5625,-13,-0.23,5469,5469,1400-8-24,2021-11-15
735,زير0103پ01,زيره سبز0103كيميابذر(پ),19,231,210700000,907648,870000,920000,12352,1.36,912121,4473,0.49,860000,920000,1400-8-24,2021-11-15
736,زعف0110پ20,زعفران0110نگين وحدت جام(پ),19,6447,1937048898,299498,309074,301000,1502,0.5,300457,959,0.32,279662,309074,1400-8-24,2021-11-15
737,گنجين,صندوق س. گنجينه يكم آويد-د,19,172060,2432466472,14131,14137,14147,16,0.11,14137,6,0.04,14137,14147,1400-8-24,2021-11-15
738,ضفلا1160,اختيارخ فولاد-7000-1400/11/24,18,40,201553000,5900,5500,4850,-1050,-17.8,5039,-861,-14.59,4850,5500,1400-8-24,2021-11-15
739,اخزا818,اسنادخزانه-م18بودجه98-010614,18,103517,86990487376,839605,840701,840010,405,0.05,840350,745,0.09,840010,841009,1400-8-24,2021-11-15
740,زعف0110پ16,زعفران0110نگين بيرجند(پ),18,8835,2648942261,302473,305000,291999,-10474,-3.46,299824,-2649,-0.88,285201,306000,1400-8-24,2021-11-15
741,تمحركه,ماشين سازي نيرو محركه,18,21676,427255636,20320,19711,19711,-609,-3,20293,-27,-0.13,19711,19711,1400-8-24,2021-11-15
742,ضملي1162,اختيارخ فملي-8000-1400/11/03,17,285,171357000,670,657,572,-98,-14.63,601,-69,-10.3,572,657,1400-8-24,2021-11-15
743,اخزا909,اسنادخزانه-م9بودجه99-020316,17,126728,90568657915,714743,713101,714743,0,0,714670,-73,-0.01,713101,714743,1400-8-24,2021-11-15
744,اطلس2,صندوق س.توسعه اندوخته آينده-س,17,170000,170000,254090,1,1,-254089,-100,1,-254089,-100,1,1,1400-8-24,2021-11-15
745,سي تيپ2ن04,گواهي سيمان تيپ2فارس نو(ن),15,747000,3702132000,4812,4956,4956,144,2.99,4812,0,0,4956,4956,1400-8-24,2021-11-15
746,سخواف,سيمان مجد خواف,15,19025,144913425,7852,7617,7617,-235,-2.99,7848,-4,-0.05,7617,7617,1400-8-24,2021-11-15
747,اخزا821,اسنادخزانه-م21بودجه98-020906,15,100151,64328016520,637161,643000,642500,5339,0.84,642310,5149,0.81,642309,643000,1400-8-24,2021-11-15
748,زعف0008پ09,زعفران0008نگين نوين(پ),15,18938,4268444000,231925,227300,230000,-1925,-0.83,225390,-6535,-2.82,222200,230000,1400-8-24,2021-11-15
749,ضمخا1035,اختيارخ اخابر-7000-1400/10/26,15,277,359841000,1529,1600,1220,-309,-20.21,1299,-230,-15.04,1220,1600,1400-8-24,2021-11-15
750,سي تيپ2ن01,گواهي سيمان تيپ 2 فارس(ن),14,549000,2719197000,4809,4953,4953,144,2.99,4809,0,0,4953,4953,1400-8-24,2021-11-15
751,كهرام,توليدي گرانيت بهسرام,14,2534,237651190,95698,93785,93785,-1913,-2,95607,-91,-0.1,93785,93785,1400-8-24,2021-11-15
752,شكف,كف,14,33844,3256605056,98187,96224,96224,-1963,-2,97523,-664,-0.68,96224,96224,1400-8-24,2021-11-15
753,ساروج,بين المللي ساروج بوشهر,14,34142,578488926,16996,17165,16831,-165,-0.97,16993,-3,-0.02,16826,17166,1400-8-24,2021-11-15
754,ضستا1003,اختيارخ شستا-10000-1400/10/29,14,346,771611000,2564,2280,2219,-345,-13.46,2230,-334,-13.03,2000,2350,1400-8-24,2021-11-15
755,ثروتم,صندوق س. ثروت آفرين پارسيان-س,14,2290,201255660,89726,88782,86643,-3083,-3.44,87885,-1841,-2.05,86643,88782,1400-8-24,2021-11-15
756,ساذري,آذريت‌,13,172965,1779809850,9800,10290,10290,490,5,9883,83,0.85,10290,10290,1400-8-24,2021-11-15
757,اخزا810,اسنادخزانه-م10بودجه98-001006,13,22545,21963015806,973999,974500,974000,1,0,974186,187,0.02,973800,979000,1400-8-24,2021-11-15
758,ضفلا1165,اختيارخ فولاد-14000-1400/11/24,13,218,142868000,722,694,636,-86,-11.91,655,-67,-9.28,636,694,1400-8-24,2021-11-15
759,ضملي1161,اختيارخ فملي-7000-1400/11/03,12,403,524982000,1847,1350,1310,-537,-29.07,1303,-544,-29.45,1221,1350,1400-8-24,2021-11-15
760,دمعيار,صندوق س. توازن معيار-د,12,234019,2344712504,10024,10025,10014,-10,-0.1,10019,-5,-0.05,10014,10026,1400-8-24,2021-11-15
761,ضملت1136,اختيارخ وبملت-4500-1400/11/13,11,583,54875000,84,55,88,4,4.76,94,10,11.9,55,100,1400-8-24,2021-11-15
762,اخزا813,اسنادخزانه-م13بودجه98-010219,11,100382,90510622668,900832,901236,901650,818,0.09,901662,830,0.09,901236,901701,1400-8-24,2021-11-15
763,ضستا1005,اختيارخ شستا-14000-1400/10/29,11,456,135800000,1,290,300,299,29900,298,297,29700,290,300,1400-8-24,2021-11-15
764,ضستا1004,اختيارخ شستا-12000-1400/10/29,11,64,74647000,1446,1350,1130,-316,-21.85,1166,-280,-19.36,1130,1350,1400-8-24,2021-11-15
765,ثهام,صندوق س ثروت هامرز-سهام,11,30896,353767640,11544,11480,11350,-194,-1.68,11450,-94,-0.81,11350,11480,1400-8-24,2021-11-15
766,فباهنرح,ح . مس‌ شهيدباهنر,11,6640,160486000,24500,24500,23800,-700,-2.86,24170,-330,-1.35,23800,24500,1400-8-24,2021-11-15
767,زعف0008پ18,زعفران0008نگين بهرامن(پ),11,2563,602916000,227486,230000,237000,9514,4.18,235238,7752,3.41,230000,244500,1400-8-24,2021-11-15
768,وسخوز,شركت س استان خوزستان,11,237123,144170784,640,608,608,-32,-5,640,0,0,608,608,1400-8-24,2021-11-15
769,افاد61,منفعت دولت6-ش.خاص140109,10,250000,249999750000,999999,999999,999999,0,0,999999,0,0,999999,999999,1400-8-24,2021-11-15
770,نهال2,صندوق س. طلاي سرخ نوويرا,10,1000000,1000000,18367,1,1,-18366,-99.99,1,-18366,-99.99,1,1,1400-8-24,2021-11-15
771,نيرو,نيرو سرمايه,10,8763,316651005,37252,36135,36135,-1117,-3,37215,-37,-0.1,36135,36135,1400-8-24,2021-11-15
772,هفارس104,اختيارف ت فارس-11832-01/04/12,9,96500,96500,1,1,1,0,0,1,0,0,1,1,1400-8-24,2021-11-15
773,هبساز103,اختيارف ت ثبهساز-2346-01/03/18,9,69579,27414126,351,394,394,43,12.25,394,43,12.25,394,394,1400-8-24,2021-11-15
774,اراد61,مرابحه عام دولت61-ش.خ0309,9,51200,51200000000,1000000,1000000,1000000,0,0,1000000,0,0,1000000,1000000,1400-8-24,2021-11-15
775,صخود412,ص مرابحه خودرو412- 3ماهه 18%,9,45200,44748090400,990001,990002,990002,1,0,990002,1,0,990002,990002,1400-8-24,2021-11-15
776,سپر2,صندوق س سپر سرمايه بيدار- ثابت,9,49000000,49000000,13143,1,1,-13142,-99.99,1,-13142,-99.99,1,1,1400-8-24,2021-11-15
777,اخزا907,اسنادخزانه-م7بودجه99-020704,9,27566,18407774300,668517,668000,667710,-807,-0.12,667771,-746,-0.11,667501,668000,1400-8-24,2021-11-15
778,سي تيپ2ن02,گواهي سيمان تيپ2صوفيان(ن),8,214000,1056518000,4794,4937,4937,143,2.98,4794,0,0,4937,4937,1400-8-24,2021-11-15
779,عيار2,صندوق سكه طلاي مفيد,8,80000,80000,32086,1,1,-32085,-100,1,-32085,-100,1,1,1400-8-24,2021-11-15
780,اخزا814,اسنادخزانه-م14بودجه98-010318,8,12579,11182633994,889362,886002,889499,137,0.02,888992,-370,-0.04,886002,891000,1400-8-24,2021-11-15
781,ضبدر8079,اختيارخ شبندر-6011-1400/08/30,8,11,30455368,888,614,541,-347,-39.08,591,-297,-33.45,521,651,1400-8-24,2021-11-15
782,آسام,صندوق س.آرمان سپهر آشنا-م,8,6910,838990000,122777,122200,121200,-1577,-1.28,121417,-1360,-1.11,121200,122200,1400-8-24,2021-11-15
783,ضبدر1161,اختيارخ شبندر-4500-1400/11/13,8,35,87500000,2953,2500,2500,-453,-15.34,2500,-453,-15.34,2500,2500,1400-8-24,2021-11-15
784,ضبدر8078,اختيارخ شبندر-5157-1400/08/30,8,36,223422116,600,1700,1300,700,116.67,1325,725,120.83,1300,1700,1400-8-24,2021-11-15
785,نگين,ص.س. زمين و ساختمان نگين شهرري,8,730,38084380,51330,51830,52300,970,1.89,52170,840,1.64,51830,52330,1400-8-24,2021-11-15
786,خعمرا,توسعه و عمران شهرستان نائين,7,161924,654658732,3851,4043,4043,192,4.99,3863,12,0.31,4043,4043,1400-8-24,2021-11-15
787,اراد554,مرابحه عام دولت5-ش.خ 0209,7,52596298,49182859564271,940359,913145,913415,-26944,-2.87,935101,-5258,-0.56,913145,970985,1400-8-24,2021-11-15
788,ضملي1159,اختيارخ فملي-5000-1400/11/03,7,28,115030000,4547,4060,4150,-397,-8.73,4108,-439,-9.65,4060,4150,1400-8-24,2021-11-15
789,زعف0110پ21,زعفران0110نگين ملل(پ),7,1864,553924316,285562,302232,296000,10438,3.66,297170,11608,4.06,295001,302232,1400-8-24,2021-11-15
790,سي تيپ2ن05,گواهي سيمان تيپ 2خاش(ن),7,480000,2369760000,4794,4937,4937,143,2.98,4794,0,0,4937,4937,1400-8-24,2021-11-15
791,زعف0008پ19,زعفران0008نگين تروند قاينات(پ),7,2713,606035918,230773,225500,223000,-7773,-3.37,223382,-7391,-3.2,222999,225500,1400-8-24,2021-11-15
792,ضغدر8058,اختيارخ وغدير-10000-1400/08/26,7,21,102308000,5336,4504,5000,-336,-6.3,4872,-464,-8.7,4503,5250,1400-8-24,2021-11-15
793,جهرم,پتروشيمي جهرم,7,44812,59779208,1375,1334,1334,-41,-2.98,1375,0,0,1334,1334,1400-8-24,2021-11-15
794,ضترا1134,اختيارخ شتران-5294-1400/11/10,7,76,85465900,644,500,450,-194,-30.12,496,-148,-22.98,450,500,1400-8-24,2021-11-15
795,ضمخا1034,اختيارخ اخابر-6000-1400/10/26,6,100,189000000,2265,1850,2000,-265,-11.7,1890,-375,-16.56,1800,2000,1400-8-24,2021-11-15
796,ضپاس1011,اختيارخ وپارس-2000-1400/10/22,6,133,58150000,447,470,415,-32,-7.16,437,-10,-2.24,415,470,1400-8-24,2021-11-15
797,طلا2,صندوق س.پشتوانه طلاي لوتوس,6,600000,600000,89391,1,1,-89390,-100,1,-89390,-100,1,1,1400-8-24,2021-11-15
798,اراد874,مرابحه عام دولت87-ش.خ030304,6,90000000,80487651900000,920000,894177,894455,-25545,-2.78,894307,-25693,-2.79,894140,894455,1400-8-24,2021-11-15
799,سنوين,سرمايه گذاري اقتصاد نوين,6,6725,45824150,7024,6814,6814,-210,-2.99,7023,-1,-0.01,6814,6814,1400-8-24,2021-11-15
800,بذر,صندوق س بذر اميد آفرين-سهام,6,506,50359350,101520,99750,99400,-2120,-2.09,99520,-2000,-1.97,97700,99750,1400-8-24,2021-11-15
801,كشم0101پ01,كشمش سبز0101خليل آباد(پ),6,56,37597000,665000,668000,678500,13500,2.03,671375,6375,0.96,668000,678500,1400-8-24,2021-11-15
802,دپارسح,ح . پارس‌ دارو,6,11304,508680000,45000,45000,45000,0,0,45000,0,0,45000,45000,1400-8-24,2021-11-15
803,اخزا905,اسنادخزانه-م5بودجه99-020218,6,104880,76246256000,726488,726200,727000,512,0.07,726986,498,0.07,726200,727000,1400-8-24,2021-11-15
804,وسصفا,شركت س استان اصفهان,6,157300,109008900,729,693,693,-36,-4.94,729,0,0,693,693,1400-8-24,2021-11-15
805,اخزا820,اسنادخزانه-م20بودجه98-020806,5,100009,65465877234,654592,653026,654600,8,0,654600,8,0,653026,654600,1400-8-24,2021-11-15
806,زير0103پ04,زيره سبز0103شركت مينوبذر(پ),5,44,41772940,898418,949385,949385,50967,5.67,949385,50967,5.67,949385,949385,1400-8-24,2021-11-15
807,اراد42,مرابحه عام دولت4-ش.خ 0106,5,42000,40740000000,977426,970000,970000,-7426,-0.76,970000,-7426,-0.76,970000,970000,1400-8-24,2021-11-15
808,سي تيپ2ن07,گواهي سيمان تيپ 2تهران(ن),5,91000,539084000,5752,5924,5924,172,2.99,5752,0,0,5924,5924,1400-8-24,2021-11-15
809,ضجار1019,اختيارخ وتجارت-1400-1400/10/15,5,64,39732000,692,650,620,-72,-10.4,621,-71,-10.26,601,650,1400-8-24,2021-11-15
810,فنرژي,گسترش صنايع انرژي آذرآب,5,6946,85560828,12569,12318,12318,-251,-2,12565,-4,-0.03,12318,12318,1400-8-24,2021-11-15
811,ضجار1024,اختيارخ وتجارت-3000-1400/10/15,5,480,9600000,37,20,20,-17,-45.95,20,-17,-45.95,20,20,1400-8-24,2021-11-15
812,شسم,توليد سموم‌ علف‌ كش,5,1100,115275600,100766,104796,104796,4030,4,100855,89,0.09,104796,104796,1400-8-24,2021-11-15
813,ضفار1134,اختيارخ فارس-13400-1400/11/06,5,240,212200000,995,880,880,-115,-11.56,884,-111,-11.16,880,890,1400-8-24,2021-11-15
814,سي تيپ2ن17,گواهي سيمان تيپ2ماهان كرمان(ن),5,125000,599250000,4794,4794,4794,0,0,4794,0,0,4794,4794,1400-8-24,2021-11-15
815,گپارس,امور رفاهي كارگزاران پارس,4,309,40558722,138166,131258,131258,-6908,-5,138136,-30,-0.02,131258,131258,1400-8-24,2021-11-15
816,كباده,توليد خاك نسوزاستقلال آباده,4,3673,84633266,22371,23042,23042,671,3,22377,6,0.03,23042,23042,1400-8-24,2021-11-15
817,وسقم,شركت س استان قم,4,26500,33575500,1333,1267,1267,-66,-4.95,1333,0,0,1267,1267,1400-8-24,2021-11-15
818,تملي702,تسهيلات مسكن ب. ملي-ارديبهشت97,4,100,87953860,837661,879538,879538,41877,5,879539,41878,5,879538,879539,1400-8-24,2021-11-15
819,نتوس,پشم‌ بافي‌ توس,4,2050,25042800,12858,12216,12216,-642,-4.99,12856,-2,-0.02,12216,12216,1400-8-24,2021-11-15
820,اراد404,مرابحه عام دولت4-ش.خ 0207,4,16094000,14771464503000,1000000,883349,918300,-81700,-8.17,917824,-82176,-8.22,883349,922434,1400-8-24,2021-11-15
821,اراد864,مرابحه عام دولت86-ش.خ020404,4,72000000,66317898000000,940000,920473,920700,-19300,-2.05,921082,-18918,-2.01,920473,921662,1400-8-24,2021-11-15
822,اخزا906,اسنادخزانه-م6بودجه99-020321,4,865,615893200,711000,711701,712200,1200,0.17,712015,1015,0.14,711701,712200,1400-8-24,2021-11-15
823,ضبدر8076,اختيارخ شبندر-3448-1400/08/30,4,9,129278400,3488,3350,2900,-588,-16.86,3067,-421,-12.07,2900,3350,1400-8-24,2021-11-15
824,ضمخا1036,اختيارخ اخابر-8000-1400/10/26,4,202,242300000,1534,1200,1100,-434,-28.29,1200,-334,-21.77,1100,1200,1400-8-24,2021-11-15
825,ضجار1021,اختيارخ وتجارت-1800-1400/10/15,3,65,20100000,377,320,300,-77,-20.42,309,-68,-18.04,300,320,1400-8-24,2021-11-15
826,كابگن,توليدي و صنعتي آبگينه‌,3,52850,316307250,5868,5985,5985,117,1.99,5882,14,0.24,5985,5985,1400-8-24,2021-11-15
827,ضترا1133,اختيارخ شتران-4411-1400/11/10,3,19,30151100,997,700,700,-297,-29.79,700,-297,-29.79,700,700,1400-8-24,2021-11-15
828,هنوري102,اختيارف ت نوري59561-01/02/15,3,1731,1731,1,1,1,0,0,1,0,0,1,1,1400-8-24,2021-11-15
829,ضفلا1162,اختيارخ فولاد-9000-1400/11/24,3,45,141060000,3695,3150,3052,-643,-17.4,3135,-560,-15.16,3052,3150,1400-8-24,2021-11-15
830,سرو2,صندوق س سروسودمند مدبران-سهام,3,110000,110000,75390,1,1,-75389,-100,1,-75389,-100,1,1,1400-8-24,2021-11-15
831,زعف0110پ08,زعفران0110نگين روستا(پ),3,200,61375000,295984,306500,307000,11016,3.72,306875,10891,3.68,306500,307000,1400-8-24,2021-11-15
832,اراد314,مرابحه عام دولت3-ش.خ 0208,3,2629500,2331726445500,929000,886606,886849,-42151,-4.54,886757,-42243,-4.55,886606,886849,1400-8-24,2021-11-15
833,سي تيپ2ن11,گواهي سيمان تيپ2دورود(ن),3,77000,468930000,6090,6090,6090,0,0,6090,0,0,6090,6090,1400-8-24,2021-11-15
834,سي تيپ2ن12,گواهي سيمان تيپ2خزر(ن),3,112000,536928000,4794,4794,4794,0,0,4794,0,0,4794,4794,1400-8-24,2021-11-15
835,تملي703,تسهيلات مسكن ب. ملي-خرداد97,3,42,22890000,571211,545000,545000,-26211,-4.59,545000,-26211,-4.59,545000,545000,1400-8-24,2021-11-15
836,صخابر102,صكوك اجاره مخابرات-3 ماهه 16%,3,20596,20184080000,991500,980000,980000,-11500,-1.16,980000,-11500,-1.16,980000,980000,1400-8-24,2021-11-15
837,ضصاد1110,اختيارخ وبصادر-1400-1400/11/06,3,3,1726000,725,620,501,-224,-30.9,575,-150,-20.69,501,620,1400-8-24,2021-11-15
838,افاد614,منفعت دولت6-ش.خاص140109,3,13000000,12532753000000,999999,963957,964121,-35878,-3.59,964058,-35941,-3.59,963957,964121,1400-8-24,2021-11-15
839,اراد49,مرابحه عام دولت4-ش.خ 0206,3,2000,1905012500,948000,975000,930012,-17988,-1.9,952506,4506,0.48,930012,975000,1400-8-24,2021-11-15
840,اراد43,مرابحه عام دولت4-ش.خ 0205,3,42000,39900000000,930500,950000,950000,19500,2.1,950000,19500,2.1,950000,950000,1400-8-24,2021-11-15
841,پادا,صندوق س.پاداش سرمايه پارس-س,3,2345,261451000,113359,113400,111200,-2159,-1.9,111493,-1866,-1.65,111200,113400,1400-8-24,2021-11-15
842,سي تيپ2ن10,گواهي سيمان تيپ 2غرب(ن),3,140000,671160000,4794,4794,4794,0,0,4794,0,0,4794,4794,1400-8-24,2021-11-15
843,افاد744,منفعت دولت7-ش.خاص ساير0204,2,4000000,3778534000000,1000000,944512,944755,-55245,-5.52,944633,-55367,-5.54,944512,944755,1400-8-24,2021-11-15
844,تملي705,تسهيلات مسكن ب. ملي-مرداد97,2,14,7686010,549936,549001,549000,-936,-0.17,549001,-935,-0.17,549000,549001,1400-8-24,2021-11-15
845,اخزا0094,اسناد خزانه-م9بودجه00-031101,2,12060000,6225987060000,512000,514358,518144,6144,1.2,516251,4251,0.83,514358,518144,1400-8-24,2021-11-15
846,طفلا1163,اختيارف فولاد-10000-1400/11/24,2,2,448000,50,348,100,50,100,224,174,348,100,348,1400-8-24,2021-11-15
847,اراد834,مرابحه عام دولت83-ش.خ041220,2,26000000,22461049000000,1000000,863703,864070,-135930,-13.59,863886,-136114,-13.61,863703,864070,1400-8-24,2021-11-15
848,وسرضوي,س.سهام عدالت استان خراسان رضوي,2,58090,40140190,727,691,691,-36,-4.95,727,0,0,691,691,1400-8-24,2021-11-15
849,اراد344,مرابحه عام دولت3-ش.خ 0305,2,19586600,16561792395500,1000000,845410,845725,-154275,-15.43,845567,-154433,-15.44,845410,845725,1400-8-24,2021-11-15
850,ضفار1132,اختيارخ فارس-9400-1400/11/06,2,26,83600000,3450,3350,3000,-450,-13.04,3215,-235,-6.81,3000,3350,1400-8-24,2021-11-15
851,شبصير2,توليدات پتروشيمي قائد بصير,2,4200000,504000000000,123394,120000,120000,-3394,-2.75,120000,-3394,-2.75,120000,120000,1400-8-24,2021-11-15
852,كهربا2,صندوق س.پشتوانه سكه طلا كهربا,2,200000,200000,10983,1,1,-10982,-99.99,1,-10982,-99.99,1,1,1400-8-24,2021-11-15
853,ضفلا1166,اختيارخ فولاد-16000-1400/11/24,2,4,1000000,340,250,250,-90,-26.47,250,-90,-26.47,250,250,1400-8-24,2021-11-15
854,صايپا012,صكوك مرابحه سايپا012-3ماهه 16%,2,1505,1505001505,1000002,1000001,1000001,-1,0,1000001,-1,0,1000001,1000001,1400-8-24,2021-11-15
855,اراد884,مرابحه عام دولت88-ش.خ041120,2,21200000,18351016800000,1000000,865428,865800,-134200,-13.42,865614,-134386,-13.44,865428,865800,1400-8-24,2021-11-15
856,اراد434,مرابحه عام دولت4-ش.خ 0205,2,3136000,2915907680000,930500,929735,929900,-600,-0.06,929817,-683,-0.07,929735,929900,1400-8-24,2021-11-15
857,اخزا009,اسناد خزانه-م9بودجه00-031101,2,68,34934000,512000,511500,519500,7500,1.46,513735,1735,0.34,511500,519500,1400-8-24,2021-11-15
858,ضپاس1009,اختيارخ وپارس-1600-1400/10/22,2,35,25540000,785,720,788,3,0.38,730,-55,-7.01,720,788,1400-8-24,2021-11-15
859,لخانه,لوازم‌ خانگي‌ پارس‌,2,1190,20755980,17981,17442,17442,-539,-3,17980,-1,-0.01,17442,17442,1400-8-24,2021-11-15
860,ضپاس1012,اختيارخ وپارس-2500-1400/10/22,2,8,1950000,250,200,250,0,0,244,-6,-2.4,200,250,1400-8-24,2021-11-15
861,اراد214,مرابحه عام دولت2ش.خ صادرات0212,2,57613400,52910245317800,1000000,918503,918231,-81769,-8.18,918367,-81633,-8.16,918231,918503,1400-8-24,2021-11-15
862,داريوش2,صندوق س. ثروت داريوش -س,2,400000,400000,9900,1,1,-9899,-99.99,1,-9899,-99.99,1,1,1400-8-24,2021-11-15
863,سايرا,ايرانيت‌,2,308,10185560,34447,33070,33070,-1377,-4,34444,-3,-0.01,33070,33070,1400-8-24,2021-11-15
864,مبين014,اجاره اعتماد مبين لوتوس011019,2,9000,8775000000,970548,975000,975000,4452,0.46,975000,4452,0.46,975000,975000,1400-8-24,2021-11-15
865,اخزا8172,اسنادخزانه-م17بودجه98-010512,2,300000,257100000000,856500,857000,857000,500,0.06,857000,500,0.06,857000,857000,1400-8-24,2021-11-15
866,اراد644,مرابحه عام دولتي64-ش.خ0111,2,31820000,29879902780000,944500,939258,938800,-5700,-0.6,939029,-5471,-0.58,938800,939258,1400-8-24,2021-11-15
867,اراد134,مرابحه عام دولت1-ش.خ ساير0206,2,10000000,9384000000000,885000,937682,939118,54118,6.12,938400,53400,6.03,937682,939118,1400-8-24,2021-11-15
868,ضغدر8056,اختيارخ وغدير-8000-1400/08/26,2,2,14051000,9000,7050,7001,-1999,-22.21,7025,-1975,-21.94,7001,7050,1400-8-24,2021-11-15
869,اراد594,مرابحه عام دولتي5-ش.خ 0309,2,16000000,14286096000000,1000000,892687,893075,-106925,-10.69,892881,-107119,-10.71,892687,893075,1400-8-24,2021-11-15
870,اراد334,مرابحه عام دولت3-ش.خ 0303,2,3194000,2729095733000,963200,853889,855000,-108200,-11.23,854444,-108756,-11.29,853889,855000,1400-8-24,2021-11-15
871,سيناد,صندوق س.سپهرسودمند سينا-د,2,120000,1204540000,10036,10038,10037,1,0.01,10038,2,0.02,10037,10038,1400-8-24,2021-11-15
872,ضملت1132,اختيارخ وبملت-2500-1400/11/13,2,5,4900000,1096,980,980,-116,-10.58,980,-116,-10.58,980,980,1400-8-24,2021-11-15
873,اراد524,مرابحه عام دولت5-ش.خ 0108,2,12666000,12026791311000,1000000,949867,949200,-50800,-5.08,949533,-50467,-5.05,949200,949867,1400-8-24,2021-11-15
874,اراد654,مرابحه عام دولتي65-ش.خ0210,2,6460554,5888071388952,985500,911302,911474,-74026,-7.51,911388,-74112,-7.52,911302,911474,1400-8-24,2021-11-15
875,افاد44,منفعت دولتي4-شرايط خاص14010729,2,6000000,5813262000000,978000,968789,968965,-9035,-0.92,968877,-9123,-0.93,968789,968965,1400-8-24,2021-11-15
876,ضملي1157,اختيارخ فملي-4000-1400/11/03,2,3,18000000,5967,6000,6000,33,0.55,6000,33,0.55,6000,6000,1400-8-24,2021-11-15
877,اراد584,مرابحه عام دولت5-ش.خ 0110,2,10602000,9997739010000,960000,943210,942800,-17200,-1.79,943005,-16995,-1.77,942800,943210,1400-8-24,2021-11-15
878,اخزا9174,اسنادخزانه-م17بودجه99-010226,2,21400000,19211357800000,897229,899454,896000,-1229,-0.14,897727,498,0.06,896000,899454,1400-8-24,2021-11-15
879,ضبدر1163,اختيارخ شبندر-6000-1400/11/13,2,20,26400000,1645,1320,1320,-325,-19.76,1320,-325,-19.76,1320,1320,1400-8-24,2021-11-15
880,سي تيپ2ن13,گواهي سيمان تيپ2بجنورد(ن),2,41000,196800000,4800,4800,4800,0,0,4800,0,0,4800,4800,1400-8-24,2021-11-15
881,افاد51,منفعت دولت5-ش.خاص كاردان0108,2,35000,34999965000,999999,999999,999999,0,0,999999,0,0,999999,999999,1400-8-24,2021-11-15
882,اخزا0062,اسنادخزانه-م6بودجه00-030723,2,225000,119475000000,529317,531000,531000,1683,0.32,531000,1683,0.32,531000,531000,1400-8-24,2021-11-15
883,اراد484,مرابحه عام دولت4-ش.خ 0009,2,7108000,7088531188000,1000000,997722,996800,-3200,-0.32,997261,-2739,-0.27,996800,997722,1400-8-24,2021-11-15
884,اراد384,مرابحه عام دولت3-ش.خ 0105,2,2300000,2215774000000,1000000,963399,963361,-36639,-3.66,963380,-36620,-3.66,963361,963399,1400-8-24,2021-11-15
885,وسالت,بانك قرض الحسنه رسالت,2,5250,5680500,1051,1082,1082,31,2.95,1051,0,0,1082,1082,1400-8-24,2021-11-15
886,اخزا8154,اسنادخزانه-م15بودجه98-010406,2,6348760,5596508125120,874628,881434,881590,6962,0.8,881512,6884,0.79,881434,881590,1400-8-24,2021-11-15
887,اروند10,منفعت صبا اروند لوتوس 14001222,2,3000,3015000000,1002326,1005000,1005000,2674,0.27,1005000,2674,0.27,1005000,1005000,1400-8-24,2021-11-15
888,همبين102,اختيارف ت مبين17952-01/02/10,2,44000,44000,1,1,1,0,0,1,0,0,1,1,1400-8-24,2021-11-15
889,اراد534,مرابحه عام دولت5-ش.خ 0207,2,10000000,9208665000000,1000000,920737,920996,-79004,-7.9,920866,-79134,-7.91,920737,920996,1400-8-24,2021-11-15
890,ضغدر8057,اختيارخ وغدير-9000-1400/08/26,2,6,37450000,5805,6200,6250,445,7.67,6242,437,7.53,6200,6250,1400-8-24,2021-11-15
891,اراد244,مرابحه عام دولت2-ش.خ ساير0212,2,8000000,7361036000000,1000000,919959,920300,-79700,-7.97,920129,-79871,-7.99,919959,920300,1400-8-24,2021-11-15
892,اراد364,مرابحه عام دولت3-ش.خ 0104,2,8785600,8472810676000,966200,964325,964470,-1730,-0.18,964397,-1803,-0.19,964325,964470,1400-8-24,2021-11-15
893,ضفار1129,اختيارخ فارس-6400-1400/11/06,2,5,29400000,6510,6000,5800,-710,-10.91,5880,-630,-9.68,5800,6000,1400-8-24,2021-11-15
894,اراد494,مرابحه عام دولت4-ش.خ 0206,2,21424000,19807334248000,948000,924679,924400,-23600,-2.49,924539,-23461,-2.47,924400,924679,1400-8-24,2021-11-15
895,ضگل1156,اختيارخ كگل-28000-1400/11/17,2,40,48000000,1322,1200,1200,-122,-9.23,1200,-122,-9.23,1200,1200,1400-8-24,2021-11-15
896,اراد544,مرابحه عام دولت5-ش.خ 0109,2,21142000,20033884354000,990000,947874,947300,-42700,-4.31,947587,-42413,-4.28,947300,947874,1400-8-24,2021-11-15
897,افاد844,منفعت دولت8-ش.خاص ساير0205,2,10000000,9416460000000,950000,941546,941746,-8254,-0.87,941646,-8354,-0.88,941546,941746,1400-8-24,2021-11-15
898,اراد704,مرابحه عام دولت70-ش.خ0112,2,34228000,32024931894000,943750,935871,935400,-8350,-0.88,935635,-8115,-0.86,935400,935871,1400-8-24,2021-11-15
899,طملت1133,اختيارف وبملت-3000-1400/11/13,2,200,22000000,1,100,120,119,11900,110,109,10900,100,120,1400-8-24,2021-11-15
900,اراد854,مرابحه عام دولت85-ش.خ010704,2,31737400,30139104536000,948170,949530,949750,1580,0.17,949640,1470,0.16,949530,949750,1400-8-24,2021-11-15
901,اراد454,مرابحه عام دولت4-ش.خ 0107,2,6316000,6026446138000,998000,954311,954000,-44000,-4.41,954155,-43845,-4.39,954000,954311,1400-8-24,2021-11-15
902,اراد604,مرابحه عام دولتي6-ش.خ0210,2,6600000,6008620200000,935666,909889,910905,-24761,-2.65,910397,-25269,-2.7,909889,910905,1400-8-24,2021-11-15
903,اخزا9164,اسنادخزانه-م16بودجه99-020528,2,53636000,39318406160000,729000,734420,731700,2700,0.37,733060,4060,0.56,731700,734420,1400-8-24,2021-11-15
904,تملي712,تسهيلات مسكن ب. ملي-اسفند97,1,10,7735140,814225,773514,773514,-40711,-5,773514,-40711,-5,773514,773514,1400-8-24,2021-11-15
905,مهان024,اجاره مهرآيندگان اميد0311,1,100000,100000000000,1000000,1000000,1000000,0,0,1000000,0,0,1000000,1000000,1400-8-24,2021-11-15
906,تابان02,اجاره تابان لوتوس14021206,1,3000,2895000000,1000000,965000,965000,-35000,-3.5,965000,-35000,-3.5,965000,965000,1400-8-24,2021-11-15
907,ضپال2004,اختيارخ اپال-20000-1401/02/12,1,1,3800000,3800,3800,3800,0,0,3800,0,0,3800,3800,1400-8-24,2021-11-15
908,پست0108پ04,پسته فندقي32-30سبزدانه0108(پ),1,3,6370335,2022329,2123445,2123445,101116,5,2123445,101116,5,2123445,2123445,1400-8-24,2021-11-15
909,شرق1400,مشاركت ليزينگ ايران وشرق140010,1,8,7998400,1005997,999800,999800,-6197,-0.62,999800,-6197,-0.62,999800,999800,1400-8-24,2021-11-15
910,ضغدر8060,اختيارخ وغدير-14000-1400/08/26,1,5,6500000,1900,1300,1300,-600,-31.58,1300,-600,-31.58,1300,1300,1400-8-24,2021-11-15
911,سحرخيز2,صندوق س. گروه زعفران سحرخيز,1,4000000,4000000,18420,1,1,-18419,-99.99,1,-18419,-99.99,1,1,1400-8-24,2021-11-15
912,واميد2,گروه مديريت سرمايه گذاري اميد,1,2070000,26910000000,13050,13000,13000,-50,-0.38,13000,-50,-0.38,13000,13000,1400-8-24,2021-11-15
913,وشمال,س. چشم انداز توسعه شمال,1,67,5016223,76396,74869,74869,-1527,-2,76394,-2,0,74869,74869,1400-8-24,2021-11-15
914,ضغدر1131,اختيارخ وغدير-12000-1400/11/20,1,10,48500000,5000,4850,4850,-150,-3,4850,-150,-3,4850,4850,1400-8-24,2021-11-15
915,اراد22,مرابحه عام دولت2-ش.خ لوتوس0212,1,1000,1000000000,990000,1000000,1000000,10000,1.01,1000000,10000,1.01,1000000,1000000,1400-8-24,2021-11-15
916,ضفلا1161,اختيارخ فولاد-8000-1400/11/24,1,3,12900000,4890,4300,4300,-590,-12.07,4300,-590,-12.07,4300,4300,1400-8-24,2021-11-15
917,امين يكم4,صندوق درآمد ثابت امين يكم فردا,1,49410000,500325660000,10115,10126,10126,11,0.11,10126,11,0.11,10126,10126,1400-8-24,2021-11-15
918,افاد53,منفعت دولت5-ش.خاص كاريزما0108,1,25000,24992175000,999687,999687,999687,0,0,999687,0,0,999687,999687,1400-8-24,2021-11-15
919,زعف0110پ19,زعفران0110نگين تروند قاينات(پ),1,20,5986240,287000,299312,299312,12312,4.29,299312,12312,4.29,299312,299312,1400-8-24,2021-11-15
920,ضپنا1032,اختيارخ رمپنا-15850-1400/10/08,1,2,5400000,1830,2700,2700,870,47.54,2700,870,47.54,2700,2700,1400-8-24,2021-11-15
921,سي تيپ2ن06,گواهي سيمان تيپ 2شاهرود(ن),1,11000,52734000,4794,4794,4794,0,0,4794,0,0,4794,4794,1400-8-24,2021-11-15
922,كهمدا2,شيشه‌ همدان‌,1,10000000,87000000000,9110,8700,8700,-410,-4.5,8700,-410,-4.5,8700,8700,1400-8-24,2021-11-15
923,ضخوز1022,اختيارخ فخوز-5000-1400/10/12,1,1,6000000,4500,2500,2500,-2000,-44.44,2500,-2000,-44.44,2500,2500,1400-8-24,2021-11-15
924,ضذوب900,اختيارخ ذوب-2500-14000917,1,13,18200000,1729,1400,1400,-329,-19.03,1400,-329,-19.03,1400,1400,1400-8-24,2021-11-15
925,آريا2,پليمر آريا ساسول,1,2485000,294472500000,120311,118500,118500,-1811,-1.51,118500,-1811,-1.51,118500,118500,1400-8-24,2021-11-15
926,ضپنا1034,اختيارخ رمپنا-19850-1400/10/08,1,10,4010000,356,401,401,45,12.64,401,45,12.64,401,401,1400-8-24,2021-11-15
927,اراد33,مرابحه عام دولت3-ش.خ 0303,1,1000,943190000,963200,943190,943190,-20010,-2.08,943190,-20010,-2.08,943190,943190,1400-8-24,2021-11-15
928,ضمخا1038,اختيارخ اخابر-10000-1400/10/26,1,1,300000,300,300,300,0,0,300,0,0,300,300,1400-8-24,2021-11-15
929,کمآذر,کم باري آذر,1,2500,1300000,250000,520,520,-249480,-99.79,520,-249480,-99.79,520,520,1400-8-24,2021-11-15
930,ضمخا1039,اختيارخ اخابر-12000-1400/10/26,1,2,200000,52,100,100,48,92.31,100,48,92.31,100,100,1400-8-24,2021-11-15
931,ياقوت2,صندوق س ياقوت آگاه-ثابت,1,11041000,11041000,13568,1,1,-13567,-99.99,1,-13567,-99.99,1,1,1400-8-24,2021-11-15
932,داراب,پتروشيمي داراب,1,4500,9760500,2236,2169,2169,-67,-3,2236,0,0,2169,2169,1400-8-24,2021-11-15
933,ضذوب904,اختيارخ ذوب-4500-14000917,1,100,6000000,150,60,60,-90,-60,60,-90,-60,60,60,1400-8-24,2021-11-15
934,ضمخا1037,اختيارخ اخابر-9000-1400/10/26,1,20,13000000,633,650,650,17,2.69,650,17,2.69,650,650,1400-8-24,2021-11-15
935,كباده2,توليد خاك نسوزاستقلال آباده,1,1000,23042000,22371,23042,23042,671,3,23042,671,3,23042,23042,1400-8-24,2021-11-15
936,کم ر 7,کم باري روز 7,1,3000,1740000,570,580,580,10,1.75,580,10,1.75,580,580,1400-8-24,2021-11-15
937,ومدير2,گ.مديريت ارزش سرمايه ص ب كشوري,1,89900000,396459000000,4473,4410,4410,-63,-1.41,4410,-63,-1.41,4410,4410,1400-8-24,2021-11-15
938,پست0108پ09,پسته بادامي32-30مه ولات0108(پ),1,3,6520500,2000000,2173500,2173500,173500,8.68,2173500,173500,8.68,2173500,2173500,1400-8-24,2021-11-15
939,صمعاد407,صكوك اجاره معادن407-3ماهه18%,1,20,19900000,995000,995000,995000,0,0,995000,0,0,995000,995000,1400-8-24,2021-11-15
940,فولاد2,فولاد مباركه اصفهان,1,16000000,182400000000,11740,11400,11400,-340,-2.9,11400,-340,-2.9,11400,11400,1400-8-24,2021-11-15
941,ضفار1130,اختيارخ فارس-7400-1400/11/06,1,2,10000000,5270,5000,5000,-270,-5.12,5000,-270,-5.12,5000,5000,1400-8-24,2021-11-15
942,ضغدر1132,اختيارخ وغدير-14000-1400/11/20,1,1,2601000,1,2601,2601,2600,260000,2601,2600,260000,2601,2601,1400-8-24,2021-11-15
943,ضفار1131,اختيارخ فارس-8400-1400/11/06,1,5,20000000,1,4000,4000,3999,399900,4000,3999,399900,4000,4000,1400-8-24,2021-11-15
944,كمند4,صندوق س. با درآمد ثابت كمند,1,121800000,1223968200000,10044,10049,10049,5,0.05,10049,5,0.05,10049,10049,1400-8-24,2021-11-15
945,ضپيك1032,اختيارخ تاپيكو-16000-00/10/15,1,100,72000000,783,720,720,-63,-8.05,720,-63,-8.05,720,720,1400-8-24,2021-11-15
946,كگل2,معدني و صنعتي گل گهر,1,12500000,301250000000,24180,24100,24100,-80,-0.33,24100,-80,-0.33,24100,24100,1400-8-24,2021-11-15
947,صخابر1022,صكوك اجاره مخابرات-3 ماهه 16%,1,100000,99300000000,991500,993000,993000,1500,0.15,993000,1500,0.15,993000,993000,1400-8-24,2021-11-15
948,طجار1021,اختيارف وتجارت-1800-1400/10/15,1,40,2000000,50,50,50,0,0,50,0,0,50,50,1400-8-24,2021-11-15
949,هماي2,صندوق س هماي آگاه-ثابت,1,280000,280000,10135,1,1,-10134,-99.99,1,-10134,-99.99,1,1,1400-8-24,2021-11-15
950,اراد35,مرابحه عام دولت3-ش.خ 0103,1,100,97719900,967537,977199,977199,9662,1,977199,9662,1,977199,977199,1400-8-24,2021-11-15
951,صملي404,صكوك اجاره صملي404-6ماهه18%,1,10,9900000,990000,990000,990000,0,0,990000,0,0,990000,990000,1400-8-24,2021-11-15
952,ضپنا1031,اختيارخ رمپنا-13850-1400/10/08,1,13,46800000,4129,3600,3600,-529,-12.81,3600,-529,-12.81,3600,3600,1400-8-24,2021-11-15
953,هفجر102,اختيارف ت بفجر8626-01/02/11,1,1640,1640,1,1,1,0,0,1,0,0,1,1,1400-8-24,2021-11-15
954,اراد794,مرابحه عام دولت79-ش.خ010612,1,4785554,4595950350520,960000,960380,960380,380,0.04,960380,380,0.04,960380,960380,1400-8-24,2021-11-15
955,طپال2004,اختيارف اپال-20000-1401/02/12,1,1,700000,1,700,700,699,69900,700,699,69900,700,700,1400-8-24,2021-11-15
956,افران2,صندوق س افرا نماد پايدار-ثابت,1,1600000,1600000,14733,1,1,-14732,-99.99,1,-14732,-99.99,1,1,1400-8-24,2021-11-15
957,زرين2,صندوق س. سهام زرين كوروش-س,1,100000,100000,13650,1,1,-13649,-99.99,1,-13649,-99.99,1,1,1400-8-24,2021-11-15
958,بفجر2,فجر انرژي خليج فارس,1,3450000,40089000000,12230,11620,11620,-610,-4.99,11620,-610,-4.99,11620,11620,1400-8-24,2021-11-15
959,شتولي,تولي‌پرس‌,1,500,9926000,20679,19852,19852,-827,-4,20677,-2,-0.01,19852,19852,1400-8-24,2021-11-15
960,آوا2,صندوق س.سهام آواي معيار-س,1,400000,400000,8211,1,1,-8210,-99.99,1,-8210,-99.99,1,1,1400-8-24,2021-11-15
961,اراد86,مرابحه عام دولت86-ش.خ020404,1,1000,960000000,940000,960000,960000,20000,2.13,960000,20000,2.13,960000,960000,1400-8-24,2021-11-15
962,صايپا203,صكوك مرابحه سايپا203-3ماهه 16%,1,4200,3999244200,952200,952201,952201,1,0,952201,1,0,952201,952201,1400-8-24,2021-11-15
